Order_Quantity,Unit_Cost,Unit_Price,Profit,Cost,Revenue
1,1252,2295,561,1252,1813
2,2171,3578,1097,4342,5439
1,1519,2443,900,1519,2419
1,344,540,185,344,529
1,713,1120,385,713,1098
1,713,1120,362,713,1075
4,713,1120,687,2852,3539
1,1266,2320,961,1266,2227
4,1252,2295,3805,5008,8813
1,1266,2320,1008,1266,2274
2,344,540,198,688,886
1,713,1120,205,713,918
1,344,540,83,344,427
3,344,540,572,1032,1604
4,2171,3578,5342,8684,14026
3,1252,2295,2854,3756,6610
2,2171,3578,1884,4342,6226
2,487,783,561,974,1535
2,713,1120,321,1426,1747
1,2171,3578,620,2171,2791
1,487,783,280,487,767
1,1083,1701,499,1083,1582
3,487,783,865,1461,2326
3,295,540,719,885,1604
1,713,1120,385,713,1098
1,344,540,77,344,421
2,344,540,381,688,1069
1,2171,3578,1371,2171,3542
3,2171,3578,4006,6513,10519
1,713,1120,362,713,1075
1,1083,1701,397,1083,1480
2,1083,1701,1100,2166,3266
1,344,540,83,344,427
1,1252,2295,561,1252,1813
1,1252,2295,997,1252,2249
3,1083,1701,884,3249,4133
1,713,1120,385,713,1098
1,1083,1701,397,1083,1480
4,487,783,495,1948,2443
3,2171,3578,2718,6513,9231
4,2171,3578,2479,8684,11163
1,1555,2443,424,1555,1979
1,1083,1701,601,1083,1684
1,1083,1701,397,1083,1480
3,2171,3578,1860,6513,8373
3,2171,3578,4006,6513,10519
4,1266,2320,2546,5064,7610
3,2171,3578,2826,6513,9339
1,713,1120,161,713,874
1,1083,1701,397,1083,1480
2,1266,2320,1366,2532,3898
1,420,769,241,420,661
4,295,540,937,1180,2117
1,1555,2443,448,1555,2003
3,1555,2443,1711,4665,6376
1,713,1120,362,713,1075
1,2171,3578,1371,2171,3542
1,1519,2443,582,1519,2101
2,2171,3578,2671,4342,7013
1,2171,3578,763,2171,2934
1,2171,3578,1192,2171,3363
1,1555,2443,375,1555,1930
1,344,540,185,344,529
1,1555,2443,497,1555,2052
4,1555,2443,3454,6220,9674
1,2171,3578,1335,2171,3506
1,1555,2443,351,1555,1906
2,1083,1701,1100,2166,3266
1,2171,3578,1335,2171,3506
1,1266,2320,752,1266,2018
2,1252,2295,1352,2504,3856
3,1912,3400,2220,5736,7956
4,1083,1701,975,4332,5307
2,1555,2443,750,3110,3860
4,344,540,503,1376,1879
3,713,1120,683,2139,2822
1,344,540,174,344,518
1,487,783,124,487,611
3,1252,2295,1821,3756,5577
1,1266,2320,961,1266,2227
1,1252,2295,951,1252,2203
4,1898,3375,5638,7592,13230
2,2171,3578,2528,4342,6870
1,713,1120,261,713,974
1,1083,1701,397,1083,1480
1,1266,2320,752,1266,2018
1,1266,2320,752,1266,2018
1,1555,2443,570,1555,2125
1,1555,2443,570,1555,2125
1,487,783,132,487,619
1,344,540,191,344,535
1,1083,1701,397,1083,1480
3,1266,2320,2257,3798,6055
3,1252,2295,2234,3756,5990
4,1555,2443,1793,6220,8013
1,344,540,77,344,421
1,344,540,126,344,470
4,2171,3578,5342,8684,14026
1,2171,3578,1335,2171,3506
4,2171,3578,5342,8684,14026
4,713,1120,1046,2852,3898
1,1083,1701,397,1083,1480
1,344,540,83,344,427
1,1083,1701,550,1083,1633
3,344,540,523,1032,1555
1,713,1120,362,713,1075
1,1083,1701,550,1083,1633
3,713,1120,1087,2139,3226
2,1083,1701,1100,2166,3266
1,1555,2443,497,1555,2052
3,713,1120,751,2139,2890
1,2171,3578,620,2171,2791
1,2171,3578,1264,2171,3435
1,344,540,83,344,427
4,344,540,741,1376,2117
1,713,1120,205,713,918
1,713,1120,172,713,885
1,1555,2443,864,1555,2419
1,1266,2320,567,1266,1833
4,1912,3400,5000,7648,12648
2,2171,3578,2528,4342,6870
1,487,783,280,487,767
1,1555,2443,375,1555,1930
1,344,540,110,344,454
1,2171,3578,1335,2171,3506
3,1252,2295,3060,3756,6816
1,420,769,188,420,608
1,1912,3400,876,1912,2788
3,2171,3578,1967,6513,8480
1,487,783,280,487,767
1,1555,2443,839,1555,2394
2,1555,2443,1678,3110,4788
3,713,1120,515,2139,2654
1,344,540,83,344,427
4,1555,2443,1402,6220,7622
3,1555,2443,1345,4665,6010
1,2171,3578,1335,2171,3506
1,1912,3400,740,1912,2652
4,1555,2443,1402,6220,7622
4,1083,1701,975,4332,5307
3,1555,2443,1711,4665,6376
1,344,540,83,344,427
1,1555,2443,864,1555,2419
4,1555,2443,3454,6220,9674
2,2171,3578,1240,4342,5582
1,487,783,124,487,611
2,1083,1701,1168,2166,3334
1,713,1120,228,713,941
1,2171,3578,1335,2171,3506
3,1252,2295,2027,3756,5783
1,420,769,318,420,738
3,2171,3578,2504,6513,9017
1,1555,2443,375,1555,1930
4,2171,3578,2479,8684,11163
4,1266,2320,3010,5064,8074
1,1083,1701,312,1083,1395
3,1555,2443,1125,4665,5790
3,713,1120,784,2139,2923
1,2171,3578,620,2171,2791
1,1266,2320,752,1266,2018
1,487,783,124,487,611
3,1555,2443,2517,4665,7182
4,713,1120,1046,2852,3898
4,1519,2443,3012,6076,9088
1,487,783,124,487,611
4,1266,2320,3010,5064,8074
1,2171,3578,942,2171,3113
2,713,1120,523,1426,1949
2,1083,1701,522,2166,2688
1,2171,3578,942,2171,3113
1,1555,2443,497,1555,2052
1,713,1120,396,713,1109
1,1555,2443,839,1555,2394
1,344,540,83,344,427
3,344,540,232,1032,1264
2,1083,1701,1100,2166,3266
1,344,540,191,344,535
1,1083,1701,584,1083,1667
2,2171,3578,2671,4342,7013
1,1252,2295,745,1252,1997
4,1266,2320,2267,5064,7331
1,2171,3578,620,2171,2791
2,713,1120,321,1426,1747
1,487,783,124,487,611
4,1519,2443,2328,6076,8404
4,2171,3578,5342,8684,14026
1,344,540,185,344,529
1,1083,1701,550,1083,1633
3,1555,2443,1711,4665,6376
2,1555,2443,994,3110,4104
1,2171,3578,1371,2171,3542
3,1555,2443,1711,4665,6376
1,344,540,66,344,410
1,713,1120,396,713,1109
3,1083,1701,1191,3249,4440
4,344,540,698,1376,2074
1,713,1120,172,713,885
1,2171,3578,1371,2171,3542
2,1912,3400,2500,3824,6324
2,713,1120,792,1426,2218
2,713,1120,523,1426,1949
1,1083,1701,261,1083,1344
4,713,1120,1583,2852,4435
2,2171,3578,2671,4342,7013
1,2171,3578,1371,2171,3542
2,2171,3578,2528,4342,6870
2,344,540,381,688,1069
3,1083,1701,731,3249,3980
1,2171,3578,763,2171,2934
1,713,1120,172,713,885
1,344,540,99,344,443
4,487,783,1059,1948,3007
4,1252,2295,2428,5008,7436
2,1252,2295,1902,2504,4406
3,1898,3375,3014,5694,8708
1,1083,1701,550,1083,1633
1,2171,3578,1371,2171,3542
4,1083,1701,1587,4332,5919
1,1252,2295,1020,1252,2272
3,713,1120,482,2139,2621
1,1083,1701,431,1083,1514
1,344,540,120,344,464
1,1083,1701,346,1083,1429
1,344,540,174,344,518
1,344,540,120,344,464
1,2171,3578,1371,2171,3542
3,2171,3578,4114,6513,10627
2,2171,3578,2742,4342,7084
2,420,769,498,840,1338
1,1912,3400,740,1912,2652
2,2171,3578,1240,4342,5582
1,1555,2443,570,1555,2125
4,713,1120,1538,2852,4390
3,713,1120,515,2139,2654
2,1266,2320,1922,2532,4454
4,1519,2443,3598,6076,9674
3,487,783,841,1461,2302
1,1555,2443,497,1555,2052
1,1519,2443,826,1519,2345
3,1083,1701,1650,3249,4899
4,1083,1701,1587,4332,5919
1,1266,2320,1008,1266,2274
2,1252,2295,1902,2504,4406
1,1555,2443,546,1555,2101
4,1555,2443,3161,6220,9381
2,1555,2443,994,3110,4104
3,713,1120,1154,2139,3293
2,344,540,381,688,1069
4,1555,2443,3454,6220,9674
1,713,1120,329,713,1042
1,344,540,185,344,529
1,1555,2443,302,1555,1857
4,1555,2443,2282,6220,8502
3,1555,2443,1271,4665,5936
1,344,540,191,344,535
1,1083,1701,261,1083,1344
4,713,1120,1583,2852,4435
4,344,540,330,1376,1706
2,344,540,381,688,1069
1,1555,2443,864,1555,2419
2,2171,3578,2671,4342,7013
3,2171,3578,4114,6513,10627
4,2171,3578,5485,8684,14169
3,1252,2295,3060,3756,6816
1,713,1120,396,713,1109
1,2171,3578,1371,2171,3542
2,1266,2320,1922,2532,4454
2,1252,2295,2040,2504,4544
4,1555,2443,3454,6220,9674
2,1519,2443,1653,3038,4691
4,1555,2443,2868,6220,9088
1,713,1120,396,713,1109
1,2171,3578,1371,2171,3542
1,344,540,185,344,529
4,2171,3578,5056,8684,13740
1,2171,3578,1371,2171,3542
3,1083,1701,1803,3249,5052
1,1555,2443,375,1555,1930
3,487,783,794,1461,2255
4,344,540,762,1376,2138
1,2171,3578,620,2171,2791
1,1555,2443,546,1555,2101
2,1519,2443,1506,3038,4544
1,487,783,280,487,767
1,1555,2443,570,1555,2125
4,713,1120,1046,2852,3898
2,344,540,154,688,842
4,1898,3375,4018,7592,11610
1,1555,2443,375,1555,1930
3,344,540,296,1032,1328
3,1555,2443,2151,4665,6816
2,1555,2443,1141,3110,4251
1,2171,3578,1371,2171,3542
1,2171,3578,1335,2171,3506
1,2171,3578,763,2171,2934
2,713,1120,792,1426,2218
1,1083,1701,601,1083,1684
2,713,1120,523,1426,1949
1,1083,1701,397,1083,1480
1,713,1120,205,713,918
4,1083,1701,1587,4332,5919
1,344,540,191,344,535
1,1555,2443,497,1555,2052
2,1083,1701,692,2166,2858
1,1519,2443,900,1519,2419
1,1519,2443,900,1519,2419
1,2171,3578,1335,2171,3506
1,1555,2443,570,1555,2125
1,1252,2295,951,1252,2203
4,1252,2295,4080,5008,9088
2,2171,3578,1240,4342,5582
2,1555,2443,750,3110,3860
4,1555,2443,2282,6220,8502
2,1555,2443,994,3110,4104
4,344,540,762,1376,2138
1,1555,2443,570,1555,2125
1,713,1120,396,713,1109
1,713,1120,228,713,941
3,1555,2443,1711,4665,6376
4,1083,1701,2404,4332,6736
4,1083,1701,1043,4332,5375
4,713,1120,642,2852,3494
2,344,540,252,688,940
1,2171,3578,763,2171,2934
3,344,540,475,1032,1507
1,713,1120,385,713,1098
1,1083,1701,244,1083,1327
3,2171,3578,2826,6513,9339
3,713,1120,1187,2139,3326
1,1555,2443,375,1555,1930
1,713,1120,172,713,885
1,2171,3578,1371,2171,3542
1,344,540,185,344,529
1,1083,1701,499,1083,1582
3,1555,2443,1125,4665,5790
1,713,1120,172,713,885
1,2171,3578,1371,2171,3542
1,1252,2295,538,1252,1790
1,2171,3578,620,2171,2791
1,1555,2443,864,1555,2419
3,344,540,556,1032,1588
3,1555,2443,1491,4665,6156
2,1083,1701,590,2166,2756
3,1083,1701,1191,3249,4440
2,344,540,381,688,1069
1,344,540,191,344,535
2,2171,3578,2742,4342,7084
1,1519,2443,900,1519,2419
1,1555,2443,864,1555,2419
4,2171,3578,3052,8684,11736
4,2171,3578,4626,8684,13310
2,713,1120,792,1426,2218
1,1266,2320,1008,1266,2274
1,2171,3578,763,2171,2934
3,1555,2443,1711,4665,6376
2,2171,3578,2742,4342,7084
1,2171,3578,1335,2171,3506
1,1252,2295,607,1252,1859
1,2171,3578,620,2171,2791
2,2171,3578,1240,4342,5582
1,344,540,99,344,443
1,1555,2443,570,1555,2125
1,713,1120,396,713,1109
1,1266,2320,567,1266,1833
1,1555,2443,839,1555,2394
3,1555,2443,2517,4665,7182
3,1555,2443,1345,4665,6010
3,713,1120,616,2139,2755
1,713,1120,228,713,941
3,713,1120,683,2139,2822
4,420,769,996,1680,2676
1,2171,3578,1335,2171,3506
1,2171,3578,1335,2171,3506
1,713,1120,362,713,1075
1,1555,2443,790,1555,2345
1,1555,2443,375,1555,1930
4,1083,1701,1247,4332,5579
3,344,540,232,1032,1264
3,2171,3578,1860,6513,8373
2,420,769,498,840,1338
1,2171,3578,906,2171,3077
1,2171,3578,1264,2171,3435
1,344,540,158,344,502
4,1083,1701,975,4332,5307
4,1555,2443,2282,6220,8502
1,713,1120,385,713,1098
1,713,1120,261,713,974
1,1083,1701,244,1083,1327
1,344,540,120,344,464
1,713,1120,329,713,1042
2,1252,2295,1260,2504,3764
1,487,783,186,487,673
3,1555,2443,905,4665,5570
1,1555,2443,497,1555,2052
2,1555,2443,750,3110,3860
1,344,540,191,344,535
4,713,1120,1046,2852,3898
4,344,540,698,1376,2074
4,344,540,395,1376,1771
4,1252,2295,2244,5008,7252
1,420,769,249,420,669
2,1898,3375,1537,3796,5333
2,2171,3578,1812,4342,6154
4,487,783,1121,1948,3069
2,1083,1701,794,2166,2960
1,1555,2443,375,1555,1930
1,2171,3578,1335,2171,3506
1,2171,3578,942,2171,3113
4,1266,2320,4030,5064,9094
1,1266,2320,752,1266,2018
1,344,540,126,344,470
3,344,540,475,1032,1507
3,2171,3578,2718,6513,9231
4,1555,2443,3454,6220,9674
1,1555,2443,839,1555,2394
2,1555,2443,750,3110,3860
1,1555,2443,448,1555,2003
2,1555,2443,1092,3110,4202
1,713,1120,385,713,1098
2,2171,3578,2742,4342,7084
1,1252,2295,951,1252,2203
1,1266,2320,1008,1266,2274
4,1898,3375,3478,7592,11070
1,1519,2443,484,1519,2003
1,487,783,280,487,767
4,1555,2443,1988,6220,8208
1,1266,2320,752,1266,2018
4,713,1120,1538,2852,4390
3,344,540,329,1032,1361
1,713,1120,396,713,1109
1,713,1120,172,713,885
1,1266,2320,752,1266,2018
2,1266,2320,1366,2532,3898
1,295,540,234,295,529
3,1898,3375,3115,5694,8809
2,2171,3578,1240,4342,5582
1,1555,2443,375,1555,1930
1,1555,2443,570,1555,2125
4,344,540,741,1376,2117
4,344,540,741,1376,2117
1,2171,3578,1335,2171,3506
3,1252,2295,2991,3756,6747
1,2171,3578,763,2171,2934
4,344,540,438,1376,1814
1,2171,3578,1335,2171,3506
3,1266,2320,2048,3798,5846
1,420,769,249,420,669
2,1555,2443,1678,3110,4788
1,2171,3578,942,2171,3113
1,1555,2443,375,1555,1930
2,1555,2443,1434,3110,4544
4,344,540,741,1376,2117
1,713,1120,261,713,974
3,1519,2443,1746,4557,6303
2,2171,3578,2671,4342,7013
1,2171,3578,942,2171,3113
1,1555,2443,448,1555,2003
4,1555,2443,3357,6220,9577
1,2171,3578,1335,2171,3506
2,1555,2443,1727,3110,4837
2,1266,2320,1366,2532,3898
1,1266,2320,729,1266,1995
2,420,769,636,840,1476
4,1266,2320,2174,5064,7238
1,2171,3578,1335,2171,3506
1,344,540,110,344,454
3,487,783,724,1461,2185
3,713,1120,616,2139,2755
1,1555,2443,570,1555,2125
1,2171,3578,1335,2171,3506
1,2171,3578,1335,2171,3506
4,1555,2443,2868,6220,9088
1,1555,2443,790,1555,2345
4,344,540,741,1376,2117
3,344,540,523,1032,1555
3,344,540,556,1032,1588
4,1083,1701,2336,4332,6668
1,713,1120,205,713,918
2,487,783,263,974,1237
1,344,540,77,344,421
1,2171,3578,1335,2171,3506
3,1252,2295,1683,3756,5439
3,1252,2295,2027,3756,5783
4,2171,3578,5485,8684,14169
1,1083,1701,346,1083,1429
1,344,540,99,344,443
3,1555,2443,1711,4665,6376
2,344,540,370,688,1058
3,344,540,572,1032,1604
4,1083,1701,1587,4332,5919
2,1083,1701,1168,2166,3334
4,713,1120,1046,2852,3898
3,1555,2443,1125,4665,5790
3,344,540,523,1032,1555
2,1252,2295,1122,2504,3626
1,1266,2320,567,1266,1833
3,1252,2295,3060,3756,6816
4,1083,1701,1383,4332,5715
1,1555,2443,351,1555,1906
1,344,540,185,344,529
1,1252,2295,676,1252,1928
1,2171,3578,548,2171,2719
1,2171,3578,942,2171,3113
4,487,783,1121,1948,3069
1,1555,2443,448,1555,2003
4,1252,2295,2703,5008,7711
1,1252,2295,745,1252,1997
2,1912,3400,2092,3824,5916
4,2171,3578,5342,8684,14026
1,2171,3578,1371,2171,3542
1,1083,1701,584,1083,1667
1,1555,2443,375,1555,1930
1,1555,2443,375,1555,1930
4,1555,2443,2282,6220,8502
2,2171,3578,2671,4342,7013
4,344,540,698,1376,2074
1,2171,3578,620,2171,2791
3,1252,2295,2027,3756,5783
3,1555,2443,1125,4665,5790
1,1555,2443,497,1555,2052
1,1555,2443,570,1555,2125
1,713,1120,261,713,974
2,1912,3400,2024,3824,5848
2,2171,3578,2528,4342,6870
1,1555,2443,717,1555,2272
1,1083,1701,550,1083,1633
2,1555,2443,1141,3110,4251
1,344,540,191,344,535
1,2171,3578,1335,2171,3506
1,713,1120,172,713,885
4,2171,3578,5342,8684,14026
4,2171,3578,5342,8684,14026
1,713,1120,250,713,963
1,1083,1701,584,1083,1667
1,2171,3578,1335,2171,3506
4,713,1120,1449,2852,4301
1,2171,3578,763,2171,2934
2,1555,2443,1678,3110,4788
2,1083,1701,522,2166,2688
1,713,1120,205,713,918
1,713,1120,172,713,885
1,2171,3578,1335,2171,3506
2,1266,2320,1783,2532,4315
4,2171,3578,5342,8684,14026
1,1555,2443,839,1555,2394
1,344,540,185,344,529
1,713,1120,172,713,885
1,2171,3578,1335,2171,3506
1,487,783,280,487,767
1,2171,3578,942,2171,3113
1,1555,2443,570,1555,2125
2,344,540,370,688,1058
1,1266,2320,752,1266,2018
4,1912,3400,4048,7648,11696
1,1555,2443,717,1555,2272
3,344,540,572,1032,1604
2,2171,3578,2313,4342,6655
2,344,540,370,688,1058
1,344,540,185,344,529
4,713,1120,1046,2852,3898
4,344,540,330,1376,1706
2,295,540,252,590,842
2,2171,3578,1669,4342,6011
1,1083,1701,312,1083,1395
4,1266,2320,2267,5064,7331
1,2171,3578,620,2171,2791
1,1555,2443,790,1555,2345
1,713,1120,250,713,963
4,487,783,526,1948,2474
3,344,540,248,1032,1280
4,344,540,762,1376,2138
3,713,1120,515,2139,2654
1,344,540,191,344,535
1,1252,2295,745,1252,1997
2,1266,2320,1087,2532,3619
1,2171,3578,620,2171,2791
3,2171,3578,3470,6513,9983
1,713,1120,385,713,1098
3,344,540,232,1032,1264
1,713,1120,261,713,974
4,1266,2320,3566,5064,8630
4,487,783,495,1948,2443
1,1083,1701,584,1083,1667
1,713,1120,385,713,1098
1,487,783,194,487,681
1,1252,2295,997,1252,2249
1,713,1120,385,713,1098
4,713,1120,1046,2852,3898
1,344,540,191,344,535
1,2171,3578,1371,2171,3542
1,1266,2320,683,1266,1949
1,1252,2295,561,1252,1813
1,2171,3578,1335,2171,3506
1,2171,3578,1335,2171,3506
2,2171,3578,2528,4342,6870
1,2171,3578,763,2171,2934
4,1555,2443,1695,6220,7915
2,344,540,349,688,1037
1,487,783,124,487,611
1,1555,2443,448,1555,2003
3,713,1120,616,2139,2755
1,2171,3578,1371,2171,3542
1,2171,3578,1264,2171,3435
1,2171,3578,763,2171,2934
3,1555,2443,1711,4665,6376
1,344,540,126,344,470
2,2171,3578,2671,4342,7013
3,1252,2295,2991,3756,6747
1,2171,3578,1157,2171,3328
1,1083,1701,397,1083,1480
4,2171,3578,2479,8684,11163
1,344,540,158,344,502
2,1266,2320,1273,2532,3805
1,420,769,249,420,669
1,1266,2320,1031,1266,2297
1,2171,3578,620,2171,2791
1,1083,1701,397,1083,1480
4,1555,2443,1988,6220,8208
1,1252,2295,997,1252,2249
1,1266,2320,683,1266,1949
4,2171,3578,2479,8684,11163
2,1555,2443,1434,3110,4544
1,2171,3578,1264,2171,3435
1,487,783,155,487,642
4,713,1120,642,2852,3494
1,1555,2443,839,1555,2394
1,1083,1701,346,1083,1429
1,487,783,288,487,775
1,2171,3578,620,2171,2791
1,2171,3578,1335,2171,3506
3,1266,2320,2257,3798,6055
1,295,540,148,295,443
1,1555,2443,448,1555,2003
1,487,783,288,487,775
1,1555,2443,717,1555,2272
4,2171,3578,3767,8684,12451
4,2171,3578,5342,8684,14026
1,1252,2295,745,1252,1997
1,420,769,249,420,669
1,2171,3578,620,2171,2791
3,2171,3578,3792,6513,10305
4,487,783,1121,1948,3069
1,1555,2443,497,1555,2052
1,344,540,126,344,470
2,344,540,370,688,1058
3,344,540,556,1032,1588
1,2171,3578,1371,2171,3542
3,344,540,523,1032,1555
3,713,1120,784,2139,2923
3,344,540,248,1032,1280
1,1266,2320,752,1266,2018
3,1266,2320,2257,3798,6055
4,1252,2295,2703,5008,7711
3,1252,2295,2991,3756,6747
1,2171,3578,1335,2171,3506
1,344,540,185,344,529
4,1555,2443,3454,6220,9674
1,1266,2320,752,1266,2018
3,1252,2295,2234,3756,5990
2,1519,2443,1506,3038,4544
2,487,783,561,974,1535
1,713,1120,161,713,874
4,1519,2443,3598,6076,9674
2,2171,3578,2742,4342,7084
1,2171,3578,1335,2171,3506
4,2171,3578,2479,8684,11163
1,487,783,280,487,767
1,1555,2443,717,1555,2272
1,1555,2443,497,1555,2052
3,344,540,556,1032,1588
3,344,540,361,1032,1393
1,344,540,191,344,535
1,713,1120,261,713,974
4,1252,2295,3988,5008,8996
1,2171,3578,906,2171,3077
1,713,1120,385,713,1098
1,1083,1701,601,1083,1684
2,1266,2320,1505,2532,4037
1,308,565,138,308,446
1,2171,3578,942,2171,3113
3,2171,3578,2504,6513,9017
2,1555,2443,994,3110,4104
1,1555,2443,375,1555,1930
1,344,540,191,344,535
4,344,540,741,1376,2117
3,344,540,248,1032,1280
1,2171,3578,1335,2171,3506
1,344,540,83,344,427
4,1252,2295,2520,5008,7528
1,308,565,184,308,492
1,487,783,280,487,767
4,1555,2443,2282,6220,8502
3,1555,2443,1491,4665,6156
1,1252,2295,538,1252,1790
4,487,783,495,1948,2443
1,2171,3578,656,2171,2827
4,713,1120,1583,2852,4435
1,308,565,184,308,492
4,487,783,1121,1948,3069
1,487,783,280,487,767
1,2171,3578,942,2171,3113
2,1555,2443,1141,3110,4251
3,1083,1701,1038,3249,4287
4,713,1120,1538,2852,4390
2,344,540,262,688,950
1,344,540,126,344,470
2,2171,3578,2671,4342,7013
1,1252,2295,745,1252,1997
2,487,783,310,974,1284
3,344,540,556,1032,1588
1,344,540,83,344,427
1,1266,2320,1031,1266,2297
1,1252,2295,676,1252,1928
1,1898,3375,735,1898,2633
2,2171,3578,2671,4342,7013
1,1083,1701,499,1083,1582
1,1083,1701,312,1083,1395
3,1555,2443,1711,4665,6376
1,713,1120,385,713,1098
3,2171,3578,3470,6513,9983
1,1555,2443,790,1555,2345
1,1083,1701,550,1083,1633
4,1555,2443,1793,6220,8013
1,420,769,249,420,669
2,2171,3578,1240,4342,5582
1,2171,3578,1264,2171,3435
1,487,783,124,487,611
1,2171,3578,763,2171,2934
1,1083,1701,584,1083,1667
1,1083,1701,312,1083,1395
4,1555,2443,3357,6220,9577
1,2171,3578,1335,2171,3506
3,1083,1701,1191,3249,4440
1,713,1120,385,713,1098
2,713,1120,411,1426,1837
3,713,1120,1154,2139,3293
1,713,1120,385,713,1098
1,713,1120,396,713,1109
1,344,540,185,344,529
4,1266,2320,2731,5064,7795
1,1266,2320,752,1266,2018
4,344,540,266,1376,1642
4,2171,3578,5342,8684,14026
3,487,783,841,1461,2302
2,1555,2443,750,3110,3860
3,1555,2443,1491,4665,6156
1,344,540,185,344,529
1,1555,2443,864,1555,2419
1,1555,2443,864,1555,2419
1,2171,3578,620,2171,2791
1,420,769,249,420,669
1,1252,2295,951,1252,2203
4,420,769,1273,1680,2953
4,2171,3578,2479,8684,11163
2,487,783,310,974,1284
2,713,1120,769,1426,2195
1,2171,3578,1335,2171,3506
3,713,1120,784,2139,2923
2,713,1120,344,1426,1770
1,487,783,288,487,775
4,2171,3578,5485,8684,14169
2,2171,3578,2671,4342,7013
1,2171,3578,1335,2171,3506
2,2171,3578,1812,4342,6154
3,1519,2443,2625,4557,7182
1,487,783,280,487,767
3,713,1120,1154,2139,3293
1,713,1120,385,713,1098
1,1555,2443,839,1555,2394
2,713,1120,769,1426,2195
1,1555,2443,570,1555,2125
1,1083,1701,346,1083,1429
2,344,540,252,688,940
4,2171,3578,2479,8684,11163
1,2171,3578,1335,2171,3506
2,2171,3578,2671,4342,7013
1,713,1120,385,713,1098
1,2171,3578,942,2171,3113
3,344,540,556,1032,1588
1,1083,1701,601,1083,1684
3,713,1120,1154,2139,3293
2,1519,2443,1506,3038,4544
1,344,540,185,344,529
2,344,540,198,688,886
1,2171,3578,1335,2171,3506
2,420,769,498,840,1338
4,1252,2295,2979,5008,7987
3,1519,2443,2625,4557,7182
2,1555,2443,1141,3110,4251
4,487,783,1121,1948,3069
1,2171,3578,656,2171,2827
4,2171,3578,3767,8684,12451
2,344,540,219,688,907
1,713,1120,385,713,1098
1,713,1120,396,713,1109
1,344,540,110,344,454
1,1252,2295,997,1252,2249
3,1252,2295,2991,3756,6747
1,1555,2443,864,1555,2419
1,1519,2443,387,1519,1906
1,1555,2443,570,1555,2125
4,1266,2320,2731,5064,7795
1,1266,2320,1008,1266,2274
2,1266,2320,1273,2532,3805
4,2171,3578,2479,8684,11163
1,487,783,280,487,767
1,344,540,83,344,427
4,487,783,1059,1948,3007
1,344,540,126,344,470
1,344,540,126,344,470
2,1266,2320,1366,2532,3898
3,1266,2320,3023,3798,6821
1,1083,1701,584,1083,1667
4,344,540,503,1376,1879
3,2171,3578,4006,6513,10519
1,1252,2295,1020,1252,2272
3,1266,2320,2257,3798,6055
1,2171,3578,906,2171,3077
1,2171,3578,620,2171,2791
1,2171,3578,1335,2171,3506
1,2171,3578,548,2171,2719
1,1083,1701,550,1083,1633
3,713,1120,1154,2139,3293
4,344,540,395,1376,1771
1,2171,3578,1335,2171,3506
3,420,769,678,1260,1938
4,1519,2443,1546,6076,7622
1,1555,2443,839,1555,2394
1,344,540,191,344,535
2,1083,1701,794,2166,2960
1,713,1120,172,713,885
2,1252,2295,1902,2504,4406
2,487,783,388,974,1362
2,713,1120,769,1426,2195
1,1252,2295,561,1252,1813
2,1266,2320,1134,2532,3666
4,1555,2443,3357,6220,9577
2,2171,3578,1812,4342,6154
1,1898,3375,1038,1898,2936
3,2171,3578,1860,6513,8373
4,344,540,438,1376,1814
4,1083,1701,2200,4332,6532
2,1083,1701,998,2166,3164
4,1555,2443,1500,6220,7720
1,1083,1701,499,1083,1582
2,344,540,349,688,1037
4,2171,3578,5485,8684,14169
1,1252,2295,997,1252,2249
1,1252,2295,745,1252,1997
1,308,565,184,308,492
4,1252,2295,3988,5008,8996
2,2171,3578,1240,4342,5582
1,2171,3578,763,2171,2934
1,713,1120,385,713,1098
1,713,1120,261,713,974
1,487,783,124,487,611
2,1555,2443,603,3110,3713
3,1555,2443,1125,4665,5790
1,1083,1701,346,1083,1429
4,1083,1701,1587,4332,5919
1,1266,2320,1008,1266,2274
4,1252,2295,4080,5008,9088
1,1083,1701,397,1083,1480
1,1083,1701,312,1083,1395
4,713,1120,822,2852,3674
1,2171,3578,1335,2171,3506
2,2171,3578,2671,4342,7013
1,1555,2443,595,1555,2150
4,1555,2443,1500,6220,7720
2,1555,2443,1141,3110,4251
1,1083,1701,584,1083,1667
3,1083,1701,1191,3249,4440
1,2171,3578,1335,2171,3506
3,1266,2320,2257,3798,6055
1,308,565,184,308,492
3,2171,3578,3040,6513,9553
4,1555,2443,3357,6220,9577
1,1555,2443,570,1555,2125
4,344,540,762,1376,2138
1,1083,1701,346,1083,1429
3,344,540,556,1032,1588
1,713,1120,396,713,1109
1,487,783,288,487,775
3,2171,3578,4006,6513,10519
1,1252,2295,1020,1252,2272
4,1266,2320,3845,5064,8909
1,420,769,249,420,669
2,2171,3578,2027,4342,6369
4,487,783,1121,1948,3069
4,1083,1701,2336,4332,6668
1,713,1120,396,713,1109
1,344,540,185,344,529
3,344,540,556,1032,1588
3,295,540,719,885,1604
1,1555,2443,302,1555,1857
2,344,540,381,688,1069
1,2171,3578,763,2171,2934
1,713,1120,261,713,974
3,1083,1701,935,3249,4184
1,713,1120,396,713,1109
1,713,1120,228,713,941
1,1266,2320,683,1266,1949
4,1266,2320,2731,5064,7795
1,1555,2443,839,1555,2394
1,1555,2443,717,1555,2272
1,713,1120,161,713,874
1,2171,3578,1335,2171,3506
1,1266,2320,683,1266,1949
1,1083,1701,550,1083,1633
3,1555,2443,1711,4665,6376
2,713,1120,769,1426,2195
3,344,540,556,1032,1588
1,344,540,191,344,535
2,1912,3400,1480,3824,5304
1,2171,3578,906,2171,3077
1,1519,2443,582,1519,2101
2,487,783,247,974,1221
2,1555,2443,897,3110,4007
3,2171,3578,2826,6513,9339
1,1898,3375,870,1898,2768
1,2171,3578,620,2171,2791
1,344,540,174,344,518
4,713,1120,1046,2852,3898
1,1555,2443,570,1555,2125
2,344,540,252,688,940
1,1252,2295,997,1252,2249
1,1252,2295,997,1252,2249
3,1555,2443,2591,4665,7256
2,1555,2443,750,3110,3860
3,1555,2443,1711,4665,6376
1,1083,1701,584,1083,1667
1,2171,3578,906,2171,3077
1,1252,2295,997,1252,2249
2,1266,2320,1366,2532,3898
1,1252,2295,997,1252,2249
4,1266,2320,4030,5064,9094
1,2171,3578,620,2171,2791
2,1555,2443,701,3110,3811
1,2171,3578,763,2171,2934
2,1083,1701,760,2166,2926
4,487,783,777,1948,2725
3,1252,2295,1683,3756,5439
1,308,565,246,308,554
4,2171,3578,2479,8684,11163
1,713,1120,385,713,1098
1,713,1120,161,713,874
2,1519,2443,1506,3038,4544
1,1519,2443,484,1519,2003
2,1555,2443,994,3110,4104
2,344,540,252,688,940
1,2171,3578,1335,2171,3506
3,713,1120,1087,2139,3226
1,487,783,280,487,767
1,2171,3578,656,2171,2827
4,713,1120,822,2852,3674
2,2171,3578,1240,4342,5582
3,1252,2295,2234,3756,5990
4,2171,3578,3052,8684,11736
1,2171,3578,620,2171,2791
1,344,540,99,344,443
4,344,540,503,1376,1879
2,1252,2295,1352,2504,3856
1,1083,1701,397,1083,1480
1,344,540,110,344,454
1,344,540,99,344,443
1,2171,3578,1335,2171,3506
1,2171,3578,1264,2171,3435
4,295,540,937,1180,2117
1,2171,3578,906,2171,3077
1,1083,1701,584,1083,1667
1,1083,1701,244,1083,1327
2,1555,2443,848,3110,3958
2,344,540,370,688,1058
2,2171,3578,2671,4342,7013
1,1266,2320,1008,1266,2274
1,487,783,186,487,673
3,713,1120,1154,2139,3293
4,713,1120,1449,2852,4301
1,2171,3578,763,2171,2934
1,344,540,110,344,454
1,344,540,185,344,529
4,420,769,1273,1680,2953
2,713,1120,724,1426,2150
1,2171,3578,763,2171,2934
2,1555,2443,1678,3110,4788
1,713,1120,228,713,941
3,1083,1701,1803,3249,5052
2,344,540,198,688,886
1,344,540,99,344,443
2,713,1120,523,1426,1949
2,344,540,219,688,907
1,1555,2443,570,1555,2125
1,344,540,126,344,470
1,1266,2320,567,1266,1833
3,713,1120,1187,2139,3326
2,487,783,247,974,1221
3,1252,2295,2854,3756,6610
1,1266,2320,1031,1266,2297
1,1083,1701,584,1083,1667
4,344,540,503,1376,1879
4,344,540,395,1376,1771
2,2171,3578,2742,4342,7084
3,2171,3578,4114,6513,10627
3,1266,2320,2257,3798,6055
1,2171,3578,1157,2171,3328
2,2171,3578,1884,4342,6226
1,713,1120,172,713,885
4,713,1120,1538,2852,4390
2,2171,3578,2671,4342,7013
1,1266,2320,1031,1266,2297
3,1252,2295,2991,3756,6747
3,1555,2443,2517,4665,7182
1,1555,2443,839,1555,2394
3,713,1120,784,2139,2923
1,2171,3578,1371,2171,3542
2,2171,3578,2671,4342,7013
2,308,565,333,616,949
3,1252,2295,2234,3756,5990
4,1252,2295,2520,5008,7528
3,2171,3578,2289,6513,8802
3,713,1120,1154,2139,3293
1,344,540,110,344,454
1,344,540,83,344,427
3,2171,3578,2718,6513,9231
1,308,565,138,308,446
3,1555,2443,2371,4665,7036
1,1083,1701,550,1083,1633
1,1555,2443,570,1555,2125
1,1519,2443,753,1519,2272
1,1555,2443,570,1555,2125
3,1083,1701,1752,3249,5001
4,344,540,330,1376,1706
1,1266,2320,683,1266,1949
1,1266,2320,683,1266,1949
1,487,783,132,487,619
2,344,540,154,688,842
1,487,783,124,487,611
1,295,540,132,295,427
1,295,540,126,295,421
1,1555,2443,839,1555,2394
1,1555,2443,839,1555,2394
3,1083,1701,1650,3249,4899
2,344,540,252,688,940
3,713,1120,784,2139,2923
3,713,1120,515,2139,2654
4,295,540,526,1180,1706
1,1555,2443,839,1555,2394
1,1555,2443,839,1555,2394
3,713,1120,616,2139,2755
4,487,783,1121,1948,3069
1,1252,2295,882,1252,2134
2,308,565,277,616,893
2,2171,3578,2313,4342,6655
1,713,1120,396,713,1109
2,487,783,373,974,1347
2,2171,3578,2313,4342,6655
1,487,783,124,487,611
1,1083,1701,380,1083,1463
3,1555,2443,1345,4665,6010
1,344,540,185,344,529
1,344,540,83,344,427
1,2171,3578,1335,2171,3506
1,1252,2295,745,1252,1997
3,1252,2295,1614,3756,5370
2,344,540,349,688,1037
1,344,540,83,344,427
1,1252,2295,745,1252,1997
2,1898,3375,2819,3796,6615
4,1555,2443,2282,6220,8502
1,2171,3578,1335,2171,3506
2,487,783,373,974,1347
1,1555,2443,839,1555,2394
1,1555,2443,570,1555,2125
1,487,783,155,487,642
3,344,540,556,1032,1588
2,2171,3578,2671,4342,7013
1,713,1120,385,713,1098
1,1519,2443,900,1519,2419
2,1555,2443,1141,3110,4251
1,1083,1701,244,1083,1327
2,1555,2443,750,3110,3860
4,1083,1701,1383,4332,5715
2,344,540,241,688,929
1,1555,2443,864,1555,2419
3,295,540,443,885,1328
2,1266,2320,1505,2532,4037
4,2171,3578,2479,8684,11163
1,344,540,126,344,470
2,713,1120,769,1426,2195
2,1083,1701,488,2166,2654
3,1555,2443,1711,4665,6376
1,1083,1701,380,1083,1463
1,1519,2443,484,1519,2003
2,713,1120,769,1426,2195
1,344,540,110,344,454
1,1252,2295,538,1252,1790
1,1898,3375,870,1898,2768
4,2171,3578,5342,8684,14026
4,1519,2443,3305,6076,9381
3,487,783,794,1461,2255
1,487,783,288,487,775
3,713,1120,1187,2139,3326
1,1555,2443,864,1555,2419
2,344,540,252,688,940
1,1083,1701,601,1083,1684
1,344,540,191,344,535
1,344,540,110,344,454
2,2171,3578,2671,4342,7013
1,308,565,184,308,492
1,1266,2320,1008,1266,2274
1,2171,3578,1335,2171,3506
4,1519,2443,3501,6076,9577
1,344,540,185,344,529
1,344,540,126,344,470
1,344,540,126,344,470
1,420,769,334,420,754
1,2171,3578,620,2171,2791
1,2171,3578,906,2171,3077
2,2171,3578,1884,4342,6226
1,713,1120,205,713,918
1,1555,2443,570,1555,2125
1,344,540,126,344,470
4,344,540,762,1376,2138
4,344,540,395,1376,1771
4,1252,2295,2520,5008,7528
2,2171,3578,2671,4342,7013
2,1555,2443,1678,3110,4788
2,344,540,219,688,907
1,1083,1701,261,1083,1344
2,308,565,503,616,1119
1,1252,2295,676,1252,1928
1,1266,2320,961,1266,2227
1,1912,3400,1420,1912,3332
4,2171,3578,3624,8684,12308
1,2171,3578,835,2171,3006
3,1555,2443,2517,4665,7182
1,713,1120,161,713,874
1,1555,2443,570,1555,2125
1,713,1120,250,713,963
1,344,540,120,344,464
1,713,1120,396,713,1109
2,713,1120,523,1426,1949
3,487,783,371,1461,1832
3,344,540,556,1032,1588
3,1266,2320,3023,3798,6821
1,2171,3578,906,2171,3077
4,2171,3578,5342,8684,14026
1,1555,2443,717,1555,2272
4,344,540,741,1376,2117
3,713,1120,784,2139,2923
2,344,540,252,688,940
2,420,769,636,840,1476
1,1519,2443,387,1519,1906
2,1555,2443,1678,3110,4788
3,344,540,232,1032,1264
1,2171,3578,906,2171,3077
2,1252,2295,1122,2504,3626
1,420,769,188,420,608
1,1555,2443,302,1555,1857
3,2171,3578,1645,6513,8158
3,2171,3578,3040,6513,9553
3,1083,1701,1752,3249,5001
2,344,540,349,688,1037
3,308,565,500,924,1424
1,2171,3578,620,2171,2791
1,487,783,280,487,767
1,487,783,280,487,767
3,713,1120,1154,2139,3293
2,344,540,154,688,842
1,713,1120,228,713,941
1,1083,1701,618,1083,1701
3,2171,3578,2718,6513,9231
2,295,540,479,590,1069
2,713,1120,500,1426,1926
4,344,540,309,1376,1685
3,713,1120,784,2139,2923
1,344,540,126,344,470
4,1252,2295,2703,5008,7711
2,1252,2295,1122,2504,3626
4,713,1120,1449,2852,4301
4,713,1120,1001,2852,3853
3,344,540,232,1032,1264
4,344,540,438,1376,1814
1,2171,3578,1371,2171,3542
2,2171,3578,2742,4342,7084
1,1252,2295,745,1252,1997
1,1912,3400,1420,1912,3332
1,2171,3578,1335,2171,3506
1,1083,1701,210,1083,1293
1,1555,2443,717,1555,2272
2,344,540,219,688,907
4,295,540,699,1180,1879
4,1266,2320,3010,5064,8074
1,1252,2295,745,1252,1997
3,344,540,232,1032,1264
3,1083,1701,1497,3249,4746
4,1083,1701,1247,4332,5579
1,487,783,241,487,728
1,1083,1701,397,1083,1480
1,1083,1701,312,1083,1395
3,344,540,556,1032,1588
1,344,540,174,344,518
4,1252,2295,4080,5008,9088
3,2171,3578,4006,6513,10519
1,1519,2443,582,1519,2101
2,1519,2443,1750,3038,4788
1,713,1120,385,713,1098
4,1555,2443,1793,6220,8013
1,1555,2443,375,1555,1930
1,1555,2443,448,1555,2003
1,344,540,185,344,529
1,713,1120,172,713,885
1,344,540,126,344,470
3,2171,3578,4006,6513,10519
1,344,540,185,344,529
3,420,769,1024,1260,2284
1,713,1120,362,713,1075
1,1519,2443,875,1519,2394
1,1555,2443,717,1555,2272
1,344,540,77,344,421
1,1519,2443,484,1519,2003
1,487,783,155,487,642
1,713,1120,385,713,1098
1,1083,1701,346,1083,1429
3,1266,2320,1909,3798,5707
3,1252,2295,2027,3756,5783
4,1555,2443,3161,6220,9381
2,1555,2443,701,3110,3811
1,1083,1701,210,1083,1293
3,1083,1701,1803,3249,5052
2,344,540,198,688,886
4,2171,3578,5485,8684,14169
1,344,540,191,344,535
1,1555,2443,864,1555,2419
1,1252,2295,561,1252,1813
1,420,769,318,420,738
1,1555,2443,302,1555,1857
2,1083,1701,1100,2166,3266
1,1083,1701,397,1083,1480
1,344,540,185,344,529
3,713,1120,1187,2139,3326
1,344,540,126,344,470
4,1083,1701,1043,4332,5375
1,344,540,110,344,454
4,344,540,698,1376,2074
3,308,565,415,924,1339
4,1252,2295,2979,5008,7987
1,1252,2295,745,1252,1997
2,1519,2443,1750,3038,4788
2,344,540,198,688,886
1,713,1120,385,713,1098
1,1555,2443,570,1555,2125
1,1083,1701,244,1083,1327
1,344,540,196,344,540
3,1266,2320,3092,3798,6890
4,713,1120,1449,2852,4301
2,1555,2443,701,3110,3811
1,1555,2443,497,1555,2052
1,1083,1701,397,1083,1480
4,2171,3578,5628,8684,14312
3,1252,2295,1683,3756,5439
3,1266,2320,1631,3798,5429
1,1266,2320,1008,1266,2274
4,1555,2443,2184,6220,8404
1,344,540,185,344,529
3,2171,3578,4006,6513,10519
3,713,1120,1154,2139,3293
1,1519,2443,826,1519,2345
3,487,783,724,1461,2185
3,1555,2443,1491,4665,6156
1,1555,2443,570,1555,2125
3,344,540,377,1032,1409
1,1252,2295,745,1252,1997
3,420,769,1001,1260,2261
2,1252,2295,1443,2504,3947
1,713,1120,385,713,1098
3,487,783,841,1461,2302
3,2171,3578,1860,6513,8373
4,1083,1701,2200,4332,6532
1,1555,2443,448,1555,2003
1,487,783,288,487,775
1,1555,2443,375,1555,1930
4,1083,1701,1043,4332,5375
1,2171,3578,1335,2171,3506
3,1252,2295,2234,3756,5990
1,1252,2295,538,1252,1790
3,1555,2443,1638,4665,6303
1,713,1120,385,713,1098
1,487,783,186,487,673
1,1083,1701,584,1083,1667
1,487,783,194,487,681
2,344,540,349,688,1037
1,1252,2295,745,1252,1997
2,1266,2320,1922,2532,4454
3,308,565,703,924,1627
1,1252,2295,997,1252,2249
4,1519,2443,2328,6076,8404
4,1519,2443,3501,6076,9577
1,487,783,280,487,767
1,713,1120,205,713,918
3,713,1120,1087,2139,3226
2,713,1120,500,1426,1926
2,2171,3578,2671,4342,7013
1,2171,3578,1335,2171,3506
4,1252,2295,3805,5008,8813
3,420,769,1001,1260,2261
3,1252,2295,2991,3756,6747
3,487,783,371,1461,1832
1,713,1120,161,713,874
2,1083,1701,692,2166,2858
2,1083,1701,794,2166,2960
2,344,540,154,688,842
3,344,540,232,1032,1264
1,344,540,191,344,535
4,2171,3578,3767,8684,12451
3,344,540,232,1032,1264
3,487,783,841,1461,2302
1,344,540,191,344,535
1,1252,2295,630,1252,1882
1,1266,2320,567,1266,1833
1,344,540,99,344,443
4,1519,2443,2328,6076,8404
1,487,783,194,487,681
4,713,1120,687,2852,3539
1,420,769,334,420,754
1,2171,3578,620,2171,2791
2,1555,2443,1678,3110,4788
3,1083,1701,1752,3249,5001
1,2171,3578,1157,2171,3328
1,344,540,77,344,421
2,1083,1701,488,2166,2654
3,1555,2443,1345,4665,6010
1,1083,1701,397,1083,1480
2,344,540,219,688,907
4,2171,3578,5485,8684,14169
4,1252,2295,2979,5008,7987
1,1266,2320,752,1266,2018
1,1252,2295,492,1252,1744
1,713,1120,385,713,1098
1,1555,2443,497,1555,2052
3,2171,3578,4006,6513,10519
1,2171,3578,1371,2171,3542
1,295,540,240,295,535
4,420,769,996,1680,2676
1,2171,3578,548,2171,2719
3,713,1120,751,2139,2890
2,1083,1701,760,2166,2926
2,487,783,388,974,1362
1,713,1120,396,713,1109
1,2171,3578,1335,2171,3506
1,1266,2320,752,1266,2018
4,2171,3578,3624,8684,12308
1,1519,2443,875,1519,2394
1,2171,3578,1157,2171,3328
4,487,783,1121,1948,3069
1,487,783,280,487,767
2,1555,2443,1141,3110,4251
4,713,1120,1001,2852,3853
4,1519,2443,3598,6076,9674
3,713,1120,616,2139,2755
1,1266,2320,1031,1266,2297
4,420,769,1273,1680,2953
2,2171,3578,2528,4342,6870
1,1555,2443,790,1555,2345
1,344,540,126,344,470
4,344,540,503,1376,1879
3,1083,1701,1191,3249,4440
1,344,540,185,344,529
2,713,1120,792,1426,2218
4,2171,3578,5342,8684,14026
1,2171,3578,1335,2171,3506
1,2171,3578,1335,2171,3506
4,1519,2443,3012,6076,9088
4,344,540,309,1376,1685
4,2171,3578,2479,8684,11163
1,1083,1701,397,1083,1480
1,713,1120,172,713,885
1,295,540,223,295,518
4,1266,2320,3845,5064,8909
4,1519,2443,1546,6076,7622
2,1519,2443,969,3038,4007
2,713,1120,769,1426,2195
3,2171,3578,4006,6513,10519
2,344,540,349,688,1037
1,2171,3578,763,2171,2934
1,2171,3578,978,2171,3149
1,1555,2443,570,1555,2125
1,1555,2443,790,1555,2345
1,1555,2443,570,1555,2125
3,1083,1701,782,3249,4031
2,1266,2320,2015,2532,4547
1,1266,2320,636,1266,1902
1,295,540,148,295,443
3,1555,2443,2591,4665,7256
3,487,783,371,1461,1832
1,487,783,280,487,767
2,1555,2443,1434,3110,4544
1,2171,3578,620,2171,2791
2,713,1120,388,1426,1814
1,1266,2320,683,1266,1949
3,2171,3578,3470,6513,9983
2,487,783,529,974,1503
1,1555,2443,570,1555,2125
1,487,783,288,487,775
1,295,540,234,295,529
1,420,769,334,420,754
3,2171,3578,3792,6513,10305
1,1555,2443,790,1555,2345
1,344,540,77,344,421
4,2171,3578,3767,8684,12451
1,2171,3578,835,2171,3006
1,2171,3578,620,2171,2791
4,1519,2443,3598,6076,9674
1,2171,3578,1335,2171,3506
1,1266,2320,683,1266,1949
1,713,1120,385,713,1098
1,2171,3578,835,2171,3006
2,713,1120,523,1426,1949
1,1083,1701,397,1083,1480
2,1083,1701,760,2166,2926
1,1519,2443,826,1519,2345
1,2171,3578,548,2171,2719
1,1555,2443,497,1555,2052
3,713,1120,751,2139,2890
2,344,540,219,688,907
3,1266,2320,2257,3798,6055
1,1266,2320,1008,1266,2274
3,1252,2295,2165,3756,5921
2,2171,3578,2671,4342,7013
4,1519,2443,2328,6076,8404
1,1555,2443,790,1555,2345
3,1555,2443,1491,4665,6156
1,1555,2443,375,1555,1930
2,2171,3578,2671,4342,7013
1,2171,3578,1371,2171,3542
1,1266,2320,752,1266,2018
4,1266,2320,3010,5064,8074
1,1266,2320,961,1266,2227
1,713,1120,161,713,874
1,2171,3578,620,2171,2791
1,487,783,194,487,681
1,1555,2443,497,1555,2052
1,1555,2443,570,1555,2125
2,2171,3578,2671,4342,7013
1,308,565,184,308,492
1,1266,2320,567,1266,1833
2,1252,2295,1076,2504,3580
1,1519,2443,753,1519,2272
2,344,540,154,688,842
4,713,1120,822,2852,3674
2,344,540,370,688,1058
1,1519,2443,900,1519,2419
1,344,540,185,344,529
3,1266,2320,3023,3798,6821
1,2171,3578,1335,2171,3506
1,2171,3578,1335,2171,3506
1,2171,3578,1264,2171,3435
3,487,783,747,1461,2208
1,1555,2443,351,1555,1906
1,713,1120,385,713,1098
1,713,1120,261,713,974
1,1555,2443,546,1555,2101
1,1519,2443,826,1519,2345
1,1083,1701,261,1083,1344
1,713,1120,161,713,874
1,713,1120,385,713,1098
4,344,540,741,1376,2117
1,1266,2320,613,1266,1879
1,1266,2320,1008,1266,2274
1,1252,2295,630,1252,1882
1,1555,2443,448,1555,2003
3,1083,1701,1038,3249,4287
2,713,1120,769,1426,2195
2,1083,1701,692,2166,2858
4,344,540,762,1376,2138
1,1519,2443,900,1519,2419
3,420,769,955,1260,2215
2,487,783,561,974,1535
1,1083,1701,244,1083,1327
1,1083,1701,244,1083,1327
1,713,1120,250,713,963
1,1555,2443,864,1555,2419
4,344,540,698,1376,2074
4,1266,2320,3845,5064,8909
1,308,565,167,308,475
3,295,540,719,885,1604
4,1252,2295,1969,5008,6977
3,2171,3578,2289,6513,8802
1,713,1120,385,713,1098
4,1083,1701,1043,4332,5375
1,344,540,110,344,454
1,1519,2443,900,1519,2419
1,1555,2443,864,1555,2419
2,487,783,576,974,1550
4,344,540,395,1376,1771
1,1266,2320,752,1266,2018
3,2171,3578,4006,6513,10519
3,487,783,371,1461,1832
3,344,540,556,1032,1588
1,1083,1701,397,1083,1480
1,344,540,185,344,529
1,713,1120,396,713,1109
1,713,1120,261,713,974
1,1083,1701,550,1083,1633
4,487,783,1153,1948,3101
1,2171,3578,1335,2171,3506
2,1252,2295,1076,2504,3580
4,2171,3578,5342,8684,14026
4,2171,3578,3624,8684,12308
1,1555,2443,864,1555,2419
4,344,540,330,1376,1706
2,713,1120,769,1426,2195
1,2171,3578,906,2171,3077
1,344,540,174,344,518
1,1266,2320,1008,1266,2274
2,1252,2295,1489,2504,3993
1,1555,2443,375,1555,1930
3,1083,1701,1038,3249,4287
1,713,1120,261,713,974
1,1083,1701,550,1083,1633
1,2171,3578,1335,2171,3506
1,344,540,110,344,454
3,308,565,551,924,1475
3,1083,1701,1497,3249,4746
3,713,1120,1154,2139,3293
1,713,1120,261,713,974
1,1252,2295,630,1252,1882
1,2171,3578,1157,2171,3328
3,1555,2443,1125,4665,5790
1,713,1120,261,713,974
1,1555,2443,864,1555,2419
1,1266,2320,683,1266,1949
1,295,540,234,295,529
4,1266,2320,4030,5064,9094
1,2171,3578,548,2171,2719
1,1555,2443,497,1555,2052
3,713,1120,683,2139,2822
3,1555,2443,1125,4665,5790
3,713,1120,1187,2139,3326
1,1519,2443,900,1519,2419
1,1252,2295,951,1252,2203
3,1266,2320,2048,3798,5846
3,1266,2320,1700,3798,5498
3,1252,2295,2234,3756,5990
1,1266,2320,1008,1266,2274
2,2171,3578,1240,4342,5582
1,1519,2443,582,1519,2101
1,1555,2443,619,1555,2174
1,2171,3578,835,2171,3006
1,344,540,126,344,470
4,713,1120,822,2852,3674
4,2171,3578,2622,8684,11306
1,1266,2320,1031,1266,2297
1,1266,2320,961,1266,2227
3,1252,2295,1614,3756,5370
2,2171,3578,2671,4342,7013
1,713,1120,161,713,874
1,1555,2443,839,1555,2394
3,2171,3578,1860,6513,8373
4,713,1120,1046,2852,3898
4,344,540,762,1376,2138
2,2171,3578,2671,4342,7013
1,1266,2320,1008,1266,2274
1,2171,3578,620,2171,2791
1,344,540,77,344,421
2,1519,2443,822,3038,3860
1,487,783,288,487,775
1,1555,2443,497,1555,2052
1,713,1120,362,713,1075
2,713,1120,769,1426,2195
1,2171,3578,1371,2171,3542
1,344,540,126,344,470
1,344,540,174,344,518
2,1519,2443,1799,3038,4837
2,1252,2295,1076,2504,3580
1,1266,2320,544,1266,1810
3,1519,2443,2625,4557,7182
4,2171,3578,2193,8684,10877
3,1555,2443,1345,4665,6010
1,308,565,138,308,446
1,1266,2320,567,1266,1833
1,1266,2320,1008,1266,2274
1,713,1120,385,713,1098
4,713,1120,1046,2852,3898
1,713,1120,261,713,974
1,344,540,191,344,535
1,1083,1701,261,1083,1344
3,1519,2443,2699,4557,7256
3,2171,3578,4114,6513,10627
3,308,565,551,924,1475
3,1266,2320,2257,3798,6055
2,1266,2320,1087,2532,3619
1,344,540,83,344,427
3,344,540,523,1032,1555
4,344,540,698,1376,2074
1,713,1120,228,713,941
2,1519,2443,1799,3038,4837
1,1266,2320,892,1266,2158
1,1252,2295,538,1252,1790
3,2171,3578,3470,6513,9983
1,344,540,174,344,518
2,487,783,561,974,1535
1,713,1120,261,713,974
1,344,540,120,344,464
1,713,1120,396,713,1109
1,1519,2443,900,1519,2419
2,1519,2443,1799,3038,4837
4,2171,3578,5342,8684,14026
4,1266,2320,3566,5064,8630
3,1555,2443,2371,4665,7036
4,2171,3578,5056,8684,13740
1,2171,3578,1157,2171,3328
1,713,1120,362,713,1075
4,1083,1701,2200,4332,6532
1,344,540,126,344,470
1,344,540,185,344,529
1,1083,1701,346,1083,1429
1,1519,2443,900,1519,2419
1,344,540,83,344,427
4,713,1120,1449,2852,4301
4,1266,2320,2267,5064,7331
1,1266,2320,683,1266,1949
2,1555,2443,1092,3110,4202
1,487,783,265,487,752
3,713,1120,1154,2139,3293
1,1555,2443,448,1555,2003
2,344,540,349,688,1037
2,713,1120,724,1426,2150
1,344,540,126,344,470
2,2171,3578,1240,4342,5582
1,308,565,138,308,446
1,1266,2320,729,1266,1995
3,295,540,524,885,1409
4,2171,3578,3767,8684,12451
1,1519,2443,387,1519,1906
2,713,1120,769,1426,2195
1,713,1120,161,713,874
1,487,783,280,487,767
2,1555,2443,750,3110,3860
1,344,540,174,344,518
2,1266,2320,1366,2532,3898
1,1555,2443,375,1555,1930
2,344,540,370,688,1058
1,1083,1701,550,1083,1633
2,344,540,252,688,940
4,1252,2295,2979,5008,7987
3,1266,2320,1909,3798,5707
1,1252,2295,882,1252,2134
1,487,783,280,487,767
1,2171,3578,656,2171,2827
3,713,1120,616,2139,2755
1,1519,2443,606,1519,2125
1,1555,2443,497,1555,2052
2,344,540,370,688,1058
3,344,540,523,1032,1555
2,344,540,381,688,1069
2,308,565,469,616,1085
4,1252,2295,2887,5008,7895
2,2171,3578,1240,4342,5582
3,713,1120,1087,2139,3226
1,1519,2443,875,1519,2394
1,713,1120,161,713,874
2,1519,2443,1506,3038,4544
2,1555,2443,1434,3110,4544
2,487,783,388,974,1362
1,1555,2443,570,1555,2125
2,344,540,381,688,1069
1,1252,2295,745,1252,1997
4,1252,2295,2152,5008,7160
2,2171,3578,1812,4342,6154
4,2171,3578,5056,8684,13740
1,2171,3578,763,2171,2934
1,713,1120,385,713,1098
3,487,783,371,1461,1832
4,487,783,965,1948,2913
1,1083,1701,244,1083,1327
1,1083,1701,550,1083,1633
3,344,540,556,1032,1588
3,713,1120,515,2139,2654
1,344,540,174,344,518
2,1252,2295,1122,2504,3626
1,1266,2320,1008,1266,2274
1,2171,3578,1264,2171,3435
1,487,783,186,487,673
4,1555,2443,3161,6220,9381
3,2171,3578,4114,6513,10627
1,713,1120,362,713,1075
4,344,540,438,1376,1814
3,2171,3578,4006,6513,10519
2,2171,3578,2671,4342,7013
1,2171,3578,1371,2171,3542
1,2171,3578,620,2171,2791
1,1555,2443,546,1555,2101
1,1519,2443,558,1519,2077
1,2171,3578,1264,2171,3435
1,713,1120,385,713,1098
1,487,783,124,487,611
4,487,783,1121,1948,3069
1,2171,3578,1335,2171,3506
2,1266,2320,1366,2532,3898
3,1266,2320,2396,3798,6194
3,1083,1701,1752,3249,5001
4,344,540,309,1376,1685
4,344,540,741,1376,2117
4,2171,3578,5342,8684,14026
4,295,540,526,1180,1706
1,1252,2295,1020,1252,2272
4,1083,1701,975,4332,5307
1,1083,1701,550,1083,1633
3,487,783,794,1461,2255
4,1083,1701,1587,4332,5919
1,713,1120,205,713,918
1,344,540,110,344,454
1,308,565,184,308,492
2,295,540,285,590,875
1,1266,2320,567,1266,1833
1,420,769,180,420,600
1,1252,2295,630,1252,1882
1,1519,2443,606,1519,2125
2,2171,3578,1669,4342,6011
1,1555,2443,497,1555,2052
1,1555,2443,570,1555,2125
3,344,540,556,1032,1588
1,1083,1701,550,1083,1633
1,1555,2443,864,1555,2419
2,1266,2320,2015,2532,4547
3,1083,1701,935,3249,4184
1,1083,1701,397,1083,1480
1,1555,2443,448,1555,2003
3,1555,2443,2371,4665,7036
4,1555,2443,2282,6220,8502
3,713,1120,1154,2139,3293
1,1555,2443,448,1555,2003
4,2171,3578,5342,8684,14026
1,1252,2295,745,1252,1997
1,1252,2295,630,1252,1882
2,1519,2443,969,3038,4007
1,1555,2443,570,1555,2125
1,1555,2443,375,1555,1930
2,1555,2443,1141,3110,4251
1,344,540,77,344,421
1,344,540,174,344,518
1,1252,2295,745,1252,1997
1,1519,2443,826,1519,2345
1,1555,2443,570,1555,2125
1,344,540,174,344,518
2,713,1120,411,1426,1837
1,344,540,110,344,454
1,713,1120,362,713,1075
1,1083,1701,550,1083,1633
3,1555,2443,1711,4665,6376
1,344,540,174,344,518
1,1555,2443,497,1555,2052
1,344,540,185,344,529
3,1083,1701,1038,3249,4287
1,344,540,174,344,518
3,344,540,296,1032,1328
3,1083,1701,935,3249,4184
3,1252,2295,2854,3756,6610
1,1252,2295,630,1252,1882
3,1519,2443,1453,4557,6010
1,1555,2443,448,1555,2003
1,1555,2443,717,1555,2272
4,1083,1701,2200,4332,6532
4,1555,2443,1988,6220,8208
2,2171,3578,2742,4342,7084
1,713,1120,261,713,974
3,1266,2320,1909,3798,5707
1,1266,2320,683,1266,1949
3,420,769,539,1260,1799
2,1252,2295,1994,2504,4498
2,1083,1701,488,2166,2654
1,1083,1701,550,1083,1633
1,1555,2443,570,1555,2125
3,344,540,523,1032,1555
2,1555,2443,1141,3110,4251
1,1252,2295,538,1252,1790
1,1252,2295,997,1252,2249
3,1555,2443,2151,4665,6816
1,2171,3578,1371,2171,3542
4,1519,2443,1937,6076,8013
1,1555,2443,570,1555,2125
1,1083,1701,346,1083,1429
1,344,540,174,344,518
1,2171,3578,1335,2171,3506
4,1252,2295,3805,5008,8813
3,1266,2320,1909,3798,5707
4,1083,1701,2336,4332,6668
1,1555,2443,546,1555,2101
2,1555,2443,1141,3110,4251
3,1555,2443,1711,4665,6376
3,344,540,523,1032,1555
3,344,540,523,1032,1555
4,1266,2320,2546,5064,7610
1,1519,2443,387,1519,1906
4,487,783,526,1948,2474
4,344,540,741,1376,2117
1,1083,1701,397,1083,1480
3,713,1120,515,2139,2654
1,2171,3578,1335,2171,3506
4,1252,2295,2979,5008,7987
1,1266,2320,1008,1266,2274
1,1252,2295,997,1252,2249
2,713,1120,500,1426,1926
1,487,783,280,487,767
1,1083,1701,244,1083,1327
1,1555,2443,570,1555,2125
1,344,540,77,344,421
1,1083,1701,397,1083,1480
1,344,540,174,344,518
1,2171,3578,620,2171,2791
2,1252,2295,1489,2504,3993
4,295,540,894,1180,2074
1,1252,2295,492,1252,1744
1,2171,3578,763,2171,2934
3,2171,3578,4114,6513,10627
3,1083,1701,1650,3249,4899
1,1555,2443,864,1555,2419
3,1555,2443,1711,4665,6376
1,344,540,77,344,421
1,1083,1701,397,1083,1480
1,1252,2295,561,1252,1813
3,2171,3578,3577,6513,10090
1,344,540,191,344,535
3,2171,3578,1860,6513,8373
1,1266,2320,961,1266,2227
1,1555,2443,570,1555,2125
4,1555,2443,2282,6220,8502
1,2171,3578,1335,2171,3506
1,2171,3578,1371,2171,3542
1,2171,3578,1371,2171,3542
1,1555,2443,570,1555,2125
1,1555,2443,375,1555,1930
1,1555,2443,570,1555,2125
3,1083,1701,1191,3249,4440
1,1252,2295,745,1252,1997
4,1252,2295,3988,5008,8996
4,1266,2320,2546,5064,7610
3,1555,2443,2517,4665,7182
1,2171,3578,1157,2171,3328
3,2171,3578,3792,6513,10305
1,1555,2443,570,1555,2125
1,713,1120,396,713,1109
1,1555,2443,570,1555,2125
1,713,1120,250,713,963
2,713,1120,321,1426,1747
1,713,1120,161,713,874
4,713,1120,822,2852,3674
4,1555,2443,2282,6220,8502
1,344,540,191,344,535
3,344,540,556,1032,1588
4,713,1120,1046,2852,3898
4,2171,3578,2479,8684,11163
1,420,769,334,420,754
4,1252,2295,2152,5008,7160
1,713,1120,250,713,963
2,1555,2443,1141,3110,4251
4,1555,2443,1500,6220,7720
2,713,1120,724,1426,2150
1,1083,1701,346,1083,1429
1,1266,2320,1008,1266,2274
1,1252,2295,997,1252,2249
3,2171,3578,2289,6513,8802
1,1083,1701,499,1083,1582
1,713,1120,396,713,1109
1,1083,1701,210,1083,1293
2,713,1120,411,1426,1837
1,713,1120,261,713,974
4,1555,2443,2282,6220,8502
4,713,1120,1046,2852,3898
2,1266,2320,1087,2532,3619
1,2171,3578,1335,2171,3506
1,1555,2443,448,1555,2003
1,2171,3578,942,2171,3113
1,1555,2443,619,1555,2174
1,2171,3578,1371,2171,3542
2,344,540,370,688,1058
2,1266,2320,1366,2532,3898
1,420,769,318,420,738
1,713,1120,385,713,1098
1,2171,3578,1264,2171,3435
4,1555,2443,1500,6220,7720
1,713,1120,385,713,1098
1,344,540,185,344,529
3,1555,2443,1711,4665,6376
1,1083,1701,397,1083,1480
2,1555,2443,1581,3110,4691
1,1555,2443,570,1555,2125
4,713,1120,1538,2852,4390
1,1555,2443,570,1555,2125
1,1555,2443,448,1555,2003
4,1555,2443,2282,6220,8502
1,1266,2320,892,1266,2158
1,295,540,223,295,518
3,1266,2320,1631,3798,5429
4,1252,2295,2152,5008,7160
4,1555,2443,1793,6220,8013
1,344,540,174,344,518
3,1083,1701,1803,3249,5052
2,2171,3578,1454,4342,5796
4,1083,1701,2200,4332,6532
3,713,1120,515,2139,2654
3,1252,2295,2991,3756,6747
1,1083,1701,584,1083,1667
3,713,1120,1154,2139,3293
1,1252,2295,538,1252,1790
1,1083,1701,601,1083,1684
1,1252,2295,1020,1252,2272
3,308,565,703,924,1627
2,2171,3578,2528,4342,6870
1,2171,3578,942,2171,3113
1,2171,3578,1157,2171,3328
2,1555,2443,603,3110,3713
2,713,1120,523,1426,1949
1,1519,2443,826,1519,2345
1,2171,3578,835,2171,3006
4,1083,1701,1587,4332,5919
3,344,540,523,1032,1555
2,344,540,198,688,886
1,344,540,174,344,518
1,344,540,83,344,427
2,1083,1701,794,2166,2960
4,2171,3578,5485,8684,14169
1,1266,2320,636,1266,1902
1,1252,2295,745,1252,1997
2,1252,2295,1902,2504,4406
1,487,783,280,487,767
3,713,1120,1154,2139,3293
2,1083,1701,692,2166,2858
2,487,783,576,974,1550
1,2171,3578,1335,2171,3506
3,1266,2320,2257,3798,6055
1,295,540,159,295,454
3,1252,2295,2234,3756,5990
2,1252,2295,1489,2504,3993
1,1519,2443,826,1519,2345
1,2171,3578,942,2171,3113
2,1083,1701,1168,2166,3334
1,2171,3578,1335,2171,3506
1,1266,2320,752,1266,2018
1,1898,3375,735,1898,2633
1,1555,2443,717,1555,2272
4,1555,2443,2282,6220,8502
4,344,540,503,1376,1879
1,1555,2443,375,1555,1930
1,713,1120,205,713,918
1,1266,2320,961,1266,2227
4,713,1120,1538,2852,4390
2,2171,3578,1884,4342,6226
1,1555,2443,790,1555,2345
4,1555,2443,2868,6220,9088
1,344,540,174,344,518
2,344,540,370,688,1058
4,1266,2320,2174,5064,7238
1,2171,3578,656,2171,2827
1,1555,2443,570,1555,2125
3,1252,2295,1614,3756,5370
3,1252,2295,2234,3756,5990
4,295,540,937,1180,2117
1,1266,2320,892,1266,2158
4,1083,1701,1587,4332,5919
1,344,540,83,344,427
2,713,1120,344,1426,1770
3,1266,2320,2048,3798,5846
4,2171,3578,3767,8684,12451
2,1083,1701,1168,2166,3334
1,1555,2443,497,1555,2052
3,1083,1701,1038,3249,4287
1,2171,3578,1335,2171,3506
1,713,1120,261,713,974
1,1252,2295,951,1252,2203
4,420,769,996,1680,2676
1,1555,2443,839,1555,2394
3,1555,2443,1345,4665,6010
4,1083,1701,1043,4332,5375
3,1555,2443,1345,4665,6010
4,344,540,762,1376,2138
2,1266,2320,1551,2532,4083
2,713,1120,724,1426,2150
3,344,540,410,1032,1442
1,308,565,184,308,492
1,487,783,280,487,767
3,1555,2443,2371,4665,7036
1,713,1120,261,713,974
1,1252,2295,607,1252,1859
4,295,540,958,1180,2138
1,344,540,131,344,475
1,1519,2443,900,1519,2419
1,1083,1701,295,1083,1378
4,1083,1701,1247,4332,5579
3,713,1120,784,2139,2923
3,308,565,703,924,1627
1,2171,3578,620,2171,2791
1,2171,3578,942,2171,3113
1,1555,2443,790,1555,2345
1,1083,1701,346,1083,1429
2,487,783,576,974,1550
1,1555,2443,570,1555,2125
2,344,540,349,688,1037
4,713,1120,687,2852,3539
1,713,1120,228,713,941
1,344,540,126,344,470
4,344,540,503,1376,1879
1,1266,2320,961,1266,2227
4,295,540,699,1180,1879
1,308,565,184,308,492
1,1252,2295,997,1252,2249
3,1252,2295,2234,3756,5990
1,487,783,155,487,642
3,1555,2443,1711,4665,6376
1,1083,1701,312,1083,1395
4,1555,2443,1988,6220,8208
1,344,540,99,344,443
2,344,540,241,688,929
3,2171,3578,1860,6513,8373
1,344,540,126,344,470
1,1266,2320,683,1266,1949
3,713,1120,784,2139,2923
1,1519,2443,900,1519,2419
2,344,540,165,688,853
1,487,783,241,487,728
4,713,1120,1046,2852,3898
1,1266,2320,961,1266,2227
3,2171,3578,1860,6513,8373
4,2171,3578,3767,8684,12451
1,713,1120,362,713,1075
4,1555,2443,1988,6220,8208
3,713,1120,583,2139,2722
1,1252,2295,997,1252,2249
1,1252,2295,951,1252,2203
4,1252,2295,2244,5008,7252
1,1519,2443,826,1519,2345
2,487,783,294,974,1268
4,487,783,1121,1948,3069
1,487,783,155,487,642
2,344,540,154,688,842
3,1083,1701,1038,3249,4287
1,1266,2320,1008,1266,2274
2,2171,3578,2742,4342,7084
1,1555,2443,717,1555,2272
4,1555,2443,1793,6220,8013
1,1083,1701,584,1083,1667
3,1555,2443,1052,4665,5717
1,1252,2295,561,1252,1813
1,308,565,138,308,446
1,1252,2295,745,1252,1997
1,1266,2320,544,1266,1810
4,1252,2295,2887,5008,7895
1,1252,2295,997,1252,2249
1,1083,1701,584,1083,1667
3,1252,2295,2234,3756,5990
1,1266,2320,752,1266,2018
3,1252,2295,2027,3756,5783
2,1252,2295,2040,2504,4544
1,1252,2295,882,1252,2134
2,420,769,498,840,1338
1,1266,2320,544,1266,1810
2,2171,3578,1240,4342,5582
1,1555,2443,375,1555,1930
1,713,1120,172,713,885
3,713,1120,784,2139,2923
4,344,540,698,1376,2074
3,1266,2320,2048,3798,5846
2,2171,3578,2528,4342,6870
1,1555,2443,351,1555,1906
3,2171,3578,3792,6513,10305
1,713,1120,362,713,1075
1,1555,2443,448,1555,2003
1,344,540,174,344,518
1,344,540,191,344,535
1,344,540,191,344,535
2,1266,2320,2015,2532,4547
2,1252,2295,1260,2504,3764
1,420,769,249,420,669
1,420,769,188,420,608
4,420,769,842,1680,2522
1,2171,3578,1264,2171,3435
3,487,783,724,1461,2185
1,1555,2443,570,1555,2125
3,344,540,248,1032,1280
2,2171,3578,2671,4342,7013
1,1266,2320,1008,1266,2274
3,1555,2443,2151,4665,6816
1,1083,1701,550,1083,1633
2,344,540,381,688,1069
1,344,540,185,344,529
4,344,540,762,1376,2138
1,1519,2443,900,1519,2419
1,1266,2320,567,1266,1833
1,1252,2295,630,1252,1882
1,1252,2295,676,1252,1928
1,1252,2295,630,1252,1882
1,1555,2443,448,1555,2003
1,1083,1701,499,1083,1582
1,1083,1701,550,1083,1633
1,420,769,226,420,646
2,1252,2295,2040,2504,4544
1,1266,2320,752,1266,2018
2,1266,2320,1505,2532,4037
3,344,540,410,1032,1442
1,2171,3578,656,2171,2827
2,1083,1701,1100,2166,3266
1,487,783,288,487,775
3,2171,3578,4114,6513,10627
4,1252,2295,2244,5008,7252
4,1266,2320,4030,5064,9094
4,1252,2295,2244,5008,7252
3,1252,2295,1890,3756,5646
2,713,1120,523,1426,1949
1,713,1120,228,713,941
1,487,783,288,487,775
3,1252,2295,1683,3756,5439
1,420,769,334,420,754
2,420,769,636,840,1476
1,2171,3578,763,2171,2934
1,1519,2443,606,1519,2125
1,713,1120,250,713,963
1,344,540,83,344,427
1,1083,1701,397,1083,1480
1,713,1120,228,713,941
1,344,540,191,344,535
3,344,540,572,1032,1604
1,713,1120,172,713,885
1,713,1120,385,713,1098
1,2171,3578,942,2171,3113
4,344,540,698,1376,2074
4,344,540,698,1376,2074
3,344,540,475,1032,1507
2,713,1120,456,1426,1882
2,1266,2320,1366,2532,3898
1,1266,2320,683,1266,1949
3,1555,2443,1711,4665,6376
1,1083,1701,346,1083,1429
1,487,783,241,487,728
4,344,540,503,1376,1879
3,1266,2320,2048,3798,5846
2,1252,2295,1902,2504,4406
4,420,769,1334,1680,3014
1,2171,3578,1335,2171,3506
1,1555,2443,546,1555,2101
3,713,1120,1154,2139,3293
3,2171,3578,3792,6513,10305
3,2171,3578,2289,6513,8802
1,487,783,155,487,642
4,1555,2443,1500,6220,7720
3,344,540,248,1032,1280
1,487,783,194,487,681
2,713,1120,769,1426,2195
1,1555,2443,717,1555,2272
2,344,540,370,688,1058
1,713,1120,172,713,885
1,344,540,174,344,518
1,1555,2443,546,1555,2101
1,487,783,280,487,767
1,713,1120,362,713,1075
1,487,783,241,487,728
1,344,540,83,344,427
3,344,540,248,1032,1280
4,1266,2320,3566,5064,8630
4,420,769,1334,1680,3014
3,487,783,583,1461,2044
3,344,540,248,1032,1280
1,308,565,133,308,441
1,1266,2320,1031,1266,2297
1,2171,3578,763,2171,2934
4,2171,3578,5056,8684,13740
4,2171,3578,3338,8684,12022
2,1555,2443,1141,3110,4251
1,1555,2443,546,1555,2101
3,1555,2443,1711,4665,6376
1,344,540,185,344,529
1,344,540,158,344,502
1,713,1120,228,713,941
1,2171,3578,906,2171,3077
2,713,1120,523,1426,1949
2,1266,2320,1273,2532,3805
3,1555,2443,1345,4665,6010
2,487,783,561,974,1535
1,1555,2443,717,1555,2272
1,713,1120,205,713,918
1,713,1120,362,713,1075
1,1555,2443,570,1555,2125
1,344,540,110,344,454
1,713,1120,172,713,885
1,1252,2295,997,1252,2249
3,713,1120,751,2139,2890
1,2171,3578,835,2171,3006
4,713,1120,1538,2852,4390
2,487,783,388,974,1362
1,420,769,188,420,608
2,295,540,479,590,1069
1,1252,2295,538,1252,1790
1,1519,2443,826,1519,2345
1,1555,2443,570,1555,2125
4,713,1120,1046,2852,3898
1,487,783,194,487,681
3,1266,2320,2675,3798,6473
4,1555,2443,3357,6220,9577
4,713,1120,1314,2852,4166
3,713,1120,515,2139,2654
3,1252,2295,2854,3756,6610
1,1252,2295,538,1252,1790
1,420,769,249,420,669
1,1555,2443,717,1555,2272
1,1555,2443,570,1555,2125
1,344,540,83,344,427
3,344,540,523,1032,1555
1,1252,2295,630,1252,1882
3,295,540,703,885,1588
2,1266,2320,2015,2532,4547
1,2171,3578,1264,2171,3435
3,2171,3578,2826,6513,9339
4,1083,1701,1996,4332,6328
3,713,1120,616,2139,2755
3,344,540,248,1032,1280
1,344,540,126,344,470
1,713,1120,228,713,941
4,487,783,683,1948,2631
2,1083,1701,794,2166,2960
1,344,540,120,344,464
4,1555,2443,2282,6220,8502
4,713,1120,911,2852,3763
1,1083,1701,550,1083,1633
1,344,540,174,344,518
1,1266,2320,1008,1266,2274
1,2171,3578,1335,2171,3506
4,1555,2443,1695,6220,7915
1,713,1120,329,713,1042
2,1252,2295,1489,2504,3993
1,1519,2443,387,1519,1906
1,1519,2443,387,1519,1906
3,1555,2443,1711,4665,6376
3,2171,3578,1860,6513,8373
1,1252,2295,997,1252,2249
1,1555,2443,839,1555,2394
1,344,540,174,344,518
1,1252,2295,997,1252,2249
3,1252,2295,2647,3756,6403
1,1083,1701,380,1083,1463
1,1519,2443,826,1519,2345
1,344,540,110,344,454
2,1083,1701,624,2166,2790
3,713,1120,683,2139,2822
1,713,1120,205,713,918
1,1252,2295,951,1252,2203
2,2171,3578,2528,4342,6870
1,1555,2443,570,1555,2125
1,344,540,158,344,502
2,344,540,219,688,907
1,2171,3578,620,2171,2791
1,1252,2295,997,1252,2249
1,713,1120,385,713,1098
1,487,783,132,487,619
1,713,1120,205,713,918
1,487,783,171,487,658
2,487,783,388,974,1362
1,713,1120,172,713,885
4,1266,2320,4030,5064,9094
2,1266,2320,1087,2532,3619
1,487,783,241,487,728
1,487,783,265,487,752
2,1252,2295,1352,2504,3856
4,1266,2320,4123,5064,9187
1,1266,2320,636,1266,1902
3,1266,2320,1631,3798,5429
1,1252,2295,997,1252,2249
1,344,540,126,344,470
1,1555,2443,497,1555,2052
4,1083,1701,1383,4332,5715
3,2171,3578,1860,6513,8373
2,1266,2320,1922,2532,4454
2,1252,2295,1902,2504,4406
4,2171,3578,3052,8684,11736
1,1083,1701,550,1083,1633
2,1083,1701,998,2166,3164
2,713,1120,792,1426,2218
4,2171,3578,2479,8684,11163
2,1252,2295,1994,2504,4498
1,487,783,280,487,767
1,2171,3578,835,2171,3006
2,487,783,529,974,1503
1,1252,2295,538,1252,1790
1,1519,2443,387,1519,1906
4,487,783,1121,1948,3069
1,487,783,194,487,681
4,713,1120,1046,2852,3898
1,1266,2320,1008,1266,2274
2,1266,2320,1458,2532,3990
1,1252,2295,997,1252,2249
3,2171,3578,2826,6513,9339
1,2171,3578,656,2171,2827
2,1083,1701,488,2166,2654
3,487,783,395,1461,1856
1,713,1120,250,713,963
1,1555,2443,570,1555,2125
1,1555,2443,790,1555,2345
1,1266,2320,544,1266,1810
3,1266,2320,3023,3798,6821
1,1519,2443,875,1519,2394
2,2171,3578,1884,4342,6226
1,487,783,194,487,681
1,487,783,265,487,752
3,1555,2443,1491,4665,6156
3,344,540,523,1032,1555
1,1266,2320,752,1266,2018
1,1252,2295,882,1252,2134
2,2171,3578,1526,4342,5868
3,1083,1701,1650,3249,4899
1,487,783,194,487,681
1,2171,3578,1335,2171,3506
1,1519,2443,387,1519,1906
2,1555,2443,897,3110,4007
3,1083,1701,1191,3249,4440
1,1083,1701,312,1083,1395
3,344,540,232,1032,1264
3,1083,1701,935,3249,4184
4,344,540,698,1376,2074
1,713,1120,228,713,941
1,713,1120,261,713,974
2,1519,2443,1799,3038,4837
2,713,1120,344,1426,1770
1,487,783,288,487,775
3,487,783,865,1461,2326
2,487,783,576,974,1550
2,1252,2295,1352,2504,3856
1,487,783,124,487,611
2,1519,2443,1653,3038,4691
1,713,1120,396,713,1109
1,344,540,174,344,518
3,344,540,377,1032,1409
1,1266,2320,752,1266,2018
1,487,783,155,487,642
1,713,1120,362,713,1075
4,1555,2443,1793,6220,8013
4,344,540,374,1376,1750
3,713,1120,583,2139,2722
1,1266,2320,961,1266,2227
4,1266,2320,4030,5064,9094
4,713,1120,1538,2852,4390
1,487,783,280,487,767
2,487,783,247,974,1221
2,1555,2443,1727,3110,4837
1,1555,2443,839,1555,2394
3,487,783,583,1461,2044
1,2171,3578,620,2171,2791
4,1252,2295,3988,5008,8996
1,1266,2320,961,1266,2227
1,2171,3578,1264,2171,3435
1,713,1120,385,713,1098
1,1555,2443,717,1555,2272
1,1555,2443,448,1555,2003
2,713,1120,792,1426,2218
1,1555,2443,570,1555,2125
1,1083,1701,397,1083,1480
1,344,540,185,344,529
3,344,540,232,1032,1264
2,420,769,667,840,1507
1,420,769,249,420,669
4,1519,2443,1546,6076,7622
1,487,783,280,487,767
1,713,1120,161,713,874
2,1083,1701,794,2166,2960
2,713,1120,411,1426,1837
4,344,540,698,1376,2074
3,344,540,377,1032,1409
1,1252,2295,951,1252,2203
2,1252,2295,1994,2504,4498
1,1252,2295,538,1252,1790
4,1555,2443,1402,6220,7622
3,2171,3578,2289,6513,8802
4,487,783,1121,1948,3069
2,1555,2443,1434,3110,4544
4,1519,2443,3305,6076,9381
1,713,1120,261,713,974
3,1083,1701,1650,3249,4899
1,713,1120,385,713,1098
1,1555,2443,570,1555,2125
1,713,1120,205,713,918
4,344,540,503,1376,1879
2,713,1120,388,1426,1814
1,1083,1701,550,1083,1633
4,420,769,996,1680,2676
1,1555,2443,546,1555,2101
1,713,1120,385,713,1098
4,1252,2295,2979,5008,7987
1,1266,2320,683,1266,1949
4,1252,2295,3988,5008,8996
1,1252,2295,997,1252,2249
4,2171,3578,5342,8684,14026
3,2171,3578,1645,6513,8158
1,2171,3578,1157,2171,3328
1,2171,3578,942,2171,3113
2,344,540,381,688,1069
1,344,540,185,344,529
1,1519,2443,900,1519,2419
1,2171,3578,620,2171,2791
2,344,540,252,688,940
1,1252,2295,745,1252,1997
3,420,769,955,1260,2215
1,1252,2295,1020,1252,2272
1,1266,2320,961,1266,2227
2,2171,3578,1526,4342,5868
1,1083,1701,397,1083,1480
4,420,769,1334,1680,3014
2,1266,2320,2015,2532,4547
2,2171,3578,2671,4342,7013
1,2171,3578,620,2171,2791
1,713,1120,385,713,1098
4,2171,3578,3767,8684,12451
1,1555,2443,448,1555,2003
3,1555,2443,2371,4665,7036
1,1519,2443,826,1519,2345
1,2171,3578,835,2171,3006
1,487,783,265,487,752
4,1083,1701,1247,4332,5579
1,1555,2443,497,1555,2052
1,1083,1701,397,1083,1480
1,344,540,185,344,529
4,713,1120,911,2852,3763
4,344,540,633,1376,2009
4,308,565,734,1232,1966
1,295,540,234,295,529
4,1266,2320,4123,5064,9187
2,1252,2295,1443,2504,3947
1,1083,1701,346,1083,1429
1,487,783,265,487,752
4,1555,2443,2282,6220,8502
4,1083,1701,1587,4332,5919
4,1083,1701,1043,4332,5375
4,713,1120,822,2852,3674
1,344,540,191,344,535
2,1898,3375,1537,3796,5333
1,1266,2320,892,1266,2158
1,2171,3578,942,2171,3113
2,1555,2443,994,3110,4104
1,487,783,241,487,728
1,1555,2443,570,1555,2125
2,1555,2443,1581,3110,4691
1,1252,2295,745,1252,1997
2,1252,2295,1489,2504,3993
1,1252,2295,951,1252,2203
1,295,540,234,295,529
1,1912,3400,740,1912,2652
2,1252,2295,1994,2504,4498
1,2171,3578,620,2171,2791
4,1083,1701,1043,4332,5375
2,1555,2443,750,3110,3860
3,713,1120,1087,2139,3226
1,1266,2320,1008,1266,2274
1,420,769,334,420,754
2,420,769,498,840,1338
1,1252,2295,1020,1252,2272
3,1252,2295,1890,3756,5646
4,1555,2443,3357,6220,9577
1,713,1120,161,713,874
4,1555,2443,1793,6220,8013
1,1555,2443,570,1555,2125
3,1555,2443,1345,4665,6010
1,487,783,280,487,767
1,713,1120,362,713,1075
2,1083,1701,692,2166,2858
3,344,540,556,1032,1588
4,1266,2320,3010,5064,8074
1,1266,2320,567,1266,1833
4,420,769,1334,1680,3014
2,1252,2295,1489,2504,3993
1,1266,2320,544,1266,1810
3,2171,3578,2826,6513,9339
1,2171,3578,763,2171,2934
3,1555,2443,2371,4665,7036
2,344,540,154,688,842
1,1519,2443,484,1519,2003
3,1555,2443,2151,4665,6816
4,487,783,777,1948,2725
1,487,783,155,487,642
3,1083,1701,1650,3249,4899
1,344,540,126,344,470
4,344,540,330,1376,1706
3,2171,3578,4006,6513,10519
3,1266,2320,2048,3798,5846
1,1252,2295,951,1252,2203
1,1252,2295,951,1252,2203
1,308,565,246,308,554
1,487,783,124,487,611
1,1083,1701,312,1083,1395
2,1083,1701,828,2166,2994
2,1555,2443,994,3110,4104
1,1555,2443,497,1555,2052
1,1083,1701,397,1083,1480
4,1083,1701,1587,4332,5919
1,344,540,83,344,427
1,1252,2295,997,1252,2249
1,420,769,188,420,608
2,1266,2320,1087,2532,3619
2,2171,3578,2671,4342,7013
1,2171,3578,1157,2171,3328
1,713,1120,161,713,874
3,2171,3578,2289,6513,8802
4,2171,3578,4626,8684,13310
1,344,540,185,344,529
2,1555,2443,897,3110,4007
2,2171,3578,1526,4342,5868
1,1555,2443,570,1555,2125
3,713,1120,986,2139,3125
4,344,540,330,1376,1706
1,713,1120,205,713,918
1,713,1120,172,713,885
1,1266,2320,1008,1266,2274
4,2171,3578,5056,8684,13740
3,1083,1701,935,3249,4184
2,487,783,529,974,1503
4,1555,2443,2282,6220,8502
2,1252,2295,1489,2504,3993
2,1252,2295,1489,2504,3993
1,1266,2320,636,1266,1902
1,2171,3578,763,2171,2934
1,487,783,186,487,673
2,487,783,373,974,1347
3,1555,2443,2151,4665,6816
1,713,1120,205,713,918
4,344,540,762,1376,2138
1,713,1120,228,713,941
1,2171,3578,1335,2171,3506
2,1266,2320,1087,2532,3619
1,420,769,249,420,669
1,1266,2320,752,1266,2018
1,2171,3578,942,2171,3113
1,1555,2443,839,1555,2394
1,713,1120,362,713,1075
4,713,1120,1538,2852,4390
4,1555,2443,1988,6220,8208
4,344,540,330,1376,1706
4,1083,1701,1587,4332,5919
1,713,1120,228,713,941
4,1266,2320,3010,5064,8074
3,1252,2295,2991,3756,6747
4,308,565,734,1232,1966
3,420,769,955,1260,2215
1,1266,2320,544,1266,1810
3,1266,2320,1909,3798,5707
1,1252,2295,630,1252,1882
3,1519,2443,2259,4557,6816
1,713,1120,261,713,974
2,344,540,165,688,853
4,1252,2295,2887,5008,7895
2,1252,2295,1765,2504,4269
2,295,540,296,590,886
4,295,540,526,1180,1706
4,1252,2295,2703,5008,7711
4,1252,2295,3988,5008,8996
4,1898,3375,4018,7592,11610
1,1266,2320,544,1266,1810
4,1266,2320,3010,5064,8074
4,1252,2295,2520,5008,7528
4,1519,2443,3110,6076,9186
3,713,1120,784,2139,2923
1,1083,1701,397,1083,1480
1,713,1120,261,713,974
4,1898,3375,3073,7592,10665
1,1266,2320,683,1266,1949
4,1252,2295,2703,5008,7711
1,1266,2320,567,1266,1833
3,295,540,719,885,1604
3,1555,2443,2517,4665,7182
3,2171,3578,3040,6513,9553
1,1083,1701,397,1083,1480
3,2171,3578,2826,6513,9339
1,1083,1701,244,1083,1327
1,713,1120,396,713,1109
1,1083,1701,346,1083,1429
4,1083,1701,2200,4332,6532
2,2171,3578,2671,4342,7013
2,420,769,636,840,1476
3,1266,2320,1909,3798,5707
1,1555,2443,497,1555,2052
1,1266,2320,892,1266,2158
1,308,565,184,308,492
1,1252,2295,1020,1252,2272
3,1266,2320,1631,3798,5429
3,1252,2295,2991,3756,6747
1,1252,2295,630,1252,1882
3,344,540,523,1032,1555
2,2171,3578,2671,4342,7013
1,713,1120,362,713,1075
1,713,1120,385,713,1098
1,487,783,265,487,752
1,344,540,185,344,529
1,1266,2320,729,1266,1995
1,1252,2295,1020,1252,2272
1,295,540,234,295,529
2,1519,2443,1750,3038,4788
1,713,1120,385,713,1098
3,1083,1701,1140,3249,4389
1,2171,3578,763,2171,2934
1,1083,1701,244,1083,1327
2,1555,2443,994,3110,4104
4,1083,1701,2200,4332,6532
1,2171,3578,835,2171,3006
2,713,1120,411,1426,1837
1,1252,2295,882,1252,2134
4,1252,2295,2703,5008,7711
1,1266,2320,567,1266,1833
2,1266,2320,1273,2532,3805
1,1252,2295,997,1252,2249
3,1266,2320,1909,3798,5707
3,1555,2443,1711,4665,6376
1,713,1120,385,713,1098
1,713,1120,329,713,1042
1,1083,1701,550,1083,1633
1,344,540,174,344,518
1,344,540,66,344,410
2,713,1120,456,1426,1882
3,1266,2320,2257,3798,6055
2,1266,2320,1134,2532,3666
1,344,540,185,344,529
1,2171,3578,835,2171,3006
3,1555,2443,2591,4665,7256
1,344,540,66,344,410
1,344,540,126,344,470
4,1083,1701,2200,4332,6532
1,1252,2295,951,1252,2203
3,1252,2295,2027,3756,5783
2,1252,2295,1122,2504,3626
2,420,769,667,840,1507
1,295,540,234,295,529
1,1519,2443,484,1519,2003
1,1083,1701,601,1083,1684
1,344,540,77,344,421
1,1266,2320,567,1266,1833
2,1266,2320,1922,2532,4454
1,1555,2443,839,1555,2394
1,1555,2443,790,1555,2345
1,1555,2443,717,1555,2272
4,2171,3578,2622,8684,11306
1,2171,3578,656,2171,2827
2,344,540,381,688,1069
1,344,540,126,344,470
1,1898,3375,768,1898,2666
3,308,565,415,924,1339
3,1252,2295,2854,3756,6610
3,420,769,747,1260,2007
1,1252,2295,997,1252,2249
2,1266,2320,1087,2532,3619
1,487,783,155,487,642
4,344,540,438,1376,1814
4,1083,1701,1587,4332,5919
3,344,540,572,1032,1604
2,1266,2320,1922,2532,4454
1,2171,3578,763,2171,2934
4,1519,2443,2230,6076,8306
1,2171,3578,942,2171,3113
3,1519,2443,2259,4557,6816
3,1083,1701,1650,3249,4899
1,1083,1701,312,1083,1395
2,713,1120,545,1426,1971
3,2171,3578,4114,6513,10627
1,713,1120,362,713,1075
1,344,540,185,344,529
1,344,540,185,344,529
2,344,540,219,688,907
1,1519,2443,900,1519,2419
2,1252,2295,1902,2504,4406
1,1252,2295,951,1252,2203
3,2171,3578,3792,6513,10305
1,2171,3578,656,2171,2827
1,1555,2443,497,1555,2052
1,344,540,126,344,470
1,713,1120,228,713,941
3,1266,2320,2257,3798,6055
1,1252,2295,745,1252,1997
4,2171,3578,3052,8684,11736
2,1555,2443,1581,3110,4691
1,713,1120,329,713,1042
1,713,1120,228,713,941
1,713,1120,172,713,885
2,1252,2295,1122,2504,3626
2,2171,3578,1097,4342,5439
2,1519,2443,1799,3038,4837
2,344,540,370,688,1058
2,713,1120,321,1426,1747
2,1555,2443,994,3110,4104
2,713,1120,769,1426,2195
2,713,1120,724,1426,2150
2,713,1120,344,1426,1770
2,1266,2320,1922,2532,4454
2,1252,2295,1902,2504,4406
2,1266,2320,2015,2532,4547
2,344,540,198,688,886
2,713,1120,411,1426,1837
2,344,540,165,688,853
2,344,540,381,688,1069
2,2171,3578,2671,4342,7013
2,1252,2295,1902,2504,4406
2,2171,3578,1884,4342,6226
2,487,783,561,974,1535
2,713,1120,321,1426,1747
2,2171,3578,1240,4342,5582
2,487,783,561,974,1535
2,1083,1701,998,2166,3164
2,487,783,576,974,1550
2,295,540,479,590,1069
2,713,1120,769,1426,2195
2,344,540,154,688,842
2,344,540,381,688,1069
2,2171,3578,2742,4342,7084
2,2171,3578,2671,4342,7013
2,713,1120,724,1426,2150
2,1083,1701,794,2166,2960
2,1083,1701,1100,2166,3266
2,344,540,165,688,853
2,1252,2295,1122,2504,3626
2,1252,2295,1994,2504,4498
2,1083,1701,590,2166,2756
2,713,1120,769,1426,2195
2,1083,1701,794,2166,2960
2,487,783,247,974,1221
2,2171,3578,1812,4342,6154
2,2171,3578,1240,4342,5582
2,1555,2443,848,3110,3958
2,1083,1701,1202,2166,3368
2,1083,1701,794,2166,2960
2,2171,3578,1240,4342,5582
2,2171,3578,2671,4342,7013
2,1266,2320,1273,2532,3805
2,2171,3578,1884,4342,6226
2,713,1120,321,1426,1747
2,1083,1701,794,2166,2960
2,1266,2320,1366,2532,3898
2,420,769,483,840,1323
2,295,540,468,590,1058
2,1555,2443,897,3110,4007
2,1555,2443,1141,3110,4251
2,713,1120,724,1426,2150
2,2171,3578,2742,4342,7084
2,1519,2443,1164,3038,4202
2,2171,3578,2671,4342,7013
2,2171,3578,1526,4342,5868
2,2171,3578,2385,4342,6727
2,1555,2443,750,3110,3860
2,344,540,370,688,1058
2,1555,2443,994,3110,4104
2,1555,2443,1727,3110,4837
2,2171,3578,2671,4342,7013
2,1555,2443,701,3110,3811
2,1083,1701,1100,2166,3266
2,2171,3578,2671,4342,7013
2,1266,2320,1505,2532,4037
2,1252,2295,1352,2504,3856
2,1912,3400,1480,3824,5304
2,1083,1701,488,2166,2654
2,1555,2443,750,3110,3860
2,344,540,252,688,940
2,713,1120,456,1426,1882
2,344,540,349,688,1037
2,487,783,247,974,1221
2,1252,2295,1214,2504,3718
2,1266,2320,1922,2532,4454
2,1252,2295,1902,2504,4406
2,1898,3375,2819,3796,6615
2,2171,3578,2528,4342,6870
2,713,1120,523,1426,1949
2,1083,1701,794,2166,2960
2,1266,2320,1505,2532,4037
2,1266,2320,1505,2532,4037
2,1555,2443,1141,3110,4251
2,1555,2443,1141,3110,4251
2,487,783,263,974,1237
2,344,540,381,688,1069
2,1083,1701,794,2166,2960
2,1266,2320,1505,2532,4037
2,1252,2295,1489,2504,3993
2,1555,2443,897,3110,4007
2,344,540,154,688,842
2,344,540,252,688,940
2,2171,3578,2671,4342,7013
2,2171,3578,2671,4342,7013
2,2171,3578,2671,4342,7013
2,713,1120,523,1426,1949
2,1083,1701,794,2166,2960
2,344,540,165,688,853
2,1083,1701,1100,2166,3266
2,344,540,349,688,1037
2,713,1120,724,1426,2150
2,1083,1701,1100,2166,3266
2,713,1120,724,1426,2150
2,1083,1701,1100,2166,3266
2,1555,2443,994,3110,4104
2,713,1120,500,1426,1926
2,2171,3578,1240,4342,5582
2,2171,3578,2528,4342,6870
2,344,540,165,688,853
2,344,540,370,688,1058
2,713,1120,411,1426,1837
2,713,1120,344,1426,1770
2,1555,2443,1727,3110,4837
2,1266,2320,1134,2532,3666
2,1912,3400,2500,3824,6324
2,2171,3578,2528,4342,6870
2,487,783,561,974,1535
2,1555,2443,750,3110,3860
2,344,540,219,688,907
2,2171,3578,2671,4342,7013
2,1252,2295,2040,2504,4544
2,420,769,375,840,1215
2,1912,3400,1752,3824,5576
2,2171,3578,1311,4342,5653
2,487,783,561,974,1535
2,1555,2443,1678,3110,4788
2,1555,2443,1678,3110,4788
2,713,1120,344,1426,1770
2,344,540,165,688,853
2,1555,2443,701,3110,3811
2,1555,2443,897,3110,4007
2,2171,3578,2671,4342,7013
2,1912,3400,1480,3824,5304
2,1555,2443,701,3110,3811
2,1083,1701,488,2166,2654
2,1555,2443,1141,3110,4251
2,344,540,165,688,853
2,1555,2443,1727,3110,4837
2,1555,2443,1727,3110,4837
2,2171,3578,1240,4342,5582
2,487,783,247,974,1221
2,1083,1701,1168,2166,3334
2,713,1120,456,1426,1882
2,2171,3578,2671,4342,7013
2,1252,2295,1352,2504,3856
2,420,769,636,840,1476
2,2171,3578,1669,4342,6011
2,1555,2443,750,3110,3860
2,2171,3578,1240,4342,5582
2,1266,2320,1505,2532,4037
2,1083,1701,624,2166,2790
2,1555,2443,750,3110,3860
2,713,1120,523,1426,1949
2,2171,3578,1240,4342,5582
2,1266,2320,1505,2532,4037
2,487,783,247,974,1221
2,1555,2443,1678,3110,4788
2,713,1120,523,1426,1949
2,1519,2443,1506,3038,4544
2,487,783,247,974,1221
2,1266,2320,1505,2532,4037
2,2171,3578,1884,4342,6226
2,713,1120,523,1426,1949
2,1083,1701,522,2166,2688
2,2171,3578,1884,4342,6226
2,1555,2443,994,3110,4104
2,713,1120,792,1426,2218
2,1555,2443,1678,3110,4788
2,344,540,165,688,853
2,344,540,154,688,842
2,1083,1701,1100,2166,3266
2,344,540,381,688,1069
2,1083,1701,1168,2166,3334
2,2171,3578,2671,4342,7013
2,1252,2295,1489,2504,3993
2,1266,2320,1134,2532,3666
2,2171,3578,1240,4342,5582
2,713,1120,321,1426,1747
2,487,783,247,974,1221
2,1519,2443,1164,3038,4202
2,2171,3578,2671,4342,7013
2,344,540,370,688,1058
2,1083,1701,1100,2166,3266
2,1555,2443,1141,3110,4251
2,1555,2443,994,3110,4104
2,2171,3578,2742,4342,7084
2,1555,2443,1141,3110,4251
2,344,540,133,688,821
2,713,1120,792,1426,2218
2,1083,1701,794,2166,2960
2,344,540,349,688,1037
2,713,1120,344,1426,1770
2,2171,3578,2742,4342,7084
2,1912,3400,2500,3824,6324
2,713,1120,792,1426,2218
2,713,1120,523,1426,1949
2,1083,1701,522,2166,2688
2,713,1120,792,1426,2218
2,2171,3578,2671,4342,7013
2,2171,3578,2742,4342,7084
2,2171,3578,2528,4342,6870
2,344,540,381,688,1069
2,1083,1701,488,2166,2654
2,2171,3578,1526,4342,5868
2,713,1120,344,1426,1770
2,344,540,198,688,886
2,487,783,529,974,1503
2,1252,2295,1214,2504,3718
2,1252,2295,1902,2504,4406
2,1898,3375,2009,3796,5805
2,1083,1701,1100,2166,3266
2,2171,3578,2742,4342,7084
2,1083,1701,794,2166,2960
2,1252,2295,2040,2504,4544
2,713,1120,321,1426,1747
2,1083,1701,862,2166,3028
2,344,540,241,688,929
2,1083,1701,692,2166,2858
2,344,540,349,688,1037
2,344,540,241,688,929
2,2171,3578,2742,4342,7084
2,2171,3578,2742,4342,7084
2,2171,3578,2742,4342,7084
2,420,769,498,840,1338
2,1912,3400,1480,3824,5304
2,2171,3578,1240,4342,5582
2,1555,2443,1141,3110,4251
2,713,1120,769,1426,2195
2,713,1120,344,1426,1770
2,1266,2320,1922,2532,4454
2,1519,2443,1799,3038,4837
2,487,783,561,974,1535
2,1555,2443,994,3110,4104
2,1519,2443,1653,3038,4691
2,1083,1701,1100,2166,3266
2,1083,1701,794,2166,2960
2,1266,2320,2015,2532,4547
2,1252,2295,1902,2504,4406
2,1555,2443,1092,3110,4202
2,1555,2443,1581,3110,4691
2,1555,2443,994,3110,4104
2,713,1120,769,1426,2195
2,344,540,381,688,1069
2,1555,2443,1727,3110,4837
2,713,1120,657,1426,2083
2,344,540,370,688,1058
2,1555,2443,603,3110,3713
2,1555,2443,1141,3110,4251
2,1555,2443,848,3110,3958
2,344,540,381,688,1069
2,1083,1701,522,2166,2688
2,713,1120,792,1426,2218
2,344,540,165,688,853
2,344,540,381,688,1069
2,1555,2443,1727,3110,4837
2,2171,3578,2671,4342,7013
2,2171,3578,2742,4342,7084
2,2171,3578,2742,4342,7084
2,1252,2295,2040,2504,4544
2,713,1120,792,1426,2218
2,2171,3578,2742,4342,7084
2,1266,2320,1922,2532,4454
2,1252,2295,2040,2504,4544
2,1555,2443,1727,3110,4837
2,1519,2443,1653,3038,4691
2,1555,2443,1434,3110,4544
2,713,1120,792,1426,2218
2,2171,3578,2742,4342,7084
2,344,540,370,688,1058
2,2171,3578,2528,4342,6870
2,2171,3578,2742,4342,7084
2,1083,1701,1202,2166,3368
2,1555,2443,750,3110,3860
2,487,783,529,974,1503
2,344,540,381,688,1069
2,2171,3578,1240,4342,5582
2,1555,2443,1092,3110,4202
2,1519,2443,1506,3038,4544
2,487,783,561,974,1535
2,1555,2443,1141,3110,4251
2,713,1120,523,1426,1949
2,344,540,154,688,842
2,1898,3375,2009,3796,5805
2,1555,2443,750,3110,3860
2,344,540,198,688,886
2,1555,2443,1434,3110,4544
2,1555,2443,1141,3110,4251
2,2171,3578,2742,4342,7084
2,2171,3578,2671,4342,7013
2,2171,3578,1526,4342,5868
2,713,1120,792,1426,2218
2,1083,1701,1202,2166,3368
2,713,1120,523,1426,1949
2,1083,1701,794,2166,2960
2,713,1120,411,1426,1837
2,1083,1701,794,2166,2960
2,344,540,381,688,1069
2,1555,2443,994,3110,4104
2,1083,1701,692,2166,2858
2,1519,2443,1799,3038,4837
2,1519,2443,1799,3038,4837
2,2171,3578,2671,4342,7013
2,1555,2443,1141,3110,4251
2,1252,2295,1902,2504,4406
2,1252,2295,2040,2504,4544
2,2171,3578,1240,4342,5582
2,1555,2443,750,3110,3860
2,1555,2443,1141,3110,4251
2,1555,2443,994,3110,4104
2,344,540,381,688,1069
2,1555,2443,1141,3110,4251
2,713,1120,792,1426,2218
2,713,1120,456,1426,1882
2,1555,2443,1141,3110,4251
2,1083,1701,1202,2166,3368
2,1083,1701,522,2166,2688
2,713,1120,321,1426,1747
2,344,540,252,688,940
2,2171,3578,1526,4342,5868
2,344,540,316,688,1004
2,713,1120,769,1426,2195
2,1083,1701,488,2166,2654
2,2171,3578,1884,4342,6226
2,713,1120,792,1426,2218
2,1555,2443,750,3110,3860
2,713,1120,344,1426,1770
2,2171,3578,2742,4342,7084
2,344,540,370,688,1058
2,1083,1701,998,2166,3164
2,1555,2443,750,3110,3860
2,713,1120,344,1426,1770
2,2171,3578,2742,4342,7084
2,1252,2295,1076,2504,3580
2,2171,3578,1240,4342,5582
2,1555,2443,1727,3110,4837
2,344,540,370,688,1058
2,1555,2443,994,3110,4104
2,1083,1701,590,2166,2756
2,1083,1701,794,2166,2960
2,344,540,381,688,1069
2,344,540,381,688,1069
2,2171,3578,2742,4342,7084
2,1519,2443,1799,3038,4837
2,1555,2443,1727,3110,4837
2,2171,3578,1526,4342,5868
2,2171,3578,2313,4342,6655
2,713,1120,792,1426,2218
2,1266,2320,2015,2532,4547
2,2171,3578,1526,4342,5868
2,1555,2443,1141,3110,4251
2,2171,3578,2742,4342,7084
2,2171,3578,2671,4342,7013
2,1252,2295,1214,2504,3718
2,2171,3578,1240,4342,5582
2,2171,3578,1240,4342,5582
2,344,540,198,688,886
2,1555,2443,1141,3110,4251
2,713,1120,792,1426,2218
2,1266,2320,1134,2532,3666
2,1555,2443,1678,3110,4788
2,1555,2443,1678,3110,4788
2,1555,2443,897,3110,4007
2,713,1120,411,1426,1837
2,713,1120,456,1426,1882
2,713,1120,456,1426,1882
2,420,769,498,840,1338
2,2171,3578,2671,4342,7013
2,2171,3578,2671,4342,7013
2,713,1120,724,1426,2150
2,1555,2443,1581,3110,4691
2,1555,2443,750,3110,3860
2,1083,1701,624,2166,2790
2,344,540,154,688,842
2,2171,3578,1240,4342,5582
2,420,769,498,840,1338
2,2171,3578,1812,4342,6154
2,2171,3578,2528,4342,6870
2,344,540,316,688,1004
2,1083,1701,488,2166,2654
2,1555,2443,1141,3110,4251
2,713,1120,769,1426,2195
2,713,1120,523,1426,1949
2,1083,1701,488,2166,2654
2,344,540,241,688,929
2,713,1120,657,1426,2083
2,1252,2295,1260,2504,3764
2,487,783,373,974,1347
2,1555,2443,603,3110,3713
2,1555,2443,994,3110,4104
2,1555,2443,750,3110,3860
2,344,540,381,688,1069
2,713,1120,523,1426,1949
2,344,540,349,688,1037
2,344,540,198,688,886
2,1252,2295,1122,2504,3626
2,420,769,498,840,1338
2,1898,3375,1537,3796,5333
2,2171,3578,1812,4342,6154
2,487,783,561,974,1535
2,1083,1701,794,2166,2960
2,1555,2443,750,3110,3860
2,2171,3578,2671,4342,7013
2,2171,3578,1884,4342,6226
2,1266,2320,2015,2532,4547
2,1266,2320,1505,2532,4037
2,344,540,252,688,940
2,344,540,316,688,1004
2,2171,3578,1812,4342,6154
2,1555,2443,1727,3110,4837
2,1555,2443,1678,3110,4788
2,1555,2443,750,3110,3860
2,1555,2443,897,3110,4007
2,1555,2443,1092,3110,4202
2,713,1120,769,1426,2195
2,2171,3578,2742,4342,7084
2,1252,2295,1902,2504,4406
2,1266,2320,2015,2532,4547
2,1898,3375,1739,3796,5535
2,1519,2443,969,3038,4007
2,487,783,561,974,1535
2,1555,2443,994,3110,4104
2,1266,2320,1505,2532,4037
2,713,1120,769,1426,2195
2,344,540,219,688,907
2,713,1120,792,1426,2218
2,713,1120,344,1426,1770
2,1266,2320,1505,2532,4037
2,1266,2320,1366,2532,3898
2,295,540,468,590,1058
2,1898,3375,2077,3796,5873
2,2171,3578,1240,4342,5582
2,1555,2443,750,3110,3860
2,1555,2443,1141,3110,4251
2,344,540,370,688,1058
2,344,540,370,688,1058
2,2171,3578,2671,4342,7013
2,1252,2295,1994,2504,4498
2,2171,3578,1526,4342,5868
2,344,540,219,688,907
2,2171,3578,2671,4342,7013
2,1266,2320,1366,2532,3898
2,420,769,498,840,1338
2,1555,2443,1678,3110,4788
2,2171,3578,1884,4342,6226
2,1555,2443,750,3110,3860
2,1555,2443,1434,3110,4544
2,344,540,370,688,1058
2,713,1120,523,1426,1949
2,1519,2443,1164,3038,4202
2,2171,3578,2671,4342,7013
2,2171,3578,1884,4342,6226
2,1555,2443,897,3110,4007
2,1555,2443,1678,3110,4788
2,2171,3578,2671,4342,7013
2,1555,2443,1727,3110,4837
2,1266,2320,1366,2532,3898
2,1266,2320,1458,2532,3990
2,420,769,636,840,1476
2,1266,2320,1087,2532,3619
2,2171,3578,2671,4342,7013
2,344,540,219,688,907
2,487,783,482,974,1456
2,713,1120,411,1426,1837
2,1555,2443,1141,3110,4251
2,2171,3578,2671,4342,7013
2,2171,3578,2671,4342,7013
2,1555,2443,1434,3110,4544
2,1555,2443,1581,3110,4691
2,344,540,370,688,1058
2,344,540,349,688,1037
2,344,540,370,688,1058
2,1083,1701,1168,2166,3334
2,713,1120,411,1426,1837
2,487,783,263,974,1237
2,344,540,154,688,842
2,2171,3578,2671,4342,7013
2,1252,2295,1122,2504,3626
2,1252,2295,1352,2504,3856
2,2171,3578,2742,4342,7084
2,1083,1701,692,2166,2858
2,344,540,198,688,886
2,1555,2443,1141,3110,4251
2,344,540,370,688,1058
2,344,540,381,688,1069
2,1083,1701,794,2166,2960
2,1083,1701,1168,2166,3334
2,713,1120,523,1426,1949
2,1555,2443,750,3110,3860
2,344,540,349,688,1037
2,1252,2295,1122,2504,3626
2,1266,2320,1134,2532,3666
2,1252,2295,2040,2504,4544
2,1083,1701,692,2166,2858
2,1555,2443,701,3110,3811
2,344,540,370,688,1058
2,1252,2295,1352,2504,3856
2,2171,3578,1097,4342,5439
2,2171,3578,1884,4342,6226
2,487,783,561,974,1535
2,1555,2443,897,3110,4007
2,1252,2295,1352,2504,3856
2,1252,2295,1489,2504,3993
2,1912,3400,2092,3824,5916
2,2171,3578,2671,4342,7013
2,2171,3578,2742,4342,7084
2,1083,1701,1168,2166,3334
2,1555,2443,750,3110,3860
2,1555,2443,750,3110,3860
2,1555,2443,1141,3110,4251
2,2171,3578,2671,4342,7013
2,344,540,349,688,1037
2,2171,3578,1240,4342,5582
2,1252,2295,1352,2504,3856
2,1555,2443,750,3110,3860
2,1555,2443,994,3110,4104
2,1555,2443,1141,3110,4251
2,713,1120,523,1426,1949
2,1912,3400,2024,3824,5848
2,2171,3578,2528,4342,6870
2,1555,2443,1434,3110,4544
2,1083,1701,1100,2166,3266
2,1555,2443,1141,3110,4251
2,344,540,381,688,1069
2,2171,3578,2671,4342,7013
2,713,1120,344,1426,1770
2,2171,3578,2671,4342,7013
2,2171,3578,2671,4342,7013
2,713,1120,500,1426,1926
2,1083,1701,1168,2166,3334
2,2171,3578,2671,4342,7013
2,713,1120,724,1426,2150
2,2171,3578,1526,4342,5868
2,1555,2443,1678,3110,4788
2,1083,1701,522,2166,2688
2,713,1120,411,1426,1837
2,713,1120,344,1426,1770
2,2171,3578,2671,4342,7013
2,1266,2320,1783,2532,4315
2,2171,3578,2671,4342,7013
2,1555,2443,1678,3110,4788
2,344,540,370,688,1058
2,713,1120,344,1426,1770
2,2171,3578,2671,4342,7013
2,487,783,561,974,1535
2,2171,3578,1884,4342,6226
2,1555,2443,1141,3110,4251
2,344,540,370,688,1058
2,1266,2320,1505,2532,4037
2,1912,3400,2024,3824,5848
2,1555,2443,1434,3110,4544
2,344,540,381,688,1069
2,2171,3578,2313,4342,6655
2,344,540,370,688,1058
2,344,540,370,688,1058
2,713,1120,523,1426,1949
2,344,540,165,688,853
2,295,540,252,590,842
2,2171,3578,1669,4342,6011
2,1083,1701,624,2166,2790
2,1266,2320,1134,2532,3666
2,2171,3578,1240,4342,5582
2,1555,2443,1581,3110,4691
2,713,1120,500,1426,1926
2,487,783,263,974,1237
2,344,540,165,688,853
2,344,540,381,688,1069
2,713,1120,344,1426,1770
2,344,540,381,688,1069
2,1252,2295,1489,2504,3993
2,1266,2320,1087,2532,3619
2,2171,3578,1240,4342,5582
2,2171,3578,2313,4342,6655
2,713,1120,769,1426,2195
2,344,540,154,688,842
2,713,1120,523,1426,1949
2,1266,2320,1783,2532,4315
2,487,783,247,974,1221
2,1083,1701,1168,2166,3334
2,713,1120,769,1426,2195
2,487,783,388,974,1362
2,1252,2295,1994,2504,4498
2,713,1120,769,1426,2195
2,713,1120,523,1426,1949
2,344,540,381,688,1069
2,2171,3578,2742,4342,7084
2,1266,2320,1366,2532,3898
2,1252,2295,1122,2504,3626
2,2171,3578,2671,4342,7013
2,2171,3578,2671,4342,7013
2,2171,3578,2528,4342,6870
2,2171,3578,1526,4342,5868
2,1555,2443,848,3110,3958
2,344,540,349,688,1037
2,487,783,247,974,1221
2,1555,2443,897,3110,4007
2,713,1120,411,1426,1837
2,2171,3578,2742,4342,7084
2,2171,3578,2528,4342,6870
2,2171,3578,1526,4342,5868
2,1555,2443,1141,3110,4251
2,344,540,252,688,940
2,2171,3578,2671,4342,7013
2,1252,2295,1994,2504,4498
2,2171,3578,2313,4342,6655
2,1083,1701,794,2166,2960
2,2171,3578,1240,4342,5582
2,344,540,316,688,1004
2,1266,2320,1273,2532,3805
2,420,769,498,840,1338
2,1266,2320,2062,2532,4594
2,2171,3578,1240,4342,5582
2,1083,1701,794,2166,2960
2,1555,2443,994,3110,4104
2,1252,2295,1994,2504,4498
2,1266,2320,1366,2532,3898
2,2171,3578,1240,4342,5582
2,1555,2443,1434,3110,4544
2,2171,3578,2528,4342,6870
2,487,783,310,974,1284
2,713,1120,321,1426,1747
2,1555,2443,1678,3110,4788
2,1083,1701,692,2166,2858
2,487,783,576,974,1550
2,2171,3578,1240,4342,5582
2,2171,3578,2671,4342,7013
2,1266,2320,1505,2532,4037
2,295,540,296,590,886
2,1555,2443,897,3110,4007
2,487,783,576,974,1550
2,1555,2443,1434,3110,4544
2,2171,3578,1884,4342,6226
2,2171,3578,2671,4342,7013
2,1252,2295,1489,2504,3993
2,420,769,498,840,1338
2,2171,3578,1240,4342,5582
2,2171,3578,2528,4342,6870
2,487,783,561,974,1535
2,1555,2443,994,3110,4104
2,344,540,252,688,940
2,344,540,370,688,1058
2,344,540,370,688,1058
2,2171,3578,2742,4342,7084
2,344,540,349,688,1037
2,713,1120,523,1426,1949
2,344,540,165,688,853
2,1266,2320,1505,2532,4037
2,1266,2320,1505,2532,4037
2,1252,2295,1352,2504,3856
2,1252,2295,1994,2504,4498
2,2171,3578,2671,4342,7013
2,344,540,370,688,1058
2,1555,2443,1727,3110,4837
2,1266,2320,1505,2532,4037
2,1252,2295,1489,2504,3993
2,1519,2443,1506,3038,4544
2,487,783,561,974,1535
2,713,1120,321,1426,1747
2,1519,2443,1799,3038,4837
2,2171,3578,2742,4342,7084
2,2171,3578,2671,4342,7013
2,2171,3578,1240,4342,5582
2,487,783,561,974,1535
2,1555,2443,1434,3110,4544
2,1555,2443,994,3110,4104
2,344,540,370,688,1058
2,344,540,241,688,929
2,344,540,381,688,1069
2,713,1120,523,1426,1949
2,1252,2295,1994,2504,4498
2,2171,3578,1812,4342,6154
2,713,1120,769,1426,2195
2,1083,1701,1202,2166,3368
2,1266,2320,1505,2532,4037
2,308,565,277,616,893
2,2171,3578,1884,4342,6226
2,2171,3578,1669,4342,6011
2,1555,2443,994,3110,4104
2,1555,2443,750,3110,3860
2,344,540,381,688,1069
2,344,540,370,688,1058
2,344,540,165,688,853
2,2171,3578,2671,4342,7013
2,344,540,165,688,853
2,1252,2295,1260,2504,3764
2,308,565,367,616,983
2,487,783,561,974,1535
2,1555,2443,1141,3110,4251
2,1555,2443,994,3110,4104
2,1252,2295,1076,2504,3580
2,487,783,247,974,1221
2,2171,3578,1311,4342,5653
2,713,1120,792,1426,2218
2,308,565,367,616,983
2,487,783,561,974,1535
2,487,783,561,974,1535
2,2171,3578,1884,4342,6226
2,1555,2443,1141,3110,4251
2,1083,1701,692,2166,2858
2,713,1120,769,1426,2195
2,344,540,262,688,950
2,344,540,252,688,940
2,2171,3578,2671,4342,7013
2,1252,2295,1489,2504,3993
2,487,783,310,974,1284
2,344,540,370,688,1058
2,344,540,165,688,853
2,1266,2320,2062,2532,4594
2,1252,2295,1352,2504,3856
2,1898,3375,1469,3796,5265
2,2171,3578,2671,4342,7013
2,1083,1701,998,2166,3164
2,1083,1701,624,2166,2790
2,1555,2443,1141,3110,4251
2,713,1120,769,1426,2195
2,2171,3578,2313,4342,6655
2,1555,2443,1581,3110,4691
2,1083,1701,1100,2166,3266
2,1555,2443,897,3110,4007
2,420,769,498,840,1338
2,2171,3578,1240,4342,5582
2,2171,3578,2528,4342,6870
2,487,783,247,974,1221
2,2171,3578,1526,4342,5868
2,1083,1701,1168,2166,3334
2,1083,1701,624,2166,2790
2,1555,2443,1678,3110,4788
2,2171,3578,2671,4342,7013
2,1083,1701,794,2166,2960
2,713,1120,769,1426,2195
2,713,1120,411,1426,1837
2,713,1120,769,1426,2195
2,713,1120,769,1426,2195
2,713,1120,792,1426,2218
2,344,540,370,688,1058
2,1266,2320,1366,2532,3898
2,1266,2320,1505,2532,4037
2,344,540,133,688,821
2,2171,3578,2671,4342,7013
2,487,783,561,974,1535
2,1555,2443,750,3110,3860
2,1555,2443,994,3110,4104
2,344,540,370,688,1058
2,1555,2443,1727,3110,4837
2,1555,2443,1727,3110,4837
2,2171,3578,1240,4342,5582
2,420,769,498,840,1338
2,1252,2295,1902,2504,4406
2,420,769,636,840,1476
2,2171,3578,1240,4342,5582
2,487,783,310,974,1284
2,713,1120,769,1426,2195
2,2171,3578,2671,4342,7013
2,713,1120,523,1426,1949
2,713,1120,344,1426,1770
2,487,783,576,974,1550
2,2171,3578,2742,4342,7084
2,2171,3578,2671,4342,7013
2,2171,3578,2671,4342,7013
2,2171,3578,1812,4342,6154
2,1519,2443,1750,3038,4788
2,487,783,561,974,1535
2,713,1120,769,1426,2195
2,713,1120,769,1426,2195
2,1555,2443,1678,3110,4788
2,713,1120,769,1426,2195
2,1555,2443,1141,3110,4251
2,1083,1701,692,2166,2858
2,344,540,252,688,940
2,2171,3578,1240,4342,5582
2,2171,3578,2671,4342,7013
2,2171,3578,2671,4342,7013
2,713,1120,769,1426,2195
2,2171,3578,1884,4342,6226
2,344,540,370,688,1058
2,1083,1701,1202,2166,3368
2,713,1120,769,1426,2195
2,1519,2443,1506,3038,4544
2,344,540,370,688,1058
2,344,540,198,688,886
2,2171,3578,2671,4342,7013
2,420,769,498,840,1338
2,1252,2295,1489,2504,3993
2,1519,2443,1750,3038,4788
2,1555,2443,1141,3110,4251
2,487,783,561,974,1535
2,2171,3578,1311,4342,5653
2,2171,3578,1884,4342,6226
2,344,540,219,688,907
2,713,1120,769,1426,2195
2,713,1120,792,1426,2218
2,344,540,219,688,907
2,1252,2295,1994,2504,4498
2,1252,2295,1994,2504,4498
2,1555,2443,1727,3110,4837
2,1519,2443,773,3038,3811
2,1555,2443,1141,3110,4251
2,1266,2320,1366,2532,3898
2,1266,2320,2015,2532,4547
2,1266,2320,1273,2532,3805
2,2171,3578,1240,4342,5582
2,487,783,561,974,1535
2,344,540,165,688,853
2,487,783,529,974,1503
2,344,540,252,688,940
2,344,540,252,688,940
2,1266,2320,1366,2532,3898
2,1266,2320,2015,2532,4547
2,1083,1701,1168,2166,3334
2,344,540,252,688,940
2,2171,3578,2671,4342,7013
2,1252,2295,2040,2504,4544
2,1266,2320,1505,2532,4037
2,2171,3578,1812,4342,6154
2,2171,3578,1240,4342,5582
2,2171,3578,2671,4342,7013
2,2171,3578,1097,4342,5439
2,1083,1701,1100,2166,3266
2,713,1120,769,1426,2195
2,344,540,198,688,886
2,2171,3578,2671,4342,7013
2,420,769,452,840,1292
2,1519,2443,773,3038,3811
2,1555,2443,1678,3110,4788
2,344,540,381,688,1069
2,1083,1701,794,2166,2960
2,713,1120,344,1426,1770
2,1252,2295,1902,2504,4406
2,487,783,388,974,1362
2,713,1120,769,1426,2195
2,1252,2295,1122,2504,3626
2,1266,2320,1134,2532,3666
2,1555,2443,1678,3110,4788
2,2171,3578,1812,4342,6154
2,1898,3375,2077,3796,5873
2,2171,3578,1240,4342,5582
2,344,540,219,688,907
2,1083,1701,1100,2166,3266
2,1083,1701,998,2166,3164
2,1555,2443,750,3110,3860
2,1083,1701,998,2166,3164
2,344,540,349,688,1037
2,2171,3578,2742,4342,7084
2,1252,2295,1994,2504,4498
2,1252,2295,1489,2504,3993
2,308,565,367,616,983
2,1252,2295,1994,2504,4498
2,2171,3578,1240,4342,5582
2,2171,3578,1526,4342,5868
2,713,1120,769,1426,2195
2,713,1120,523,1426,1949
2,487,783,247,974,1221
2,1555,2443,603,3110,3713
2,1555,2443,750,3110,3860
2,1083,1701,692,2166,2858
2,1083,1701,794,2166,2960
2,1266,2320,2015,2532,4547
2,1252,2295,2040,2504,4544
2,1083,1701,794,2166,2960
2,1083,1701,624,2166,2790
2,713,1120,411,1426,1837
2,2171,3578,2671,4342,7013
2,2171,3578,2671,4342,7013
2,1555,2443,1190,3110,4300
2,1555,2443,750,3110,3860
2,1555,2443,1141,3110,4251
2,1083,1701,1168,2166,3334
2,1083,1701,794,2166,2960
2,2171,3578,2671,4342,7013
2,1266,2320,1505,2532,4037
2,308,565,367,616,983
2,2171,3578,2027,4342,6369
2,1555,2443,1678,3110,4788
2,1555,2443,1141,3110,4251
2,344,540,381,688,1069
2,1083,1701,692,2166,2858
2,344,540,370,688,1058
2,713,1120,792,1426,2218
2,487,783,576,974,1550
2,2171,3578,2671,4342,7013
2,1252,2295,2040,2504,4544
2,1266,2320,1922,2532,4454
2,420,769,498,840,1338
2,2171,3578,2027,4342,6369
2,487,783,561,974,1535
2,1083,1701,1168,2166,3334
2,713,1120,792,1426,2218
2,344,540,370,688,1058
2,344,540,370,688,1058
2,295,540,479,590,1069
2,1555,2443,603,3110,3713
2,344,540,381,688,1069
2,2171,3578,1526,4342,5868
2,713,1120,523,1426,1949
2,1083,1701,624,2166,2790
2,713,1120,792,1426,2218
2,713,1120,456,1426,1882
2,1266,2320,1366,2532,3898
2,1266,2320,1366,2532,3898
2,1555,2443,1678,3110,4788
2,1555,2443,1434,3110,4544
2,713,1120,321,1426,1747
2,2171,3578,2671,4342,7013
2,1266,2320,1366,2532,3898
2,1083,1701,1100,2166,3266
2,1555,2443,1141,3110,4251
2,713,1120,769,1426,2195
2,344,540,370,688,1058
2,344,540,381,688,1069
2,1912,3400,1480,3824,5304
2,2171,3578,1812,4342,6154
2,1519,2443,1164,3038,4202
2,487,783,247,974,1221
2,1555,2443,897,3110,4007
2,2171,3578,1884,4342,6226
2,1898,3375,1739,3796,5535
2,2171,3578,1240,4342,5582
2,344,540,349,688,1037
2,713,1120,523,1426,1949
2,1555,2443,1141,3110,4251
2,344,540,252,688,940
2,1252,2295,1994,2504,4498
2,1252,2295,1994,2504,4498
2,1555,2443,1727,3110,4837
2,1555,2443,750,3110,3860
2,1555,2443,1141,3110,4251
2,1083,1701,1168,2166,3334
2,2171,3578,1812,4342,6154
2,1252,2295,1994,2504,4498
2,1266,2320,1366,2532,3898
2,1252,2295,1994,2504,4498
2,1266,2320,2015,2532,4547
2,2171,3578,1240,4342,5582
2,1555,2443,701,3110,3811
2,2171,3578,1526,4342,5868
2,1083,1701,760,2166,2926
2,487,783,388,974,1362
2,1252,2295,1122,2504,3626
2,308,565,491,616,1107
2,2171,3578,1240,4342,5582
2,713,1120,769,1426,2195
2,713,1120,321,1426,1747
2,1519,2443,1506,3038,4544
2,1519,2443,969,3038,4007
2,1555,2443,994,3110,4104
2,344,540,252,688,940
2,2171,3578,2671,4342,7013
2,713,1120,724,1426,2150
2,487,783,561,974,1535
2,2171,3578,1311,4342,5653
2,713,1120,411,1426,1837
2,2171,3578,1240,4342,5582
2,1252,2295,1489,2504,3993
2,2171,3578,1526,4342,5868
2,2171,3578,1240,4342,5582
2,344,540,198,688,886
2,344,540,252,688,940
2,1252,2295,1352,2504,3856
2,1083,1701,794,2166,2960
2,344,540,219,688,907
2,344,540,198,688,886
2,2171,3578,2671,4342,7013
2,2171,3578,2528,4342,6870
2,295,540,468,590,1058
2,2171,3578,1812,4342,6154
2,1083,1701,1168,2166,3334
2,1083,1701,488,2166,2654
2,1555,2443,848,3110,3958
2,344,540,370,688,1058
2,2171,3578,2671,4342,7013
2,1266,2320,2015,2532,4547
2,487,783,373,974,1347
2,713,1120,769,1426,2195
2,713,1120,724,1426,2150
2,2171,3578,1526,4342,5868
2,344,540,219,688,907
2,344,540,370,688,1058
2,420,769,636,840,1476
2,713,1120,724,1426,2150
2,2171,3578,1526,4342,5868
2,1555,2443,1678,3110,4788
2,713,1120,456,1426,1882
2,1083,1701,1202,2166,3368
2,344,540,198,688,886
2,344,540,198,688,886
2,713,1120,523,1426,1949
2,344,540,219,688,907
2,1555,2443,1141,3110,4251
2,344,540,252,688,940
2,1266,2320,1134,2532,3666
2,713,1120,792,1426,2218
2,487,783,247,974,1221
2,1252,2295,1902,2504,4406
2,1266,2320,2062,2532,4594
2,1083,1701,1168,2166,3334
2,344,540,252,688,940
2,344,540,198,688,886
2,2171,3578,2742,4342,7084
2,2171,3578,2742,4342,7084
2,1266,2320,1505,2532,4037
2,2171,3578,2313,4342,6655
2,2171,3578,1884,4342,6226
2,713,1120,344,1426,1770
2,713,1120,769,1426,2195
2,2171,3578,2671,4342,7013
2,1266,2320,2062,2532,4594
2,1252,2295,1994,2504,4498
2,1555,2443,1678,3110,4788
2,1555,2443,1678,3110,4788
2,713,1120,523,1426,1949
2,2171,3578,2742,4342,7084
2,2171,3578,2671,4342,7013
2,308,565,333,616,949
2,1252,2295,1489,2504,3993
2,1252,2295,1260,2504,3764
2,2171,3578,1526,4342,5868
2,713,1120,769,1426,2195
2,344,540,219,688,907
2,344,540,165,688,853
2,2171,3578,1812,4342,6154
2,308,565,277,616,893
2,1555,2443,1581,3110,4691
2,1083,1701,1100,2166,3266
2,1555,2443,1141,3110,4251
2,1519,2443,1506,3038,4544
2,1555,2443,1141,3110,4251
2,1083,1701,1168,2166,3334
2,344,540,165,688,853
2,1266,2320,1366,2532,3898
2,1266,2320,1366,2532,3898
2,487,783,263,974,1237
2,344,540,154,688,842
2,487,783,247,974,1221
2,295,540,263,590,853
2,295,540,252,590,842
2,1555,2443,1678,3110,4788
2,1555,2443,1678,3110,4788
2,1083,1701,1100,2166,3266
2,344,540,252,688,940
2,713,1120,523,1426,1949
2,713,1120,344,1426,1770
2,295,540,263,590,853
2,1555,2443,1678,3110,4788
2,1555,2443,1678,3110,4788
2,713,1120,411,1426,1837
2,487,783,561,974,1535
2,1252,2295,1765,2504,4269
2,308,565,277,616,893
2,2171,3578,2313,4342,6655
2,713,1120,792,1426,2218
2,487,783,373,974,1347
2,2171,3578,2313,4342,6655
2,487,783,247,974,1221
2,1083,1701,760,2166,2926
2,1555,2443,897,3110,4007
2,344,540,370,688,1058
2,344,540,165,688,853
2,2171,3578,2671,4342,7013
2,1252,2295,1489,2504,3993
2,1252,2295,1076,2504,3580
2,344,540,349,688,1037
2,344,540,165,688,853
2,1252,2295,1489,2504,3993
2,1898,3375,2819,3796,6615
2,1555,2443,1141,3110,4251
2,2171,3578,2671,4342,7013
2,487,783,373,974,1347
2,1555,2443,1678,3110,4788
2,1555,2443,1141,3110,4251
2,487,783,310,974,1284
2,344,540,370,688,1058
2,2171,3578,2671,4342,7013
2,713,1120,769,1426,2195
2,1519,2443,1799,3038,4837
2,1555,2443,1141,3110,4251
2,1083,1701,488,2166,2654
2,1555,2443,750,3110,3860
2,1083,1701,692,2166,2858
2,344,540,241,688,929
2,1555,2443,1727,3110,4837
2,295,540,296,590,886
2,1266,2320,1505,2532,4037
2,2171,3578,1240,4342,5582
2,344,540,252,688,940
2,713,1120,769,1426,2195
2,1083,1701,488,2166,2654
2,1555,2443,1141,3110,4251
2,1083,1701,760,2166,2926
2,1519,2443,969,3038,4007
2,713,1120,769,1426,2195
2,344,540,219,688,907
2,1252,2295,1076,2504,3580
2,1898,3375,1739,3796,5535
2,2171,3578,2671,4342,7013
2,1519,2443,1653,3038,4691
2,487,783,529,974,1503
2,487,783,576,974,1550
2,713,1120,792,1426,2218
2,1555,2443,1727,3110,4837
2,344,540,252,688,940
2,1083,1701,1202,2166,3368
2,344,540,381,688,1069
2,344,540,219,688,907
2,2171,3578,2671,4342,7013
2,308,565,367,616,983
2,1266,2320,2015,2532,4547
2,2171,3578,2671,4342,7013
2,1519,2443,1750,3038,4788
2,344,540,370,688,1058
2,344,540,252,688,940
2,344,540,252,688,940
2,420,769,667,840,1507
2,2171,3578,1240,4342,5582
2,2171,3578,1812,4342,6154
2,2171,3578,1884,4342,6226
2,713,1120,411,1426,1837
2,1555,2443,1141,3110,4251
2,344,540,252,688,940
2,344,540,381,688,1069
2,344,540,198,688,886
2,1252,2295,1260,2504,3764
2,2171,3578,2671,4342,7013
2,1555,2443,1678,3110,4788
2,344,540,219,688,907
2,1083,1701,522,2166,2688
2,308,565,503,616,1119
2,1252,2295,1352,2504,3856
2,1266,2320,1922,2532,4454
2,1912,3400,2840,3824,6664
2,2171,3578,1812,4342,6154
2,2171,3578,1669,4342,6011
2,1555,2443,1678,3110,4788
2,713,1120,321,1426,1747
2,1555,2443,1141,3110,4251
2,713,1120,500,1426,1926
2,344,540,241,688,929
2,713,1120,792,1426,2218
2,713,1120,523,1426,1949
2,487,783,247,974,1221
2,344,540,370,688,1058
2,1266,2320,2015,2532,4547
2,2171,3578,1812,4342,6154
2,2171,3578,2671,4342,7013
2,1555,2443,1434,3110,4544
2,344,540,370,688,1058
2,713,1120,523,1426,1949
2,344,540,252,688,940
2,420,769,636,840,1476
2,1519,2443,773,3038,3811
2,1555,2443,1678,3110,4788
2,344,540,154,688,842
2,2171,3578,1812,4342,6154
2,1252,2295,1122,2504,3626
2,420,769,375,840,1215
2,1555,2443,603,3110,3713
2,2171,3578,1097,4342,5439
2,2171,3578,2027,4342,6369
2,1083,1701,1168,2166,3334
2,344,540,349,688,1037
2,308,565,333,616,949
2,2171,3578,1240,4342,5582
2,487,783,561,974,1535
2,487,783,561,974,1535
2,713,1120,769,1426,2195
2,344,540,154,688,842
2,713,1120,456,1426,1882
2,1083,1701,1236,2166,3402
2,2171,3578,1812,4342,6154
2,295,540,479,590,1069
2,713,1120,500,1426,1926
2,344,540,154,688,842
2,713,1120,523,1426,1949
2,344,540,252,688,940
2,1252,2295,1352,2504,3856
2,1252,2295,1122,2504,3626
2,713,1120,724,1426,2150
2,713,1120,500,1426,1926
2,344,540,154,688,842
2,344,540,219,688,907
2,2171,3578,2742,4342,7084
2,2171,3578,2742,4342,7084
2,1252,2295,1489,2504,3993
2,1912,3400,2840,3824,6664
2,2171,3578,2671,4342,7013
2,1083,1701,420,2166,2586
2,1555,2443,1434,3110,4544
2,344,540,219,688,907
2,295,540,350,590,940
2,1266,2320,1505,2532,4037
2,1252,2295,1489,2504,3993
2,344,540,154,688,842
2,1083,1701,998,2166,3164
2,1083,1701,624,2166,2790
2,487,783,482,974,1456
2,1083,1701,794,2166,2960
2,1083,1701,624,2166,2790
2,344,540,370,688,1058
2,344,540,349,688,1037
2,1252,2295,2040,2504,4544
2,2171,3578,2671,4342,7013
2,1519,2443,1164,3038,4202
2,1519,2443,1750,3038,4788
2,713,1120,769,1426,2195
2,1555,2443,897,3110,4007
2,1555,2443,750,3110,3860
2,1555,2443,897,3110,4007
2,344,540,370,688,1058
2,713,1120,344,1426,1770
2,344,540,252,688,940
2,2171,3578,2671,4342,7013
2,344,540,370,688,1058
2,420,769,683,840,1523
2,713,1120,724,1426,2150
2,1519,2443,1750,3038,4788
2,1555,2443,1434,3110,4544
2,344,540,154,688,842
2,1519,2443,969,3038,4007
2,487,783,310,974,1284
2,713,1120,769,1426,2195
2,1083,1701,692,2166,2858
2,1266,2320,1273,2532,3805
2,1252,2295,1352,2504,3856
2,1555,2443,1581,3110,4691
2,1555,2443,701,3110,3811
2,1083,1701,420,2166,2586
2,1083,1701,1202,2166,3368
2,344,540,198,688,886
2,2171,3578,2742,4342,7084
2,344,540,381,688,1069
2,1555,2443,1727,3110,4837
2,1252,2295,1122,2504,3626
2,420,769,636,840,1476
2,1555,2443,603,3110,3713
2,1083,1701,1100,2166,3266
2,1083,1701,794,2166,2960
2,344,540,370,688,1058
2,713,1120,792,1426,2218
2,344,540,252,688,940
2,1083,1701,522,2166,2688
2,344,540,219,688,907
2,344,540,349,688,1037
2,308,565,277,616,893
2,1252,2295,1489,2504,3993
2,1252,2295,1489,2504,3993
2,1519,2443,1750,3038,4788
2,344,540,198,688,886
2,713,1120,769,1426,2195
2,1555,2443,1141,3110,4251
2,1083,1701,488,2166,2654
2,344,540,392,688,1080
2,1266,2320,2062,2532,4594
2,713,1120,724,1426,2150
2,1555,2443,701,3110,3811
2,1555,2443,994,3110,4104
2,1083,1701,794,2166,2960
2,2171,3578,2814,4342,7156
2,1252,2295,1122,2504,3626
2,1266,2320,1087,2532,3619
2,1266,2320,2015,2532,4547
2,1555,2443,1092,3110,4202
2,344,540,370,688,1058
2,2171,3578,2671,4342,7013
2,713,1120,769,1426,2195
2,1519,2443,1653,3038,4691
2,487,783,482,974,1456
2,1555,2443,994,3110,4104
2,1555,2443,1141,3110,4251
2,344,540,252,688,940
2,1252,2295,1489,2504,3993
2,420,769,667,840,1507
2,1252,2295,1443,2504,3947
2,713,1120,769,1426,2195
2,487,783,561,974,1535
2,2171,3578,1240,4342,5582
2,1083,1701,1100,2166,3266
2,1555,2443,897,3110,4007
2,487,783,576,974,1550
2,1555,2443,750,3110,3860
2,1083,1701,522,2166,2688
2,2171,3578,2671,4342,7013
2,1252,2295,1489,2504,3993
2,1252,2295,1076,2504,3580
2,1555,2443,1092,3110,4202
2,713,1120,769,1426,2195
2,487,783,373,974,1347
2,1083,1701,1168,2166,3334
2,487,783,388,974,1362
2,344,540,349,688,1037
2,1252,2295,1489,2504,3993
2,1266,2320,1922,2532,4454
2,308,565,469,616,1085
2,1252,2295,1994,2504,4498
2,1519,2443,1164,3038,4202
2,1519,2443,1750,3038,4788
2,487,783,561,974,1535
2,713,1120,411,1426,1837
2,713,1120,724,1426,2150
2,713,1120,500,1426,1926
2,2171,3578,2671,4342,7013
2,2171,3578,2671,4342,7013
2,1252,2295,1902,2504,4406
2,420,769,667,840,1507
2,1252,2295,1994,2504,4498
2,487,783,247,974,1221
2,713,1120,321,1426,1747
2,1083,1701,692,2166,2858
2,1083,1701,794,2166,2960
2,344,540,154,688,842
2,344,540,154,688,842
2,344,540,381,688,1069
2,2171,3578,1884,4342,6226
2,344,540,154,688,842
2,487,783,561,974,1535
2,344,540,381,688,1069
2,1252,2295,1260,2504,3764
2,1266,2320,1134,2532,3666
2,344,540,198,688,886
2,1519,2443,1164,3038,4202
2,487,783,388,974,1362
2,713,1120,344,1426,1770
2,420,769,667,840,1507
2,2171,3578,1240,4342,5582
2,1555,2443,1678,3110,4788
2,1083,1701,1168,2166,3334
2,2171,3578,2313,4342,6655
2,344,540,154,688,842
2,1083,1701,488,2166,2654
2,1555,2443,897,3110,4007
2,1083,1701,794,2166,2960
2,344,540,219,688,907
2,2171,3578,2742,4342,7084
2,1252,2295,1489,2504,3993
2,1266,2320,1505,2532,4037
2,1252,2295,984,2504,3488
2,713,1120,769,1426,2195
2,1555,2443,994,3110,4104
2,2171,3578,2671,4342,7013
2,2171,3578,2742,4342,7084
2,295,540,479,590,1069
2,420,769,498,840,1338
2,2171,3578,1097,4342,5439
2,713,1120,500,1426,1926
2,1083,1701,760,2166,2926
2,487,783,388,974,1362
2,713,1120,792,1426,2218
2,2171,3578,2671,4342,7013
2,1266,2320,1505,2532,4037
2,2171,3578,1812,4342,6154
2,1519,2443,1750,3038,4788
2,2171,3578,2313,4342,6655
2,487,783,561,974,1535
2,487,783,561,974,1535
2,1555,2443,1141,3110,4251
2,713,1120,500,1426,1926
2,1519,2443,1799,3038,4837
2,713,1120,411,1426,1837
2,1266,2320,2062,2532,4594
2,420,769,636,840,1476
2,2171,3578,2528,4342,6870
2,1555,2443,1581,3110,4691
2,344,540,252,688,940
2,344,540,252,688,940
2,1083,1701,794,2166,2960
2,344,540,370,688,1058
2,713,1120,792,1426,2218
2,2171,3578,2671,4342,7013
2,2171,3578,2671,4342,7013
2,2171,3578,2671,4342,7013
2,1519,2443,1506,3038,4544
2,344,540,154,688,842
2,2171,3578,1240,4342,5582
2,1083,1701,794,2166,2960
2,713,1120,344,1426,1770
2,295,540,447,590,1037
2,1266,2320,1922,2532,4454
2,1519,2443,773,3038,3811
2,1519,2443,969,3038,4007
2,713,1120,769,1426,2195
2,2171,3578,2671,4342,7013
2,344,540,349,688,1037
2,2171,3578,1526,4342,5868
2,2171,3578,1955,4342,6297
2,1555,2443,1141,3110,4251
2,1555,2443,1581,3110,4691
2,1555,2443,1141,3110,4251
2,1083,1701,522,2166,2688
2,1266,2320,2015,2532,4547
2,1266,2320,1273,2532,3805
2,295,540,296,590,886
2,1555,2443,1727,3110,4837
2,487,783,247,974,1221
2,487,783,561,974,1535
2,1555,2443,1434,3110,4544
2,2171,3578,1240,4342,5582
2,713,1120,388,1426,1814
2,1266,2320,1366,2532,3898
2,2171,3578,2313,4342,6655
2,487,783,529,974,1503
2,1555,2443,1141,3110,4251
2,487,783,576,974,1550
2,295,540,468,590,1058
2,420,769,667,840,1507
2,2171,3578,2528,4342,6870
2,1555,2443,1581,3110,4691
2,344,540,154,688,842
2,2171,3578,1884,4342,6226
2,2171,3578,1669,4342,6011
2,2171,3578,1240,4342,5582
2,1519,2443,1799,3038,4837
2,2171,3578,2671,4342,7013
2,1266,2320,1366,2532,3898
2,713,1120,769,1426,2195
2,2171,3578,1669,4342,6011
2,713,1120,523,1426,1949
2,1083,1701,794,2166,2960
2,1083,1701,760,2166,2926
2,1519,2443,1653,3038,4691
2,2171,3578,1097,4342,5439
2,1555,2443,994,3110,4104
2,713,1120,500,1426,1926
2,344,540,219,688,907
2,1266,2320,1505,2532,4037
2,1266,2320,2015,2532,4547
2,1252,2295,1443,2504,3947
2,2171,3578,2671,4342,7013
2,1519,2443,1164,3038,4202
2,1555,2443,1581,3110,4691
2,1555,2443,994,3110,4104
2,1555,2443,750,3110,3860
2,2171,3578,2671,4342,7013
2,2171,3578,2742,4342,7084
2,1266,2320,1505,2532,4037
2,1266,2320,1505,2532,4037
2,1266,2320,1922,2532,4454
2,713,1120,321,1426,1747
2,2171,3578,1240,4342,5582
2,487,783,388,974,1362
2,1555,2443,994,3110,4104
2,1555,2443,1141,3110,4251
2,2171,3578,2671,4342,7013
2,308,565,367,616,983
2,1266,2320,1134,2532,3666
2,1252,2295,1076,2504,3580
2,1519,2443,1506,3038,4544
2,344,540,154,688,842
2,713,1120,411,1426,1837
2,344,540,370,688,1058
2,1519,2443,1799,3038,4837
2,344,540,370,688,1058
2,1266,2320,2015,2532,4547
2,2171,3578,2671,4342,7013
2,2171,3578,2671,4342,7013
2,2171,3578,2528,4342,6870
2,487,783,498,974,1472
2,1555,2443,701,3110,3811
2,713,1120,769,1426,2195
2,713,1120,523,1426,1949
2,1555,2443,1092,3110,4202
2,1519,2443,1653,3038,4691
2,1083,1701,522,2166,2688
2,713,1120,321,1426,1747
2,713,1120,769,1426,2195
2,344,540,370,688,1058
2,1266,2320,1226,2532,3758
2,1266,2320,2015,2532,4547
2,1252,2295,1260,2504,3764
2,1555,2443,897,3110,4007
2,1083,1701,692,2166,2858
2,713,1120,769,1426,2195
2,1083,1701,692,2166,2858
2,344,540,381,688,1069
2,1519,2443,1799,3038,4837
2,420,769,636,840,1476
2,487,783,561,974,1535
2,1083,1701,488,2166,2654
2,1083,1701,488,2166,2654
2,713,1120,500,1426,1926
2,1555,2443,1727,3110,4837
2,344,540,349,688,1037
2,1266,2320,1922,2532,4454
2,308,565,333,616,949
2,295,540,479,590,1069
2,1252,2295,984,2504,3488
2,2171,3578,1526,4342,5868
2,713,1120,769,1426,2195
2,1083,1701,522,2166,2688
2,344,540,219,688,907
2,1519,2443,1799,3038,4837
2,1555,2443,1727,3110,4837
2,487,783,576,974,1550
2,344,540,198,688,886
2,1266,2320,1505,2532,4037
2,2171,3578,2671,4342,7013
2,487,783,247,974,1221
2,344,540,370,688,1058
2,1083,1701,794,2166,2960
2,344,540,370,688,1058
2,713,1120,792,1426,2218
2,713,1120,523,1426,1949
2,1083,1701,1100,2166,3266
2,487,783,576,974,1550
2,2171,3578,2671,4342,7013
2,1252,2295,1076,2504,3580
2,2171,3578,2671,4342,7013
2,2171,3578,1812,4342,6154
2,1555,2443,1727,3110,4837
2,344,540,165,688,853
2,713,1120,769,1426,2195
2,2171,3578,1812,4342,6154
2,344,540,349,688,1037
2,1266,2320,2015,2532,4547
2,1252,2295,1489,2504,3993
2,1555,2443,750,3110,3860
2,1083,1701,692,2166,2858
2,713,1120,523,1426,1949
2,1083,1701,1100,2166,3266
2,2171,3578,2671,4342,7013
2,344,540,219,688,907
2,308,565,367,616,983
2,1083,1701,998,2166,3164
2,713,1120,769,1426,2195
2,713,1120,523,1426,1949
2,1252,2295,1260,2504,3764
2,2171,3578,2313,4342,6655
2,1555,2443,750,3110,3860
2,713,1120,523,1426,1949
2,1555,2443,1727,3110,4837
2,1266,2320,1366,2532,3898
2,295,540,468,590,1058
2,1266,2320,2015,2532,4547
2,2171,3578,1097,4342,5439
2,1555,2443,994,3110,4104
2,713,1120,456,1426,1882
2,1555,2443,750,3110,3860
2,713,1120,792,1426,2218
2,1519,2443,1799,3038,4837
2,1252,2295,1902,2504,4406
2,1266,2320,1366,2532,3898
2,1266,2320,1134,2532,3666
2,1252,2295,1489,2504,3993
2,1266,2320,2015,2532,4547
2,2171,3578,1240,4342,5582
2,1519,2443,1164,3038,4202
2,1555,2443,1239,3110,4349
2,2171,3578,1669,4342,6011
2,344,540,252,688,940
2,713,1120,411,1426,1837
2,2171,3578,1311,4342,5653
2,1266,2320,2062,2532,4594
2,1266,2320,1922,2532,4454
2,1252,2295,1076,2504,3580
2,2171,3578,2671,4342,7013
2,713,1120,321,1426,1747
2,1555,2443,1678,3110,4788
2,2171,3578,1240,4342,5582
2,713,1120,523,1426,1949
2,344,540,381,688,1069
2,2171,3578,2671,4342,7013
2,1266,2320,2015,2532,4547
2,2171,3578,1240,4342,5582
2,344,540,154,688,842
2,1519,2443,822,3038,3860
2,487,783,576,974,1550
2,1555,2443,994,3110,4104
2,713,1120,724,1426,2150
2,713,1120,769,1426,2195
2,2171,3578,2742,4342,7084
2,344,540,252,688,940
2,344,540,349,688,1037
2,1519,2443,1799,3038,4837
2,1252,2295,1076,2504,3580
2,1266,2320,1087,2532,3619
2,1519,2443,1750,3038,4788
2,2171,3578,1097,4342,5439
2,1555,2443,897,3110,4007
2,308,565,277,616,893
2,1266,2320,1134,2532,3666
2,1266,2320,2015,2532,4547
2,713,1120,769,1426,2195
2,713,1120,523,1426,1949
2,713,1120,523,1426,1949
2,344,540,381,688,1069
2,1083,1701,522,2166,2688
2,1519,2443,1799,3038,4837
2,2171,3578,2742,4342,7084
2,308,565,367,616,983
2,1266,2320,1505,2532,4037
2,1266,2320,1087,2532,3619
2,344,540,165,688,853
2,344,540,349,688,1037
2,344,540,349,688,1037
2,713,1120,456,1426,1882
2,1519,2443,1799,3038,4837
2,1266,2320,1783,2532,4315
2,1252,2295,1076,2504,3580
2,2171,3578,2313,4342,6655
2,344,540,349,688,1037
2,487,783,561,974,1535
2,713,1120,523,1426,1949
2,344,540,241,688,929
2,713,1120,792,1426,2218
2,1519,2443,1799,3038,4837
2,1519,2443,1799,3038,4837
2,2171,3578,2671,4342,7013
2,1266,2320,1783,2532,4315
2,1555,2443,1581,3110,4691
2,2171,3578,2528,4342,6870
2,2171,3578,2313,4342,6655
2,713,1120,724,1426,2150
2,1083,1701,1100,2166,3266
2,344,540,252,688,940
2,344,540,370,688,1058
2,1083,1701,692,2166,2858
2,1519,2443,1799,3038,4837
2,344,540,165,688,853
2,713,1120,724,1426,2150
2,1266,2320,1134,2532,3666
2,1266,2320,1366,2532,3898
2,1555,2443,1092,3110,4202
2,487,783,529,974,1503
2,713,1120,769,1426,2195
2,1555,2443,897,3110,4007
2,344,540,349,688,1037
2,713,1120,724,1426,2150
2,344,540,252,688,940
2,2171,3578,1240,4342,5582
2,308,565,277,616,893
2,1266,2320,1458,2532,3990
2,295,540,350,590,940
2,2171,3578,1884,4342,6226
2,1519,2443,773,3038,3811
2,713,1120,769,1426,2195
2,713,1120,321,1426,1747
2,487,783,561,974,1535
2,1555,2443,750,3110,3860
2,344,540,349,688,1037
2,1266,2320,1366,2532,3898
2,1555,2443,750,3110,3860
2,344,540,370,688,1058
2,1083,1701,1100,2166,3266
2,344,540,252,688,940
2,1252,2295,1489,2504,3993
2,1266,2320,1273,2532,3805
2,1252,2295,1765,2504,4269
2,487,783,561,974,1535
2,2171,3578,1311,4342,5653
2,713,1120,411,1426,1837
2,1519,2443,1213,3038,4251
2,1555,2443,994,3110,4104
2,344,540,370,688,1058
2,344,540,349,688,1037
2,344,540,381,688,1069
2,308,565,469,616,1085
2,1252,2295,1443,2504,3947
2,2171,3578,1240,4342,5582
2,713,1120,724,1426,2150
2,1519,2443,1750,3038,4788
2,713,1120,321,1426,1747
2,1519,2443,1506,3038,4544
2,1555,2443,1434,3110,4544
2,487,783,388,974,1362
2,1555,2443,1141,3110,4251
2,344,540,381,688,1069
2,1252,2295,1489,2504,3993
2,1252,2295,1076,2504,3580
2,2171,3578,1812,4342,6154
2,2171,3578,2528,4342,6870
2,2171,3578,1526,4342,5868
2,713,1120,769,1426,2195
2,487,783,247,974,1221
2,487,783,482,974,1456
2,1083,1701,488,2166,2654
2,1083,1701,1100,2166,3266
2,344,540,370,688,1058
2,713,1120,344,1426,1770
2,344,540,349,688,1037
2,1252,2295,1122,2504,3626
2,1266,2320,2015,2532,4547
2,2171,3578,2528,4342,6870
2,487,783,373,974,1347
2,1555,2443,1581,3110,4691
2,2171,3578,2742,4342,7084
2,713,1120,724,1426,2150
2,344,540,219,688,907
2,2171,3578,2671,4342,7013
2,2171,3578,2671,4342,7013
2,2171,3578,2742,4342,7084
2,2171,3578,1240,4342,5582
2,1555,2443,1092,3110,4202
2,1519,2443,1115,3038,4153
2,2171,3578,2528,4342,6870
2,713,1120,769,1426,2195
2,487,783,247,974,1221
2,487,783,561,974,1535
2,2171,3578,2671,4342,7013
2,1266,2320,1366,2532,3898
2,1266,2320,1598,2532,4130
2,1083,1701,1168,2166,3334
2,344,540,154,688,842
2,344,540,370,688,1058
2,2171,3578,2671,4342,7013
2,295,540,263,590,853
2,1252,2295,2040,2504,4544
2,1083,1701,488,2166,2654
2,1083,1701,1100,2166,3266
2,487,783,529,974,1503
2,1083,1701,794,2166,2960
2,713,1120,411,1426,1837
2,344,540,219,688,907
2,308,565,367,616,983
2,295,540,285,590,875
2,1266,2320,1134,2532,3666
2,420,769,360,840,1200
2,1252,2295,1260,2504,3764
2,1519,2443,1213,3038,4251
2,2171,3578,1669,4342,6011
2,1555,2443,994,3110,4104
2,1555,2443,1141,3110,4251
2,344,540,370,688,1058
2,1083,1701,1100,2166,3266
2,1555,2443,1727,3110,4837
2,1266,2320,2015,2532,4547
2,1083,1701,624,2166,2790
2,1083,1701,794,2166,2960
2,1555,2443,897,3110,4007
2,1555,2443,1581,3110,4691
2,1555,2443,1141,3110,4251
2,713,1120,769,1426,2195
2,1555,2443,897,3110,4007
2,2171,3578,2671,4342,7013
2,1252,2295,1489,2504,3993
2,1252,2295,1260,2504,3764
2,1519,2443,969,3038,4007
2,1555,2443,1141,3110,4251
2,1555,2443,750,3110,3860
2,1555,2443,1141,3110,4251
2,344,540,154,688,842
2,344,540,349,688,1037
2,1252,2295,1489,2504,3993
2,1519,2443,1653,3038,4691
2,1555,2443,1141,3110,4251
2,344,540,349,688,1037
2,713,1120,411,1426,1837
2,344,540,219,688,907
2,713,1120,724,1426,2150
2,1083,1701,1100,2166,3266
2,1555,2443,1141,3110,4251
2,344,540,349,688,1037
2,1555,2443,994,3110,4104
2,344,540,370,688,1058
2,1083,1701,692,2166,2858
2,344,540,349,688,1037
2,344,540,198,688,886
2,1083,1701,624,2166,2790
2,1252,2295,1902,2504,4406
2,1252,2295,1260,2504,3764
2,1519,2443,969,3038,4007
2,1555,2443,897,3110,4007
2,1555,2443,1434,3110,4544
2,1083,1701,1100,2166,3266
2,1555,2443,994,3110,4104
2,2171,3578,2742,4342,7084
2,713,1120,523,1426,1949
2,1266,2320,1273,2532,3805
2,1266,2320,1366,2532,3898
2,420,769,360,840,1200
2,1252,2295,1994,2504,4498
2,1083,1701,488,2166,2654
2,1083,1701,1100,2166,3266
2,1555,2443,1141,3110,4251
2,344,540,349,688,1037
2,1555,2443,1141,3110,4251
2,1252,2295,1076,2504,3580
2,1252,2295,1994,2504,4498
2,1555,2443,1434,3110,4544
2,2171,3578,2742,4342,7084
2,1519,2443,969,3038,4007
2,1555,2443,1141,3110,4251
2,1083,1701,692,2166,2858
2,344,540,349,688,1037
2,2171,3578,2671,4342,7013
2,1252,2295,1902,2504,4406
2,1266,2320,1273,2532,3805
2,1083,1701,1168,2166,3334
2,1555,2443,1092,3110,4202
2,1555,2443,1141,3110,4251
2,1555,2443,1141,3110,4251
2,344,540,349,688,1037
2,344,540,349,688,1037
2,1266,2320,1273,2532,3805
2,1519,2443,773,3038,3811
2,487,783,263,974,1237
2,344,540,370,688,1058
2,1083,1701,794,2166,2960
2,713,1120,344,1426,1770
2,2171,3578,2671,4342,7013
2,1252,2295,1489,2504,3993
2,1266,2320,2015,2532,4547
2,1252,2295,1994,2504,4498
2,713,1120,500,1426,1926
2,487,783,561,974,1535
2,1083,1701,488,2166,2654
2,1555,2443,1141,3110,4251
2,344,540,154,688,842
2,1083,1701,794,2166,2960
2,344,540,349,688,1037
2,2171,3578,1240,4342,5582
2,1252,2295,1489,2504,3993
2,295,540,447,590,1037
2,1252,2295,984,2504,3488
2,2171,3578,1526,4342,5868
2,2171,3578,2742,4342,7084
2,1083,1701,1100,2166,3266
2,1555,2443,1727,3110,4837
2,1555,2443,1141,3110,4251
2,344,540,154,688,842
2,1083,1701,794,2166,2960
2,1252,2295,1122,2504,3626
2,2171,3578,2385,4342,6727
2,344,540,381,688,1069
2,2171,3578,1240,4342,5582
2,1266,2320,1922,2532,4454
2,1555,2443,1141,3110,4251
2,1555,2443,1141,3110,4251
2,2171,3578,2671,4342,7013
2,2171,3578,2742,4342,7084
2,2171,3578,2742,4342,7084
2,1555,2443,1141,3110,4251
2,1555,2443,750,3110,3860
2,1555,2443,1141,3110,4251
2,1083,1701,794,2166,2960
2,1252,2295,1489,2504,3993
2,1252,2295,1994,2504,4498
2,1266,2320,1273,2532,3805
2,1555,2443,1678,3110,4788
2,2171,3578,2313,4342,6655
2,2171,3578,2528,4342,6870
2,1555,2443,1141,3110,4251
2,713,1120,792,1426,2218
2,1555,2443,1141,3110,4251
2,713,1120,500,1426,1926
2,713,1120,321,1426,1747
2,713,1120,321,1426,1747
2,713,1120,411,1426,1837
2,1555,2443,1141,3110,4251
2,344,540,381,688,1069
2,344,540,370,688,1058
2,713,1120,523,1426,1949
2,2171,3578,1240,4342,5582
2,420,769,667,840,1507
2,1252,2295,1076,2504,3580
2,713,1120,500,1426,1926
2,1555,2443,1141,3110,4251
2,1555,2443,750,3110,3860
2,713,1120,724,1426,2150
2,1083,1701,692,2166,2858
2,1266,2320,2015,2532,4547
2,1252,2295,1994,2504,4498
2,2171,3578,1526,4342,5868
2,1083,1701,998,2166,3164
2,713,1120,792,1426,2218
2,1083,1701,420,2166,2586
2,713,1120,411,1426,1837
2,713,1120,523,1426,1949
2,1555,2443,1141,3110,4251
2,713,1120,523,1426,1949
2,1266,2320,1087,2532,3619
2,2171,3578,2671,4342,7013
2,1555,2443,897,3110,4007
2,2171,3578,1884,4342,6226
2,1555,2443,1239,3110,4349
2,2171,3578,2742,4342,7084
2,344,540,370,688,1058
2,1266,2320,1366,2532,3898
2,420,769,636,840,1476
2,713,1120,769,1426,2195
2,2171,3578,2528,4342,6870
2,1555,2443,750,3110,3860
2,713,1120,769,1426,2195
2,344,540,370,688,1058
2,1555,2443,1141,3110,4251
2,1083,1701,794,2166,2960
2,1555,2443,1581,3110,4691
2,1555,2443,1141,3110,4251
2,713,1120,769,1426,2195
2,1555,2443,1141,3110,4251
2,1555,2443,897,3110,4007
2,1555,2443,1141,3110,4251
2,1266,2320,1783,2532,4315
2,295,540,447,590,1037
2,1266,2320,1087,2532,3619
2,1252,2295,1076,2504,3580
2,1555,2443,897,3110,4007
2,344,540,349,688,1037
2,1083,1701,1202,2166,3368
2,2171,3578,1454,4342,5796
2,1083,1701,1100,2166,3266
2,713,1120,344,1426,1770
2,1252,2295,1994,2504,4498
2,1083,1701,1168,2166,3334
2,713,1120,769,1426,2195
2,1252,2295,1076,2504,3580
2,1083,1701,1202,2166,3368
2,1252,2295,2040,2504,4544
2,308,565,469,616,1085
2,2171,3578,2528,4342,6870
2,2171,3578,1884,4342,6226
2,2171,3578,2313,4342,6655
2,1555,2443,603,3110,3713
2,713,1120,523,1426,1949
2,1519,2443,1653,3038,4691
2,2171,3578,1669,4342,6011
2,1083,1701,794,2166,2960
2,344,540,349,688,1037
2,344,540,198,688,886
2,344,540,349,688,1037
2,344,540,165,688,853
2,1083,1701,794,2166,2960
2,2171,3578,2742,4342,7084
2,1266,2320,1273,2532,3805
2,1252,2295,1489,2504,3993
2,1252,2295,1902,2504,4406
2,487,783,561,974,1535
2,713,1120,769,1426,2195
2,1083,1701,692,2166,2858
2,487,783,576,974,1550
2,2171,3578,2671,4342,7013
2,1266,2320,1505,2532,4037
2,295,540,317,590,907
2,1252,2295,1489,2504,3993
2,1252,2295,1489,2504,3993
2,1519,2443,1653,3038,4691
2,2171,3578,1884,4342,6226
2,1083,1701,1168,2166,3334
2,2171,3578,2671,4342,7013
2,1266,2320,1505,2532,4037
2,1898,3375,1469,3796,5265
2,1555,2443,1434,3110,4544
2,1555,2443,1141,3110,4251
2,344,540,252,688,940
2,1555,2443,750,3110,3860
2,713,1120,411,1426,1837
2,1266,2320,1922,2532,4454
2,713,1120,769,1426,2195
2,2171,3578,1884,4342,6226
2,1555,2443,1581,3110,4691
2,1555,2443,1434,3110,4544
2,344,540,349,688,1037
2,344,540,370,688,1058
2,1266,2320,1087,2532,3619
2,2171,3578,1311,4342,5653
2,1555,2443,1141,3110,4251
2,1252,2295,1076,2504,3580
2,1252,2295,1489,2504,3993
2,295,540,468,590,1058
2,1266,2320,1783,2532,4315
2,1083,1701,794,2166,2960
2,344,540,165,688,853
2,713,1120,344,1426,1770
2,1266,2320,1366,2532,3898
2,2171,3578,1884,4342,6226
2,1083,1701,1168,2166,3334
2,1555,2443,994,3110,4104
2,1083,1701,692,2166,2858
2,2171,3578,2671,4342,7013
2,713,1120,523,1426,1949
2,1252,2295,1902,2504,4406
2,420,769,498,840,1338
2,1555,2443,1678,3110,4788
2,1555,2443,897,3110,4007
2,1083,1701,522,2166,2688
2,1555,2443,897,3110,4007
2,344,540,381,688,1069
2,1266,2320,1551,2532,4083
2,713,1120,724,1426,2150
2,344,540,273,688,961
2,308,565,367,616,983
2,487,783,561,974,1535
2,1555,2443,1581,3110,4691
2,713,1120,523,1426,1949
2,1252,2295,1214,2504,3718
2,295,540,479,590,1069
2,344,540,262,688,950
2,1519,2443,1799,3038,4837
2,1083,1701,590,2166,2756
2,1083,1701,624,2166,2790
2,713,1120,523,1426,1949
2,308,565,469,616,1085
2,2171,3578,1240,4342,5582
2,2171,3578,1884,4342,6226
2,1555,2443,1581,3110,4691
2,1083,1701,692,2166,2858
2,487,783,576,974,1550
2,1555,2443,1141,3110,4251
2,344,540,349,688,1037
2,713,1120,344,1426,1770
2,713,1120,456,1426,1882
2,344,540,252,688,940
2,344,540,252,688,940
2,1266,2320,1922,2532,4454
2,295,540,350,590,940
2,308,565,367,616,983
2,1252,2295,1994,2504,4498
2,1252,2295,1489,2504,3993
2,487,783,310,974,1284
2,1555,2443,1141,3110,4251
2,1083,1701,624,2166,2790
2,1555,2443,994,3110,4104
2,344,540,198,688,886
2,344,540,241,688,929
2,2171,3578,1240,4342,5582
2,344,540,252,688,940
2,1266,2320,1366,2532,3898
2,713,1120,523,1426,1949
2,1519,2443,1799,3038,4837
2,344,540,165,688,853
2,487,783,482,974,1456
2,713,1120,523,1426,1949
2,1266,2320,1922,2532,4454
2,2171,3578,1240,4342,5582
2,2171,3578,1884,4342,6226
2,713,1120,724,1426,2150
2,1555,2443,994,3110,4104
2,713,1120,388,1426,1814
2,1252,2295,1994,2504,4498
2,1252,2295,1902,2504,4406
2,1252,2295,1122,2504,3626
2,1519,2443,1653,3038,4691
2,487,783,294,974,1268
2,487,783,561,974,1535
2,487,783,310,974,1284
2,344,540,154,688,842
2,1083,1701,692,2166,2858
2,1266,2320,2015,2532,4547
2,2171,3578,2742,4342,7084
2,1555,2443,1434,3110,4544
2,1555,2443,897,3110,4007
2,1083,1701,1168,2166,3334
2,1555,2443,701,3110,3811
2,1252,2295,1122,2504,3626
2,308,565,277,616,893
2,1252,2295,1489,2504,3993
2,1266,2320,1087,2532,3619
2,1252,2295,1443,2504,3947
2,1252,2295,1994,2504,4498
2,1083,1701,1168,2166,3334
2,1252,2295,1489,2504,3993
2,1266,2320,1505,2532,4037
2,1252,2295,1352,2504,3856
2,1252,2295,2040,2504,4544
2,1252,2295,1765,2504,4269
2,420,769,498,840,1338
2,1266,2320,1087,2532,3619
2,2171,3578,1240,4342,5582
2,1555,2443,750,3110,3860
2,713,1120,344,1426,1770
2,713,1120,523,1426,1949
2,344,540,349,688,1037
2,1266,2320,1366,2532,3898
2,2171,3578,2528,4342,6870
2,1555,2443,701,3110,3811
2,2171,3578,2528,4342,6870
2,713,1120,724,1426,2150
2,1555,2443,897,3110,4007
2,344,540,349,688,1037
2,344,540,381,688,1069
2,344,540,381,688,1069
2,1266,2320,2015,2532,4547
2,1252,2295,1260,2504,3764
2,420,769,498,840,1338
2,420,769,375,840,1215
2,420,769,421,840,1261
2,2171,3578,2528,4342,6870
2,487,783,482,974,1456
2,1555,2443,1141,3110,4251
2,344,540,165,688,853
2,2171,3578,2671,4342,7013
2,1266,2320,2015,2532,4547
2,1555,2443,1434,3110,4544
2,1083,1701,1100,2166,3266
2,344,540,381,688,1069
2,344,540,370,688,1058
2,344,540,381,688,1069
2,1519,2443,1799,3038,4837
2,1266,2320,1134,2532,3666
2,1252,2295,1260,2504,3764
2,1252,2295,1352,2504,3856
2,1252,2295,1260,2504,3764
2,1555,2443,897,3110,4007
2,1083,1701,998,2166,3164
2,1083,1701,1100,2166,3266
2,420,769,452,840,1292
2,1252,2295,2040,2504,4544
2,1266,2320,1505,2532,4037
2,1266,2320,1505,2532,4037
2,344,540,273,688,961
2,2171,3578,1311,4342,5653
2,1083,1701,1100,2166,3266
2,487,783,576,974,1550
2,2171,3578,2742,4342,7084
2,1252,2295,1122,2504,3626
2,1266,2320,2015,2532,4547
2,1252,2295,1122,2504,3626
2,1252,2295,1260,2504,3764
2,713,1120,523,1426,1949
2,713,1120,456,1426,1882
2,487,783,576,974,1550
2,1252,2295,1122,2504,3626
2,420,769,667,840,1507
2,420,769,636,840,1476
2,2171,3578,1526,4342,5868
2,1519,2443,1213,3038,4251
2,713,1120,500,1426,1926
2,344,540,165,688,853
2,1083,1701,794,2166,2960
2,713,1120,456,1426,1882
2,344,540,381,688,1069
2,344,540,381,688,1069
2,713,1120,344,1426,1770
2,713,1120,769,1426,2195
2,2171,3578,1884,4342,6226
2,344,540,349,688,1037
2,344,540,349,688,1037
2,344,540,316,688,1004
2,713,1120,456,1426,1882
2,1266,2320,1366,2532,3898
2,1266,2320,1366,2532,3898
2,1555,2443,1141,3110,4251
2,1083,1701,692,2166,2858
2,487,783,482,974,1456
2,344,540,252,688,940
2,1266,2320,1366,2532,3898
2,1252,2295,1902,2504,4406
2,420,769,667,840,1507
2,2171,3578,2671,4342,7013
2,1555,2443,1092,3110,4202
2,713,1120,769,1426,2195
2,2171,3578,2528,4342,6870
2,2171,3578,1526,4342,5868
2,487,783,310,974,1284
2,1555,2443,750,3110,3860
2,344,540,165,688,853
2,487,783,388,974,1362
2,713,1120,769,1426,2195
2,1555,2443,1434,3110,4544
2,344,540,370,688,1058
2,713,1120,344,1426,1770
2,344,540,349,688,1037
2,1555,2443,1092,3110,4202
2,487,783,561,974,1535
2,713,1120,724,1426,2150
2,487,783,482,974,1456
2,344,540,165,688,853
2,344,540,165,688,853
2,1266,2320,1783,2532,4315
2,420,769,667,840,1507
2,487,783,388,974,1362
2,344,540,165,688,853
2,308,565,265,616,881
2,1266,2320,2062,2532,4594
2,2171,3578,1526,4342,5868
2,2171,3578,2528,4342,6870
2,2171,3578,1669,4342,6011
2,1555,2443,1141,3110,4251
2,1555,2443,1092,3110,4202
2,1555,2443,1141,3110,4251
2,344,540,370,688,1058
2,344,540,316,688,1004
2,713,1120,456,1426,1882
2,2171,3578,1812,4342,6154
2,713,1120,523,1426,1949
2,1266,2320,1273,2532,3805
2,1555,2443,897,3110,4007
2,487,783,561,974,1535
2,1555,2443,1434,3110,4544
2,713,1120,411,1426,1837
2,713,1120,724,1426,2150
2,1555,2443,1141,3110,4251
2,344,540,219,688,907
2,713,1120,344,1426,1770
2,1252,2295,1994,2504,4498
2,713,1120,500,1426,1926
2,2171,3578,1669,4342,6011
2,713,1120,769,1426,2195
2,487,783,388,974,1362
2,420,769,375,840,1215
2,295,540,479,590,1069
2,1252,2295,1076,2504,3580
2,1519,2443,1653,3038,4691
2,1555,2443,1141,3110,4251
2,713,1120,523,1426,1949
2,487,783,388,974,1362
2,1266,2320,1783,2532,4315
2,1555,2443,1678,3110,4788
2,713,1120,657,1426,2083
2,713,1120,344,1426,1770
2,1252,2295,1902,2504,4406
2,1252,2295,1076,2504,3580
2,420,769,498,840,1338
2,1555,2443,1434,3110,4544
2,1555,2443,1141,3110,4251
2,344,540,165,688,853
2,344,540,349,688,1037
2,1252,2295,1260,2504,3764
2,295,540,468,590,1058
2,1266,2320,2015,2532,4547
2,2171,3578,2528,4342,6870
2,2171,3578,1884,4342,6226
2,1083,1701,998,2166,3164
2,713,1120,411,1426,1837
2,344,540,165,688,853
2,344,540,252,688,940
2,713,1120,456,1426,1882
2,487,783,341,974,1315
2,1083,1701,794,2166,2960
2,344,540,241,688,929
2,1555,2443,1141,3110,4251
2,713,1120,456,1426,1882
2,1083,1701,1100,2166,3266
2,344,540,349,688,1037
2,1266,2320,2015,2532,4547
2,2171,3578,2671,4342,7013
2,1555,2443,848,3110,3958
2,713,1120,657,1426,2083
2,1252,2295,1489,2504,3993
2,1519,2443,773,3038,3811
2,1519,2443,773,3038,3811
2,1555,2443,1141,3110,4251
2,2171,3578,1240,4342,5582
2,1252,2295,1994,2504,4498
2,1555,2443,1678,3110,4788
2,344,540,349,688,1037
2,1252,2295,1994,2504,4498
2,1252,2295,1765,2504,4269
2,1083,1701,760,2166,2926
2,1519,2443,1653,3038,4691
2,344,540,219,688,907
2,1083,1701,624,2166,2790
2,713,1120,456,1426,1882
2,713,1120,411,1426,1837
2,1252,2295,1902,2504,4406
2,2171,3578,2528,4342,6870
2,1555,2443,1141,3110,4251
2,344,540,316,688,1004
2,344,540,219,688,907
2,2171,3578,1240,4342,5582
2,1252,2295,1994,2504,4498
2,713,1120,769,1426,2195
2,487,783,263,974,1237
2,713,1120,411,1426,1837
2,487,783,341,974,1315
2,487,783,388,974,1362
2,713,1120,344,1426,1770
2,1266,2320,2015,2532,4547
2,1266,2320,1087,2532,3619
2,487,783,482,974,1456
2,487,783,529,974,1503
2,1252,2295,1352,2504,3856
2,1266,2320,2062,2532,4594
2,1266,2320,1273,2532,3805
2,1266,2320,1087,2532,3619
2,1252,2295,1994,2504,4498
2,344,540,252,688,940
2,1555,2443,994,3110,4104
2,1083,1701,692,2166,2858
2,2171,3578,1240,4342,5582
2,1266,2320,1922,2532,4454
2,1252,2295,1902,2504,4406
2,2171,3578,1526,4342,5868
2,1083,1701,1100,2166,3266
2,1083,1701,998,2166,3164
2,713,1120,792,1426,2218
2,2171,3578,1240,4342,5582
2,1252,2295,1994,2504,4498
2,487,783,561,974,1535
2,2171,3578,1669,4342,6011
2,487,783,529,974,1503
2,1252,2295,1076,2504,3580
2,1519,2443,773,3038,3811
2,487,783,561,974,1535
2,487,783,388,974,1362
2,713,1120,523,1426,1949
2,1266,2320,2015,2532,4547
2,1266,2320,1458,2532,3990
2,1252,2295,1994,2504,4498
2,2171,3578,1884,4342,6226
2,2171,3578,1311,4342,5653
2,1083,1701,488,2166,2654
2,487,783,263,974,1237
2,713,1120,500,1426,1926
2,1555,2443,1141,3110,4251
2,1555,2443,1581,3110,4691
2,1266,2320,1087,2532,3619
2,1266,2320,2015,2532,4547
2,1519,2443,1750,3038,4788
2,2171,3578,1884,4342,6226
2,487,783,388,974,1362
2,487,783,529,974,1503
2,1555,2443,994,3110,4104
2,344,540,349,688,1037
2,1266,2320,1505,2532,4037
2,1252,2295,1765,2504,4269
2,2171,3578,1526,4342,5868
2,1083,1701,1100,2166,3266
2,487,783,388,974,1362
2,2171,3578,2671,4342,7013
2,1519,2443,773,3038,3811
2,1555,2443,897,3110,4007
2,1083,1701,794,2166,2960
2,1083,1701,624,2166,2790
2,344,540,154,688,842
2,1083,1701,624,2166,2790
2,344,540,349,688,1037
2,713,1120,456,1426,1882
2,713,1120,523,1426,1949
2,1519,2443,1799,3038,4837
2,713,1120,344,1426,1770
2,487,783,576,974,1550
2,487,783,576,974,1550
2,487,783,576,974,1550
2,1252,2295,1352,2504,3856
2,487,783,247,974,1221
2,1519,2443,1653,3038,4691
2,713,1120,792,1426,2218
2,344,540,349,688,1037
2,344,540,252,688,940
2,1266,2320,1505,2532,4037
2,487,783,310,974,1284
2,713,1120,724,1426,2150
2,1555,2443,897,3110,4007
2,344,540,187,688,875
2,713,1120,388,1426,1814
2,1266,2320,1922,2532,4454
2,1266,2320,2015,2532,4547
2,713,1120,769,1426,2195
2,487,783,561,974,1535
2,487,783,247,974,1221
2,1555,2443,1727,3110,4837
2,1555,2443,1678,3110,4788
2,487,783,388,974,1362
2,2171,3578,1240,4342,5582
2,1252,2295,1994,2504,4498
2,1266,2320,1922,2532,4454
2,2171,3578,2528,4342,6870
2,713,1120,769,1426,2195
2,1555,2443,1434,3110,4544
2,1555,2443,897,3110,4007
2,713,1120,792,1426,2218
2,1555,2443,1141,3110,4251
2,1083,1701,794,2166,2960
2,344,540,370,688,1058
2,344,540,154,688,842
2,420,769,667,840,1507
2,420,769,498,840,1338
2,1519,2443,773,3038,3811
2,487,783,561,974,1535
2,713,1120,321,1426,1747
2,1083,1701,794,2166,2960
2,713,1120,411,1426,1837
2,344,540,349,688,1037
2,344,540,252,688,940
2,1252,2295,1902,2504,4406
2,1252,2295,1994,2504,4498
2,1252,2295,1076,2504,3580
2,1555,2443,701,3110,3811
2,2171,3578,1526,4342,5868
2,487,783,561,974,1535
2,1555,2443,1434,3110,4544
2,1519,2443,1653,3038,4691
2,713,1120,523,1426,1949
2,1083,1701,1100,2166,3266
2,713,1120,769,1426,2195
2,1555,2443,1141,3110,4251
2,713,1120,411,1426,1837
2,344,540,252,688,940
2,713,1120,388,1426,1814
2,1083,1701,1100,2166,3266
2,420,769,498,840,1338
2,1555,2443,1092,3110,4202
2,713,1120,769,1426,2195
2,1252,2295,1489,2504,3993
2,1266,2320,1366,2532,3898
2,1252,2295,1994,2504,4498
2,1252,2295,1994,2504,4498
2,2171,3578,2671,4342,7013
2,2171,3578,1097,4342,5439
2,2171,3578,2313,4342,6655
2,2171,3578,1884,4342,6226
2,344,540,381,688,1069
2,344,540,370,688,1058
2,1519,2443,1799,3038,4837
2,2171,3578,1240,4342,5582
2,344,540,252,688,940
2,1252,2295,1489,2504,3993
2,420,769,636,840,1476
2,1252,2295,2040,2504,4544
2,1266,2320,1922,2532,4454
2,2171,3578,1526,4342,5868
2,1083,1701,794,2166,2960
2,420,769,667,840,1507
2,1266,2320,2015,2532,4547
2,2171,3578,2671,4342,7013
2,2171,3578,1240,4342,5582
2,713,1120,769,1426,2195
2,2171,3578,1884,4342,6226
2,1555,2443,897,3110,4007
2,1555,2443,1581,3110,4691
2,1519,2443,1653,3038,4691
2,2171,3578,1669,4342,6011
2,487,783,529,974,1503
2,1083,1701,624,2166,2790
2,1555,2443,994,3110,4104
2,1083,1701,794,2166,2960
2,344,540,370,688,1058
2,713,1120,456,1426,1882
2,344,540,316,688,1004
2,308,565,367,616,983
2,295,540,468,590,1058
2,1266,2320,2062,2532,4594
2,1252,2295,1443,2504,3947
2,1083,1701,692,2166,2858
2,487,783,529,974,1503
2,1555,2443,1141,3110,4251
2,1083,1701,794,2166,2960
2,1083,1701,522,2166,2688
2,713,1120,411,1426,1837
2,344,540,381,688,1069
2,1898,3375,1537,3796,5333
2,1266,2320,1783,2532,4315
2,2171,3578,1884,4342,6226
2,1555,2443,994,3110,4104
2,487,783,482,974,1456
2,1555,2443,1141,3110,4251
2,1555,2443,1581,3110,4691
2,1252,2295,1489,2504,3993
2,1252,2295,1489,2504,3993
2,1252,2295,1902,2504,4406
2,295,540,468,590,1058
2,1912,3400,1480,3824,5304
2,1252,2295,1994,2504,4498
2,2171,3578,1240,4342,5582
2,1083,1701,522,2166,2688
2,1555,2443,750,3110,3860
2,713,1120,724,1426,2150
2,1266,2320,2015,2532,4547
2,420,769,667,840,1507
2,420,769,498,840,1338
2,1252,2295,2040,2504,4544
2,1252,2295,1260,2504,3764
2,1555,2443,1678,3110,4788
2,713,1120,321,1426,1747
2,1555,2443,897,3110,4007
2,1555,2443,1141,3110,4251
2,1555,2443,897,3110,4007
2,487,783,561,974,1535
2,713,1120,724,1426,2150
2,1083,1701,692,2166,2858
2,344,540,370,688,1058
2,1266,2320,1505,2532,4037
2,1266,2320,1134,2532,3666
2,420,769,667,840,1507
2,1252,2295,1489,2504,3993
2,1266,2320,1087,2532,3619
2,2171,3578,1884,4342,6226
2,2171,3578,1526,4342,5868
2,1555,2443,1581,3110,4691
2,344,540,154,688,842
2,1519,2443,969,3038,4007
2,1555,2443,1434,3110,4544
2,487,783,388,974,1362
2,487,783,310,974,1284
2,1083,1701,1100,2166,3266
2,344,540,252,688,940
2,344,540,165,688,853
2,2171,3578,2671,4342,7013
2,1266,2320,1366,2532,3898
2,1252,2295,1902,2504,4406
2,1252,2295,1902,2504,4406
2,308,565,491,616,1107
2,487,783,247,974,1221
2,1083,1701,624,2166,2790
2,1083,1701,828,2166,2994
2,1555,2443,994,3110,4104
2,1555,2443,994,3110,4104
2,1083,1701,794,2166,2960
2,1083,1701,794,2166,2960
2,344,540,165,688,853
2,1252,2295,1994,2504,4498
2,420,769,375,840,1215
2,1266,2320,1087,2532,3619
2,2171,3578,2671,4342,7013
2,2171,3578,2313,4342,6655
2,713,1120,321,1426,1747
2,2171,3578,1526,4342,5868
2,2171,3578,2313,4342,6655
2,344,540,370,688,1058
2,1555,2443,897,3110,4007
2,2171,3578,1526,4342,5868
2,1555,2443,1141,3110,4251
2,713,1120,657,1426,2083
2,344,540,165,688,853
2,713,1120,411,1426,1837
2,713,1120,344,1426,1770
2,1266,2320,2015,2532,4547
2,2171,3578,2528,4342,6870
2,1083,1701,624,2166,2790
2,487,783,529,974,1503
2,1555,2443,1141,3110,4251
2,1252,2295,1489,2504,3993
2,1252,2295,1489,2504,3993
2,1266,2320,1273,2532,3805
2,2171,3578,1526,4342,5868
2,487,783,373,974,1347
2,487,783,373,974,1347
2,1555,2443,1434,3110,4544
2,713,1120,411,1426,1837
2,344,540,381,688,1069
2,713,1120,456,1426,1882
2,2171,3578,2671,4342,7013
2,1266,2320,1087,2532,3619
2,420,769,498,840,1338
2,1266,2320,1505,2532,4037
2,2171,3578,1884,4342,6226
2,1555,2443,1678,3110,4788
2,713,1120,724,1426,2150
2,713,1120,769,1426,2195
2,1555,2443,994,3110,4104
2,344,540,165,688,853
2,1083,1701,794,2166,2960
2,713,1120,456,1426,1882
2,1266,2320,1505,2532,4037
2,1252,2295,1994,2504,4498
2,308,565,367,616,983
2,420,769,636,840,1476
2,1266,2320,1087,2532,3619
2,1266,2320,1273,2532,3805
2,1252,2295,1260,2504,3764
2,1519,2443,1506,3038,4544
2,713,1120,523,1426,1949
2,344,540,165,688,853
2,1252,2295,1443,2504,3947
2,1252,2295,1765,2504,4269
2,295,540,296,590,886
2,295,540,263,590,853
2,1252,2295,1352,2504,3856
2,1252,2295,1994,2504,4498
2,1898,3375,2009,3796,5805
2,1266,2320,1087,2532,3619
2,1266,2320,1505,2532,4037
2,1252,2295,1260,2504,3764
2,1519,2443,1555,3038,4593
2,713,1120,523,1426,1949
2,1083,1701,794,2166,2960
2,713,1120,523,1426,1949
2,1898,3375,1537,3796,5333
2,1266,2320,1366,2532,3898
2,1252,2295,1352,2504,3856
2,1266,2320,1134,2532,3666
2,295,540,479,590,1069
2,1555,2443,1678,3110,4788
2,2171,3578,2027,4342,6369
2,1083,1701,794,2166,2960
2,2171,3578,1884,4342,6226
2,1083,1701,488,2166,2654
2,713,1120,792,1426,2218
2,1083,1701,692,2166,2858
2,1083,1701,1100,2166,3266
2,2171,3578,2671,4342,7013
2,420,769,636,840,1476
2,1266,2320,1273,2532,3805
2,1555,2443,994,3110,4104
2,1266,2320,1783,2532,4315
2,308,565,367,616,983
2,1252,2295,2040,2504,4544
2,1266,2320,1087,2532,3619
2,1252,2295,1994,2504,4498
2,1252,2295,1260,2504,3764
2,344,540,349,688,1037
2,2171,3578,2671,4342,7013
2,713,1120,724,1426,2150
2,713,1120,769,1426,2195
2,487,783,529,974,1503
2,344,540,370,688,1058
2,1266,2320,1458,2532,3990
2,1252,2295,2040,2504,4544
2,295,540,468,590,1058
2,1519,2443,1750,3038,4788
2,713,1120,769,1426,2195
2,1083,1701,760,2166,2926
2,2171,3578,1526,4342,5868
2,1083,1701,488,2166,2654
2,1555,2443,994,3110,4104
2,1083,1701,1100,2166,3266
2,2171,3578,1669,4342,6011
2,713,1120,411,1426,1837
2,1252,2295,1765,2504,4269
2,1252,2295,1352,2504,3856
2,1266,2320,1134,2532,3666
2,1266,2320,1273,2532,3805
2,1252,2295,1994,2504,4498
2,1266,2320,1273,2532,3805
2,1555,2443,1141,3110,4251
2,713,1120,769,1426,2195
2,713,1120,657,1426,2083
2,1083,1701,1100,2166,3266
2,344,540,349,688,1037
2,344,540,133,688,821
2,713,1120,456,1426,1882
2,1266,2320,1505,2532,4037
2,1266,2320,1134,2532,3666
2,344,540,370,688,1058
2,2171,3578,1669,4342,6011
2,1555,2443,1727,3110,4837
2,344,540,133,688,821
2,344,540,252,688,940
2,1083,1701,1100,2166,3266
2,1252,2295,1902,2504,4406
2,1252,2295,1352,2504,3856
2,1252,2295,1122,2504,3626
2,420,769,667,840,1507
2,295,540,468,590,1058
2,1519,2443,969,3038,4007
2,1083,1701,1202,2166,3368
2,344,540,154,688,842
2,1266,2320,1134,2532,3666
2,1266,2320,1922,2532,4454
2,1555,2443,1678,3110,4788
2,1555,2443,1581,3110,4691
2,1555,2443,1434,3110,4544
2,2171,3578,1311,4342,5653
2,2171,3578,1311,4342,5653
2,344,540,381,688,1069
2,344,540,252,688,940
2,1898,3375,1537,3796,5333
2,308,565,277,616,893
2,1252,2295,1902,2504,4406
2,420,769,498,840,1338
2,1252,2295,1994,2504,4498
2,1266,2320,1087,2532,3619
2,487,783,310,974,1284
2,344,540,219,688,907
2,1083,1701,794,2166,2960
2,344,540,381,688,1069
2,1266,2320,1922,2532,4454
2,2171,3578,1526,4342,5868
2,1519,2443,1115,3038,4153
2,2171,3578,1884,4342,6226
2,1519,2443,1506,3038,4544
2,1083,1701,1100,2166,3266
2,1083,1701,624,2166,2790
2,713,1120,545,1426,1971
2,2171,3578,2742,4342,7084
2,713,1120,724,1426,2150
2,344,540,370,688,1058
2,344,540,370,688,1058
2,344,540,219,688,907
2,1519,2443,1799,3038,4837
2,1252,2295,1902,2504,4406
2,1252,2295,1902,2504,4406
2,2171,3578,2528,4342,6870
2,2171,3578,1311,4342,5653
2,1555,2443,994,3110,4104
2,344,540,252,688,940
2,713,1120,456,1426,1882
2,1266,2320,1505,2532,4037
2,1252,2295,1489,2504,3993
2,2171,3578,1526,4342,5868
2,1555,2443,1581,3110,4691
2,713,1120,657,1426,2083
2,713,1120,456,1426,1882
2,713,1120,344,1426,1770
1,1266,2320,1008,1266,2274
1,2171,3578,620,2171,2791
1,1555,2443,448,1555,2003
1,487,783,257,487,744
1,487,783,186,487,673
1,1555,2443,717,1555,2272
1,1083,1701,346,1083,1429
1,713,1120,261,713,974
1,1252,2295,745,1252,1997
1,1252,2295,882,1252,2134
1,1266,2320,752,1266,2018
1,1266,2320,683,1266,1949
1,2171,3578,1335,2171,3506
1,2171,3578,1264,2171,3435
1,1083,1701,550,1083,1633
1,2171,3578,942,2171,3113
1,1083,1701,397,1083,1480
1,344,540,174,344,518
1,344,540,174,344,518
1,344,540,126,344,470
1,1266,2320,752,1266,2018
1,1252,2295,561,1252,1813
1,1266,2320,961,1266,2227
1,487,783,280,487,767
1,1555,2443,790,1555,2345
1,2171,3578,1371,2171,3542
1,1083,1701,346,1083,1429
1,295,540,126,295,421
1,1083,1701,397,1083,1480
1,1083,1701,312,1083,1395
1,1083,1701,312,1083,1395
1,1083,1701,397,1083,1480
1,1083,1701,397,1083,1480
1,344,540,174,344,518
1,713,1120,172,713,885
1,1252,2295,561,1252,1813
1,308,565,246,308,554
1,1266,2320,1031,1266,2297
1,2171,3578,1264,2171,3435
1,2171,3578,656,2171,2827
1,1555,2443,570,1555,2125
1,344,540,174,344,518
1,1555,2443,448,1555,2003
1,713,1120,205,713,918
1,1252,2295,951,1252,2203
1,308,565,184,308,492
1,1266,2320,636,1266,1902
1,2171,3578,906,2171,3077
1,1519,2443,387,1519,1906
1,1519,2443,387,1519,1906
1,1083,1701,550,1083,1633
1,1555,2443,448,1555,2003
1,1083,1701,312,1083,1395
1,1266,2320,567,1266,1833
1,1252,2295,745,1252,1997
1,1252,2295,745,1252,1997
1,1252,2295,722,1252,1974
1,1266,2320,752,1266,2018
1,420,769,211,420,631
1,2171,3578,1264,2171,3435
1,487,783,280,487,767
1,487,783,124,487,611
1,1083,1701,261,1083,1344
1,1266,2320,1008,1266,2274
1,1266,2320,683,1266,1949
1,420,769,334,420,754
1,1266,2320,1008,1266,2274
1,420,769,249,420,669
1,1555,2443,570,1555,2125
1,1519,2443,753,1519,2272
1,713,1120,250,713,963
1,713,1120,194,713,907
1,1252,2295,676,1252,1928
1,308,565,251,308,559
1,2171,3578,620,2171,2791
1,344,540,174,344,518
1,1083,1701,346,1083,1429
1,1083,1701,550,1083,1633
1,344,540,83,344,427
1,1083,1701,312,1083,1395
1,1083,1701,261,1083,1344
1,713,1120,194,713,907
1,2171,3578,1335,2171,3506
1,1266,2320,961,1266,2227
1,308,565,184,308,492
1,1266,2320,1008,1266,2274
1,1555,2443,839,1555,2394
1,1519,2443,826,1519,2345
1,2171,3578,942,2171,3113
1,344,540,83,344,427
1,1266,2320,567,1266,1833
1,1252,2295,997,1252,2249
1,1266,2320,1008,1266,2274
1,420,769,249,420,669
1,420,769,318,420,738
1,1083,1701,550,1083,1633
1,2171,3578,1335,2171,3506
1,1266,2320,544,1266,1810
1,1266,2320,752,1266,2018
1,420,769,249,420,669
1,1555,2443,717,1555,2272
1,1555,2443,790,1555,2345
1,1555,2443,570,1555,2125
1,487,783,288,487,775
1,487,783,265,487,752
1,1555,2443,570,1555,2125
1,344,540,174,344,518
1,344,540,126,344,470
1,2171,3578,1335,2171,3506
1,1252,2295,538,1252,1790
1,1252,2295,745,1252,1997
1,1266,2320,683,1266,1949
1,1266,2320,961,1266,2227
1,1266,2320,1008,1266,2274
1,1266,2320,729,1266,1995
1,1266,2320,544,1266,1810
1,1266,2320,567,1266,1833
1,1266,2320,752,1266,2018
1,1252,2295,561,1252,1813
1,2171,3578,1264,2171,3435
1,1519,2443,606,1519,2125
1,1083,1701,601,1083,1684
1,1555,2443,497,1555,2052
1,1083,1701,261,1083,1344
1,2171,3578,1335,2171,3506
1,1252,2295,882,1252,2134
1,1266,2320,961,1266,2227
1,1266,2320,636,1266,1902
1,1252,2295,722,1252,1974
1,1519,2443,484,1519,2003
1,1555,2443,790,1555,2345
1,487,783,186,487,673
1,1555,2443,839,1555,2394
1,2171,3578,942,2171,3113
1,344,540,191,344,535
1,2171,3578,1335,2171,3506
1,1912,3400,774,1912,2686
1,1252,2295,997,1252,2249
1,1266,2320,567,1266,1833
1,1266,2320,544,1266,1810
1,2171,3578,1335,2171,3506
1,1555,2443,839,1555,2394
1,1083,1701,550,1083,1633
1,1252,2295,630,1252,1882
1,1898,3375,1410,1898,3308
1,1555,2443,717,1555,2272
1,713,1120,362,713,1075
1,1083,1701,397,1083,1480
1,1555,2443,497,1555,2052
1,1555,2443,864,1555,2419
1,1252,2295,745,1252,1997
1,1266,2320,683,1266,1949
1,1252,2295,538,1252,1790
1,2171,3578,656,2171,2827
1,1083,1701,550,1083,1633
1,1266,2320,683,1266,1949
1,420,769,249,420,669
1,308,565,234,308,542
1,295,540,169,295,464
1,1266,2320,636,1266,1902
1,2171,3578,763,2171,2934
1,1555,2443,497,1555,2052
1,308,565,184,308,492
1,1266,2320,683,1266,1949
1,1252,2295,538,1252,1790
1,1519,2443,753,1519,2272
1,2171,3578,656,2171,2827
1,344,540,126,344,470
1,344,540,126,344,470
1,1266,2320,683,1266,1949
1,1252,2295,745,1252,1997
1,713,1120,261,713,974
1,1555,2443,717,1555,2272
1,1555,2443,717,1555,2272
1,1555,2443,839,1555,2394
1,487,783,265,487,752
1,1555,2443,497,1555,2052
1,1519,2443,900,1519,2419
1,2171,3578,620,2171,2791
1,1252,2295,630,1252,1882
1,1252,2295,561,1252,1813
1,420,769,318,420,738
1,713,1120,362,713,1075
1,713,1120,250,713,963
1,713,1120,205,713,918
1,713,1120,385,713,1098
1,713,1120,385,713,1098
1,713,1120,329,713,1042
1,344,540,93,344,437
1,1083,1701,397,1083,1480
1,1083,1701,261,1083,1344
1,2171,3578,835,2171,3006
1,2171,3578,1335,2171,3506
1,1252,2295,1020,1252,2272
1,1252,2295,951,1252,2203
1,1898,3375,1241,1898,3139
1,1555,2443,570,1555,2125
1,344,540,185,344,529
1,2171,3578,1335,2171,3506
1,713,1120,329,713,1042
1,1252,2295,561,1252,1813
1,2171,3578,1335,2171,3506
1,2171,3578,942,2171,3113
1,344,540,77,344,421
1,1252,2295,745,1252,1997
1,1266,2320,752,1266,2018
1,420,769,334,420,754
1,1266,2320,961,1266,2227
1,1252,2295,882,1252,2134
1,1555,2443,717,1555,2272
1,1555,2443,424,1555,1979
1,1555,2443,497,1555,2052
1,344,540,83,344,427
1,344,540,126,344,470
1,1252,2295,997,1252,2249
1,1083,1701,261,1083,1344
1,1083,1701,550,1083,1633
1,1912,3400,944,1912,2856
1,1266,2320,683,1266,1949
1,2171,3578,1157,2171,3328
1,713,1120,250,713,963
1,1555,2443,375,1555,1930
1,713,1120,261,713,974
1,1083,1701,550,1083,1633
1,713,1120,362,713,1075
1,1555,2443,570,1555,2125
1,1555,2443,375,1555,1930
1,1083,1701,346,1083,1429
1,344,540,174,344,518
1,2171,3578,620,2171,2791
1,1266,2320,683,1266,1949
1,2171,3578,1157,2171,3328
1,713,1120,385,713,1098
1,1555,2443,570,1555,2125
1,344,540,137,344,481
1,344,540,126,344,470
1,1266,2320,1008,1266,2274
1,1266,2320,1031,1266,2297
1,295,540,240,295,535
1,1266,2320,636,1266,1902
1,1519,2443,826,1519,2345
1,344,540,83,344,427
1,713,1120,172,713,885
1,2171,3578,620,2171,2791
1,1266,2320,683,1266,1949
1,308,565,184,308,492
1,1252,2295,538,1252,1790
1,1266,2320,1008,1266,2274
1,2171,3578,1335,2171,3506
1,2171,3578,620,2171,2791
1,1555,2443,497,1555,2052
1,344,540,185,344,529
1,1083,1701,346,1083,1429
1,2171,3578,620,2171,2791
1,1252,2295,722,1252,1974
1,1252,2295,630,1252,1882
1,1266,2320,752,1266,2018
1,2171,3578,942,2171,3113
1,1519,2443,606,1519,2125
1,1083,1701,397,1083,1480
1,1083,1701,295,1083,1378
1,1555,2443,570,1555,2125
1,487,783,265,487,752
1,344,540,185,344,529
1,1252,2295,1020,1252,2272
1,308,565,155,308,463
1,1266,2320,636,1266,1902
1,2171,3578,1264,2171,3435
1,713,1120,329,713,1042
1,1083,1701,261,1083,1344
1,713,1120,396,713,1109
1,1555,2443,375,1555,1930
1,344,540,174,344,518
1,420,769,249,420,669
1,1266,2320,752,1266,2018
1,1266,2320,1031,1266,2297
1,1266,2320,1008,1266,2274
1,2171,3578,1264,2171,3435
1,713,1120,250,713,963
1,487,783,280,487,767
1,2171,3578,763,2171,2934
1,2171,3578,835,2171,3006
1,1555,2443,302,1555,1857
1,1555,2443,497,1555,2052
1,713,1120,228,713,941
1,713,1120,205,713,918
1,487,783,194,487,681
1,1083,1701,550,1083,1633
1,344,540,110,344,454
1,344,540,174,344,518
1,1266,2320,1008,1266,2274
1,420,769,180,420,600
1,1252,2295,951,1252,2203
1,1266,2320,752,1266,2018
1,1252,2295,722,1252,1974
1,2171,3578,1335,2171,3506
1,2171,3578,1371,2171,3542
1,1083,1701,397,1083,1480
1,1266,2320,497,1266,1763
1,1252,2295,882,1252,2134
1,1252,2295,1020,1252,2272
1,1266,2320,544,1266,1810
1,2171,3578,1264,2171,3435
1,487,783,186,487,673
1,713,1120,329,713,1042
1,2171,3578,942,2171,3113
1,1555,2443,839,1555,2394
1,1555,2443,570,1555,2125
1,344,540,77,344,421
1,344,540,77,344,421
1,344,540,126,344,470
1,2171,3578,1335,2171,3506
1,1898,3375,937,1898,2835
1,308,565,184,308,492
1,1252,2295,676,1252,1928
1,1252,2295,1020,1252,2272
1,1252,2295,538,1252,1790
1,2171,3578,942,2171,3113
1,1555,2443,570,1555,2125
1,713,1120,172,713,885
1,1898,3375,768,1898,2666
1,1266,2320,1031,1266,2297
1,1266,2320,636,1266,1902
1,1266,2320,683,1266,1949
1,2171,3578,1264,2171,3435
1,713,1120,284,713,997
1,1083,1701,244,1083,1327
1,713,1120,138,713,851
1,1083,1701,346,1083,1429
1,344,540,185,344,529
1,713,1120,205,713,918
1,1266,2320,1008,1266,2274
1,1266,2320,961,1266,2227
1,1252,2295,561,1252,1813
1,1252,2295,630,1252,1882
1,1266,2320,613,1266,1879
1,1252,2295,745,1252,1997
1,420,769,318,420,738
1,1898,3375,870,1898,2768
1,1555,2443,717,1555,2272
1,1083,1701,312,1083,1395
1,1083,1701,550,1083,1633
1,1252,2295,745,1252,1997
1,1266,2320,961,1266,2227
1,1252,2295,1020,1252,2272
1,1252,2295,1020,1252,2272
1,1912,3400,672,1912,2584
1,487,783,124,487,611
1,2171,3578,656,2171,2827
1,420,769,249,420,669
1,1266,2320,683,1266,1949
1,1252,2295,951,1252,2203
1,1083,1701,550,1083,1633
1,308,565,167,308,475
1,420,769,249,420,669
1,1252,2295,745,1252,1997
1,1266,2320,752,1266,2018
1,1252,2295,722,1252,1974
1,1266,2320,1008,1266,2274
1,1519,2443,826,1519,2345
1,2171,3578,942,2171,3113
1,487,783,155,487,642
1,1555,2443,448,1555,2003
1,1898,3375,768,1898,2666
1,1252,2295,882,1252,2134
1,1266,2320,683,1266,1949
1,1252,2295,561,1252,1813
1,308,565,155,308,463
1,2171,3578,942,2171,3113
1,487,783,280,487,767
1,1519,2443,484,1519,2003
1,713,1120,250,713,963
1,344,540,174,344,518
1,713,1120,261,713,974
1,1898,3375,937,1898,2835
1,1252,2295,676,1252,1928
1,2171,3578,1335,2171,3506
1,2171,3578,1264,2171,3435
1,2171,3578,1157,2171,3328
1,2171,3578,763,2171,2934
1,1083,1701,397,1083,1480
1,344,540,185,344,529
1,344,540,185,344,529
1,344,540,174,344,518
1,344,540,185,344,529
1,1252,2295,745,1252,1997
1,1266,2320,567,1266,1833
1,1252,2295,630,1252,1882
1,1252,2295,538,1252,1790
1,1555,2443,570,1555,2125
1,344,540,120,344,464
1,1083,1701,397,1083,1480
1,1083,1701,295,1083,1378
1,1083,1701,397,1083,1480
1,1519,2443,900,1519,2419
1,344,540,126,344,470
1,1252,2295,882,1252,2134
1,1252,2295,951,1252,2203
1,1266,2320,752,1266,2018
1,420,769,341,420,761
1,1266,2320,1008,1266,2274
1,1266,2320,636,1266,1902
1,308,565,138,308,446
1,1252,2295,745,1252,1997
1,420,769,249,420,669
1,1252,2295,1020,1252,2272
1,2171,3578,835,2171,3006
1,1519,2443,631,1519,2150
1,1083,1701,397,1083,1480
1,344,540,99,344,443
1,344,540,174,344,518
1,344,540,174,344,518
1,1898,3375,768,1898,2666
1,1266,2320,567,1266,1833
1,420,769,188,420,608
1,420,769,318,420,738
1,1266,2320,636,1266,1902
1,1898,3375,735,1898,2633
1,1555,2443,717,1555,2272
1,487,783,280,487,767
1,1519,2443,753,1519,2272
1,1555,2443,717,1555,2272
1,713,1120,172,713,885
1,713,1120,172,713,885
1,713,1120,172,713,885
1,1266,2320,1008,1266,2274
1,420,769,334,420,754
1,1252,2295,745,1252,1997
1,713,1120,250,713,963
1,2171,3578,763,2171,2934
1,1083,1701,499,1083,1582
1,713,1120,362,713,1075
1,1083,1701,346,1083,1429
1,713,1120,172,713,885
1,2171,3578,1335,2171,3506
1,1266,2320,683,1266,1949
1,1252,2295,951,1252,2203
1,1252,2295,722,1252,1974
1,487,783,186,487,673
1,487,783,124,487,611
1,2171,3578,942,2171,3113
1,1083,1701,295,1083,1378
1,1083,1701,261,1083,1344
1,713,1120,172,713,885
1,713,1120,205,713,918
1,1266,2320,1008,1266,2274
1,1252,2295,882,1252,2134
1,1252,2295,630,1252,1882
1,1266,2320,1008,1266,2274
1,1266,2320,752,1266,2018
1,2171,3578,1264,2171,3435
1,2171,3578,942,2171,3113
1,1555,2443,448,1555,2003
1,2171,3578,942,2171,3113
1,713,1120,385,713,1098
1,713,1120,205,713,918
1,713,1120,205,713,918
1,2171,3578,1335,2171,3506
1,1266,2320,636,1266,1902
1,1266,2320,567,1266,1833
1,1555,2443,570,1555,2125
1,487,783,155,487,642
1,1083,1701,346,1083,1429
1,713,1120,205,713,918
1,1083,1701,397,1083,1480
1,1083,1701,397,1083,1480
1,1083,1701,550,1083,1633
1,344,540,174,344,518
1,2171,3578,1335,2171,3506
1,487,783,124,487,611
1,713,1120,205,713,918
1,713,1120,194,713,907
1,1252,2295,1020,1252,2272
1,1266,2320,892,1266,2158
1,1266,2320,636,1266,1902
1,1252,2295,607,1252,1859
1,1266,2320,1008,1266,2274
1,487,783,280,487,767
1,2171,3578,835,2171,3006
1,2171,3578,1335,2171,3506
1,713,1120,362,713,1075
1,1083,1701,550,1083,1633
1,2171,3578,1335,2171,3506
1,1912,3400,774,1912,2686
1,1252,2295,951,1252,2203
1,713,1120,385,713,1098
1,1519,2443,484,1519,2003
1,1555,2443,570,1555,2125
1,1083,1701,601,1083,1684
1,1555,2443,570,1555,2125
1,2171,3578,835,2171,3006
1,2171,3578,835,2171,3006
1,2171,3578,835,2171,3006
1,487,783,155,487,642
1,713,1120,362,713,1075
1,713,1120,362,713,1075
1,1083,1701,346,1083,1429
1,713,1120,194,713,907
1,420,769,226,420,646
1,1519,2443,484,1519,2003
1,713,1120,205,713,918
1,713,1120,385,713,1098
1,1083,1701,550,1083,1633
1,2171,3578,906,2171,3077
1,2171,3578,1335,2171,3506
1,2171,3578,656,2171,2827
1,713,1120,362,713,1075
1,2171,3578,1335,2171,3506
1,1266,2320,683,1266,1949
1,420,769,249,420,669
1,1266,2320,567,1266,1833
1,1252,2295,997,1252,2249
1,2171,3578,763,2171,2934
1,1083,1701,312,1083,1395
1,713,1120,205,713,918
1,2171,3578,1335,2171,3506
1,1266,2320,683,1266,1949
1,1252,2295,951,1252,2203
1,1519,2443,875,1519,2394
1,2171,3578,1264,2171,3435
1,2171,3578,942,2171,3113
1,487,783,210,487,697
1,1555,2443,448,1555,2003
1,344,540,174,344,518
1,713,1120,261,713,974
1,1252,2295,951,1252,2203
1,1252,2295,630,1252,1882
1,1266,2320,683,1266,1949
1,1266,2320,1031,1266,2297
1,1266,2320,1008,1266,2274
1,1555,2443,546,1555,2101
1,1555,2443,351,1555,1906
1,2171,3578,1371,2171,3542
1,1555,2443,570,1555,2125
1,344,540,126,344,470
1,344,540,191,344,535
1,1266,2320,1008,1266,2274
1,1252,2295,745,1252,1997
1,420,769,188,420,608
1,487,783,155,487,642
1,344,540,126,344,470
1,713,1120,261,713,974
1,1266,2320,683,1266,1949
1,420,769,249,420,669
1,1083,1701,312,1083,1395
1,1083,1701,499,1083,1582
1,1083,1701,499,1083,1582
1,487,783,241,487,728
1,1266,2320,636,1266,1902
1,1252,2295,951,1252,2203
1,1266,2320,752,1266,2018
1,1252,2295,745,1252,1997
1,1252,2295,745,1252,1997
1,1266,2320,1031,1266,2297
1,1266,2320,1008,1266,2274
1,1555,2443,375,1555,1930
1,1555,2443,448,1555,2003
1,1083,1701,550,1083,1633
1,1083,1701,244,1083,1327
1,2171,3578,656,2171,2827
1,713,1120,161,713,874
1,344,540,83,344,427
1,344,540,83,344,427
1,1083,1701,261,1083,1344
1,2171,3578,906,2171,3077
1,344,540,66,344,410
1,2171,3578,1335,2171,3506
1,1519,2443,387,1519,1906
1,1083,1701,380,1083,1463
1,1519,2443,606,1519,2125
1,2171,3578,942,2171,3113
1,1252,2295,745,1252,1997
1,308,565,184,308,492
1,1266,2320,1008,1266,2274
1,2171,3578,906,2171,3077
1,487,783,280,487,767
1,1555,2443,570,1555,2125
1,1555,2443,448,1555,2003
1,344,540,174,344,518
1,344,540,174,344,518
1,1252,2295,676,1252,1928
1,1252,2295,745,1252,1997
1,420,769,249,420,669
1,420,769,203,420,623
1,308,565,217,308,525
1,420,769,188,420,608
1,1266,2320,729,1266,1995
1,1912,3400,672,1912,2584
1,713,1120,205,713,918
1,1519,2443,826,1519,2345
1,1555,2443,790,1555,2345
1,2171,3578,942,2171,3113
1,1555,2443,448,1555,2003
1,1555,2443,570,1555,2125
1,1252,2295,676,1252,1928
1,1266,2320,567,1266,1833
1,1266,2320,1008,1266,2274
1,487,783,280,487,767
1,2171,3578,656,2171,2827
1,1252,2295,538,1252,1790
1,1266,2320,567,1266,1833
1,1083,1701,397,1083,1480
1,713,1120,396,713,1109
1,713,1120,261,713,974
1,1266,2320,636,1266,1902
1,1252,2295,676,1252,1928
1,420,769,249,420,669
1,2171,3578,1013,2171,3184
1,1555,2443,790,1555,2345
1,713,1120,261,713,974
1,1555,2443,570,1555,2125
1,344,540,126,344,470
1,1266,2320,752,1266,2018
1,1252,2295,951,1252,2203
1,1266,2320,1008,1266,2274
1,1252,2295,745,1252,1997
1,420,769,226,420,646
1,1252,2295,745,1252,1997
1,295,540,240,295,535
1,1266,2320,544,1266,1810
1,2171,3578,763,2171,2934
1,1519,2443,826,1519,2345
1,344,540,77,344,421
1,1083,1701,312,1083,1395
1,2171,3578,942,2171,3113
1,713,1120,385,713,1098
1,1555,2443,570,1555,2125
1,344,540,174,344,518
1,713,1120,261,713,974
1,487,783,132,487,619
1,344,540,174,344,518
1,1898,3375,1038,1898,2936
1,1252,2295,745,1252,1997
1,1266,2320,683,1266,1949
1,1266,2320,1008,1266,2274
1,1252,2295,882,1252,2134
1,344,540,174,344,518
1,344,540,93,344,437
1,1266,2320,961,1266,2227
1,420,769,249,420,669
1,1266,2320,961,1266,2227
1,1266,2320,1008,1266,2274
1,1555,2443,570,1555,2125
1,2171,3578,656,2171,2827
1,1519,2443,484,1519,2003
1,1083,1701,550,1083,1633
1,713,1120,385,713,1098
1,295,540,234,295,529
1,295,540,240,295,535
1,2171,3578,942,2171,3113
1,487,783,265,487,752
1,2171,3578,906,2171,3077
1,1266,2320,961,1266,2227
1,713,1120,161,713,874
1,1519,2443,606,1519,2125
1,1555,2443,448,1555,2003
1,344,540,126,344,470
1,1083,1701,550,1083,1633
1,487,783,194,487,681
1,1252,2295,882,1252,2134
1,1252,2295,745,1252,1997
1,1252,2295,745,1252,1997
1,1266,2320,1031,1266,2297
1,1555,2443,375,1555,1930
1,1083,1701,550,1083,1633
1,713,1120,396,713,1109
1,713,1120,205,713,918
1,344,540,174,344,518
1,1252,2295,882,1252,2134
1,1252,2295,1020,1252,2272
1,420,769,249,420,669
1,295,540,132,295,427
1,420,769,249,420,669
1,1252,2295,997,1252,2249
1,1555,2443,546,1555,2101
1,2171,3578,1264,2171,3435
1,1519,2443,826,1519,2345
1,1083,1701,431,1083,1514
1,713,1120,138,713,851
1,1083,1701,397,1083,1480
1,1083,1701,550,1083,1633
1,2171,3578,942,2171,3113
1,1083,1701,346,1083,1429
1,1252,2295,951,1252,2203
1,1266,2320,1008,1266,2274
1,1252,2295,561,1252,1813
1,1266,2320,961,1266,2227
1,1555,2443,790,1555,2345
1,2171,3578,656,2171,2827
1,1555,2443,717,1555,2272
1,487,783,241,487,728
1,344,540,126,344,470
1,344,540,99,344,443
1,713,1120,228,713,941
1,2171,3578,620,2171,2791
1,1912,3400,1046,1912,2958
1,1266,2320,567,1266,1833
1,1252,2295,538,1252,1790
1,1912,3400,1284,1912,3196
1,2171,3578,1264,2171,3435
1,1083,1701,499,1083,1582
1,487,783,194,487,681
1,713,1120,385,713,1098
1,713,1120,250,713,963
1,713,1120,261,713,974
1,2171,3578,835,2171,3006
1,420,769,249,420,669
1,2171,3578,1335,2171,3506
1,713,1120,161,713,874
1,487,783,194,487,681
1,487,783,288,487,775
1,1252,2295,882,1252,2134
1,1898,3375,1410,1898,3308
1,2171,3578,1264,2171,3435
1,2171,3578,656,2171,2827
1,1083,1701,380,1083,1463
1,713,1120,329,713,1042
1,1083,1701,261,1083,1344
1,308,565,121,308,429
1,1252,2295,630,1252,1882
1,1252,2295,745,1252,1997
1,308,565,184,308,492
1,344,540,174,344,518
1,713,1120,261,713,974
1,420,769,341,420,761
1,2171,3578,1335,2171,3506
1,2171,3578,1264,2171,3435
1,713,1120,205,713,918
1,2171,3578,1371,2171,3542
1,1912,3400,774,1912,2686
1,1252,2295,676,1252,1928
1,1252,2295,997,1252,2249
1,2171,3578,1264,2171,3435
1,420,769,249,420,669
1,420,769,180,420,600
1,1252,2295,538,1252,1790
1,1519,2443,606,1519,2125
1,1555,2443,570,1555,2125
1,1083,1701,397,1083,1480
1,1519,2443,900,1519,2419
1,2171,3578,1335,2171,3506
1,1252,2295,745,1252,1997
1,1252,2295,951,1252,2203
1,1519,2443,900,1519,2419
1,713,1120,396,713,1109
1,1912,3400,774,1912,2686
1,420,769,295,420,715
1,420,769,188,420,608
1,1252,2295,997,1252,2249
1,487,783,132,487,619
1,2171,3578,1371,2171,3542
1,713,1120,329,713,1042
1,1083,1701,550,1083,1633
1,344,540,110,344,454
1,344,540,174,344,518
1,713,1120,261,713,974
1,1083,1701,261,1083,1344
1,1083,1701,312,1083,1395
1,1252,2295,1020,1252,2272
1,1266,2320,752,1266,2018
1,1266,2320,1008,1266,2274
1,2171,3578,1264,2171,3435
1,1083,1701,584,1083,1667
1,1083,1701,346,1083,1429
1,1083,1701,397,1083,1480
1,1555,2443,570,1555,2125
1,487,783,132,487,619
1,2171,3578,620,2171,2791
1,1266,2320,567,1266,1833
1,420,769,249,420,669
1,420,769,249,420,669
1,1266,2320,683,1266,1949
1,344,540,66,344,410
1,1555,2443,790,1555,2345
1,2171,3578,942,2171,3113
1,1555,2443,717,1555,2272
1,2171,3578,1371,2171,3542
1,487,783,194,487,681
1,1266,2320,636,1266,1902
1,1252,2295,538,1252,1790
1,1252,2295,538,1252,1790
1,1519,2443,484,1519,2003
1,1555,2443,448,1555,2003
1,487,783,265,487,752
1,344,540,185,344,529
1,1083,1701,346,1083,1429
1,487,783,132,487,619
1,344,540,83,344,427
1,1266,2320,752,1266,2018
1,2171,3578,1157,2171,3328
1,487,783,124,487,611
1,487,783,186,487,673
1,1555,2443,741,1555,2296
1,487,783,155,487,642
1,713,1120,205,713,918
1,1083,1701,397,1083,1480
1,1083,1701,601,1083,1684
1,1555,2443,570,1555,2125
1,344,540,99,344,443
1,1266,2320,1008,1266,2274
1,420,769,188,420,608
1,420,769,180,420,600
1,1252,2295,561,1252,1813
1,1266,2320,683,1266,1949
1,1252,2295,630,1252,1882
1,420,769,318,420,738
1,420,769,249,420,669
1,1252,2295,1020,1252,2272
1,2171,3578,1335,2171,3506
1,344,540,126,344,470
1,344,540,174,344,518
1,344,540,126,344,470
1,1252,2295,676,1252,1928
1,2171,3578,620,2171,2791
1,713,1120,261,713,974
1,1083,1701,550,1083,1633
1,1083,1701,397,1083,1480
1,1252,2295,630,1252,1882
1,1266,2320,567,1266,1833
1,420,769,318,420,738
1,1252,2295,1020,1252,2272
1,2171,3578,906,2171,3077
1,2171,3578,942,2171,3113
1,2171,3578,1157,2171,3328
1,487,783,194,487,681
1,1555,2443,790,1555,2345
1,1555,2443,448,1555,2003
1,1083,1701,346,1083,1429
1,344,540,77,344,421
1,1252,2295,951,1252,2203
1,420,769,180,420,600
1,420,769,249,420,669
1,420,769,211,420,631
1,1266,2320,1008,1266,2274
1,1252,2295,882,1252,2134
1,2171,3578,620,2171,2791
1,344,540,158,344,502
1,1555,2443,570,1555,2125
1,2171,3578,1335,2171,3506
1,1252,2295,561,1252,1813
1,1555,2443,790,1555,2345
1,713,1120,362,713,1075
1,2171,3578,906,2171,3077
1,487,783,132,487,619
1,1266,2320,683,1266,1949
1,1252,2295,561,1252,1813
1,420,769,203,420,623
1,1266,2320,1008,1266,2274
1,713,1120,250,713,963
1,2171,3578,835,2171,3006
1,2171,3578,656,2171,2827
1,2171,3578,942,2171,3113
1,713,1120,261,713,974
1,344,540,126,344,470
1,344,540,126,344,470
1,1252,2295,722,1252,1974
1,1252,2295,630,1252,1882
1,420,769,211,420,631
1,1266,2320,752,1266,2018
1,308,565,184,308,492
1,1266,2320,961,1266,2227
1,487,783,280,487,767
1,487,783,280,487,767
1,2171,3578,835,2171,3006
1,1555,2443,570,1555,2125
1,713,1120,261,713,974
1,713,1120,362,713,1075
1,344,540,83,344,427
1,1252,2295,676,1252,1928
1,1252,2295,882,1252,2134
1,1266,2320,567,1266,1833
1,420,769,318,420,738
1,1252,2295,745,1252,1997
1,2171,3578,620,2171,2791
1,2171,3578,620,2171,2791
1,1555,2443,448,1555,2003
1,1083,1701,584,1083,1667
1,344,540,126,344,470
1,1266,2320,636,1266,1902
1,1898,3375,768,1898,2666
1,1266,2320,752,1266,2018
1,1252,2295,745,1252,1997
1,1252,2295,676,1252,1928
1,1252,2295,1020,1252,2272
1,1252,2295,1020,1252,2272
1,1252,2295,951,1252,2203
1,1266,2320,636,1266,1902
1,1266,2320,892,1266,2158
1,1252,2295,722,1252,1974
1,1266,2320,544,1266,1810
1,1266,2320,544,1266,1810
1,713,1120,161,713,874
1,2171,3578,1264,2171,3435
1,344,540,158,344,502
1,344,540,191,344,535
1,344,540,99,344,443
1,713,1120,261,713,974
1,1266,2320,683,1266,1949
1,1266,2320,636,1266,1902
1,1266,2320,544,1266,1810
1,1519,2443,900,1519,2419
1,1083,1701,499,1083,1582
1,2171,3578,763,2171,2934
1,713,1120,205,713,918
1,1266,2320,752,1266,2018
1,1266,2320,752,1266,2018
1,1266,2320,961,1266,2227
1,420,769,249,420,669
1,1266,2320,544,1266,1810
1,1252,2295,722,1252,1974
1,1555,2443,839,1555,2394
1,1083,1701,312,1083,1395
1,713,1120,261,713,974
1,713,1120,362,713,1075
1,1083,1701,550,1083,1633
1,344,540,158,344,502
1,344,540,185,344,529
1,1083,1701,499,1083,1582
1,1083,1701,601,1083,1684
1,487,783,288,487,775
1,344,540,126,344,470
1,344,540,126,344,470
1,1266,2320,636,1266,1902
1,1266,2320,683,1266,1949
1,1252,2295,997,1252,2249
1,1266,2320,544,1266,1810
1,2171,3578,942,2171,3113
1,713,1120,161,713,874
1,713,1120,261,713,974
1,308,565,138,308,446
1,1252,2295,997,1252,2249
1,1519,2443,387,1519,1906
1,1555,2443,839,1555,2394
1,2171,3578,656,2171,2827
1,713,1120,362,713,1075
1,344,540,185,344,529
1,344,540,126,344,470
1,487,783,194,487,681
1,2171,3578,1335,2171,3506
1,1898,3375,937,1898,2835
1,1266,2320,1008,1266,2274
1,1252,2295,745,1252,1997
1,420,769,318,420,738
1,2171,3578,763,2171,2934
1,2171,3578,763,2171,2934
1,344,540,99,344,443
1,1266,2320,567,1266,1833
1,420,769,249,420,669
1,2171,3578,942,2171,3113
1,487,783,124,487,611
1,1555,2443,448,1555,2003
1,1519,2443,533,1519,2052
1,1083,1701,584,1083,1667
1,2171,3578,1335,2171,3506
1,344,540,126,344,470
1,1555,2443,497,1555,2052
1,1083,1701,550,1083,1633
1,487,783,171,487,658
1,487,783,171,487,658
1,487,783,132,487,619
1,713,1120,228,713,941
1,2171,3578,620,2171,2791
1,1252,2295,882,1252,2134
1,420,769,180,420,600
1,1266,2320,752,1266,2018
1,1252,2295,745,1252,1997
1,1266,2320,961,1266,2227
1,713,1120,362,713,1075
1,344,540,185,344,529
1,713,1120,205,713,918
1,344,540,99,344,443
1,344,540,126,344,470
1,344,540,126,344,470
1,1266,2320,752,1266,2018
1,1266,2320,1008,1266,2274
1,2171,3578,1157,2171,3328
1,713,1120,284,713,997
1,713,1120,385,713,1098
1,2171,3578,656,2171,2827
1,344,540,99,344,443
1,1912,3400,774,1912,2686
1,420,769,257,420,677
1,1252,2295,676,1252,1928
1,1252,2295,1020,1252,2272
1,1555,2443,448,1555,2003
1,487,783,241,487,728
1,713,1120,273,713,986
1,713,1120,385,713,1098
1,713,1120,205,713,918
1,713,1120,250,713,963
1,487,783,194,487,681
1,1083,1701,550,1083,1633
1,344,540,77,344,421
1,2171,3578,1335,2171,3506
1,713,1120,161,713,874
1,1555,2443,570,1555,2125
1,487,783,194,487,681
1,2171,3578,906,2171,3077
1,344,540,126,344,470
1,2171,3578,620,2171,2791
1,1266,2320,544,1266,1810
1,1555,2443,448,1555,2003
1,713,1120,362,713,1075
1,2171,3578,656,2171,2827
1,344,540,137,344,481
1,344,540,126,344,470
1,1898,3375,1038,1898,2936
1,1266,2320,567,1266,1833
1,1252,2295,630,1252,1882
1,1266,2320,752,1266,2018
1,1266,2320,1008,1266,2274
1,1266,2320,544,1266,1810
1,1266,2320,544,1266,1810
1,2171,3578,620,2171,2791
1,1083,1701,499,1083,1582
1,487,783,194,487,681
1,344,540,191,344,535
1,487,783,171,487,658
1,2171,3578,620,2171,2791
1,344,540,174,344,518
1,2171,3578,1335,2171,3506
1,1252,2295,630,1252,1882
1,420,769,188,420,608
1,1266,2320,613,1266,1879
1,1266,2320,752,1266,2018
1,1252,2295,997,1252,2249
1,1555,2443,448,1555,2003
1,1083,1701,397,1083,1480
1,1083,1701,584,1083,1667
1,2171,3578,656,2171,2827
1,713,1120,250,713,963
1,713,1120,362,713,1075
1,1083,1701,550,1083,1633
1,344,540,126,344,470
1,487,783,194,487,681
1,2171,3578,1335,2171,3506
1,1266,2320,683,1266,1949
1,1266,2320,1008,1266,2274
1,2171,3578,763,2171,2934
1,713,1120,161,713,874
1,713,1120,250,713,963
1,1083,1701,601,1083,1684
1,344,540,174,344,518
1,344,540,191,344,535
1,344,540,126,344,470
1,1266,2320,567,1266,1833
1,1252,2295,745,1252,1997
1,1266,2320,567,1266,1833
1,1266,2320,683,1266,1949
1,2171,3578,656,2171,2827
1,713,1120,205,713,918
1,344,540,185,344,529
1,344,540,185,344,529
1,344,540,126,344,470
1,1083,1701,550,1083,1633
1,713,1120,205,713,918
1,1266,2320,683,1266,1949
1,1252,2295,745,1252,1997
1,1252,2295,538,1252,1790
1,2171,3578,1335,2171,3506
1,1083,1701,499,1083,1582
1,713,1120,362,713,1075
1,1083,1701,550,1083,1633
1,344,540,126,344,470
1,1555,2443,448,1555,2003
1,1555,2443,717,1555,2272
1,2171,3578,942,2171,3113
1,713,1120,205,713,918
1,344,540,83,344,427
1,344,540,93,344,437
1,2171,3578,835,2171,3006
1,1252,2295,630,1252,1882
1,1266,2320,752,1266,2018
1,1266,2320,1031,1266,2297
1,295,540,234,295,529
1,2171,3578,763,2171,2934
1,1083,1701,397,1083,1480
1,1083,1701,312,1083,1395
1,713,1120,396,713,1109
1,2171,3578,906,2171,3077
1,713,1120,362,713,1075
1,344,540,83,344,427
1,1252,2295,630,1252,1882
1,1266,2320,1008,1266,2274
1,308,565,138,308,446
1,1266,2320,1031,1266,2297
1,420,769,180,420,600
1,1266,2320,567,1266,1833
1,420,769,249,420,669
1,1252,2295,997,1252,2249
1,1519,2443,875,1519,2394
1,487,783,124,487,611
1,713,1120,362,713,1075
1,1083,1701,550,1083,1633
1,713,1120,172,713,885
1,1252,2295,676,1252,1928
1,1252,2295,630,1252,1882
1,420,769,341,420,761
1,295,540,234,295,529
1,1252,2295,997,1252,2249
1,1252,2295,997,1252,2249
1,2171,3578,620,2171,2791
1,2171,3578,1157,2171,3328
1,487,783,155,487,642
1,1519,2443,900,1519,2419
1,1083,1701,550,1083,1633
1,420,769,249,420,669
1,1266,2320,567,1266,1833
1,1266,2320,752,1266,2018
1,420,769,334,420,754
1,2171,3578,942,2171,3113
1,1555,2443,790,1555,2345
1,344,540,77,344,421
1,713,1120,362,713,1075
1,344,540,185,344,529
1,344,540,185,344,529
1,344,540,77,344,421
1,344,540,110,344,454
1,1083,1701,295,1083,1378
1,1083,1701,397,1083,1480
1,2171,3578,942,2171,3113
1,1252,2295,722,1252,1974
1,1266,2320,567,1266,1833
1,295,540,175,295,470
1,1266,2320,1008,1266,2274
1,1083,1701,601,1083,1684
1,2171,3578,1371,2171,3542
1,344,540,174,344,518
1,1083,1701,601,1083,1684
1,2171,3578,1335,2171,3506
1,1898,3375,1038,1898,2936
1,1252,2295,951,1252,2203
1,1252,2295,745,1252,1997
1,1266,2320,1008,1266,2274
1,1252,2295,561,1252,1813
1,1252,2295,538,1252,1790
1,2171,3578,763,2171,2934
1,2171,3578,763,2171,2934
1,2171,3578,656,2171,2827
1,1083,1701,397,1083,1480
1,1083,1701,397,1083,1480
1,713,1120,205,713,918
1,487,783,155,487,642
1,1083,1701,295,1083,1378
1,1252,2295,882,1252,2134
1,1252,2295,745,1252,1997
1,1266,2320,683,1266,1949
1,1266,2320,752,1266,2018
1,1252,2295,951,1252,2203
1,1912,3400,1012,1912,2924
1,1252,2295,997,1252,2249
1,1266,2320,1008,1266,2274
1,2171,3578,620,2171,2791
1,487,783,124,487,611
1,487,783,124,487,611
1,1083,1701,601,1083,1684
1,2171,3578,942,2171,3113
1,713,1120,161,713,874
1,2171,3578,1371,2171,3542
1,1266,2320,752,1266,2018
1,1266,2320,1031,1266,2297
1,420,769,211,420,631
1,2171,3578,1264,2171,3435
1,713,1120,329,713,1042
1,1555,2443,375,1555,1930
1,344,540,185,344,529
1,1555,2443,570,1555,2125
1,344,540,174,344,518
1,1252,2295,630,1252,1882
1,1266,2320,636,1266,1902
1,420,769,334,420,754
1,1252,2295,745,1252,1997
1,1266,2320,683,1266,1949
1,1252,2295,997,1252,2249
1,1519,2443,826,1519,2345
1,2171,3578,656,2171,2827
1,2171,3578,942,2171,3113
1,1519,2443,484,1519,2003
1,487,783,265,487,752
1,344,540,158,344,502
1,487,783,265,487,752
1,713,1120,385,713,1098
1,2171,3578,620,2171,2791
1,1252,2295,1020,1252,2272
1,1266,2320,776,1266,2042
1,2171,3578,906,2171,3077
1,713,1120,385,713,1098
1,2171,3578,942,2171,3113
1,1083,1701,244,1083,1327
1,713,1120,205,713,918
1,1555,2443,375,1555,1930
1,1898,3375,937,1898,2835
1,1266,2320,961,1266,2227
1,487,783,280,487,767
1,1519,2443,753,1519,2272
1,2171,3578,942,2171,3113
1,713,1120,205,713,918
1,1912,3400,774,1912,2686
1,1266,2320,752,1266,2018
1,1266,2320,683,1266,1949
1,1266,2320,799,1266,2065
1,1252,2295,1020,1252,2272
1,1266,2320,636,1266,1902
1,2171,3578,620,2171,2791
1,2171,3578,942,2171,3113
1,713,1120,329,713,1042
1,2171,3578,1371,2171,3542
1,1083,1701,550,1083,1633
1,344,540,174,344,518
1,295,540,175,295,470
1,1266,2320,752,1266,2018
1,1252,2295,745,1252,1997
1,1266,2320,729,1266,1995
1,1266,2320,1008,1266,2274
1,1555,2443,570,1555,2125
1,2171,3578,763,2171,2934
1,713,1120,205,713,918
1,2171,3578,656,2171,2827
1,1555,2443,717,1555,2272
1,1083,1701,550,1083,1633
1,713,1120,205,713,918
1,1083,1701,397,1083,1480
1,1252,2295,630,1252,1882
1,1252,2295,745,1252,1997
1,713,1120,362,713,1075
1,1083,1701,397,1083,1480
1,713,1120,362,713,1075
1,713,1120,362,713,1075
1,1083,1701,346,1083,1429
1,344,540,110,344,454
1,344,540,110,344,454
1,1912,3400,774,1912,2686
1,1266,2320,1008,1266,2274
1,295,540,175,295,470
1,1252,2295,951,1252,2203
1,1252,2295,538,1252,1790
1,487,783,124,487,611
1,1555,2443,302,1555,1857
1,1083,1701,244,1083,1327
1,487,783,265,487,752
1,713,1120,261,713,974
1,1083,1701,397,1083,1480
1,344,540,126,344,470
1,1252,2295,745,1252,1997
1,1266,2320,752,1266,2018
1,1252,2295,745,1252,1997
1,1252,2295,997,1252,2249
1,1519,2443,826,1519,2345
1,713,1120,250,713,963
1,713,1120,172,713,885
1,713,1120,205,713,918
1,344,540,83,344,427
1,420,769,249,420,669
1,1252,2295,676,1252,1928
1,295,540,234,295,529
1,2171,3578,906,2171,3077
1,713,1120,385,713,1098
1,1555,2443,302,1555,1857
1,487,783,155,487,642
1,2171,3578,620,2171,2791
1,1266,2320,961,1266,2227
1,1252,2295,630,1252,1882
1,1555,2443,448,1555,2003
1,1555,2443,790,1555,2345
1,344,540,158,344,502
1,1555,2443,497,1555,2052
1,344,540,83,344,427
1,344,540,83,344,427
1,2171,3578,763,2171,2934
1,2171,3578,835,2171,3006
1,1266,2320,892,1266,2158
1,1266,2320,567,1266,1833
1,1252,2295,607,1252,1859
1,1252,2295,997,1252,2249
1,1252,2295,997,1252,2249
1,2171,3578,1264,2171,3435
1,1083,1701,584,1083,1667
1,1266,2320,544,1266,1810
1,1252,2295,951,1252,2203
1,1252,2295,538,1252,1790
1,2171,3578,620,2171,2791
1,2171,3578,620,2171,2791
1,1519,2443,826,1519,2345
1,713,1120,205,713,918
1,1519,2443,900,1519,2419
1,1555,2443,570,1555,2125
1,713,1120,172,713,885
1,1266,2320,497,1266,1763
1,1266,2320,892,1266,2158
1,420,769,180,420,600
1,713,1120,362,713,1075
1,713,1120,261,713,974
1,487,783,265,487,752
1,2171,3578,942,2171,3113
1,1083,1701,397,1083,1480
1,344,540,185,344,529
1,1083,1701,346,1083,1429
1,1912,3400,774,1912,2686
1,1266,2320,567,1266,1833
1,1252,2295,882,1252,2134
1,1266,2320,567,1266,1833
1,1252,2295,1020,1252,2272
1,1266,2320,544,1266,1810
1,2171,3578,1264,2171,3435
1,487,783,280,487,767
1,1083,1701,397,1083,1480
1,1083,1701,397,1083,1480
1,713,1120,228,713,941
1,713,1120,261,713,974
1,1252,2295,882,1252,2134
1,1252,2295,951,1252,2203
1,1252,2295,745,1252,1997
1,1266,2320,683,1266,1949
1,1266,2320,1054,1266,2320
1,2171,3578,763,2171,2934
1,344,540,158,344,502
1,344,540,158,344,502
1,487,783,265,487,752
1,713,1120,362,713,1075
1,1083,1701,346,1083,1429
1,2171,3578,1335,2171,3506
1,1266,2320,1031,1266,2297
1,1266,2320,1008,1266,2274
1,420,769,226,420,646
1,1252,2295,997,1252,2249
1,1266,2320,868,1266,2134
1,1555,2443,351,1555,1906
1,2171,3578,1157,2171,3328
1,1555,2443,790,1555,2345
1,1083,1701,584,1083,1667
1,2171,3578,656,2171,2827
1,713,1120,261,713,974
1,713,1120,385,713,1098
1,1083,1701,261,1083,1344
1,1083,1701,550,1083,1633
1,713,1120,172,713,885
1,2171,3578,1335,2171,3506
1,420,769,249,420,669
1,1252,2295,745,1252,1997
1,2171,3578,1264,2171,3435
1,1083,1701,601,1083,1684
1,1519,2443,484,1519,2003
1,1083,1701,584,1083,1667
1,1083,1701,312,1083,1395
1,420,769,334,420,754
1,420,769,249,420,669
1,420,769,180,420,600
1,420,769,334,420,754
1,1266,2320,683,1266,1949
1,308,565,189,308,497
1,1252,2295,997,1252,2249
1,1266,2320,1008,1266,2274
1,1083,1701,499,1083,1582
1,487,783,288,487,775
1,1266,2320,752,1266,2018
1,1252,2295,745,1252,1997
1,1266,2320,544,1266,1810
1,1252,2295,745,1252,1997
1,1252,2295,1020,1252,2272
1,1252,2295,538,1252,1790
1,2171,3578,942,2171,3113
1,713,1120,329,713,1042
1,1083,1701,499,1083,1582
1,1555,2443,570,1555,2125
1,1912,3400,1046,1912,2958
1,1252,2295,745,1252,1997
1,1252,2295,561,1252,1813
1,1252,2295,997,1252,2249
1,1266,2320,544,1266,1810
1,487,783,280,487,767
1,1083,1701,397,1083,1480
1,487,783,280,487,767
1,344,540,158,344,502
1,1083,1701,397,1083,1480
1,713,1120,261,713,974
1,1555,2443,864,1555,2419
1,1266,2320,1008,1266,2274
1,1252,2295,928,1252,2180
1,1266,2320,729,1266,1995
1,1252,2295,997,1252,2249
1,2171,3578,942,2171,3113
1,713,1120,340,713,1053
1,2171,3578,1371,2171,3542
1,1083,1701,261,1083,1344
1,344,540,191,344,535
1,1266,2320,683,1266,1949
1,1266,2320,683,1266,1949
1,1266,2320,636,1266,1902
1,2171,3578,763,2171,2934
1,1555,2443,448,1555,2003
1,713,1120,362,713,1075
1,1083,1701,312,1083,1395
1,2171,3578,942,2171,3113
1,487,783,265,487,752
1,1555,2443,351,1555,1906
1,1555,2443,570,1555,2125
1,344,540,174,344,518
1,2171,3578,1335,2171,3506
1,1083,1701,397,1083,1480
1,713,1120,228,713,941
1,1266,2320,892,1266,2158
1,1266,2320,729,1266,1995
1,1266,2320,567,1266,1833
1,1252,2295,997,1252,2249
1,1252,2295,997,1252,2249
1,1555,2443,790,1555,2345
1,1083,1701,584,1083,1667
1,2171,3578,942,2171,3113
1,1083,1701,601,1083,1684
1,713,1120,261,713,974
1,344,540,191,344,535
1,344,540,185,344,529
1,1083,1701,499,1083,1582
1,2171,3578,620,2171,2791
1,344,540,99,344,443
1,487,783,132,487,619
1,2171,3578,1335,2171,3506
1,1266,2320,567,1266,1833
1,1252,2295,538,1252,1790
1,2171,3578,1264,2171,3435
1,1519,2443,387,1519,1906
1,487,783,280,487,767
1,1519,2443,484,1519,2003
1,487,783,241,487,728
1,487,783,202,487,689
1,1555,2443,448,1555,2003
1,344,540,126,344,470
1,487,783,265,487,752
1,1083,1701,261,1083,1344
1,713,1120,172,713,885
1,1083,1701,397,1083,1480
1,713,1120,172,713,885
1,1266,2320,892,1266,2158
1,1252,2295,630,1252,1882
1,1252,2295,630,1252,1882
1,1252,2295,768,1252,2020
1,1912,3400,1046,1912,2958
1,1252,2295,745,1252,1997
1,1266,2320,567,1266,1833
1,1252,2295,951,1252,2203
1,295,540,234,295,529
1,713,1120,385,713,1098
1,487,783,265,487,752
1,487,783,132,487,619
1,713,1120,362,713,1075
1,1252,2295,951,1252,2203
1,1252,2295,997,1252,2249
1,487,783,186,487,673
1,487,783,265,487,752
1,344,540,185,344,529
1,344,540,83,344,427
1,344,540,83,344,427
1,344,540,126,344,470
1,2171,3578,1335,2171,3506
1,420,769,211,420,631
1,1252,2295,676,1252,1928
1,2171,3578,1335,2171,3506
1,1083,1701,312,1083,1395
1,1083,1701,397,1083,1480
1,713,1120,205,713,918
1,344,540,120,344,464
1,1083,1701,584,1083,1667
1,713,1120,228,713,941
1,308,565,155,308,463
1,420,769,249,420,669
1,1252,2295,630,1252,1882
1,2171,3578,942,2171,3113
1,1555,2443,717,1555,2272
1,713,1120,385,713,1098
1,2171,3578,656,2171,2827
1,344,540,110,344,454
1,1266,2320,752,1266,2018
1,295,540,159,295,454
1,420,769,334,420,754
1,420,769,341,420,761
1,295,540,148,295,443
1,1266,2320,567,1266,1833
1,2171,3578,942,2171,3113
1,1555,2443,448,1555,2003
1,1083,1701,601,1083,1684
1,1083,1701,499,1083,1582
1,713,1120,172,713,885
1,1252,2295,951,1252,2203
1,1266,2320,544,1266,1810
1,420,769,249,420,669
1,1555,2443,839,1555,2394
1,1555,2443,448,1555,2003
1,1555,2443,790,1555,2345
1,2171,3578,942,2171,3113
1,1555,2443,864,1555,2419
1,713,1120,385,713,1098
1,487,783,265,487,752
1,1083,1701,295,1083,1378
1,1266,2320,799,1266,2065
1,1912,3400,774,1912,2686
1,1266,2320,636,1266,1902
1,420,769,249,420,669
1,1266,2320,1008,1266,2274
1,295,540,175,295,470
1,1252,2295,997,1252,2249
1,1252,2295,997,1252,2249
1,344,540,174,344,518
1,1555,2443,570,1555,2125
1,344,540,174,344,518
1,1555,2443,546,1555,2101
1,1555,2443,790,1555,2345
1,1555,2443,839,1555,2394
1,1555,2443,570,1555,2125
1,2171,3578,1335,2171,3506
1,2171,3578,620,2171,2791
1,1252,2295,538,1252,1790
1,1266,2320,636,1266,1902
1,295,540,132,295,427
1,1898,3375,1005,1898,2903
1,1252,2295,538,1252,1790
1,2171,3578,942,2171,3113
1,1519,2443,606,1519,2125
1,1252,2295,997,1252,2249
1,420,769,211,420,631
1,1266,2320,567,1266,1833
1,295,540,234,295,529
1,1252,2295,676,1252,1928
1,1266,2320,961,1266,2227
1,1266,2320,729,1266,1995
1,1266,2320,1008,1266,2274
1,1519,2443,387,1519,1906
1,2171,3578,763,2171,2934
1,1555,2443,570,1555,2125
1,1083,1701,584,1083,1667
1,1083,1701,584,1083,1667
1,713,1120,261,713,974
1,1266,2320,683,1266,1949
1,1266,2320,636,1266,1902
1,1266,2320,636,1266,1902
1,1252,2295,745,1252,1997
1,1252,2295,745,1252,1997
1,1083,1701,210,1083,1293
1,2171,3578,656,2171,2827
1,1083,1701,499,1083,1582
1,713,1120,261,713,974
1,344,540,83,344,427
1,1252,2295,745,1252,1997
1,1912,3400,1046,1912,2958
1,420,769,249,420,669
1,1252,2295,676,1252,1928
1,1252,2295,997,1252,2249
1,295,540,234,295,529
1,1083,1701,550,1083,1633
1,1555,2443,790,1555,2345
1,1555,2443,302,1555,1857
1,713,1120,385,713,1098
1,713,1120,161,713,874
1,1252,2295,630,1252,1882
1,1266,2320,1008,1266,2274
1,295,540,132,295,427
1,1252,2295,997,1252,2249
1,2171,3578,835,2171,3006
1,713,1120,385,713,1098
1,1083,1701,397,1083,1480
1,1555,2443,570,1555,2125
1,713,1120,172,713,885
1,2171,3578,1335,2171,3506
1,1252,2295,745,1252,1997
1,1252,2295,951,1252,2203
1,1252,2295,951,1252,2203
1,1252,2295,722,1252,1974
1,2171,3578,942,2171,3113
1,1083,1701,210,1083,1293
1,2171,3578,835,2171,3006
1,1083,1701,601,1083,1684
1,1083,1701,397,1083,1480
1,487,783,132,487,619
1,344,540,83,344,427
1,1266,2320,799,1266,2065
1,1266,2320,752,1266,2018
1,1266,2320,567,1266,1833
1,295,540,126,295,421
1,1252,2295,607,1252,1859
1,713,1120,362,713,1075
1,487,783,280,487,767
1,1555,2443,448,1555,2003
1,1555,2443,717,1555,2272
1,1083,1701,312,1083,1395
1,1083,1701,397,1083,1480
1,1555,2443,448,1555,2003
1,713,1120,261,713,974
1,713,1120,261,713,974
1,1252,2295,882,1252,2134
1,1519,2443,753,1519,2272
1,713,1120,340,713,1053
1,1083,1701,244,1083,1327
1,713,1120,329,713,1042
1,713,1120,205,713,918
1,713,1120,228,713,941
1,1912,3400,1352,1912,3264
1,1266,2320,892,1266,2158
1,1266,2320,1008,1266,2274
1,1266,2320,683,1266,1949
1,420,769,249,420,669
1,1519,2443,826,1519,2345
1,1555,2443,717,1555,2272
1,1555,2443,448,1555,2003
1,1083,1701,397,1083,1480
1,713,1120,205,713,918
1,1252,2295,745,1252,1997
1,1252,2295,951,1252,2203
1,1252,2295,997,1252,2249
1,308,565,150,308,458
1,1555,2443,351,1555,1906
1,487,783,265,487,752
1,713,1120,385,713,1098
1,487,783,265,487,752
1,1252,2295,951,1252,2203
1,420,769,334,420,754
1,1252,2295,997,1252,2249
1,420,769,295,420,715
1,2171,3578,978,2171,3149
1,487,783,280,487,767
1,344,540,185,344,529
1,1555,2443,448,1555,2003
1,1083,1701,397,1083,1480
1,1083,1701,550,1083,1633
1,1555,2443,717,1555,2272
1,1083,1701,397,1083,1480
1,2171,3578,620,2171,2791
1,2171,3578,1335,2171,3506
1,1252,2295,561,1252,1813
1,1252,2295,745,1252,1997
1,420,769,249,420,669
1,1252,2295,997,1252,2249
1,1252,2295,997,1252,2249
1,487,783,265,487,752
1,1555,2443,570,1555,2125
1,713,1120,261,713,974
1,1083,1701,584,1083,1667
1,2171,3578,1371,2171,3542
1,1252,2295,561,1252,1813
1,1252,2295,997,1252,2249
1,1266,2320,1008,1266,2274
1,344,540,174,344,518
1,713,1120,362,713,1075
1,1519,2443,875,1519,2394
1,2171,3578,1264,2171,3435
1,713,1120,138,713,851
1,1083,1701,244,1083,1327
1,2171,3578,656,2171,2827
1,2171,3578,942,2171,3113
1,2171,3578,656,2171,2827
1,713,1120,385,713,1098
1,713,1120,205,713,918
1,344,540,99,344,443
1,344,540,110,344,454
1,1252,2295,538,1252,1790
1,1266,2320,1008,1266,2274
1,2171,3578,942,2171,3113
1,487,783,280,487,767
1,1083,1701,601,1083,1684
1,487,783,194,487,681
1,1898,3375,1038,1898,2936
1,420,769,334,420,754
1,295,540,175,295,470
1,1519,2443,387,1519,1906
1,344,540,185,344,529
1,487,783,241,487,728
1,713,1120,194,713,907
1,2171,3578,620,2171,2791
1,2171,3578,942,2171,3113
1,1252,2295,630,1252,1882
1,1252,2295,492,1252,1744
1,1266,2320,752,1266,2018
1,1266,2320,567,1266,1833
1,420,769,334,420,754
1,1252,2295,561,1252,1813
1,1266,2320,636,1266,1902
1,2171,3578,620,2171,2791
1,1555,2443,790,1555,2345
1,1519,2443,606,1519,2125
1,713,1120,205,713,918
1,1266,2320,567,1266,1833
1,420,769,318,420,738
1,1252,2295,630,1252,1882
1,1519,2443,411,1519,1930
1,2171,3578,656,2171,2827
1,1083,1701,397,1083,1480
1,1083,1701,346,1083,1429
1,713,1120,261,713,974
1,344,540,99,344,443
1,1252,2295,538,1252,1790
1,1252,2295,951,1252,2203
1,420,769,226,420,646
1,2171,3578,1264,2171,3435
1,2171,3578,942,2171,3113
1,344,540,185,344,529
1,344,540,126,344,470
1,713,1120,261,713,974
1,1252,2295,882,1252,2134
1,1266,2320,544,1266,1810
1,1252,2295,745,1252,1997
1,1252,2295,561,1252,1813
1,1252,2295,630,1252,1882
1,308,565,155,308,463
1,1083,1701,550,1083,1633
1,2171,3578,763,2171,2934
1,1555,2443,375,1555,1930
1,487,783,155,487,642
1,487,783,265,487,752
1,344,540,77,344,421
1,344,540,99,344,443
1,1266,2320,752,1266,2018
1,1266,2320,636,1266,1902
1,295,540,148,295,443
1,308,565,178,308,486
1,1266,2320,636,1266,1902
1,487,783,280,487,767
1,487,783,280,487,767
1,1083,1701,312,1083,1395
1,2171,3578,656,2171,2827
1,487,783,155,487,642
1,2171,3578,1335,2171,3506
1,713,1120,261,713,974
1,344,540,126,344,470
1,1266,2320,1008,1266,2274
1,1912,3400,1046,1912,2958
1,1266,2320,729,1266,1995
1,420,769,226,420,646
1,1252,2295,997,1252,2249
1,713,1120,205,713,918
1,2171,3578,1335,2171,3506
1,1912,3400,1352,1912,3264
1,1266,2320,1008,1266,2274
1,1266,2320,567,1266,1833
1,1266,2320,1031,1266,2297
1,1266,2320,567,1266,1833
1,420,769,249,420,669
1,295,540,240,295,535
1,713,1120,362,713,1075
1,1083,1701,397,1083,1480
1,2171,3578,620,2171,2791
8,59,159,635,472,1107
5,3,9,27,15,42
28,3,9,150,84,234
19,2,5,45,38,83
10,2,5,24,20,44
2,2,5,5,4,9
2,13,35,31,26,57
28,13,35,489,364,853
21,13,35,300,273,573
9,13,35,157,117,274
14,38,50,161,532,693
5,38,50,28,190,218
2,42,54,9,84,93
1,1266,2320,892,1266,2158
1,295,540,126,295,421
1,2171,3578,763,2171,2934
1,1555,2443,864,1555,2419
1,1555,2443,570,1555,2125
1,713,1120,250,713,963
1,1083,1701,397,1083,1480
1,1555,2443,570,1555,2125
1,2171,3578,1371,2171,3542
1,2171,3578,1335,2171,3506
24,1,2,13,24,37
30,1,2,17,30,47
21,1,2,13,21,34
22,1,2,14,22,36
8,9,25,124,72,196
24,8,21,246,192,438
12,8,21,123,96,219
3,1,4,7,3,10
22,1,4,55,22,77
1,755,1215,436,755,1191
1,1482,2384,592,1482,2074
1,1482,2384,592,1482,2074
23,4,10,122,92,214
12,4,10,64,48,112
21,2,5,61,42,103
7,2,5,20,14,34
29,2,5,61,58,119
30,2,5,63,60,123
30,2,5,71,60,131
10,2,5,24,20,44
12,3,9,49,36,85
10,3,9,41,30,71
6,7,9,1,42,43
29,7,9,53,203,256
28,8,22,380,224,604
13,8,22,179,104,283
4,9,24,43,36,79
9,13,35,185,117,302
29,13,35,455,377,832
12,13,35,188,156,344
5,13,35,107,65,172
10,13,35,196,130,326
13,13,35,268,169,437
22,13,35,453,286,739
11,42,54,25,462,487
29,42,54,238,1218,1456
1,1898,3375,768,1898,2666
1,1252,2295,882,1252,2134
1,1266,2320,567,1266,1833
1,1266,2320,961,1266,2227
1,308,565,251,308,559
1,420,769,249,420,669
1,308,565,246,308,554
1,2171,3578,763,2171,2934
1,2171,3578,763,2171,2934
1,2171,3578,1335,2171,3506
1,713,1120,362,713,1075
1,344,540,174,344,518
19,9,25,285,171,456
26,9,25,390,234,624
16,2,5,31,32,63
23,2,5,45,46,91
1,755,1215,375,755,1130
1,1482,2384,807,1482,2289
3,3,9,14,9,23
7,3,9,34,21,55
5,2,5,13,10,23
24,2,5,64,48,112
3,4,10,17,12,29
26,2,5,55,52,107
17,2,5,36,34,70
8,2,5,19,16,35
2,2,5,5,4,9
10,2,5,24,20,44
1,2,5,2,2,4
24,2,5,67,48,115
5,2,5,14,10,24
28,2,5,78,56,134
7,2,5,20,14,34
7,7,9,10,49,59
10,7,9,16,70,86
29,7,9,24,203,227
17,8,22,231,136,367
30,8,22,334,240,574
6,9,24,87,54,141
29,9,24,421,261,682
16,13,35,279,208,487
23,13,35,490,299,789
22,13,35,469,286,755
7,13,35,122,91,213
7,13,35,149,91,240
26,13,35,508,338,846
5,13,35,103,65,168
10,13,35,147,130,277
1,42,54,8,42,50
14,42,54,70,588,658
1,1898,3375,1038,1898,2936
1,1898,3375,768,1898,2666
1,1898,3375,768,1898,2666
1,1898,3375,1038,1898,2936
1,420,769,334,420,754
1,1252,2295,951,1252,2203
1,1252,2295,745,1252,1997
1,1266,2320,1008,1266,2274
1,1252,2295,951,1252,2203
1,1083,1701,499,1083,1582
1,2171,3578,763,2171,2934
1,2171,3578,942,2171,3113
1,713,1120,362,713,1075
1,344,540,185,344,529
1,344,540,158,344,502
1,713,1120,261,713,974
1,344,540,83,344,427
1,3,9,6,3,9
30,3,9,161,90,251
17,1,2,16,17,33
9,1,2,9,9,18
7,2,5,14,14,28
10,2,5,20,20,40
2,2,5,4,4,8
13,1,2,10,13,23
27,1,2,20,27,47
1,1,2,1,1,2
30,1,4,85,30,115
1,755,1215,375,755,1130
1,755,1215,436,755,1191
1,1482,2384,807,1482,2289
1,1482,2384,401,1482,1883
13,3,9,70,39,109
13,3,9,70,39,109
21,3,9,105,63,168
3,3,9,15,9,24
8,2,5,18,16,34
17,2,5,37,34,71
11,3,9,64,33,97
12,3,9,70,36,106
30,7,9,30,210,240
5,7,9,8,35,43
25,7,9,10,175,185
4,8,22,54,32,86
6,13,35,130,78,208
1,13,35,20,13,33
13,13,35,268,169,437
16,13,35,262,208,470
13,13,35,227,169,396
8,13,35,126,104,230
3,13,35,64,39,103
19,21,55,531,399,930
2,21,55,54,42,96
7,42,54,69,294,363
1,1912,3400,842,1912,2754
1,1912,3400,774,1912,2686
1,1898,3375,937,1898,2835
1,1252,2295,630,1252,1882
1,1252,2295,745,1252,1997
1,1266,2320,799,1266,2065
1,1252,2295,745,1252,1997
1,1266,2320,1008,1266,2274
1,1252,2295,997,1252,2249
1,713,1120,362,713,1075
1,1519,2443,826,1519,2345
1,2171,3578,835,2171,3006
1,713,1120,385,713,1098
1,2171,3578,1371,2171,3542
1,1555,2443,790,1555,2345
1,2171,3578,1335,2171,3506
1,2171,3578,1335,2171,3506
1,344,540,126,344,470
1,2171,3578,942,2171,3113
16,1,2,15,16,31
1,1,2,1,1,2
30,2,5,84,60,144
25,12,33,492,300,792
22,12,33,433,264,697
22,13,35,384,286,670
9,13,35,157,117,274
10,8,21,126,80,206
28,8,21,352,224,576
30,1,4,74,30,104
20,1,4,50,20,70
15,1,4,37,15,52
1,461,742,147,461,608
1,1482,2384,735,1482,2217
1,1482,2384,592,1482,2074
1,755,1215,411,755,1166
27,24,64,1045,648,1693
21,2,5,44,42,86
11,2,5,23,22,45
16,2,5,34,32,66
9,2,5,19,18,37
13,2,5,36,26,62
1,2,5,3,2,5
8,2,5,22,16,38
10,2,5,28,20,48
16,2,5,42,32,74
29,2,5,77,58,135
1,7,9,0,7,7
29,3,8,140,87,227
24,3,8,118,72,190
25,8,22,235,200,435
1,9,24,11,9,20
28,13,35,440,364,804
3,13,35,49,39,88
18,13,35,390,234,624
23,38,50,230,874,1104
11,42,54,108,462,570
1,1898,3375,768,1898,2666
1,1266,2320,636,1266,1902
1,295,540,223,295,518
1,1266,2320,544,1266,1810
1,344,540,99,344,443
1,2171,3578,656,2171,2827
1,2171,3578,835,2171,3006
1,1083,1701,601,1083,1684
1,713,1120,385,713,1098
1,2171,3578,1371,2171,3542
1,1083,1701,550,1083,1633
1,2171,3578,1335,2171,3506
18,2,5,52,36,88
15,2,5,44,30,74
1,1,4,2,1,3
21,1,4,45,21,66
1,1482,2384,473,1482,1955
1,755,1215,411,755,1166
1,461,742,229,461,690
13,2,5,27,26,53
29,2,5,61,58,119
17,2,5,40,34,74
5,2,5,12,10,22
5,7,9,0,35,35
25,8,22,229,200,429
19,8,22,174,152,326
7,8,22,78,56,134
27,9,24,321,243,564
23,13,35,401,299,700
12,13,35,247,156,403
2,42,54,5,84,89
8,38,50,8,304,312
1,1252,2295,630,1252,1882
1,1912,3400,1046,1912,2958
1,1252,2295,538,1252,1790
1,1266,2320,544,1266,1810
1,1252,2295,951,1252,2203
15,13,35,215,195,410
7,13,35,100,91,191
30,1,2,28,30,58
6,1,2,6,6,12
1,1482,2384,592,1482,2074
17,24,64,441,408,849
29,2,5,57,58,115
13,2,5,25,26,51
8,7,9,13,56,69
2,3,8,8,6,14
17,8,22,156,136,292
14,8,22,193,112,305
9,9,24,107,81,188
23,13,35,474,299,773
26,13,35,508,338,846
27,13,35,471,351,822
6,13,35,86,78,164
2,13,35,29,26,55
7,13,35,122,91,213
30,21,55,954,630,1584
17,38,50,94,646,740
2,42,54,10,84,94
20,42,54,197,840,1037
6,42,54,49,252,301
1,1898,3375,768,1898,2666
1,1912,3400,1352,1912,3264
1,308,565,251,308,559
1,1266,2320,544,1266,1810
1,295,540,126,295,421
1,1519,2443,484,1519,2003
1,1555,2443,790,1555,2345
1,2171,3578,835,2171,3006
1,1083,1701,397,1083,1480
1,2171,3578,942,2171,3113
1,2171,3578,942,2171,3113
1,2171,3578,1371,2171,3542
1,1083,1701,550,1083,1633
1,1083,1701,550,1083,1633
1,487,783,194,487,681
23,2,5,64,46,110
16,2,5,34,32,66
9,2,5,19,18,37
27,1,2,26,27,53
29,1,2,28,29,57
20,2,5,44,40,84
10,2,5,22,20,42
29,2,5,64,58,122
9,2,5,18,18,36
1,1482,2384,592,1482,2074
1,461,742,229,461,690
23,24,64,905,552,1457
21,3,9,96,63,159
25,3,9,114,75,189
25,2,5,53,50,103
20,4,10,94,80,174
8,2,5,22,16,38
7,2,5,20,14,34
18,7,9,7,126,133
17,8,22,234,136,370
24,13,35,469,312,781
5,13,35,72,65,137
5,13,35,98,65,163
3,13,35,47,39,86
12,21,55,289,252,541
1,1912,3400,876,1912,2788
1,1266,2320,729,1266,1995
1,1912,3400,1454,1912,3366
1,1898,3375,937,1898,2835
1,1266,2320,636,1266,1902
1,1266,2320,752,1266,2018
1,1252,2295,561,1252,1813
1,1266,2320,752,1266,2018
1,295,540,223,295,518
1,2171,3578,1157,2171,3328
1,713,1120,362,713,1075
1,344,540,158,344,502
1,1555,2443,448,1555,2003
26,1,2,22,26,48
18,1,2,15,18,33
28,1,4,68,28,96
16,1,2,12,16,28
28,1,2,21,28,49
21,2,5,59,42,101
18,2,5,50,36,86
4,2,5,11,8,19
5,1,2,5,5,10
1,1482,2384,378,1482,1860
1,1482,2384,735,1482,2217
20,24,64,710,480,1190
11,2,5,23,22,45
12,2,5,25,24,49
7,2,5,20,14,34
8,2,5,23,16,39
30,2,5,80,60,140
12,2,5,32,24,56
25,2,5,66,50,116
4,2,5,12,8,20
4,2,5,12,8,20
3,2,5,7,6,13
9,2,5,21,18,39
30,2,5,62,60,122
7,2,5,14,14,28
4,2,5,8,8,16
21,2,5,41,42,83
24,3,9,129,72,201
13,3,9,70,39,109
3,3,9,13,9,22
23,3,9,101,69,170
22,7,9,18,154,172
22,7,9,8,154,162
29,7,9,11,203,214
9,7,9,15,63,78
7,3,8,34,21,55
26,8,22,341,208,549
30,9,24,421,270,691
12,9,24,160,108,268
17,13,35,267,221,488
11,13,35,234,143,377
20,13,35,391,260,651
12,38,50,102,456,558
19,38,50,57,722,779
12,42,54,118,504,622
1,308,565,121,308,429
1,1252,2295,1020,1252,2272
1,1266,2320,636,1266,1902
1,1912,3400,1046,1912,2958
1,1252,2295,951,1252,2203
1,1252,2295,882,1252,2134
1,420,769,334,420,754
1,420,769,318,420,738
1,295,540,234,295,529
1,1519,2443,753,1519,2272
1,2171,3578,656,2171,2827
1,1083,1701,550,1083,1633
1,2171,3578,763,2171,2934
1,1555,2443,717,1555,2272
1,713,1120,194,713,907
1,344,540,158,344,502
1,344,540,99,344,443
11,2,5,32,22,54
10,1,2,6,10,16
8,1,2,7,8,15
1,461,742,147,461,608
1,1482,2384,473,1482,1955
1,1482,2384,401,1482,1883
1,1482,2384,401,1482,1883
1,24,64,27,24,51
6,2,5,14,12,26
6,3,9,24,18,42
3,3,9,12,9,21
25,2,5,59,50,109
30,2,5,71,60,131
26,7,9,47,182,229
18,3,8,84,54,138
30,13,35,639,390,1029
11,13,35,234,143,377
7,13,35,110,91,201
30,13,35,524,390,914
17,42,54,39,714,753
18,42,54,2,756,758
1,1912,3400,1046,1912,2958
1,1252,2295,997,1252,2249
1,1266,2320,1008,1266,2274
1,1519,2443,826,1519,2345
1,1555,2443,448,1555,2003
1,2171,3578,942,2171,3113
1,1083,1701,312,1083,1395
1,1083,1701,550,1083,1633
1,487,783,194,487,681
1,2171,3578,835,2171,3006
1,2171,3578,620,2171,2791
8,13,35,170,104,274
25,13,35,533,325,858
26,1,2,17,26,43
18,1,2,17,18,35
18,1,2,17,18,35
1,755,1215,193,755,948
1,461,742,147,461,608
1,461,742,266,461,727
1,461,742,266,461,727
19,24,64,602,456,1058
6,2,5,13,12,25
19,2,5,40,38,78
13,3,9,70,39,109
26,3,9,140,78,218
25,4,10,145,100,245
20,4,10,116,80,196
7,3,9,41,21,62
19,3,9,111,57,168
7,7,9,13,49,62
6,7,9,11,42,53
16,8,22,175,128,303
25,8,22,339,200,539
25,8,22,279,200,479
22,13,35,469,286,755
18,13,35,314,234,548
12,13,35,247,156,403
25,13,35,428,325,753
22,13,35,384,286,670
9,21,55,202,189,391
9,21,55,296,189,485
14,38,50,42,532,574
23,42,54,15,966,981
2,38,50,22,76,98
1,42,54,11,42,53
27,42,54,134,1134,1268
1,1912,3400,774,1912,2686
1,1266,2320,567,1266,1833
1,1266,2320,729,1266,1995
1,1266,2320,636,1266,1902
1,420,769,211,420,631
1,1266,2320,752,1266,2018
1,1266,2320,1008,1266,2274
1,1266,2320,1008,1266,2274
1,1266,2320,752,1266,2018
1,1252,2295,538,1252,1790
1,1555,2443,717,1555,2272
1,2171,3578,763,2171,2934
1,1519,2443,533,1519,2052
1,1083,1701,584,1083,1667
1,344,540,126,344,470
1,713,1120,362,713,1075
1,344,540,120,344,464
1,2171,3578,656,2171,2827
1,1083,1701,584,1083,1667
1,1083,1701,397,1083,1480
1,713,1120,228,713,941
15,3,9,72,45,117
2,11,29,26,22,48
19,11,29,243,209,452
19,11,29,243,209,452
25,9,25,288,225,513
26,9,25,299,234,533
23,9,25,265,207,472
4,2,5,12,8,20
29,2,5,84,58,142
17,1,2,13,17,30
17,2,5,49,34,83
28,2,5,81,56,137
18,1,2,13,18,31
25,1,2,18,25,43
24,2,5,47,48,95
27,2,5,53,54,107
12,2,5,23,24,47
15,9,25,191,135,326
22,9,25,281,198,479
7,2,5,13,14,27
1,1482,2384,473,1482,1955
1,755,1215,436,755,1191
11,24,64,313,264,577
13,2,5,36,26,62
2,2,5,6,4,10
29,2,5,84,58,142
12,2,5,35,24,59
6,2,5,11,12,23
24,2,5,46,48,94
10,2,5,23,20,43
30,2,5,69,60,129
7,3,9,41,21,62
21,3,9,122,63,185
18,3,9,74,54,128
1,3,9,4,3,7
6,7,9,4,42,46
8,7,9,1,56,57
28,3,8,131,84,215
4,13,35,63,52,115
19,13,35,405,247,652
20,13,35,391,260,651
15,21,55,494,315,809
14,38,50,21,532,553
1,1266,2320,961,1266,2227
1,420,769,334,420,754
1,420,769,334,420,754
1,308,565,246,308,554
1,1519,2443,387,1519,1906
1,713,1120,261,713,974
1,2171,3578,1157,2171,3328
1,487,783,186,487,673
1,713,1120,138,713,851
1,1555,2443,448,1555,2003
1,2171,3578,763,2171,2934
1,2171,3578,763,2171,2934
1,1083,1701,261,1083,1344
19,3,9,83,57,140
22,2,5,64,44,108
7,2,5,20,14,34
17,1,2,11,17,28
8,1,2,5,8,13
30,1,2,19,30,49
21,1,4,43,21,64
5,1,4,11,5,16
24,1,4,51,24,75
1,1,4,2,1,3
2,1,2,2,2,4
5,1,2,5,5,10
1,1482,2384,854,1482,2336
1,1482,2384,378,1482,1860
10,45,120,726,450,1176
26,2,5,61,52,113
27,2,5,63,54,117
18,2,5,42,36,78
20,2,5,47,40,87
11,7,9,15,77,92
13,3,8,43,39,82
2,8,22,22,16,38
1,9,24,12,9,21
27,9,24,379,243,622
28,13,35,489,364,853
28,13,35,489,364,853
1,13,35,17,13,30
14,13,35,244,182,426
20,13,35,272,260,532
24,13,35,419,312,731
4,38,50,46,152,198
13,38,50,72,494,566
4,38,50,34,152,186
20,42,54,100,840,940
1,1912,3400,774,1912,2686
1,1266,2320,729,1266,1995
1,420,769,180,420,600
1,1252,2295,538,1252,1790
1,1898,3375,768,1898,2666
1,1252,2295,745,1252,1997
1,1252,2295,745,1252,1997
1,420,769,249,420,669
1,1266,2320,1031,1266,2297
1,1266,2320,1008,1266,2274
1,1083,1701,499,1083,1582
1,2171,3578,942,2171,3113
1,2171,3578,942,2171,3113
1,2171,3578,942,2171,3113
1,713,1120,362,713,1075
22,9,25,237,198,435
24,9,25,258,216,474
6,9,25,65,54,119
23,2,5,67,46,113
4,2,5,12,8,20
1,1,4,2,1,3
22,1,4,54,22,76
1,755,1215,302,755,1057
1,1482,2384,330,1482,1812
22,2,5,46,44,90
14,2,5,29,28,57
1,2,5,3,2,5
21,2,5,61,42,103
14,7,9,23,98,121
20,7,9,38,140,178
5,8,22,69,40,109
20,13,35,314,260,574
11,13,35,234,143,377
10,13,35,213,130,343
7,13,35,149,91,240
15,13,35,262,195,457
4,42,54,18,168,186
7,38,50,70,266,336
1,1252,2295,722,1252,1974
1,1252,2295,997,1252,2249
1,1252,2295,1020,1252,2272
1,1252,2295,722,1252,1974
1,2171,3578,1264,2171,3435
1,487,783,280,487,767
1,1083,1701,550,1083,1633
1,487,783,155,487,642
1,1083,1701,584,1083,1667
1,713,1120,261,713,974
1,713,1120,385,713,1098
1,2171,3578,1335,2171,3506
1,344,540,174,344,518
3,26,70,103,78,181
6,2,5,17,12,29
22,2,5,62,44,106
27,9,25,405,243,648
24,2,5,70,48,118
26,1,2,25,26,51
18,1,2,17,18,35
7,1,2,7,7,14
1,461,742,274,461,735
1,1482,2384,568,1482,2050
1,461,742,266,461,727
7,24,64,217,168,385
7,45,120,349,315,664
8,45,120,427,360,787
5,45,120,333,225,558
10,45,120,558,450,1008
27,4,10,157,108,265
22,4,10,128,88,216
20,2,5,59,40,99
4,3,9,16,12,28
19,3,9,78,57,135
28,2,5,78,56,134
15,2,5,42,30,72
23,7,9,38,161,199
3,3,8,15,9,24
5,3,8,23,15,38
22,8,22,221,176,397
29,8,22,272,232,504
1,8,22,12,8,20
27,8,22,283,216,499
16,9,24,236,144,380
30,9,24,443,270,713
5,13,35,73,65,138
4,13,35,87,52,139
11,13,35,227,143,370
27,13,35,556,351,907
10,42,54,1,420,421
26,38,50,299,988,1287
30,38,50,330,1140,1470
4,38,50,6,152,158
1,1898,3375,768,1898,2666
1,1252,2295,1020,1252,2272
1,1252,2295,630,1252,1882
1,1912,3400,944,1912,2856
1,1266,2320,683,1266,1949
1,308,565,217,308,525
1,1252,2295,951,1252,2203
1,1266,2320,961,1266,2227
1,1252,2295,1020,1252,2272
1,1252,2295,997,1252,2249
1,1555,2443,839,1555,2394
1,344,540,77,344,421
1,713,1120,396,713,1109
1,344,540,126,344,470
1,1083,1701,261,1083,1344
1,344,540,137,344,481
1,344,540,83,344,427
28,26,70,1212,728,1940
8,8,21,69,64,133
20,8,21,172,160,332
7,1,2,4,7,11
11,1,2,6,11,17
22,2,5,52,44,96
8,2,5,19,16,35
25,2,5,61,50,111
12,2,5,29,24,53
27,1,2,26,27,53
24,1,2,24,24,48
10,1,2,10,10,20
12,2,5,23,24,47
18,1,4,51,18,69
10,1,4,28,10,38
1,461,742,251,461,712
1,1482,2384,878,1482,2360
13,2,5,25,26,51
25,2,5,48,50,98
3,2,5,9,6,15
25,2,5,73,50,123
8,3,9,47,24,71
3,3,9,17,9,26
1,2,5,2,2,4
2,2,5,4,4,8
24,7,9,0,168,168
12,7,9,22,84,106
22,8,22,231,176,407
18,8,22,244,144,388
18,9,24,218,162,380
20,9,24,214,180,394
9,13,35,185,117,302
18,13,35,383,234,617
18,13,35,383,234,617
11,13,35,180,143,323
5,13,35,72,65,137
8,13,35,170,104,274
12,21,55,401,252,653
23,42,54,3,966,969
21,38,50,231,798,1029
7,38,50,35,266,301
1,420,769,180,420,600
1,1912,3400,1352,1912,3264
1,1266,2320,1008,1266,2274
1,1266,2320,683,1266,1949
1,1266,2320,1031,1266,2297
1,2171,3578,978,2171,3149
1,487,783,124,487,611
1,713,1120,385,713,1098
1,713,1120,205,713,918
1,1555,2443,497,1555,2052
1,344,540,120,344,464
28,2,5,78,56,134
2,2,5,5,4,9
1,1482,2384,854,1482,2336
1,755,1215,436,755,1191
1,1482,2384,854,1482,2336
9,45,120,502,405,907
9,2,5,24,18,42
7,2,5,19,14,33
3,3,9,12,9,21
16,3,9,64,48,112
15,3,8,53,45,98
12,8,22,134,96,230
10,8,22,136,80,216
15,8,22,203,120,323
12,9,24,174,108,282
14,13,35,205,182,387
16,13,35,313,208,521
26,13,35,554,338,892
18,13,35,371,234,605
1,13,35,17,13,30
24,21,55,790,504,1294
14,38,50,140,532,672
12,38,50,36,456,492
1,1898,3375,870,1898,2768
1,1252,2295,997,1252,2249
1,1266,2320,683,1266,1949
1,420,769,249,420,669
1,308,565,246,308,554
1,308,565,251,308,559
1,2171,3578,620,2171,2791
1,2171,3578,763,2171,2934
1,1083,1701,550,1083,1633
1,2171,3578,835,2171,3006
1,344,540,185,344,529
1,1083,1701,261,1083,1344
1,344,540,174,344,518
29,13,35,597,377,974
24,13,35,494,312,806
28,9,25,420,252,672
16,9,25,240,144,384
15,9,25,236,135,371
24,9,25,378,216,594
4,13,35,63,52,115
5,13,35,79,65,144
1,1482,2384,735,1482,2217
1,755,1215,436,755,1191
1,461,742,147,461,608
14,7,9,0,98,98
12,3,8,56,36,92
1,3,8,5,3,8
5,8,22,68,40,108
14,13,35,288,182,470
14,13,35,288,182,470
17,42,54,167,714,881
7,38,50,7,266,273
1,1252,2295,997,1252,2249
1,2171,3578,1264,2171,3435
1,487,783,280,487,767
1,1083,1701,584,1083,1667
1,1083,1701,244,1083,1327
1,487,783,265,487,752
1,1519,2443,606,1519,2125
18,1,2,13,18,31
1,2,5,3,2,5
8,2,5,23,16,39
1,1482,2384,807,1482,2289
1,461,742,251,461,712
12,24,64,465,288,753
9,45,120,524,405,929
4,2,5,9,8,17
6,2,5,14,12,26
1,3,9,5,3,8
13,3,9,59,39,98
18,2,5,42,36,78
19,2,5,45,38,83
18,7,9,30,126,156
19,8,22,258,152,410
17,13,35,243,221,464
12,13,35,197,156,353
17,13,35,249,221,470
8,42,54,1,336,337
16,38,50,80,608,688
25,38,50,25,950,975
4,42,54,20,168,188
1,1252,2295,722,1252,1974
1,1252,2295,997,1252,2249
1,1083,1701,244,1083,1327
1,1083,1701,244,1083,1327
1,1083,1701,397,1083,1480
1,2171,3578,763,2171,2934
1,2171,3578,835,2171,3006
1,1519,2443,411,1519,1930
1,1083,1701,261,1083,1344
1,2171,3578,906,2171,3077
1,2171,3578,906,2171,3077
22,1,2,16,22,38
4,1,2,3,4,7
17,1,2,16,17,33
2,11,29,35,22,57
21,11,29,366,231,597
29,11,29,505,319,824
11,1,2,6,11,17
29,1,2,17,29,46
1,461,742,251,461,712
1,461,742,251,461,712
4,59,159,387,236,623
1,2,5,3,2,5
18,4,10,85,72,157
3,4,10,14,12,26
29,4,10,168,116,284
23,4,10,133,92,225
12,3,9,53,36,89
28,3,9,123,84,207
15,2,5,44,30,74
9,2,5,26,18,44
26,3,9,147,78,225
30,3,9,169,90,259
1,3,9,6,3,9
15,3,9,62,45,107
8,3,9,33,24,57
1,2,5,2,2,4
16,7,9,29,112,141
3,7,9,6,21,27
5,7,9,4,35,39
22,7,9,0,154,154
25,3,8,121,75,196
12,8,22,113,96,209
19,8,22,178,152,330
27,8,22,366,216,582
21,8,22,285,168,453
2,8,22,26,16,42
16,13,35,251,208,459
30,13,35,618,390,1008
2,13,35,35,26,61
5,13,35,87,65,152
28,13,35,440,364,804
8,13,35,170,104,274
18,13,35,383,234,617
18,13,35,352,234,586
3,21,55,99,63,162
24,38,50,276,912,1188
19,42,54,13,798,811
8,42,54,79,336,415
27,38,50,270,1026,1296
1,1912,3400,774,1912,2686
1,1266,2320,636,1266,1902
1,1898,3375,768,1898,2666
1,420,769,334,420,754
1,1266,2320,1008,1266,2274
1,420,769,188,420,608
1,420,769,318,420,738
1,1252,2295,997,1252,2249
1,1083,1701,397,1083,1480
1,2171,3578,763,2171,2934
1,1555,2443,839,1555,2394
1,713,1120,385,713,1098
1,487,783,265,487,752
1,344,540,174,344,518
1,344,540,77,344,421
1,713,1120,385,713,1098
1,344,540,174,344,518
1,344,540,185,344,529
1,1083,1701,312,1083,1395
1,713,1120,261,713,974
1,344,540,174,344,518
14,1,2,8,14,22
19,1,2,11,19,30
8,1,2,4,8,12
3,2,5,6,6,12
26,1,2,25,26,51
10,2,5,28,20,48
2,2,5,6,4,10
4,11,30,74,44,118
14,1,4,32,14,46
17,1,4,39,17,56
7,2,5,20,14,34
5,2,5,15,10,25
1,755,1215,193,755,948
1,461,742,229,461,690
1,1482,2384,878,1482,2360
8,24,64,300,192,492
5,2,5,11,10,21
25,2,5,53,50,103
9,2,5,24,18,42
6,2,5,16,12,28
11,3,8,51,33,84
29,3,8,115,87,202
30,8,22,301,240,541
25,13,35,393,325,718
2,13,35,41,26,67
19,13,35,405,247,652
6,13,35,128,78,206
28,13,35,596,364,960
28,13,35,547,364,911
1,1266,2320,752,1266,2018
1,1266,2320,1008,1266,2274
1,1252,2295,745,1252,1997
1,308,565,155,308,463
1,344,540,158,344,502
1,487,783,280,487,767
1,1083,1701,584,1083,1667
29,26,70,1012,754,1766
20,2,5,56,40,96
23,2,5,64,46,110
1,1482,2384,807,1482,2289
1,461,742,251,461,712
4,45,120,290,180,470
12,3,9,70,36,106
30,3,9,175,90,265
19,2,5,56,38,94
8,2,5,24,16,40
18,2,5,52,36,88
24,2,5,70,48,118
6,2,5,11,12,23
1,2,5,2,2,4
8,2,5,23,16,39
24,2,5,70,48,118
2,7,9,4,14,18
19,7,9,31,133,164
11,7,9,20,77,97
27,3,8,100,81,181
15,8,22,203,120,323
28,13,35,577,364,941
7,13,35,122,91,213
10,38,50,110,380,490
25,42,54,-24,1050,1026
21,38,50,210,798,1008
27,42,54,266,1134,1400
1,1912,3400,944,1912,2856
1,1266,2320,1008,1266,2274
1,1266,2320,752,1266,2018
1,420,769,341,420,761
1,420,769,318,420,738
1,1912,3400,1420,1912,3332
1,2171,3578,1264,2171,3435
1,1555,2443,790,1555,2345
1,1083,1701,210,1083,1293
1,1083,1701,584,1083,1667
1,1083,1701,397,1083,1480
1,1083,1701,397,1083,1480
1,344,540,77,344,421
1,1083,1701,550,1083,1633
1,487,783,288,487,775
21,26,70,909,546,1455
25,11,30,295,275,570
11,1,4,33,11,44
30,2,5,87,60,147
18,9,25,230,162,392
16,9,25,204,144,348
1,755,1215,436,755,1191
1,755,1215,193,755,948
26,2,5,73,52,125
15,2,5,42,30,72
13,2,5,31,26,57
14,2,5,33,28,61
15,2,5,35,30,65
3,7,9,2,21,23
4,7,9,7,28,35
16,7,9,29,112,141
9,3,8,36,27,63
14,8,22,190,112,302
24,13,35,419,312,731
24,13,35,511,312,823
25,13,35,515,325,840
29,13,35,597,377,974
22,13,35,361,286,647
2,38,50,22,76,98
1,38,50,10,38,48
21,38,50,231,798,1029
1,1898,3375,1342,1898,3240
1,420,769,334,420,754
1,1266,2320,1008,1266,2274
1,1555,2443,839,1555,2394
1,1555,2443,790,1555,2345
1,2171,3578,942,2171,3113
1,1555,2443,839,1555,2394
1,1083,1701,550,1083,1633
1,713,1120,362,713,1075
1,1555,2443,570,1555,2125
1,1555,2443,497,1555,2052
1,487,783,194,487,681
1,344,540,174,344,518
1,2171,3578,1335,2171,3506
29,13,35,618,377,995
1,461,742,162,461,623
3,59,159,224,177,401
27,3,9,130,81,211
21,3,9,101,63,164
21,2,5,59,42,101
22,2,5,62,44,106
27,3,9,145,81,226
24,3,9,129,72,201
5,2,5,15,10,25
2,2,5,6,4,10
2,2,5,6,4,10
29,2,5,84,58,142
28,2,5,53,56,109
1,2,5,2,2,4
21,3,9,122,63,185
2,3,9,12,6,18
21,3,9,122,63,185
6,3,9,35,18,53
3,2,5,9,6,15
26,2,5,77,52,129
28,2,5,78,56,134
1,2,5,3,2,5
20,7,9,0,140,140
3,7,9,5,21,26
10,7,9,18,70,88
30,7,9,25,210,235
5,8,22,68,40,108
11,8,22,115,88,203
23,8,22,317,184,501
12,9,24,117,108,225
28,9,24,407,252,659
9,13,35,185,117,302
29,13,35,597,377,974
20,13,35,349,260,609
21,13,35,344,273,617
18,21,55,553,378,931
10,38,50,100,380,480
24,42,54,262,1008,1270
14,38,50,154,532,686
1,1252,2295,538,1252,1790
1,1898,3375,937,1898,2835
1,1266,2320,1031,1266,2297
1,1912,3400,1352,1912,3264
1,1898,3375,937,1898,2835
1,420,769,334,420,754
1,420,769,318,420,738
1,1266,2320,544,1266,1810
1,420,769,249,420,669
1,295,540,126,295,421
1,1266,2320,1008,1266,2274
1,2171,3578,1192,2171,3363
1,2171,3578,1264,2171,3435
1,713,1120,385,713,1098
1,2171,3578,1157,2171,3328
1,2171,3578,1264,2171,3435
1,487,783,280,487,767
1,1083,1701,550,1083,1633
1,2171,3578,942,2171,3113
1,2171,3578,942,2171,3113
1,344,540,126,344,470
1,713,1120,228,713,941
1,344,540,110,344,454
1,2171,3578,1335,2171,3506
22,26,70,629,572,1201
29,3,9,169,87,256
26,2,5,73,52,125
19,2,5,36,38,74
23,2,5,68,46,114
18,2,5,53,36,89
1,2,5,3,2,5
28,1,2,21,28,49
6,1,2,4,6,10
10,1,2,7,10,17
10,1,2,7,10,17
29,1,2,20,29,49
2,1,2,1,2,3
4,1,4,9,4,13
3,1,4,7,3,10
7,2,5,20,14,34
17,2,5,49,34,83
1,1482,2384,854,1482,2336
1,755,1215,436,755,1191
1,461,742,274,461,735
1,1482,2384,854,1482,2336
27,1482,2384,14055,40014,54069
25,24,64,888,600,1488
30,2,5,66,60,126
27,2,5,59,54,113
5,2,5,12,10,22
15,2,5,35,30,65
15,7,9,8,105,113
18,8,22,169,144,313
22,9,24,261,198,459
12,13,35,176,156,332
23,13,35,490,299,789
26,13,35,408,338,746
8,13,35,170,104,274
11,13,35,157,143,300
12,13,35,247,156,403
21,21,55,564,441,1005
18,42,54,12,756,768
27,38,50,149,1026,1175
1,1912,3400,774,1912,2686
1,1252,2295,997,1252,2249
1,1266,2320,752,1266,2018
1,420,769,249,420,669
1,1252,2295,951,1252,2203
1,487,783,280,487,767
1,1555,2443,717,1555,2272
1,1555,2443,448,1555,2003
1,713,1120,385,713,1098
1,2171,3578,835,2171,3006
1,713,1120,161,713,874
1,344,540,174,344,518
1,344,540,126,344,470
1,344,540,126,344,470
20,2,5,47,40,87
28,2,5,66,56,122
24,2,5,56,48,104
10,1,2,9,10,19
4,8,21,34,32,66
19,8,21,163,152,315
16,8,21,164,128,292
16,8,21,164,128,292
1,1482,2384,401,1482,1883
30,2,5,71,60,131
4,2,5,9,8,17
30,7,9,49,210,259
17,3,8,59,51,110
14,8,22,156,112,268
8,8,22,108,64,172
8,9,24,85,72,157
7,13,35,149,91,240
11,13,35,192,143,335
27,13,35,585,351,936
13,13,35,277,169,446
10,13,35,196,130,326
17,13,35,362,221,583
10,13,35,143,130,273
24,21,55,578,504,1082
6,21,55,141,126,267
9,42,54,45,378,423
1,1252,2295,630,1252,1882
1,1898,3375,836,1898,2734
1,1912,3400,1046,1912,2958
1,1898,3375,937,1898,2835
1,1252,2295,997,1252,2249
1,1252,2295,997,1252,2249
1,295,540,234,295,529
1,1252,2295,997,1252,2249
1,2171,3578,1371,2171,3542
1,713,1120,261,713,974
1,344,540,174,344,518
1,1555,2443,570,1555,2125
1,2171,3578,1335,2171,3506
29,13,35,618,377,995
1,1,4,3,1,4
7,1,4,21,7,28
18,1,4,45,18,63
17,1,4,42,17,59
29,1,2,20,29,49
22,1,2,15,22,37
24,2,5,70,48,118
9,2,5,26,18,44
1,1482,2384,735,1482,2217
1,461,742,251,461,712
1,1482,2384,854,1482,2336
1,1482,2384,854,1482,2336
1,755,1215,193,755,948
17,2,5,45,34,79
6,2,5,12,12,24
11,2,5,21,22,43
6,2,5,18,12,30
19,2,5,56,38,94
14,3,9,83,42,125
10,3,9,59,30,89
29,3,9,137,87,224
18,3,9,85,54,139
17,7,9,32,119,151
17,3,8,55,51,106
7,8,22,76,56,132
9,13,35,195,117,312
15,13,35,309,195,504
29,13,35,496,377,873
10,38,50,15,380,395
24,42,54,3,1008,1011
1,1898,3375,937,1898,2835
1,1266,2320,892,1266,2158
1,1252,2295,722,1252,1974
1,1266,2320,544,1266,1810
1,308,565,246,308,554
1,1555,2443,546,1555,2101
1,2171,3578,656,2171,2827
1,1083,1701,601,1083,1684
1,1083,1701,550,1083,1633
1,713,1120,385,713,1098
1,344,540,174,344,518
1,713,1120,205,713,918
26,3,9,105,78,183
2,1,2,1,2,3
18,1,2,12,18,30
3,1,2,2,3,5
27,1,2,19,27,46
23,1,2,21,23,44
2,1,2,2,2,4
18,1,4,53,18,71
12,1,4,35,12,47
9,1,4,26,9,35
1,461,742,274,461,735
1,755,1215,193,755,948
1,461,742,118,461,579
8,3,9,33,24,57
30,2,5,87,60,147
4,2,5,12,8,20
30,2,5,87,60,147
18,2,5,42,36,78
6,2,5,14,12,26
22,7,9,36,154,190
25,3,8,113,75,188
8,8,22,75,64,139
2,8,22,18,16,34
26,8,22,261,208,469
1,13,35,15,13,28
1,13,35,21,13,34
25,38,50,75,950,1025
21,38,50,210,798,1008
28,38,50,154,1064,1218
27,38,50,270,1026,1296
1,1898,3375,768,1898,2666
1,1252,2295,630,1252,1882
1,1252,2295,538,1252,1790
1,295,540,234,295,529
1,308,565,184,308,492
1,2171,3578,1335,2171,3506
1,1519,2443,875,1519,2394
1,2171,3578,1264,2171,3435
1,2171,3578,656,2171,2827
1,487,783,155,487,642
1,487,783,288,487,775
1,487,783,265,487,752
1,344,540,164,344,508
1,344,540,174,344,518
6,1,2,5,6,11
5,1,2,4,5,9
23,1,2,20,23,43
24,2,5,46,48,94
14,2,5,39,28,67
24,2,5,67,48,115
1,755,1215,205,755,960
1,1482,2384,592,1482,2074
3,2,5,6,6,12
16,2,5,31,32,63
23,2,5,53,46,99
3,2,5,7,6,13
17,4,10,71,68,139
12,3,9,55,36,91
18,4,10,68,72,140
26,4,10,99,104,203
13,2,5,38,26,64
30,4,10,138,120,258
28,3,8,100,84,184
23,9,24,334,207,541
17,9,24,226,153,379
8,13,35,165,104,269
9,13,35,195,117,312
8,13,35,156,104,260
21,13,35,330,273,603
15,21,55,337,315,652
8,21,55,175,168,343
6,21,55,145,126,271
4,42,54,9,168,177
15,38,50,83,570,653
1,38,50,1,38,39
29,38,50,29,1102,1131
8,38,50,68,304,372
7,38,50,60,266,326
1,1912,3400,774,1912,2686
1,1252,2295,538,1252,1790
1,1252,2295,722,1252,1974
1,1266,2320,636,1266,1902
1,1898,3375,870,1898,2768
1,1266,2320,636,1266,1902
1,420,769,334,420,754
1,1252,2295,745,1252,1997
1,1252,2295,676,1252,1928
1,420,769,188,420,608
1,420,769,318,420,738
1,1266,2320,892,1266,2158
1,1266,2320,544,1266,1810
1,2171,3578,942,2171,3113
1,2171,3578,906,2171,3077
1,2171,3578,1157,2171,3328
1,1555,2443,570,1555,2125
1,344,540,77,344,421
1,2171,3578,1371,2171,3542
1,1083,1701,550,1083,1633
1,2171,3578,835,2171,3006
4,1,2,3,4,7
1,1,2,1,1,2
27,1,2,17,27,44
21,13,35,447,273,720
28,13,35,596,364,960
1,1,2,1,1,2
4,1,2,3,4,7
16,2,5,45,32,77
11,2,5,31,22,53
27,2,5,76,54,130
1,1482,2384,473,1482,1955
1,1482,2384,735,1482,2217
1,755,1215,436,755,1191
1,461,742,274,461,735
13,24,64,337,312,649
25,24,64,792,600,1392
14,24,64,551,336,887
8,45,120,398,360,758
2,2,5,4,4,8
27,3,9,111,81,192
12,3,9,49,36,85
22,3,9,118,66,184
21,3,9,113,63,176
5,3,9,27,15,42
6,3,9,32,18,50
1,7,9,0,7,7
15,7,9,21,105,126
16,7,9,29,112,141
17,8,22,231,136,367
28,13,35,577,364,941
30,13,35,587,390,977
19,42,54,2,798,800
1,1252,2295,882,1252,2134
1,1252,2295,676,1252,1928
1,1266,2320,544,1266,1810
1,1266,2320,1008,1266,2274
1,420,769,188,420,608
1,1555,2443,790,1555,2345
1,1083,1701,499,1083,1582
1,487,783,132,487,619
1,1555,2443,717,1555,2272
1,713,1120,329,713,1042
9,2,5,25,18,43
7,2,5,20,14,34
15,1,2,8,15,23
21,1,2,12,21,33
1,755,1215,193,755,948
1,755,1215,436,755,1191
25,45,120,1815,1125,2940
28,2,5,66,56,122
23,2,5,54,46,100
20,2,5,56,40,96
16,2,5,46,32,78
4,2,5,12,8,20
4,2,5,9,8,17
1,2,5,2,2,4
22,2,5,52,44,96
25,3,9,134,75,209
13,3,9,70,39,109
25,2,5,70,50,120
1,2,5,3,2,5
14,7,9,19,98,117
1,8,22,11,8,19
23,9,24,334,207,541
15,13,35,215,195,410
10,13,35,175,130,305
29,13,35,506,377,883
14,13,35,298,182,480
1,13,35,16,13,29
14,13,35,274,182,456
14,13,35,288,182,470
13,21,55,428,273,701
28,42,54,139,1176,1315
1,1266,2320,544,1266,1810
1,1912,3400,1046,1912,2958
1,1252,2295,997,1252,2249
1,1252,2295,745,1252,1997
1,1266,2320,1008,1266,2274
1,308,565,184,308,492
1,1252,2295,997,1252,2249
1,344,540,174,344,518
1,1555,2443,546,1555,2101
1,2171,3578,1264,2171,3435
1,1555,2443,448,1555,2003
1,1083,1701,397,1083,1480
1,2171,3578,1335,2171,3506
8,2,5,22,16,38
17,2,5,48,34,82
17,2,5,48,34,82
21,1,2,13,21,34
28,1,2,18,28,46
9,8,21,113,72,185
1,755,1215,411,755,1166
1,461,742,229,461,690
1,1482,2384,592,1482,2074
1,1482,2384,735,1482,2217
1,1482,2384,807,1482,2289
2,59,159,159,118,277
6,59,159,428,354,782
29,2,5,86,58,144
18,2,5,53,36,89
20,2,5,46,40,86
25,2,5,58,50,108
11,2,5,32,22,54
18,2,5,53,36,89
2,2,5,6,4,10
20,2,5,58,40,98
11,2,5,32,22,54
26,2,5,75,52,127
20,3,9,116,60,176
11,3,9,53,33,86
29,7,9,53,203,256
23,7,9,42,161,203
14,3,8,69,42,111
14,3,8,69,42,111
1,8,22,14,8,22
4,8,22,54,32,86
22,9,24,293,198,491
3,9,24,44,27,71
30,9,24,421,270,691
2,9,24,22,18,40
17,9,24,251,153,404
2,13,35,27,26,53
9,13,35,157,117,274
14,13,35,220,182,402
8,13,35,117,104,221
12,13,35,260,156,416
16,13,35,313,208,521
22,13,35,438,286,724
14,13,35,298,182,480
18,13,35,383,234,617
27,13,35,528,351,879
4,13,35,85,52,137
7,21,55,230,147,377
15,21,55,494,315,809
28,42,54,18,1176,1194
15,38,50,173,570,743
11,38,50,94,418,512
18,38,50,198,684,882
30,42,54,344,1260,1604
25,38,50,275,950,1225
25,38,50,25,950,975
1,1266,2320,497,1266,1763
1,1252,2295,1020,1252,2272
1,1266,2320,961,1266,2227
1,713,1120,385,713,1098
1,2171,3578,656,2171,2827
1,713,1120,161,713,874
1,1555,2443,351,1555,1906
1,344,540,185,344,529
1,2171,3578,1371,2171,3542
18,26,70,704,468,1172
6,3,9,28,18,46
15,8,21,119,120,239
28,8,21,223,224,447
18,8,21,155,144,299
22,2,5,42,44,86
26,2,5,49,52,101
2,2,5,5,4,9
11,2,5,24,22,46
13,1,4,30,13,43
26,1,4,59,26,85
17,1,2,16,17,33
12,1,2,12,12,24
17,2,5,50,34,84
23,2,5,68,46,114
7,1,2,7,7,14
4,1,2,4,4,8
4,2,5,11,8,19
21,2,5,59,42,101
17,12,33,318,204,522
17,12,33,318,204,522
28,1,2,27,28,55
10,1,2,10,10,20
1,1,2,1,1,2
29,1,2,20,29,49
16,1,2,10,16,26
1,1,2,1,1,2
11,2,5,21,22,43
3,2,5,6,6,12
16,2,5,30,32,62
17,2,5,32,34,66
21,13,35,308,273,581
5,13,35,73,65,138
28,13,35,410,364,774
3,2,5,9,6,15
2,1,4,6,2,8
20,1,2,17,20,37
5,1,2,3,5,8
11,1,2,7,11,18
22,1,2,12,22,34
12,1,2,12,12,24
3,1,2,3,3,6
1,1,2,1,1,2
8,2,5,23,16,39
20,2,5,58,40,98
11,2,5,32,22,54
8,2,5,23,16,39
27,2,5,78,54,132
18,2,5,42,36,78
17,2,5,40,34,74
16,1,4,45,16,61
11,9,25,171,99,270
27,9,25,419,243,662
1,755,1215,387,755,1142
1,1482,2384,592,1482,2074
10,24,64,387,240,627
5,45,120,369,225,594
29,2,5,86,58,144
25,3,9,148,75,223
23,3,9,136,69,205
19,3,9,112,57,169
5,3,9,30,15,45
27,2,5,80,54,134
20,2,5,56,40,96
19,2,5,45,38,83
15,2,5,35,30,65
5,2,5,15,10,25
7,4,10,41,28,69
6,2,5,17,12,29
8,2,5,23,16,39
18,2,5,38,36,74
30,2,5,89,60,149
25,3,9,110,75,185
5,3,9,22,15,37
25,2,5,55,50,105
7,2,5,15,14,29
23,7,9,38,161,199
29,7,9,55,203,258
22,7,9,0,154,154
15,7,9,27,105,132
25,3,8,121,75,196
13,3,8,50,39,89
24,3,8,78,72,150
28,3,8,109,84,193
20,3,8,89,60,149
8,3,8,32,24,56
3,8,22,27,24,51
3,8,22,33,24,57
10,8,22,131,80,211
26,8,22,272,208,480
9,9,24,133,81,214
20,9,24,295,180,475
5,9,24,74,45,119
23,9,24,334,207,541
19,9,24,212,171,383
18,13,35,314,234,548
22,13,35,476,286,762
5,13,35,103,65,168
24,13,35,326,312,638
18,13,35,276,234,510
29,13,35,425,377,802
9,13,35,195,117,312
15,13,35,325,195,520
8,13,35,165,104,269
30,13,35,650,390,1040
8,13,35,170,104,274
26,13,35,408,338,746
20,13,35,314,260,574
14,13,35,230,182,412
11,13,35,215,143,358
12,21,55,401,252,653
24,21,55,803,504,1307
24,21,55,644,504,1148
4,42,54,20,168,188
1,1266,2320,544,1266,1810
1,1252,2295,745,1252,1997
1,2171,3578,942,2171,3113
1,1555,2443,546,1555,2101
1,344,540,110,344,454
1,344,540,99,344,443
9,26,70,383,234,617
25,3,9,146,75,221
3,2,5,9,6,15
24,2,5,71,48,119
3,8,21,36,24,60
14,8,21,170,112,282
5,8,21,61,40,101
13,8,21,158,104,262
6,2,5,12,12,24
11,2,5,23,22,45
2,1,4,6,2,8
6,1,4,18,6,24
27,2,5,78,54,132
30,2,5,87,60,147
6,2,5,18,12,30
19,2,5,56,38,94
1,2,5,3,2,5
10,9,25,100,90,190
1,9,25,10,9,19
16,1,2,16,16,32
17,1,2,17,17,34
12,11,30,178,132,310
1,11,30,15,11,26
25,2,5,73,50,123
25,2,5,73,50,123
9,1,2,8,9,17
13,1,2,11,13,24
13,1,4,31,13,44
10,1,2,9,10,19
20,1,2,17,20,37
20,2,5,38,40,78
6,1,2,3,6,9
8,1,2,4,8,12
4,2,5,8,8,16
20,1,2,12,20,32
22,1,2,13,22,35
1,461,742,251,461,712
1,1482,2384,878,1482,2360
1,1482,2384,473,1482,1955
26,24,64,1007,624,1631
30,24,64,854,720,1574
27,24,64,769,648,1417
1,45,120,74,45,119
11,45,120,799,495,1294
10,45,120,738,450,1188
3,59,159,290,177,467
10,59,159,793,590,1383
27,2,5,57,54,111
4,2,5,8,8,16
25,2,5,74,50,124
3,2,5,9,6,15
9,4,10,53,36,89
4,4,10,24,16,40
12,4,10,71,48,119
29,4,10,171,116,287
26,2,5,73,52,125
13,4,10,55,52,107
12,4,10,50,48,98
27,2,5,78,54,132
5,2,5,15,10,25
22,3,9,130,66,196
16,3,9,95,48,143
15,2,5,44,30,74
1,2,5,2,2,4
17,2,5,35,34,69
21,7,9,8,147,155
21,7,9,40,147,187
28,7,9,46,196,242
22,7,9,18,154,172
17,7,9,2,119,121
25,7,9,46,175,221
28,7,9,23,196,219
1,3,8,4,3,7
23,8,22,312,184,496
26,8,22,353,208,561
22,8,22,303,176,479
3,8,22,33,24,57
10,8,22,136,80,216
1,8,22,11,8,19
6,8,22,83,48,131
2,8,22,28,16,44
6,9,24,71,54,125
14,9,24,150,126,276
16,9,24,236,144,380
4,9,24,53,36,89
14,13,35,288,182,470
22,13,35,469,286,755
16,13,35,262,208,470
26,13,35,536,338,874
27,13,35,585,351,936
9,13,35,195,117,312
6,13,35,103,78,181
16,13,35,341,208,549
6,13,35,88,78,166
20,13,35,391,260,651
8,13,35,170,104,274
20,13,35,342,260,602
25,13,35,384,325,709
7,21,55,184,147,331
20,21,55,636,420,1056
15,42,54,172,630,802
15,42,54,2,630,632
2,42,54,22,84,106
4,38,50,12,152,164
14,38,50,154,532,686
18,42,54,41,756,797
29,38,50,44,1102,1146
19,38,50,219,722,941
1,38,50,11,38,49
7,42,54,31,294,325
1,1252,2295,630,1252,1882
1,1252,2295,1020,1252,2272
1,1266,2320,567,1266,1833
1,1266,2320,1008,1266,2274
1,420,769,334,420,754
1,420,769,334,420,754
1,420,769,341,420,761
1,1266,2320,544,1266,1810
1,1252,2295,997,1252,2249
1,1266,2320,1008,1266,2274
1,487,783,280,487,767
1,2171,3578,656,2171,2827
1,2171,3578,656,2171,2827
1,344,540,120,344,464
1,1083,1701,550,1083,1633
1,2171,3578,1335,2171,3506
1,26,70,43,26,69
10,26,70,426,260,686
13,26,70,445,338,783
24,26,70,1039,624,1663
6,3,9,35,18,53
2,13,35,43,26,69
22,13,35,469,286,755
8,1,2,4,8,12
16,1,2,12,16,28
7,1,2,5,7,12
23,1,2,17,23,40
4,2,5,11,8,19
12,9,25,129,108,237
25,1,4,59,25,84
20,1,4,47,20,67
5,2,5,10,10,20
15,2,5,29,30,59
9,2,5,27,18,45
15,2,5,44,30,74
22,2,5,65,44,109
5,2,5,15,10,25
12,2,5,35,24,59
19,2,5,56,38,94
7,11,30,89,77,166
15,11,30,191,165,356
22,1,4,55,22,77
6,1,2,6,6,12
26,1,2,24,26,50
28,1,2,26,28,54
25,2,5,49,50,99
6,2,5,12,12,24
20,9,25,310,180,490
14,9,25,217,126,343
15,2,5,44,30,74
19,2,5,56,38,94
21,2,5,62,42,104
19,2,5,56,38,94
11,9,25,124,99,223
4,9,25,45,36,81
28,1,2,27,28,55
29,1,2,28,29,57
16,1,2,15,16,31
5,1,2,5,5,10
25,2,5,59,50,109
26,2,5,61,52,113
22,1,2,19,22,41
2,2,5,4,4,8
1,1482,2384,592,1482,2074
1,755,1215,411,755,1166
1,1482,2384,473,1482,1955
4,59,159,375,236,611
3,2,5,6,6,12
28,2,5,53,56,109
6,2,5,14,12,26
5,2,5,12,10,22
11,4,10,46,44,90
4,4,10,17,16,33
11,2,5,31,22,53
13,2,5,36,26,62
12,2,5,23,24,47
27,2,5,51,54,105
19,2,5,36,38,74
15,4,10,84,60,144
14,2,5,27,28,55
18,2,5,34,36,70
2,2,5,4,4,8
23,2,5,51,46,97
16,2,5,35,32,67
5,2,5,12,10,22
20,2,5,42,40,82
3,7,9,6,21,27
26,7,9,1,182,183
4,7,9,7,28,35
17,7,9,0,119,119
3,7,9,2,21,23
10,3,8,33,30,63
16,8,22,147,128,275
28,8,22,349,224,573
3,8,22,31,24,55
4,8,22,37,32,69
22,8,22,221,176,397
4,8,22,55,32,87
24,9,24,354,216,570
12,9,24,177,108,285
26,13,35,563,338,901
6,13,35,98,78,176
2,13,35,29,26,55
23,13,35,498,299,797
19,13,35,411,247,658
7,13,35,103,91,194
19,13,35,405,247,652
29,13,35,455,377,832
16,13,35,234,208,442
27,13,35,396,351,747
25,21,55,548,525,1073
30,21,55,657,630,1287
26,38,50,143,988,1131
17,38,50,145,646,791
15,42,54,172,630,802
23,42,54,3,966,969
3,38,50,33,114,147
24,38,50,24,912,936
16,38,50,184,608,792
27,38,50,297,1026,1323
16,42,54,183,672,855
1,1912,3400,1352,1912,3264
1,1252,2295,538,1252,1790
1,1252,2295,882,1252,2134
1,420,769,318,420,738
1,1252,2295,951,1252,2203
1,1266,2320,961,1266,2227
1,1266,2320,1008,1266,2274
1,308,565,251,308,559
1,487,783,280,487,767
1,2171,3578,656,2171,2827
1,1555,2443,497,1555,2052
1,344,540,126,344,470
18,26,70,779,468,1247
24,26,70,1039,624,1663
5,1,2,3,5,8
20,1,2,14,20,34
8,1,2,6,8,14
25,9,25,300,225,525
7,9,25,84,63,147
18,2,5,53,36,89
5,2,5,14,10,24
15,1,2,10,15,25
19,1,2,12,19,31
21,13,35,455,273,728
20,1,2,11,20,31
7,1,2,4,7,11
4,2,5,12,8,20
14,9,25,151,126,277
6,1,2,6,6,12
11,1,2,11,11,22
30,2,5,89,60,149
9,2,5,27,18,45
30,1,2,17,30,47
21,1,4,57,21,78
18,1,2,17,18,35
12,1,2,12,12,24
16,8,21,195,128,323
29,8,21,249,232,481
7,8,21,88,56,144
22,8,21,277,176,453
22,2,5,64,44,108
1,1482,2384,568,1482,2050
1,461,742,185,461,646
1,461,742,185,461,646
6,24,64,236,144,380
1,59,159,65,59,124
26,2,5,55,52,107
19,2,5,40,38,78
20,4,10,84,80,164
4,4,10,17,16,33
1,4,10,5,4,9
1,4,10,5,4,9
7,2,5,21,14,35
29,2,5,86,58,144
7,4,10,41,28,69
16,2,5,37,32,69
11,4,10,65,44,109
2,4,10,12,8,20
10,2,5,19,20,39
26,2,5,49,52,101
7,2,5,21,14,35
20,2,5,59,40,99
29,7,9,1,203,204
28,7,9,1,196,197
15,3,8,73,45,118
28,3,8,100,84,184
24,3,8,112,72,184
19,8,22,262,152,414
21,8,22,192,168,360
22,8,22,303,176,479
30,8,22,301,240,541
1,9,24,15,9,24
8,13,35,126,104,230
4,13,35,87,52,139
29,13,35,496,377,873
18,13,35,283,234,517
17,13,35,249,221,470
19,13,35,405,247,652
5,13,35,107,65,172
9,13,35,141,117,258
9,13,35,195,117,312
20,13,35,286,260,546
29,21,55,874,609,1483
4,21,55,88,84,172
14,42,54,32,588,620
13,38,50,72,494,566
8,38,50,92,304,396
20,38,50,20,760,780
1,1252,2295,1020,1252,2272
1,1252,2295,722,1252,1974
1,295,540,234,295,529
1,713,1120,205,713,918
30,26,70,1299,780,2079
19,26,70,543,494,1037
6,26,70,256,156,412
24,26,70,686,624,1310
21,26,70,909,546,1455
15,3,9,60,45,105
28,3,9,163,84,247
3,1,4,9,3,12
19,13,35,411,247,658
17,13,35,368,221,589
20,1,2,19,20,39
26,1,2,25,26,51
26,12,33,512,312,824
2,12,33,39,24,63
10,11,30,148,110,258
6,11,30,89,66,155
13,2,5,38,26,64
2,2,5,6,4,10
25,1,2,16,25,41
25,1,2,16,25,41
25,11,30,310,275,585
27,11,30,335,297,632
2,1,2,1,2,3
18,12,33,283,216,499
7,1,2,5,7,12
13,1,2,8,13,21
20,1,2,19,20,39
15,2,5,44,30,74
24,2,5,70,48,118
10,2,5,19,20,39
8,2,5,15,16,31
18,1,4,49,18,67
23,2,5,64,46,110
21,2,5,59,42,101
23,12,33,316,276,592
29,12,33,398,348,746
30,12,33,412,360,772
15,2,5,35,30,65
16,2,5,38,32,70
21,2,5,49,42,91
7,2,5,20,14,34
4,9,25,62,36,98
21,9,25,326,189,515
14,9,25,217,126,343
1,1482,2384,854,1482,2336
17,45,120,989,765,1754
17,3,9,99,51,150
29,3,9,169,87,256
22,2,5,62,44,106
1,2,5,3,2,5
9,2,5,17,18,35
13,2,5,36,26,62
15,2,5,40,30,70
29,3,9,169,87,256
26,2,5,73,52,125
29,2,5,81,58,139
24,7,9,44,168,212
2,7,9,3,14,17
5,7,9,0,35,35
2,7,9,3,14,17
27,7,9,44,189,233
12,7,9,20,84,104
17,3,8,66,51,117
6,3,8,28,18,46
9,3,8,32,27,59
26,8,22,284,208,492
19,8,22,174,152,326
16,8,22,220,128,348
24,8,22,331,192,523
30,8,22,413,240,653
16,9,24,236,144,380
29,9,24,421,261,682
17,9,24,239,153,392
8,13,35,140,104,244
25,13,35,436,325,761
28,13,35,606,364,970
19,13,35,405,247,652
20,13,35,328,260,588
21,13,35,433,273,706
2,13,35,43,26,69
3,13,35,59,39,98
7,13,35,149,91,240
4,13,35,82,52,134
3,13,35,47,39,86
10,13,35,164,130,294
3,13,35,52,39,91
14,13,35,220,182,402
12,13,35,209,156,365
1,42,54,11,42,53
1,42,54,0,42,42
11,42,54,108,462,570
8,42,54,87,336,423
21,38,50,32,798,830
1,42,54,10,42,52
20,38,50,60,760,820
1,1252,2295,722,1252,1974
1,1266,2320,752,1266,2018
1,1252,2295,1020,1252,2272
1,1252,2295,745,1252,1997
1,1252,2295,951,1252,2203
1,420,769,318,420,738
1,295,540,148,295,443
1,487,783,280,487,767
1,2171,3578,835,2171,3006
1,2171,3578,942,2171,3113
1,1555,2443,375,1555,1930
1,344,540,174,344,518
1,344,540,174,344,518
1,344,540,174,344,518
30,26,70,1236,780,2016
30,26,70,1026,780,1806
9,26,70,276,234,510
26,3,9,151,78,229
20,2,5,47,40,87
18,2,5,42,36,78
19,9,25,204,171,375
22,1,2,14,22,36
2,1,2,1,2,3
7,2,5,21,14,35
14,2,5,41,28,69
13,2,5,38,26,64
14,2,5,41,28,69
24,11,29,342,264,606
14,11,29,199,154,353
2,1,2,1,2,3
25,1,2,15,25,40
8,1,2,5,8,13
23,2,5,67,46,113
26,2,5,75,52,127
2,9,25,32,18,50
22,2,5,62,44,106
22,1,2,14,22,36
7,1,2,4,7,11
29,1,4,82,29,111
4,9,25,60,36,96
16,9,25,240,144,384
14,9,25,210,126,336
19,2,5,45,38,83
10,8,21,90,80,170
17,8,21,153,136,289
8,1,2,6,8,14
15,1,2,15,15,30
21,1,2,21,21,42
19,1,2,17,19,36
30,2,5,69,60,129
21,2,5,48,42,90
18,1,2,17,18,35
25,1,2,24,25,49
4,2,5,12,8,20
28,2,5,66,56,122
1,1482,2384,521,1482,2003
3,45,120,160,135,295
4,4,10,17,16,33
2,4,10,8,8,16
11,3,9,48,33,81
30,3,9,131,90,221
3,4,10,13,12,25
30,4,10,132,120,252
23,3,9,136,69,205
27,2,5,55,54,109
21,2,5,43,42,85
15,2,5,44,30,74
12,3,9,49,36,85
10,3,9,41,30,71
18,2,5,52,36,88
24,2,5,67,48,115
13,2,5,36,26,62
12,2,5,23,24,47
14,2,5,27,28,55
4,2,5,12,8,20
12,2,5,23,24,47
8,2,5,15,16,31
1,2,5,2,2,4
15,2,5,44,30,74
9,2,5,27,18,45
1,2,5,3,2,5
10,3,9,48,30,78
24,3,9,116,72,188
18,2,5,35,36,71
11,2,5,21,22,43
24,7,9,46,168,214
2,7,9,1,14,15
12,3,8,48,36,84
6,3,8,21,18,39
14,3,8,52,42,94
28,3,8,136,84,220
26,3,8,126,78,204
11,3,8,53,33,86
12,8,22,163,96,259
20,8,22,271,160,431
28,8,22,349,224,573
5,8,22,69,40,109
20,8,22,262,160,422
13,9,24,154,117,271
28,9,24,413,252,665
3,9,24,44,27,71
6,13,35,128,78,206
6,13,35,130,78,208
2,13,35,29,26,55
19,13,35,278,247,525
13,13,35,186,169,355
15,13,35,215,195,410
9,13,35,192,117,309
3,13,35,62,39,101
3,13,35,62,39,101
16,13,35,229,208,437
4,13,35,85,52,137
23,13,35,490,299,789
18,13,35,383,234,617
4,13,35,87,52,139
30,13,35,639,390,1029
12,21,55,302,252,554
12,21,55,395,252,647
10,21,55,236,210,446
28,42,54,139,1176,1315
21,42,54,105,882,987
2,38,50,6,76,82
8,42,54,92,336,428
19,42,54,84,798,882
3,38,50,26,114,140
23,38,50,127,874,1001
1,1898,3375,1038,1898,2936
1,1912,3400,876,1912,2788
1,1252,2295,951,1252,2203
1,1252,2295,1020,1252,2272
1,420,769,211,420,631
1,420,769,318,420,738
1,295,540,148,295,443
1,1266,2320,1008,1266,2274
1,1266,2320,1008,1266,2274
1,1555,2443,448,1555,2003
1,2171,3578,942,2171,3113
1,2171,3578,656,2171,2827
1,2171,3578,656,2171,2827
1,2171,3578,727,2171,2898
1,2171,3578,656,2171,2827
1,344,540,77,344,421
1,713,1120,362,713,1075
1,1083,1701,261,1083,1344
1,344,540,99,344,443
1,713,1120,172,713,885
9,26,70,308,234,542
28,26,70,801,728,1529
29,26,70,1256,754,2010
3,3,9,17,9,26
14,3,9,75,42,117
29,9,25,370,261,631
20,9,25,255,180,435
3,9,25,32,27,59
26,9,25,280,234,514
22,1,2,21,22,43
16,1,2,10,16,26
30,1,2,19,30,49
25,1,2,16,25,41
22,2,5,65,44,109
8,1,2,8,8,16
19,1,2,19,19,38
17,2,5,32,34,66
19,2,5,36,38,74
14,1,2,12,14,26
6,9,25,95,54,149
20,9,25,315,180,495
26,1,2,15,26,41
11,1,2,6,11,17
18,2,5,34,36,70
11,2,5,21,22,43
2,1,4,4,2,6
4,1,4,8,4,12
27,1,4,57,27,84
20,2,5,58,40,98
26,2,5,75,52,127
16,1,4,45,16,61
14,1,4,40,14,54
27,1,2,26,27,53
4,1,2,4,4,8
11,1,2,11,11,22
18,2,5,53,36,89
13,11,30,165,143,308
23,9,25,288,207,495
22,9,25,275,198,473
13,1,4,37,13,50
10,1,4,28,10,38
11,1,4,32,11,43
7,1,4,20,7,27
12,1,2,9,12,21
23,1,2,17,23,40
24,1,4,68,24,92
4,1,4,11,4,15
22,8,21,277,176,453
24,8,21,302,192,494
18,1,2,10,18,28
8,1,2,4,8,12
23,1,2,13,23,36
1,1482,2384,521,1482,2003
1,1482,2384,592,1482,2074
5,45,120,369,225,594
16,2,5,45,32,77
27,2,5,51,54,105
27,2,5,51,54,105
14,2,5,41,28,69
8,2,5,23,16,39
5,4,10,29,20,49
20,2,5,46,40,86
4,2,5,9,8,17
5,2,5,12,10,22
24,2,5,55,48,103
24,4,10,113,96,209
28,2,5,66,56,122
20,2,5,47,40,87
18,2,5,52,36,88
8,2,5,23,16,39
18,2,5,52,36,88
30,2,5,71,60,131
7,2,5,16,14,30
16,3,9,93,48,141
22,3,9,128,66,194
15,3,9,71,45,116
1,3,9,6,3,9
26,2,5,75,52,127
10,2,5,29,20,49
28,2,5,83,56,139
11,2,5,32,22,54
12,3,9,64,36,100
24,3,9,129,72,201
9,2,5,27,18,45
23,7,9,44,161,205
18,7,9,7,126,133
23,7,9,3,161,164
29,7,9,24,203,227
8,7,9,15,56,71
29,7,9,21,203,224
21,7,9,16,147,163
16,7,9,13,112,125
6,7,9,11,42,53
7,3,8,34,21,55
23,8,22,312,184,496
3,8,22,27,24,51
12,8,22,163,96,259
13,8,22,176,104,280
29,8,22,317,232,549
9,8,22,100,72,172
13,8,22,179,104,283
21,8,22,229,168,397
22,9,24,235,198,433
7,9,24,83,63,146
12,9,24,168,108,276
25,13,35,393,325,718
3,13,35,49,39,88
8,13,35,170,104,274
22,13,35,315,286,601
18,13,35,383,234,617
4,13,35,70,52,122
2,13,35,43,26,69
9,13,35,157,117,274
13,13,35,281,169,450
28,13,35,410,364,774
12,13,35,256,156,412
11,13,35,188,143,331
13,13,35,277,169,446
16,13,35,330,208,538
28,13,35,489,364,853
20,13,35,349,260,609
11,13,35,227,143,370
24,13,35,343,312,655
6,13,35,94,78,172
17,13,35,243,221,464
11,21,55,241,231,472
23,21,55,769,483,1252
18,42,54,90,756,846
10,42,54,23,420,443
3,42,54,7,126,133
24,38,50,96,912,1008
26,42,54,129,1092,1221
10,38,50,110,380,490
16,42,54,71,672,743
17,38,50,94,646,740
28,42,54,18,1176,1194
1,1898,3375,937,1898,2835
1,1266,2320,729,1266,1995
1,1266,2320,544,1266,1810
1,420,769,249,420,669
1,1266,2320,1008,1266,2274
1,1266,2320,636,1266,1902
1,1252,2295,630,1252,1882
1,2171,3578,1264,2171,3435
1,1555,2443,448,1555,2003
1,2171,3578,942,2171,3113
1,1555,2443,717,1555,2272
1,1083,1701,397,1083,1480
1,344,540,185,344,529
1,1083,1701,346,1083,1429
1,1083,1701,550,1083,1633
1,2171,3578,906,2171,3077
21,26,70,659,546,1205
24,26,70,686,624,1310
13,26,70,472,338,810
30,1,2,29,30,59
1,1,2,1,1,2
1,1,2,1,1,2
11,13,35,173,143,316
14,13,35,298,182,480
26,2,5,61,52,113
16,2,5,38,32,70
25,1,2,23,25,48
29,1,2,27,29,56
15,1,2,14,15,29
16,2,5,46,32,78
16,2,5,46,32,78
10,2,5,28,20,48
8,1,4,23,8,31
23,1,4,65,23,88
8,2,5,24,16,40
17,2,5,50,34,84
16,1,2,12,16,28
25,2,5,73,50,123
18,11,30,272,198,470
6,1,2,4,6,10
7,1,2,5,7,12
5,1,2,4,5,9
1,2,5,2,2,4
26,2,5,49,52,101
13,2,5,31,26,57
2,2,5,5,4,9
12,2,5,28,24,52
22,2,5,58,44,102
3,2,5,8,6,14
11,1,2,8,11,19
11,1,2,8,11,19
16,2,5,47,32,79
27,2,5,80,54,134
17,2,5,50,34,84
8,1,2,5,8,13
7,1,2,4,7,11
19,2,5,53,38,91
3,12,33,44,36,80
28,12,33,412,336,748
25,1,2,18,25,43
6,2,5,14,12,26
4,2,5,9,8,17
5,1,2,4,5,9
29,1,2,21,29,50
23,11,30,423,253,676
29,12,33,456,348,804
17,12,33,267,204,471
6,8,21,73,48,121
3,1,2,3,3,6
8,1,2,8,8,16
17,1,2,16,17,33
16,9,25,168,144,312
2,9,25,21,18,39
7,1,2,5,7,12
11,1,2,8,11,19
25,2,5,74,50,124
5,2,5,15,10,25
25,2,5,73,50,123
17,1,4,36,17,53
17,1,4,36,17,53
1,12,33,20,12,32
20,12,33,394,240,634
20,9,25,210,180,390
19,9,25,200,171,371
12,1,2,7,12,19
15,1,2,8,15,23
13,1,2,7,13,20
15,9,25,233,135,368
1,9,25,16,9,25
12,9,25,186,108,294
3,2,5,8,6,14
1,2,5,3,2,5
1,1482,2384,854,1482,2336
1,1482,2384,854,1482,2336
1,755,1215,375,755,1130
1,1482,2384,592,1482,2074
1,461,742,266,461,727
14,24,64,542,336,878
5,59,159,333,295,628
12,2,5,35,24,59
13,2,5,38,26,64
11,2,5,23,22,45
11,2,5,23,22,45
10,4,10,39,40,79
20,4,10,78,80,158
2,2,5,4,4,8
3,3,9,13,9,22
13,3,9,57,39,96
30,4,10,174,120,294
18,4,10,104,72,176
11,2,5,32,22,54
28,2,5,66,56,122
27,2,5,63,54,117
28,2,5,66,56,122
5,3,9,28,15,43
26,3,9,147,78,225
14,3,9,64,42,106
8,3,9,36,24,60
17,2,5,40,34,74
12,2,5,28,24,52
22,3,9,130,66,196
23,7,9,19,161,180
9,7,9,7,63,70
27,7,9,22,189,211
21,7,9,8,147,155
18,7,9,33,126,159
16,3,8,53,48,101
15,3,8,58,45,103
12,8,22,110,96,206
10,8,22,136,80,216
10,8,22,105,80,185
6,9,24,84,54,138
22,9,24,309,198,507
15,9,24,218,135,353
14,9,24,139,126,265
6,13,35,105,78,183
6,13,35,130,78,208
21,13,35,411,273,684
27,13,35,471,351,822
15,13,35,262,195,457
28,13,35,606,364,970
6,13,35,105,78,183
26,13,35,536,338,874
22,13,35,384,286,670
18,13,35,383,234,617
29,13,35,496,377,873
15,13,35,309,195,504
8,13,35,170,104,274
23,13,35,490,299,789
20,13,35,426,260,686
5,13,35,73,65,138
13,21,55,328,273,601
12,21,55,401,252,653
14,21,55,468,294,762
22,42,54,240,924,1164
9,42,54,45,378,423
3,38,50,30,114,144
29,38,50,319,1102,1421
17,42,54,186,714,900
1,1266,2320,544,1266,1810
1,1252,2295,997,1252,2249
1,1266,2320,544,1266,1810
1,1266,2320,729,1266,1995
1,420,769,295,420,715
1,295,540,234,295,529
1,1252,2295,951,1252,2203
1,420,769,318,420,738
1,2171,3578,942,2171,3113
1,2171,3578,942,2171,3113
1,1083,1701,601,1083,1684
1,1555,2443,570,1555,2125
1,2171,3578,656,2171,2827
1,1083,1701,312,1083,1395
1,344,540,77,344,421
1,487,783,132,487,619
1,713,1120,205,713,918
17,3,9,68,51,119
17,3,9,73,51,124
19,1,4,56,19,75
22,9,25,275,198,473
21,9,25,263,189,452
15,8,21,129,120,249
2,8,21,17,16,33
26,8,21,223,208,431
28,13,35,400,364,764
17,9,25,204,153,357
19,9,25,228,171,399
6,1,2,3,6,9
28,1,2,16,28,44
1,1,2,1,1,2
17,1,2,16,17,33
25,9,25,319,225,544
8,9,25,102,72,174
11,1,2,8,11,19
22,1,2,16,22,38
15,13,35,262,195,457
2,13,35,35,26,61
4,2,5,12,8,20
1,2,5,3,2,5
26,2,5,75,52,127
9,1,2,9,9,18
16,11,30,242,176,418
7,11,30,106,77,183
29,11,30,438,319,757
14,11,30,211,154,365
5,2,5,15,10,25
3,2,5,9,6,15
19,9,25,219,171,390
25,9,25,288,225,513
9,11,30,128,99,227
27,13,35,443,351,794
6,1,4,18,6,24
28,1,4,82,28,110
10,1,2,7,10,17
10,1,2,7,10,17
29,1,4,66,29,95
23,1,2,20,23,43
27,1,2,23,27,50
4,1,2,4,4,8
19,1,2,18,19,37
20,2,5,58,40,98
21,1,4,61,21,82
23,8,21,236,184,420
24,8,21,246,192,438
4,1,2,4,4,8
8,1,2,8,8,16
5,1,2,4,5,9
17,1,2,13,17,30
16,1,2,12,16,28
1,755,1215,229,755,984
1,1482,2384,854,1482,2336
1,461,742,125,461,586
7,24,64,199,168,367
7,59,159,433,413,846
15,3,9,66,45,111
20,3,9,88,60,148
9,4,10,53,36,89
13,2,5,38,26,64
9,2,5,21,18,39
29,3,9,132,87,219
8,3,9,36,24,60
6,2,5,16,12,28
16,2,5,37,32,69
12,3,9,71,36,107
16,7,9,12,112,124
5,7,9,4,35,39
17,7,9,31,119,150
16,7,9,6,112,118
15,7,9,12,105,117
21,7,9,40,147,187
14,3,8,69,42,111
24,3,8,116,72,188
24,3,8,116,72,188
25,3,8,89,75,164
2,8,22,27,16,43
3,8,22,30,24,54
25,8,22,339,200,539
8,8,22,110,64,174
4,9,24,48,36,84
20,13,35,286,260,546
19,13,35,258,247,505
8,13,35,114,104,218
4,13,35,66,52,118
8,13,35,126,104,230
8,13,35,156,104,260
21,13,35,455,273,728
20,13,35,426,260,686
18,13,35,383,234,617
15,13,35,320,195,515
18,42,54,197,756,953
10,38,50,115,380,495
24,42,54,120,1008,1128
2,38,50,17,76,93
29,42,54,317,1218,1535
1,420,769,334,420,754
1,1266,2320,636,1266,1902
1,487,783,155,487,642
1,2171,3578,835,2171,3006
1,1555,2443,839,1555,2394
1,344,540,185,344,529
9,26,70,314,234,548
11,26,70,315,286,601
5,26,70,217,130,347
14,13,35,298,182,480
30,13,35,639,390,1029
24,2,5,70,48,118
23,13,35,498,299,797
12,13,35,260,156,416
9,13,35,195,117,312
5,11,29,64,55,119
14,2,5,41,28,69
29,2,5,84,58,142
30,2,5,89,60,149
14,9,25,217,126,343
3,9,25,47,27,74
26,1,2,25,26,51
2,11,30,24,22,46
13,11,30,153,143,296
7,1,2,5,7,12
19,1,2,14,19,33
14,9,25,221,126,347
25,1,2,25,25,50
6,1,2,6,6,12
18,9,25,207,162,369
26,2,5,69,52,121
12,2,5,32,24,56
1,1,2,1,1,2
6,9,25,93,54,147
30,9,25,465,270,735
12,1,4,25,12,37
28,1,2,16,28,44
6,1,2,3,6,9
29,2,5,67,58,125
13,2,5,30,26,56
12,8,21,151,96,247
23,1,2,13,23,36
15,1,2,8,15,23
15,1,2,15,15,30
7,24,64,271,168,439
13,24,64,320,312,632
26,24,64,924,624,1548
5,59,159,492,295,787
6,59,159,581,354,935
30,2,5,89,60,149
20,2,5,59,40,99
19,2,5,56,38,94
29,2,5,77,58,135
9,4,10,52,36,88
24,4,10,139,96,235
28,4,10,157,112,269
20,4,10,112,80,192
19,3,9,92,57,149
11,3,9,53,33,86
18,4,10,68,72,140
5,4,10,19,20,39
28,2,5,81,56,137
4,2,5,12,8,20
26,7,9,50,182,232
5,7,9,10,35,45
21,7,9,38,147,185
21,7,9,38,147,185
9,7,9,15,63,78
7,7,9,4,49,53
11,3,8,54,33,87
11,3,8,54,33,87
15,3,8,49,45,94
4,8,22,37,32,69
19,9,24,221,171,392
15,9,24,175,135,310
23,13,35,337,299,636
26,13,35,554,338,892
16,13,35,246,208,454
15,13,35,262,195,457
28,13,35,410,364,774
2,13,35,41,26,67
30,13,35,618,390,1008
7,13,35,122,91,213
18,13,35,371,234,605
19,13,35,405,247,652
13,13,35,227,169,396
1,38,50,11,38,49
3,42,54,34,126,160
24,38,50,264,912,1176
20,38,50,100,760,860
1,1266,2320,1008,1266,2274
1,1252,2295,997,1252,2249
1,2171,3578,1264,2171,3435
1,2171,3578,942,2171,3113
1,2171,3578,942,2171,3113
1,1083,1701,550,1083,1633
1,487,783,265,487,752
1,713,1120,250,713,963
1,1083,1701,550,1083,1633
1,344,540,126,344,470
1,1083,1701,312,1083,1395
1,2171,3578,1335,2171,3506
12,26,70,520,312,832
25,26,70,855,650,1505
4,26,70,131,104,235
22,3,9,128,66,194
23,3,9,130,69,199
10,1,2,6,10,16
7,1,2,4,7,11
5,2,5,14,10,24
16,2,5,47,32,79
5,2,5,15,10,25
17,2,5,50,34,84
7,2,5,21,14,35
20,2,5,59,40,99
1,11,30,15,11,26
14,11,30,211,154,365
27,11,30,408,297,705
14,12,33,289,168,457
22,12,33,455,264,719
8,2,5,19,16,35
30,2,5,71,60,131
8,2,5,24,16,40
2,2,5,6,4,10
1,2,5,3,2,5
4,11,30,74,44,118
10,9,25,133,90,223
8,9,25,106,72,178
9,1,2,5,9,14
6,1,2,3,6,9
26,1,2,24,26,50
8,1,2,7,8,15
23,1,2,22,23,45
23,1,2,22,23,45
27,1,2,15,27,42
27,1,2,15,27,42
2,1,2,1,2,3
7,1,2,7,7,14
29,1,4,85,29,114
16,1,4,47,16,63
16,1,4,47,16,63
4,1,4,12,4,16
23,1,4,50,23,73
27,1,4,66,27,93
1,1482,2384,878,1482,2360
1,1482,2384,854,1482,2336
2,59,159,149,118,267
2,3,9,12,6,18
4,3,9,24,12,36
19,2,5,36,38,74
22,2,5,42,44,86
25,3,9,114,75,189
11,3,9,50,33,83
1,2,5,3,2,5
4,2,5,12,8,20
7,2,5,20,14,34
11,2,5,32,22,54
17,4,10,95,68,163
6,2,5,13,12,25
12,2,5,34,24,58
28,2,5,78,56,134
20,3,9,107,60,167
4,3,9,21,12,33
24,2,5,64,48,112
29,2,5,86,58,144
3,2,5,8,6,14
10,2,5,28,20,48
19,2,5,45,38,83
26,2,5,61,52,113
19,7,9,35,133,168
26,7,9,10,182,192
28,7,9,51,196,247
14,7,9,12,98,110
13,7,9,18,91,109
10,3,8,49,30,79
21,8,22,289,168,457
23,8,22,312,184,496
1,8,22,14,8,22
28,8,22,380,224,604
30,8,22,407,240,647
25,9,24,249,225,474
21,9,24,305,189,494
12,9,24,160,108,268
3,9,24,42,27,69
2,9,24,29,18,47
11,9,24,117,99,216
20,13,35,426,260,686
28,13,35,606,364,970
5,13,35,108,65,173
12,13,35,256,156,412
24,13,35,494,312,806
24,13,35,394,312,706
13,13,35,268,169,437
19,13,35,405,247,652
9,13,35,195,117,312
1,13,35,21,13,34
17,21,55,428,357,785
15,38,50,150,570,720
23,38,50,265,874,1139
12,42,54,131,504,635
26,38,50,286,988,1274
21,42,54,229,882,1111
30,42,54,328,1260,1588
12,42,54,1,504,505
4,38,50,46,152,198
10,42,54,7,420,427
28,38,50,154,1064,1218
1,1898,3375,1443,1898,3341
1,420,769,334,420,754
1,1266,2320,1008,1266,2274
1,420,769,249,420,669
1,1252,2295,745,1252,1997
1,308,565,246,308,554
1,1266,2320,961,1266,2227
1,2171,3578,1335,2171,3506
1,1083,1701,550,1083,1633
1,2171,3578,1264,2171,3435
1,2171,3578,1264,2171,3435
1,2171,3578,835,2171,3006
1,2171,3578,620,2171,2791
1,713,1120,385,713,1098
1,344,540,99,344,443
1,344,540,185,344,529
1,713,1120,172,713,885
1,1083,1701,499,1083,1582
1,713,1120,172,713,885
1,2171,3578,1335,2171,3506
21,26,70,733,546,1279
21,26,70,601,546,1147
13,26,70,372,338,710
18,3,9,105,54,159
16,3,9,76,48,124
7,3,9,41,21,62
8,3,9,47,24,71
24,3,9,96,72,168
5,1,4,15,5,20
18,1,4,53,18,71
20,1,4,59,20,79
4,1,2,4,4,8
4,1,2,3,4,7
4,13,35,68,52,120
23,2,5,64,46,110
20,2,5,56,40,96
27,2,5,80,54,134
4,2,5,12,8,20
11,2,5,32,22,54
19,1,4,56,19,75
15,1,4,44,15,59
14,1,4,41,14,55
8,9,25,120,72,192
11,9,25,165,99,264
21,2,5,61,42,103
4,2,5,12,8,20
24,2,5,55,48,103
7,2,5,16,14,30
11,2,5,31,22,53
6,2,5,17,12,29
13,2,5,36,26,62
16,1,2,11,16,27
12,1,2,8,12,20
23,11,30,313,253,566
8,2,5,19,16,35
2,2,5,5,4,9
17,12,33,267,204,471
29,12,33,456,348,804
22,12,33,346,264,610
12,1,2,8,12,20
9,1,4,26,9,35
1,1,4,3,1,4
13,1,4,38,13,51
12,2,5,35,24,59
2,2,5,6,4,10
5,2,5,10,10,20
1,2,5,2,2,4
26,11,30,478,286,764
9,1,4,26,9,35
28,1,2,16,28,44
24,1,2,13,24,37
8,1,2,4,8,12
16,12,33,325,192,517
26,2,5,75,52,127
30,2,5,87,60,147
13,1,4,38,13,51
16,8,21,201,128,329
8,8,21,101,64,165
7,8,21,88,56,144
3,2,5,9,6,15
28,2,5,81,56,137
25,1,2,16,25,41
5,1,2,3,5,8
1,1482,2384,807,1482,2289
1,1482,2384,807,1482,2289
1,755,1215,375,755,1130
1,461,742,185,461,646
5,2,5,15,10,25
22,2,5,65,44,109
5,4,10,21,20,41
8,4,10,34,32,66
14,2,5,32,28,60
25,2,5,58,50,108
27,2,5,62,54,116
17,2,5,39,34,73
28,4,10,115,112,227
10,4,10,59,40,99
3,4,10,18,12,30
13,2,5,25,26,51
22,2,5,64,44,108
30,2,5,87,60,147
17,2,5,40,34,74
29,2,5,86,58,144
6,2,5,18,12,30
3,2,5,7,6,13
12,2,5,28,24,52
20,7,9,33,140,173
21,7,9,16,147,163
18,7,9,7,126,133
25,7,9,46,175,221
12,7,9,20,84,104
25,7,9,46,175,221
10,7,9,8,70,78
4,3,8,19,12,31
17,3,8,61,51,112
22,8,22,221,176,397
10,8,22,100,80,180
22,8,22,298,176,474
19,8,22,262,152,414
12,8,22,131,96,227
6,9,24,89,54,143
28,9,24,413,252,665
26,9,24,303,234,537
16,9,24,232,144,376
18,9,24,261,162,423
3,13,35,43,39,82
3,13,35,64,39,103
30,13,35,650,390,1040
26,13,35,536,338,874
25,13,35,541,325,866
21,13,35,455,273,728
28,13,35,577,364,941
10,13,35,175,130,305
4,13,35,82,52,134
24,13,35,511,312,823
2,13,35,43,26,69
4,13,35,87,52,139
21,13,35,433,273,706
11,13,35,238,143,381
29,13,35,415,377,792
4,13,35,82,52,134
16,21,55,535,336,871
26,21,55,584,546,1130
13,21,55,428,273,701
14,21,55,468,294,762
28,42,54,139,1176,1315
5,38,50,8,190,198
21,38,50,242,798,1040
16,42,54,175,672,847
15,42,54,164,630,794
14,42,54,62,588,650
1,1266,2320,1008,1266,2274
1,1266,2320,1008,1266,2274
1,1266,2320,961,1266,2227
1,308,565,184,308,492
1,1266,2320,636,1266,1902
1,420,769,180,420,600
1,295,540,234,295,529
1,308,565,234,308,542
1,308,565,138,308,446
1,308,565,251,308,559
1,420,769,249,420,669
1,1555,2443,839,1555,2394
1,713,1120,396,713,1109
1,713,1120,250,713,963
1,344,540,174,344,518
16,26,70,693,416,1109
25,26,70,1065,650,1715
12,26,70,511,312,823
20,26,70,656,520,1176
3,26,70,130,78,208
12,26,70,520,312,832
6,3,9,35,18,53
2,2,5,4,4,8
27,2,5,57,54,111
19,9,25,299,171,470
6,9,25,95,54,149
7,9,25,110,63,173
24,13,35,511,312,823
2,13,35,43,26,69
6,1,2,6,6,12
19,1,2,19,19,38
7,2,5,20,14,34
29,2,5,68,58,126
14,2,5,33,28,61
3,2,5,7,6,13
3,1,2,3,3,6
25,1,2,25,25,50
22,1,2,21,22,43
3,1,2,3,3,6
18,11,30,337,198,535
10,11,30,187,110,297
27,1,2,25,27,52
16,1,2,15,16,31
12,2,5,34,24,58
7,2,5,13,14,27
26,9,25,410,234,644
11,9,25,173,99,272
6,9,25,95,54,149
24,1,2,22,24,46
25,1,2,25,25,50
2,2,5,6,4,10
22,2,5,65,44,109
12,1,2,12,12,24
24,1,4,55,24,79
21,1,4,48,21,69
2,12,33,41,24,65
30,1,4,88,30,118
5,1,2,5,5,10
27,1,2,26,27,53
4,1,2,3,4,7
13,1,2,10,13,23
23,1,4,65,23,88
13,1,4,37,13,50
1,1,4,3,1,4
17,1,4,50,17,67
1,755,1215,448,755,1203
1,755,1215,436,755,1191
27,24,64,1063,648,1711
19,24,64,492,456,948
17,45,120,1234,765,1999
10,59,159,968,590,1558
15,2,5,44,30,74
10,2,5,29,20,49
7,2,5,20,14,34
19,2,5,37,38,75
10,2,5,30,20,50
22,2,5,65,44,109
8,2,5,17,16,33
10,2,5,21,20,41
23,2,5,67,46,113
21,2,5,61,42,103
16,2,5,29,32,61
19,2,5,40,38,78
7,2,5,15,14,29
9,2,5,18,18,36
18,2,5,35,36,71
20,2,5,38,40,78
1,2,5,2,2,4
29,2,5,86,58,144
21,2,5,40,42,82
4,2,5,8,8,16
23,2,5,54,46,100
25,2,5,59,50,109
29,2,5,84,58,142
16,2,5,46,32,78
17,7,9,14,119,133
16,7,9,29,112,141
23,7,9,19,161,180
23,7,9,44,161,205
7,3,8,28,21,49
2,8,22,27,16,43
17,8,22,223,136,359
25,8,22,229,200,429
21,8,22,192,168,360
27,8,22,372,216,588
5,8,22,56,40,96
25,8,22,251,200,451
17,9,24,251,153,404
2,9,24,21,18,39
23,13,35,498,299,797
10,13,35,213,130,343
27,13,35,575,351,926
29,13,35,415,377,792
30,13,35,587,390,977
20,13,35,349,260,609
26,13,35,563,338,901
11,13,35,150,143,293
25,13,35,515,325,840
16,13,35,341,208,549
9,13,35,185,117,302
2,21,55,44,42,86
12,21,55,401,252,653
10,42,54,7,420,427
10,38,50,100,380,480
28,38,50,322,1064,1386
28,42,54,139,1176,1315
10,42,54,50,420,470
4,42,54,9,168,177
20,38,50,110,760,870
30,38,50,165,1140,1305
11,38,50,61,418,479
17,38,50,196,646,842
1,1252,2295,951,1252,2203
1,420,769,334,420,754
1,1252,2295,951,1252,2203
1,295,540,234,295,529
1,420,769,211,420,631
1,1252,2295,997,1252,2249
1,487,783,124,487,611
1,487,783,155,487,642
1,713,1120,205,713,918
1,1083,1701,550,1083,1633
1,1519,2443,411,1519,1930
1,344,540,126,344,470
1,344,540,77,344,421
1,487,783,194,487,681
1,2171,3578,1335,2171,3506
16,26,70,693,416,1109
6,26,70,260,156,416
14,26,70,489,364,853
28,26,70,1212,728,1940
20,3,9,118,60,178
12,3,9,71,36,107
18,1,2,15,18,33
30,1,2,26,30,56
4,1,2,4,4,8
15,1,2,15,15,30
27,11,29,478,297,775
12,2,5,28,24,52
2,1,2,1,2,3
4,1,2,3,4,7
1,11,30,15,11,26
26,11,30,478,286,764
18,11,30,331,198,529
13,9,25,195,117,312
15,1,2,11,15,26
22,2,5,62,44,106
20,1,2,15,20,35
24,1,2,18,24,42
9,2,5,26,18,44
14,2,5,41,28,69
29,1,2,21,29,50
22,1,2,16,22,38
25,1,2,14,25,39
28,1,2,16,28,44
20,2,5,59,40,99
2,2,5,6,4,10
5,8,21,61,40,101
26,8,21,316,208,524
27,8,21,328,216,544
9,2,5,25,18,43
28,2,5,78,56,134
7,1,4,16,7,23
3,1,4,7,3,10
18,1,2,18,18,36
26,1,2,25,26,51
19,1,2,19,19,38
18,1,2,18,18,36
7,2,5,16,14,30
8,2,5,19,16,35
28,2,5,66,56,122
17,1,2,17,17,34
10,2,5,28,20,48
21,2,5,59,42,101
12,9,25,186,108,294
17,9,25,264,153,417
1,461,742,229,461,690
4,3,9,23,12,35
15,4,10,89,60,149
19,4,10,112,76,188
23,2,5,44,46,90
28,2,5,78,56,134
1,2,5,3,2,5
5,2,5,15,10,25
16,4,10,75,64,139
30,2,5,74,60,134
19,2,5,47,38,85
12,2,5,35,24,59
15,2,5,44,30,74
11,2,5,26,22,48
26,2,5,61,52,113
20,2,5,47,40,87
12,2,5,28,24,52
16,7,9,26,112,138
19,7,9,36,133,169
26,7,9,3,182,185
17,7,9,23,119,142
2,3,8,6,6,12
21,8,22,192,168,360
24,8,22,331,192,523
3,8,22,41,24,65
20,8,22,223,160,383
27,8,22,378,216,594
4,8,22,45,32,77
12,9,24,177,108,285
25,9,24,267,225,492
11,13,35,173,143,316
2,13,35,29,26,55
27,13,35,585,351,936
23,13,35,361,299,660
1,13,35,20,13,33
2,13,35,43,26,69
15,13,35,220,195,415
18,13,35,264,234,498
24,13,35,494,312,806
15,13,35,220,195,415
5,13,35,98,65,163
29,21,55,970,609,1579
4,38,50,12,152,164
2,38,50,11,76,87
18,42,54,206,756,962
22,42,54,216,924,1140
20,38,50,200,760,960
16,42,54,192,672,864
3,38,50,5,114,119
21,42,54,207,882,1089
1,1252,2295,630,1252,1882
1,1266,2320,544,1266,1810
1,713,1120,362,713,1075
1,344,540,137,344,481
1,344,540,174,344,518
1,1555,2443,864,1555,2419
23,26,70,948,598,1546
25,26,70,785,650,1435
14,3,9,61,42,103
25,3,9,141,75,216
11,3,9,53,33,86
9,3,9,37,27,64
28,3,9,113,84,197
4,2,5,8,8,16
19,2,5,36,38,74
3,2,5,7,6,13
23,2,5,54,46,100
22,2,5,46,44,90
22,9,25,237,198,435
20,9,25,215,180,395
19,2,5,37,38,75
4,2,5,12,8,20
19,2,5,55,38,93
2,1,2,1,2,3
24,1,2,15,24,39
27,1,4,77,27,104
4,1,2,3,4,7
19,1,2,16,19,35
20,1,4,42,20,62
1,1,4,2,1,3
17,2,5,40,34,74
16,1,2,14,16,30
6,1,2,5,6,11
11,2,5,31,22,53
6,2,5,17,12,29
7,1,2,4,7,11
6,8,21,52,48,100
24,8,21,206,192,398
11,2,5,32,22,54
8,1,4,23,8,31
22,1,4,64,22,86
24,1,4,51,24,75
8,8,21,97,64,161
8,8,21,97,64,161
27,2,5,57,54,111
30,2,5,63,60,123
1,1482,2384,378,1482,1860
3,45,120,200,135,335
8,59,159,596,472,1068
26,3,9,114,78,192
15,2,5,35,30,65
10,2,5,24,20,44
17,2,5,32,34,66
13,2,5,25,26,51
3,2,5,8,6,14
23,2,5,64,46,110
16,2,5,30,32,62
21,2,5,40,42,82
4,2,5,12,8,20
19,2,5,56,38,94
2,2,5,6,4,10
22,4,10,128,88,216
20,4,10,116,80,196
22,3,9,130,66,196
16,3,9,95,48,143
23,3,9,130,69,199
3,3,9,17,9,26
18,2,5,34,36,70
28,2,5,53,56,109
5,2,5,15,10,25
3,2,5,9,6,15
10,2,5,30,20,50
10,2,5,30,20,50
22,2,5,42,44,86
13,2,5,25,26,51
1,2,5,2,2,4
26,7,9,1,182,183
10,7,9,19,70,89
10,7,9,16,70,86
27,7,9,44,189,233
8,7,9,15,56,71
11,7,9,18,77,95
20,3,8,89,60,149
14,3,8,52,42,94
12,3,8,59,36,95
7,3,8,23,21,44
4,8,22,37,32,69
5,8,22,68,40,108
20,8,22,210,160,370
30,8,22,413,240,653
27,8,22,247,216,463
22,8,22,303,176,479
19,9,24,185,171,356
24,9,24,354,216,570
26,13,35,554,338,892
14,13,35,288,182,470
15,13,35,215,195,410
9,13,35,195,117,312
29,13,35,506,377,883
22,13,35,453,286,739
17,13,35,249,221,470
23,13,35,329,299,628
17,13,35,243,221,464
15,13,35,262,195,457
28,13,35,577,364,941
27,13,35,528,351,879
11,13,35,227,143,370
24,13,35,511,312,823
20,13,35,426,260,686
29,13,35,618,377,995
8,13,35,140,104,244
3,13,35,65,39,104
14,13,35,220,182,402
19,21,55,636,399,1035
26,42,54,17,1092,1109
7,38,50,11,266,277
16,42,54,80,672,752
13,38,50,13,494,507
15,38,50,15,570,585
19,38,50,57,722,779
1,1252,2295,630,1252,1882
1,1266,2320,1008,1266,2274
1,1266,2320,752,1266,2018
1,1252,2295,997,1252,2249
1,420,769,188,420,608
1,420,769,318,420,738
1,487,783,155,487,642
1,344,540,174,344,518
1,1083,1701,601,1083,1684
20,26,70,586,520,1106
5,26,70,217,130,347
18,3,9,102,54,156
30,8,21,346,240,586
25,8,21,288,200,488
23,8,21,265,184,449
14,13,35,298,182,480
15,13,35,320,195,515
27,13,35,575,351,926
19,2,5,53,38,91
4,13,35,78,52,130
5,13,35,107,65,172
9,13,35,192,117,309
9,11,30,168,99,267
14,11,30,262,154,416
23,9,25,265,207,472
26,9,25,299,234,533
12,1,2,9,12,21
10,2,5,28,20,48
24,11,30,406,264,670
17,11,30,287,187,474
7,1,2,4,7,11
21,1,2,16,21,37
14,1,2,10,14,24
22,2,5,65,44,109
7,2,5,21,14,35
15,2,5,44,30,74
23,9,25,362,207,569
12,9,25,189,108,297
19,2,5,45,38,83
17,2,5,40,34,74
24,1,4,55,24,79
17,1,4,39,17,56
28,2,5,81,56,137
8,2,5,23,16,39
10,1,2,10,10,20
22,1,2,22,22,44
19,2,5,55,38,93
14,2,5,41,28,69
21,2,5,59,42,101
25,11,30,460,275,735
20,8,21,205,160,365
26,8,21,267,208,475
27,9,25,419,243,662
1,755,1215,411,755,1166
1,1482,2384,878,1482,2360
1,755,1215,448,755,1203
1,755,1215,193,755,948
1,1482,2384,807,1482,2289
1,1482,2384,378,1482,1860
1,1482,2384,807,1482,2289
25,24,64,792,600,1392
2,24,64,75,48,123
28,45,120,1697,1260,2957
8,59,159,749,472,1221
15,2,5,44,30,74
24,2,5,46,48,94
7,2,5,13,14,27
16,2,5,45,32,77
29,7,9,53,203,256
30,7,9,25,210,235
1,7,9,2,7,9
7,7,9,11,49,60
9,7,9,16,63,79
14,8,22,147,112,259
6,8,22,68,48,116
20,8,22,276,160,436
10,8,22,92,80,172
12,8,22,163,96,259
14,8,22,193,112,305
8,9,24,95,72,167
10,9,24,145,90,235
28,9,24,333,252,585
15,9,24,167,135,302
20,13,35,433,260,693
27,13,35,396,351,747
6,13,35,94,78,172
7,13,35,122,91,213
21,13,35,455,273,728
22,13,35,469,286,755
11,13,35,188,143,331
30,13,35,618,390,1008
15,13,35,236,195,431
9,13,35,192,117,309
8,13,35,170,104,274
1,13,35,20,13,33
14,21,55,337,294,631
17,42,54,167,714,881
28,38,50,308,1064,1372
19,38,50,219,722,941
24,38,50,264,912,1176
10,38,50,55,380,435
24,42,54,107,1008,1115
1,1252,2295,997,1252,2249
1,1252,2295,951,1252,2203
1,1266,2320,544,1266,1810
1,308,565,189,308,497
1,713,1120,205,713,918
1,1555,2443,570,1555,2125
1,2171,3578,656,2171,2827
1,1083,1701,550,1083,1633
1,344,540,126,344,470
1,713,1120,205,713,918
1,1555,2443,864,1555,2419
1,344,540,174,344,518
1,2171,3578,1335,2171,3506
1,26,70,35,26,61
23,26,70,980,598,1578
29,26,70,1053,754,1807
4,3,9,24,12,36
30,2,5,89,60,149
14,1,2,9,14,23
6,1,2,4,6,10
29,2,5,70,58,128
10,2,5,24,20,44
21,12,33,337,252,589
19,2,5,56,38,94
2,2,5,6,4,10
4,1,4,11,4,15
17,1,4,48,17,65
17,9,25,183,153,336
18,9,25,194,162,356
28,9,25,301,252,553
20,11,30,374,220,594
7,11,30,131,77,208
5,2,5,14,10,24
11,2,5,31,22,53
10,2,5,29,20,49
7,1,4,17,7,24
25,13,35,436,325,761
10,13,35,175,130,305
13,13,35,227,169,396
19,9,25,285,171,456
25,9,25,375,225,600
24,13,35,494,312,806
29,2,5,86,58,144
23,2,5,68,46,114
4,1,2,3,4,7
29,1,2,19,29,48
17,2,5,50,34,84
27,2,5,80,54,134
19,1,2,17,19,36
9,1,2,8,9,17
7,2,5,20,14,34
5,2,5,15,10,25
27,2,5,78,54,132
16,1,2,16,16,32
4,2,5,12,8,20
29,12,33,475,348,823
22,12,33,360,264,624
14,1,2,10,14,24
14,1,2,10,14,24
22,8,21,254,176,430
18,8,21,208,144,352
26,1,2,25,26,51
2,1,2,2,2,4
6,1,2,6,6,12
28,2,5,64,56,120
7,2,5,20,14,34
28,2,5,81,56,137
10,2,5,29,20,49
4,2,5,12,8,20
18,2,5,52,36,88
20,1,2,18,20,38
24,1,2,22,24,46
30,2,5,71,60,131
30,2,5,71,60,131
28,8,21,352,224,576
19,8,21,239,152,391
6,8,21,75,48,123
16,1,4,39,16,55
17,1,4,41,17,58
1,1482,2384,473,1482,1955
1,755,1215,290,755,1045
1,1482,2384,854,1482,2336
1,1482,2384,521,1482,2003
13,24,64,412,312,724
2,45,120,148,90,238
6,45,120,349,270,619
10,59,159,793,590,1383
25,2,5,60,50,110
27,2,5,80,54,134
12,2,5,35,24,59
29,2,5,55,58,113
11,2,5,21,22,43
19,2,5,36,38,74
11,3,9,62,33,95
24,3,9,135,72,207
17,4,10,71,68,139
17,4,10,71,68,139
26,3,9,151,78,229
8,3,9,47,24,71
20,4,10,112,80,192
15,4,10,84,60,144
25,2,5,73,50,123
12,2,5,35,24,59
21,2,5,62,42,104
29,2,5,57,58,115
10,2,5,20,20,40
6,2,5,14,12,26
30,2,5,71,60,131
4,2,5,8,8,16
19,2,5,37,38,75
7,7,9,0,49,49
17,7,9,6,119,125
8,7,9,3,56,59
2,7,9,3,14,17
25,7,9,46,175,221
21,7,9,17,147,164
29,7,9,53,203,256
3,7,9,5,21,26
20,3,8,98,60,158
16,3,8,65,48,113
19,8,22,258,152,410
27,8,22,372,216,588
29,8,22,253,232,485
17,8,22,231,136,367
18,8,22,244,144,388
10,8,22,136,80,216
28,8,22,386,224,610
21,9,24,295,189,484
3,9,24,42,27,69
22,9,24,319,198,517
23,9,24,334,207,541
13,13,35,186,169,355
22,13,35,392,286,678
14,13,35,220,182,402
11,13,35,157,143,300
16,13,35,279,208,487
10,13,35,143,130,273
5,13,35,103,65,168
15,13,35,309,195,504
6,13,35,128,78,206
8,13,35,170,104,274
30,13,35,524,390,914
18,13,35,314,234,548
7,13,35,149,91,240
7,13,35,122,91,213
17,13,35,362,221,583
8,13,35,170,104,274
29,13,35,455,377,832
28,21,55,736,588,1324
11,21,55,362,231,593
23,42,54,3,966,969
19,38,50,0,722,722
16,42,54,36,672,708
23,38,50,69,874,943
20,42,54,46,840,886
24,42,54,55,1008,1063
17,38,50,26,646,672
9,42,54,98,378,476
14,38,50,140,532,672
1,420,769,257,420,677
1,1252,2295,538,1252,1790
1,1266,2320,729,1266,1995
1,1266,2320,1008,1266,2274
1,1252,2295,997,1252,2249
1,420,769,341,420,761
1,2171,3578,1264,2171,3435
1,1555,2443,570,1555,2125
1,344,540,185,344,529
1,344,540,185,344,529
1,2171,3578,942,2171,3113
1,487,783,155,487,642
1,2171,3578,656,2171,2827
1,713,1120,205,713,918
1,713,1120,205,713,918
1,487,783,265,487,752
1,344,540,126,344,470
1,713,1120,205,713,918
1,713,1120,172,713,885
1,344,540,174,344,518
1,344,540,174,344,518
2,26,70,85,52,137
3,26,70,86,78,164
13,3,9,62,39,101
28,13,35,606,364,970
4,13,35,87,52,139
11,13,35,238,143,381
25,11,30,468,275,743
13,2,5,36,26,62
12,2,5,34,24,58
9,1,2,7,9,16
7,13,35,125,91,216
20,13,35,356,260,616
28,2,5,83,56,139
19,1,2,11,19,30
3,1,2,2,3,5
17,2,5,50,34,84
2,2,5,6,4,10
3,2,5,9,6,15
30,9,25,345,270,615
4,1,2,4,4,8
8,1,2,7,8,15
2,1,2,2,2,4
21,1,4,51,21,72
17,1,4,41,17,58
21,1,2,20,21,41
7,12,33,142,84,226
11,12,33,224,132,356
25,8,21,304,200,504
8,1,2,6,8,14
30,1,2,22,30,52
27,1,2,19,27,46
15,2,5,42,30,72
2,2,5,6,4,10
16,2,5,46,32,78
1,1482,2384,473,1482,1955
1,461,742,118,461,579
1,461,742,251,461,712
1,755,1215,205,755,960
1,1482,2384,449,1482,1931
7,24,64,186,168,354
13,24,64,512,312,824
12,45,120,871,540,1411
7,59,159,466,413,879
17,2,5,39,34,73
24,4,10,91,96,187
25,2,5,48,50,98
16,2,5,30,32,62
26,2,5,75,52,127
27,2,5,78,54,132
27,2,5,78,54,132
9,2,5,26,18,44
12,4,10,71,48,119
23,2,5,54,46,100
24,2,5,71,48,119
16,2,5,47,32,79
21,4,10,122,84,206
19,4,10,110,76,186
14,2,5,27,28,55
29,3,9,171,87,258
1,3,9,6,3,9
2,3,9,8,6,14
30,3,9,123,90,213
20,2,5,58,40,98
25,2,5,73,50,123
29,7,9,55,203,258
8,7,9,7,56,63
14,7,9,27,98,125
15,7,9,12,105,117
5,7,9,8,35,43
3,7,9,5,21,26
18,7,9,2,126,128
19,3,8,71,57,128
10,3,8,48,30,78
26,8,22,358,208,566
23,8,22,312,184,496
6,8,22,81,48,129
5,8,22,69,40,109
14,9,24,207,126,333
5,9,24,73,45,118
11,9,24,162,99,261
8,13,35,173,104,277
26,13,35,372,338,710
25,13,35,533,325,858
15,13,35,309,195,504
10,13,35,217,130,347
27,13,35,556,351,907
25,13,35,358,325,683
19,13,35,325,247,572
28,13,35,606,364,970
4,13,35,85,52,137
16,13,35,279,208,487
19,13,35,411,247,658
14,13,35,303,182,485
4,13,35,87,52,139
23,13,35,329,299,628
16,13,35,346,208,554
24,13,35,494,312,806
2,13,35,29,26,55
2,13,35,29,26,55
11,13,35,227,143,370
16,21,55,535,336,871
7,38,50,81,266,347
9,42,54,45,378,423
10,38,50,115,380,495
20,38,50,20,760,780
2,38,50,20,76,96
4,38,50,44,152,196
22,38,50,242,836,1078
8,38,50,40,304,344
15,42,54,75,630,705
30,38,50,30,1140,1170
27,42,54,134,1134,1268
15,38,50,173,570,743
1,1252,2295,1020,1252,2272
1,1266,2320,1031,1266,2297
1,1252,2295,951,1252,2203
1,1252,2295,997,1252,2249
1,420,769,341,420,761
1,1266,2320,544,1266,1810
1,1519,2443,387,1519,1906
1,2171,3578,1264,2171,3435
1,487,783,280,487,767
1,713,1120,362,713,1075
1,1083,1701,397,1083,1480
1,344,540,174,344,518
1,713,1120,172,713,885
1,2171,3578,1335,2171,3506
1,2171,3578,1335,2171,3506
24,26,70,1039,624,1663
21,26,70,895,546,1441
12,26,70,343,312,655
7,3,9,28,21,49
4,1,2,4,4,8
14,13,35,298,182,480
6,13,35,128,78,206
15,2,5,32,30,62
20,12,33,334,240,574
18,2,5,53,36,89
5,2,5,15,10,25
20,1,2,12,20,32
19,1,2,11,19,30
8,1,2,5,8,13
23,2,5,44,46,90
25,2,5,48,50,98
17,2,5,32,34,66
16,9,25,228,144,372
30,13,35,618,390,1008
4,13,35,82,52,134
17,1,2,12,17,29
16,1,2,11,16,27
1,1,2,1,1,2
12,13,35,260,156,416
13,9,25,166,117,283
20,2,5,56,40,96
1,2,5,3,2,5
12,1,4,34,12,46
21,1,4,60,21,81
30,11,30,561,330,891
19,1,4,52,19,71
16,1,4,44,16,60
25,2,5,74,50,124
13,1,4,32,13,45
9,1,2,5,9,14
20,1,2,11,20,31
30,1,2,28,30,58
21,1,2,20,21,41
17,1,2,16,17,33
15,1,2,8,15,23
13,1,2,7,13,20
20,2,5,39,40,79
24,2,5,47,48,95
19,2,5,36,38,74
27,2,5,51,54,105
8,2,5,23,16,39
5,1,2,5,5,10
17,1,2,17,17,34
4,1,2,3,4,7
13,1,2,9,13,22
22,1,4,62,22,84
19,1,4,54,19,73
4,1,4,11,4,15
20,1,4,57,20,77
16,1,4,47,16,63
6,1,2,3,6,9
22,2,5,64,44,108
23,1,4,52,23,75
1,1482,2384,807,1482,2289
1,1482,2384,401,1482,1883
1,461,742,274,461,735
10,24,64,374,240,614
3,45,120,175,135,310
2,2,5,6,4,10
21,2,5,61,42,103
30,2,5,87,60,147
24,2,5,56,48,104
10,7,9,14,70,84
19,7,9,28,133,161
7,7,9,13,49,62
2,7,9,4,14,18
13,3,8,61,39,100
13,8,22,176,104,280
2,8,22,18,16,34
13,8,22,179,104,283
15,8,22,207,120,327
9,9,24,107,81,188
2,9,24,24,18,42
8,13,35,131,104,235
11,13,35,234,143,377
12,13,35,256,156,412
9,13,35,185,117,302
20,13,35,426,260,686
15,13,35,215,195,410
1,13,35,17,13,30
14,13,35,303,182,485
9,13,35,179,117,296
1,13,35,17,13,30
16,13,35,346,208,554
9,13,35,192,117,309
9,13,35,129,117,246
4,13,35,63,52,115
19,13,35,391,247,638
3,13,35,49,39,88
8,42,54,87,336,423
3,38,50,33,114,147
27,38,50,149,1026,1175
20,38,50,200,760,960
1,1266,2320,752,1266,2018
1,1266,2320,961,1266,2227
1,420,769,334,420,754
1,420,769,249,420,669
1,344,540,77,344,421
1,1083,1701,499,1083,1582
1,2171,3578,942,2171,3113
1,1083,1701,584,1083,1667
1,713,1120,362,713,1075
1,2171,3578,656,2171,2827
1,344,540,174,344,518
1,344,540,83,344,427
4,26,70,170,104,274
22,26,70,645,572,1217
12,3,9,70,36,106
19,3,9,76,57,133
2,2,5,6,4,10
12,13,35,256,156,412
4,13,35,85,52,137
28,1,2,27,28,55
15,1,2,15,15,30
22,1,2,22,22,44
14,2,5,39,28,67
23,2,5,64,46,110
16,1,4,47,16,63
24,1,4,71,24,95
6,11,29,77,66,143
23,11,29,294,253,547
15,2,5,44,30,74
8,1,2,6,8,14
28,2,5,78,56,134
5,2,5,14,10,24
6,1,2,4,6,10
29,1,2,20,29,49
17,13,35,368,221,589
28,2,5,76,56,132
24,2,5,65,48,113
24,1,2,18,24,42
25,1,2,19,25,44
15,8,21,173,120,293
5,8,21,58,40,98
1,2,5,2,2,4
8,2,5,19,16,35
12,2,5,28,24,52
22,2,5,52,44,96
9,2,5,25,18,43
2,2,5,6,4,10
21,2,5,59,42,101
23,12,33,324,276,600
17,12,33,239,204,443
19,12,33,267,228,495
16,2,5,46,32,78
7,2,5,20,14,34
1,2,5,2,2,4
5,2,5,12,10,22
28,2,5,64,56,120
30,2,5,69,60,129
7,1,2,7,7,14
9,1,2,9,9,18
24,1,2,23,24,47
1,1482,2384,521,1482,2003
1,1482,2384,521,1482,2003
1,1482,2384,378,1482,1860
1,755,1215,241,755,996
30,24,64,1181,720,1901
1,2,5,3,2,5
27,2,5,80,54,134
19,2,5,55,38,93
10,2,5,29,20,49
28,2,5,59,56,115
28,2,5,59,56,115
15,4,10,87,60,147
7,2,5,20,14,34
25,2,5,73,50,123
24,2,5,59,48,107
12,2,5,29,24,53
16,2,5,30,32,62
26,3,9,154,78,232
27,3,9,160,81,241
6,7,9,11,42,53
20,7,9,36,140,176
22,7,9,42,154,196
10,7,9,16,70,86
1,3,8,4,3,7
18,8,22,244,144,388
18,8,22,244,144,388
21,8,22,234,168,402
16,8,22,220,128,348
1,9,24,15,9,24
16,9,24,156,144,300
2,9,24,25,18,43
9,13,35,129,117,246
6,13,35,128,78,206
17,13,35,332,221,553
28,13,35,596,364,960
11,13,35,234,143,377
9,13,35,154,117,271
1,13,35,16,13,29
1,13,35,14,13,27
24,13,35,511,312,823
11,13,35,188,143,331
6,13,35,130,78,208
24,13,35,469,312,781
13,13,35,186,169,355
4,13,35,70,52,122
13,21,55,435,273,708
2,21,55,66,42,108
22,42,54,240,924,1164
21,38,50,242,798,1040
15,42,54,67,630,697
2,42,54,9,84,93
9,38,50,27,342,369
18,38,50,207,684,891
5,38,50,55,190,245
5,38,50,5,190,195
22,38,50,121,836,957
6,42,54,14,252,266
1,1266,2320,1008,1266,2274
1,1266,2320,1008,1266,2274
1,487,783,280,487,767
1,487,783,280,487,767
1,487,783,155,487,642
1,487,783,210,487,697
1,713,1120,250,713,963
1,713,1120,284,713,997
1,344,540,174,344,518
1,344,540,77,344,421
1,1083,1701,312,1083,1395
1,344,540,99,344,443
1,344,540,126,344,470
15,26,70,513,390,903
25,26,70,1030,650,1680
25,3,9,101,75,176
24,3,9,116,72,188
15,3,9,66,45,111
6,3,9,27,18,45
5,1,2,3,5,8
18,1,2,10,18,28
3,2,5,6,6,12
23,2,5,44,46,90
11,1,2,11,11,22
5,1,2,5,5,10
22,13,35,469,286,755
29,2,5,61,58,119
18,2,5,38,36,74
24,2,5,50,48,98
18,1,2,17,18,35
2,13,35,35,26,61
25,1,2,18,25,43
20,2,5,38,40,78
12,2,5,35,24,59
12,2,5,35,24,59
10,1,2,9,10,19
2,1,2,2,2,4
17,1,2,10,17,27
20,1,2,11,20,31
4,9,25,53,36,89
16,9,25,212,144,356
9,9,25,119,81,200
9,1,2,6,9,15
21,13,35,344,273,617
15,13,35,246,195,441
8,2,5,24,16,40
23,8,21,193,184,377
26,8,21,218,208,426
10,11,30,169,110,279
27,11,30,456,297,753
10,11,30,184,110,294
19,11,30,350,209,559
2,1,2,1,2,3
15,1,2,11,15,26
24,1,2,17,24,41
14,1,2,12,14,26
27,1,2,23,27,50
25,2,5,48,50,98
25,1,2,17,25,42
11,1,2,7,11,18
12,1,4,33,12,45
4,2,5,9,8,17
25,2,5,59,50,109
16,2,5,38,32,70
25,2,5,59,50,109
13,2,5,31,26,57
1,755,1215,448,755,1203
3,2,5,6,6,12
12,2,5,23,24,47
12,2,5,23,24,47
12,2,5,26,24,50
15,2,5,33,30,63
12,4,10,64,48,112
21,2,5,59,42,101
3,2,5,9,6,15
22,2,5,64,44,108
27,7,9,15,189,204
7,7,9,11,49,60
28,7,9,46,196,242
11,7,9,21,77,98
10,7,9,1,70,71
25,3,8,121,75,196
23,3,8,111,69,180
30,3,8,133,90,223
30,3,8,97,90,187
26,8,22,284,208,492
9,8,22,124,72,196
24,13,35,343,312,655
27,13,35,462,351,813
5,13,35,98,65,163
21,13,35,447,273,720
19,13,35,405,247,652
6,13,35,103,78,181
20,21,55,438,420,858
3,42,54,10,126,136
12,38,50,132,456,588
27,38,50,149,1026,1175
6,42,54,14,252,266
30,38,50,30,1140,1170
22,38,50,220,836,1056
5,42,54,55,210,265
1,1266,2320,1008,1266,2274
1,1252,2295,722,1252,1974
1,1266,2320,752,1266,2018
1,2171,3578,835,2171,3006
1,344,540,185,344,529
1,344,540,185,344,529
1,2171,3578,1335,2171,3506
1,2171,3578,1335,2171,3506
1,2171,3578,1335,2171,3506
19,26,70,597,494,1091
8,26,70,341,208,549
24,26,70,1022,624,1646
2,26,70,59,52,111
14,1,2,13,14,27
12,1,2,12,12,24
10,2,5,19,20,39
24,2,5,46,48,94
12,13,35,256,156,412
10,2,5,27,20,47
7,2,5,19,14,33
25,1,2,22,25,47
19,12,33,299,228,527
11,12,33,173,132,305
27,1,2,17,27,44
8,1,4,23,8,31
23,1,4,65,23,88
21,2,5,49,42,91
16,1,4,47,16,63
21,1,4,57,21,78
1,461,742,177,461,638
4,45,120,281,180,461
7,59,159,555,413,968
24,4,10,113,96,209
4,2,5,12,8,20
14,2,5,41,28,69
28,4,10,157,112,269
15,4,10,84,60,144
6,2,5,17,12,29
15,2,5,44,30,74
13,2,5,31,26,57
11,3,9,64,33,97
20,3,9,116,60,176
11,2,5,32,22,54
12,2,5,28,24,52
10,2,5,22,20,42
29,2,5,64,58,122
5,7,9,3,35,38
24,7,9,20,168,188
10,7,9,8,70,78
26,7,9,10,182,192
3,7,9,2,21,23
28,8,22,256,224,480
6,8,22,81,48,129
14,8,22,156,112,268
12,8,22,163,96,259
11,9,24,107,99,206
3,9,24,44,27,71
16,13,35,346,208,554
17,13,35,368,221,589
2,13,35,43,26,69
26,13,35,426,338,764
5,13,35,87,65,152
26,13,35,563,338,901
28,13,35,400,364,764
15,13,35,293,195,488
30,13,35,639,390,1029
27,13,35,386,351,737
20,13,35,426,260,686
2,13,35,43,26,69
24,21,55,790,504,1294
14,38,50,77,532,609
14,42,54,9,588,597
17,42,54,85,714,799
22,38,50,66,836,902
15,38,50,83,570,653
15,42,54,50,630,680
1,1252,2295,1020,1252,2272
1,1252,2295,1020,1252,2272
1,1266,2320,961,1266,2227
1,1252,2295,538,1252,1790
1,420,769,249,420,669
1,1266,2320,961,1266,2227
1,308,565,246,308,554
1,1555,2443,717,1555,2272
1,2171,3578,942,2171,3113
1,1555,2443,497,1555,2052
1,344,540,83,344,427
10,26,70,349,260,609
9,2,5,17,18,35
28,2,5,53,56,109
28,13,35,596,364,960
3,13,35,64,39,103
11,2,5,26,22,48
14,2,5,33,28,61
4,2,5,8,8,16
13,2,5,38,26,64
14,2,5,41,28,69
18,2,5,50,36,86
18,11,29,303,198,501
29,11,29,488,319,807
9,12,33,141,108,249
11,12,33,173,132,305
28,2,5,83,56,139
10,11,30,169,110,279
28,11,30,381,308,689
30,11,30,408,330,738
23,1,2,21,23,44
16,1,2,15,16,31
4,1,2,4,4,8
20,1,2,12,20,32
21,2,5,40,42,82
17,2,5,49,34,83
9,1,4,26,9,35
26,2,5,73,52,125
2,2,5,6,4,10
20,2,5,58,40,98
1,461,742,274,461,735
20,24,64,774,480,1254
23,24,64,891,552,1443
2,59,159,194,118,312
3,59,159,195,177,372
28,2,5,55,56,111
23,2,5,45,46,91
7,4,10,41,28,69
5,4,10,30,20,50
21,4,10,124,84,208
18,4,10,106,72,178
16,2,5,47,32,79
11,4,10,64,44,108
14,4,10,81,56,137
8,4,10,47,32,79
27,4,10,159,108,267
23,4,10,136,92,228
26,4,10,153,104,257
6,2,5,17,12,29
17,2,5,49,34,83
12,2,5,35,24,59
30,2,5,87,60,147
28,2,5,64,56,120
12,2,5,28,24,52
11,2,5,26,22,48
12,2,5,28,24,52
28,2,5,66,56,122
29,2,5,68,58,126
24,2,5,70,48,118
2,2,5,6,4,10
25,7,9,3,175,178
30,7,9,49,210,259
15,7,9,29,105,134
13,7,9,4,91,95
10,7,9,18,70,88
21,7,9,38,147,185
9,3,8,36,27,63
1,8,22,14,8,22
25,8,22,229,200,429
11,8,22,152,88,240
18,8,22,248,144,392
13,8,22,128,104,232
25,8,22,279,200,479
10,9,24,148,90,238
17,9,24,251,153,404
29,9,24,428,261,689
1,9,24,15,9,24
13,9,24,189,117,306
12,9,24,174,108,282
2,9,24,23,18,41
28,13,35,596,364,960
21,13,35,447,273,720
30,13,35,524,390,914
19,13,35,411,247,658
27,13,35,414,351,765
18,13,35,264,234,498
22,13,35,476,286,762
18,13,35,383,234,617
24,13,35,520,312,832
6,13,35,130,78,208
29,13,35,628,377,1005
5,13,35,103,65,168
27,13,35,462,351,813
11,13,35,234,143,377
13,13,35,281,169,450
26,13,35,454,338,792
24,13,35,520,312,832
11,13,35,227,143,370
22,13,35,469,286,755
11,13,35,227,143,370
6,13,35,94,78,172
9,13,35,195,117,312
22,13,35,361,286,647
17,21,55,559,357,916
20,21,55,658,420,1078
16,42,54,183,672,855
14,38,50,161,532,693
5,38,50,13,190,203
17,42,54,11,714,725
16,38,50,24,608,632
1,1252,2295,997,1252,2249
1,1266,2320,1008,1266,2274
1,1898,3375,768,1898,2666
1,420,769,341,420,761
1,1252,2295,1020,1252,2272
1,1252,2295,722,1252,1974
1,1266,2320,1008,1266,2274
1,1266,2320,961,1266,2227
1,308,565,178,308,486
1,1898,3375,1410,1898,3308
1,1266,2320,1008,1266,2274
1,2171,3578,1264,2171,3435
1,2171,3578,656,2171,2827
1,713,1120,385,713,1098
1,2171,3578,763,2171,2934
1,1519,2443,606,1519,2125
1,713,1120,396,713,1109
1,2171,3578,1335,2171,3506
1,2171,3578,1335,2171,3506
1,2171,3578,1335,2171,3506
8,26,70,346,208,554
23,26,70,787,598,1385
19,26,70,809,494,1303
19,8,21,163,152,315
5,8,21,43,40,83
20,8,21,172,160,332
4,2,5,12,8,20
6,2,5,17,12,29
18,11,29,319,198,517
23,13,35,401,299,700
10,2,5,30,20,50
22,2,5,65,44,109
7,13,35,149,91,240
15,13,35,320,195,515
15,2,5,29,30,59
10,2,5,24,20,44
10,2,5,27,20,47
7,9,25,110,63,173
15,9,25,236,135,371
18,2,5,42,36,78
19,2,5,45,38,83
15,2,5,35,30,65
21,1,2,21,21,42
9,1,2,9,9,18
22,1,2,22,22,44
16,1,2,16,16,32
18,1,2,18,18,36
9,2,5,27,18,45
9,8,21,113,72,185
11,8,21,138,88,226
13,8,21,109,104,213
14,8,21,117,112,229
1,2,5,3,2,5
2,2,5,6,4,10
25,2,5,74,50,124
30,2,5,89,60,149
4,1,2,3,4,7
16,12,33,325,192,517
17,12,33,346,204,550
5,12,33,102,60,162
19,12,33,386,228,614
24,1,2,18,24,42
5,1,2,5,5,10
28,1,2,27,28,55
29,8,21,353,232,585
12,8,21,146,96,242
7,8,21,85,56,141
30,1,4,85,30,115
5,1,4,14,5,19
8,1,2,8,8,16
19,9,25,242,171,413
2,9,25,26,18,44
20,1,2,17,20,37
18,1,2,15,18,33
15,1,2,13,15,28
16,1,2,14,16,30
16,1,2,14,16,30
3,1,2,3,3,6
9,1,2,5,9,14
11,1,4,27,11,38
23,1,4,56,23,79
1,1482,2384,878,1482,2360
1,461,742,147,461,608
1,461,742,229,461,690
1,755,1215,266,755,1021
28,24,64,744,672,1416
27,24,64,855,648,1503
21,24,64,585,504,1089
20,24,64,634,480,1114
3,45,120,221,135,356
2,45,120,92,90,182
3,45,120,221,135,356
19,2,5,56,38,94
18,4,10,106,72,178
14,4,10,83,56,139
5,4,10,30,20,50
3,4,10,14,12,26
8,4,10,38,32,70
11,2,5,31,22,53
17,2,5,48,34,82
23,2,5,44,46,90
22,2,5,64,44,108
18,2,5,52,36,88
28,3,9,135,84,219
5,2,5,15,10,25
22,2,5,65,44,109
28,2,5,59,56,115
16,2,5,47,32,79
29,2,5,86,58,144
10,2,5,28,20,48
4,2,5,11,8,19
20,3,9,113,60,173
7,7,9,13,49,62
23,7,9,44,161,205
13,7,9,5,91,96
18,7,9,7,126,133
29,7,9,11,203,214
13,7,9,24,91,115
29,3,8,115,87,202
4,3,8,20,12,32
30,3,8,119,90,209
26,3,8,126,78,204
28,8,22,312,224,536
18,8,22,248,144,392
15,8,22,207,120,327
12,8,22,165,96,261
18,8,22,224,144,368
16,9,24,236,144,380
6,9,24,89,54,143
2,9,24,30,18,48
8,9,24,116,72,188
12,13,35,197,156,353
30,13,35,639,390,1029
10,13,35,206,130,336
30,13,35,650,390,1040
9,13,35,157,117,274
16,13,35,251,208,459
23,13,35,490,299,789
11,13,35,238,143,381
21,13,35,455,273,728
1,13,35,21,13,34
23,13,35,498,299,797
14,13,35,288,182,470
24,21,55,803,504,1307
7,21,55,211,147,358
22,42,54,240,924,1164
12,38,50,138,456,594
21,38,50,116,798,914
5,38,50,55,190,245
2,38,50,22,76,98
23,38,50,265,874,1139
16,38,50,48,608,656
1,1266,2320,1008,1266,2274
1,1912,3400,774,1912,2686
1,1252,2295,630,1252,1882
1,1266,2320,1008,1266,2274
1,308,565,246,308,554
1,1898,3375,1410,1898,3308
1,2171,3578,942,2171,3113
1,1519,2443,826,1519,2345
1,2171,3578,942,2171,3113
1,344,540,174,344,518
1,1555,2443,864,1555,2419
1,713,1120,396,713,1109
1,344,540,191,344,535
1,344,540,174,344,518
10,26,70,433,260,693
28,26,70,1212,728,1940
16,13,35,274,208,482
19,9,25,299,171,470
2,9,25,32,18,50
12,9,25,189,108,297
3,2,5,9,6,15
7,2,5,20,14,34
6,2,5,17,12,29
29,1,2,16,29,45
18,1,2,10,18,28
23,1,2,13,23,36
16,9,25,204,144,348
24,9,25,306,216,522
9,9,25,115,81,196
9,13,35,195,117,312
16,13,35,346,208,554
11,9,25,138,99,237
3,1,2,3,3,6
5,1,2,5,5,10
23,2,5,54,46,100
2,9,25,23,18,41
11,2,5,26,22,48
18,2,5,41,36,77
9,2,5,21,18,39
27,2,5,62,54,116
27,1,4,67,27,94
4,1,4,10,4,14
13,12,33,269,156,425
30,1,2,19,30,49
5,1,4,12,5,17
4,1,4,10,4,14
14,1,2,13,14,27
26,11,30,354,286,640
8,1,2,7,8,15
21,2,5,61,42,103
20,2,5,58,40,98
29,2,5,55,58,113
30,2,5,71,60,131
30,2,5,71,60,131
16,2,5,38,32,70
28,1,2,27,28,55
2,2,5,6,4,10
10,2,5,30,20,50
30,1,2,16,30,46
9,1,2,5,9,14
10,2,5,21,20,41
12,1,2,8,12,20
6,1,2,4,6,10
11,2,5,26,22,48
4,2,5,9,8,17
26,1,2,24,26,50
23,1,2,21,23,44
20,8,21,168,160,328
19,8,21,159,152,311
25,2,5,73,50,123
2,2,5,6,4,10
19,1,4,54,19,73
22,1,4,62,22,84
26,1,2,19,26,45
30,1,2,22,30,52
25,8,21,315,200,515
10,8,21,126,80,206
2,2,5,6,4,10
23,1,2,12,23,35
29,2,5,84,58,142
10,2,5,29,20,49
3,2,5,8,6,14
16,2,5,38,32,70
23,9,25,357,207,564
1,1482,2384,473,1482,1955
1,755,1215,436,755,1191
1,461,742,266,461,727
1,461,742,266,461,727
25,24,64,968,600,1568
8,45,120,590,360,950
27,4,10,127,108,235
8,4,10,38,32,70
2,2,5,6,4,10
24,2,5,71,48,119
1,2,5,2,2,4
20,2,5,39,40,79
5,2,5,15,10,25
24,2,5,71,48,119
27,2,5,80,54,134
30,7,9,25,210,235
5,7,9,8,35,43
10,3,8,41,30,71
17,3,8,61,51,112
13,3,8,63,39,102
27,8,22,366,216,582
12,8,22,110,96,206
29,8,22,291,232,523
16,8,22,178,128,306
14,8,22,193,112,305
7,8,22,96,56,152
15,8,22,197,120,317
9,9,24,107,81,188
14,9,24,207,126,333
22,9,24,261,198,459
26,9,24,253,234,487
2,9,24,29,18,47
10,13,35,196,130,326
5,13,35,72,65,137
25,13,35,366,325,691
8,13,35,114,104,218
1,13,35,14,13,27
27,13,35,528,351,879
21,13,35,455,273,728
9,13,35,185,117,302
19,13,35,325,247,572
24,13,35,520,312,832
1,13,35,14,13,27
28,13,35,489,364,853
25,13,35,454,325,779
24,13,35,511,312,823
5,21,55,165,105,270
26,21,55,584,546,1130
29,42,54,332,1218,1550
1,38,50,11,38,49
15,38,50,165,570,735
11,42,54,55,462,517
10,38,50,15,380,395
9,42,54,103,378,481
2,38,50,23,76,99
1,1266,2320,799,1266,2065
1,1252,2295,538,1252,1790
1,1252,2295,745,1252,1997
1,1266,2320,729,1266,1995
1,1266,2320,1008,1266,2274
1,1252,2295,951,1252,2203
1,2171,3578,620,2171,2791
1,2171,3578,1264,2171,3435
1,713,1120,250,713,963
1,487,783,265,487,752
1,344,540,77,344,421
1,713,1120,261,713,974
1,344,540,83,344,427
1,713,1120,284,713,997
1,2171,3578,1335,2171,3506
1,2171,3578,1335,2171,3506
2,26,70,87,52,139
26,26,70,1126,676,1802
12,26,70,343,312,655
25,3,9,148,75,223
5,3,9,20,15,35
20,2,5,53,40,93
27,2,5,72,54,126
18,1,4,46,18,64
6,1,4,15,6,21
30,1,4,77,30,107
25,1,2,25,25,50
28,1,2,27,28,55
27,1,4,67,27,94
21,1,4,52,21,73
7,2,5,21,14,35
2,2,5,6,4,10
22,1,2,13,22,35
14,1,2,13,14,27
17,1,2,16,17,33
21,2,5,61,42,103
19,12,33,374,228,602
13,12,33,256,156,412
24,2,5,56,48,104
7,13,35,137,91,228
5,13,35,98,65,163
16,13,35,313,208,521
5,2,5,14,10,24
14,2,5,39,28,67
5,1,2,5,5,10
8,1,2,8,8,16
16,1,2,12,16,28
13,1,2,10,13,23
8,1,2,6,8,14
12,2,5,35,24,59
11,1,2,6,11,17
27,1,2,15,27,42
14,1,2,9,14,23
26,12,33,357,312,669
4,12,33,55,48,103
13,2,5,38,26,64
10,1,2,7,10,17
17,1,2,12,17,29
15,1,2,11,15,26
23,1,2,17,23,40
15,1,2,11,15,26
19,2,5,55,38,93
8,2,5,23,16,39
22,11,29,370,242,612
4,1,4,12,4,16
30,1,4,88,30,118
2,1,4,4,2,6
1,755,1215,302,755,1057
1,461,742,229,461,690
1,1482,2384,807,1482,2289
1,755,1215,448,755,1203
1,755,1215,290,755,1045
1,1482,2384,330,1482,1812
2,45,120,148,90,238
19,2,5,37,38,75
4,3,9,24,12,36
30,2,5,57,60,117
26,2,5,55,52,107
28,2,5,59,56,115
5,3,9,29,15,44
2,2,5,6,4,10
5,2,5,15,10,25
10,2,5,29,20,49
26,2,5,73,52,125
24,2,5,70,48,118
13,2,5,38,26,64
8,2,5,17,16,33
6,2,5,13,12,25
1,2,5,3,2,5
21,2,5,61,42,103
2,2,5,6,4,10
8,2,5,16,16,32
23,4,10,108,92,200
30,2,5,89,60,149
1,2,5,3,2,5
17,2,5,49,34,83
2,3,9,11,6,17
14,7,9,0,98,98
4,7,9,8,28,36
12,7,9,20,84,104
23,7,9,9,161,170
4,7,9,2,28,30
29,7,9,53,203,256
24,7,9,44,168,212
18,7,9,30,126,156
15,7,9,2,105,107
30,8,22,407,240,647
4,8,22,40,32,72
3,8,22,33,24,57
2,9,24,20,18,38
26,9,24,378,234,612
16,9,24,232,144,376
21,9,24,305,189,494
29,13,35,445,377,822
9,13,35,129,117,246
5,13,35,72,65,137
1,13,35,15,13,28
11,13,35,238,143,381
18,13,35,352,234,586
27,13,35,424,351,775
3,13,35,59,39,98
27,13,35,471,351,822
7,13,35,122,91,213
10,13,35,213,130,343
14,13,35,288,182,470
3,13,35,62,39,101
3,13,35,62,39,101
8,13,35,173,104,277
18,13,35,371,234,605
5,13,35,86,65,151
21,13,35,447,273,720
30,13,35,429,390,819
29,21,55,970,609,1579
22,21,55,724,462,1186
16,21,55,526,336,862
25,42,54,125,1050,1175
17,38,50,187,646,833
1,1266,2320,544,1266,1810
1,308,565,155,308,463
1,1252,2295,997,1252,2249
1,487,783,124,487,611
1,344,540,120,344,464
1,487,783,265,487,752
3,3,9,12,9,21
11,1,2,10,11,21
21,1,2,21,21,42
20,1,2,20,20,40
16,2,5,46,32,78
4,13,35,87,52,139
1,1,2,1,1,2
18,11,30,337,198,535
2,2,5,5,4,9
1,2,5,3,2,5
19,2,5,55,38,93
25,2,5,73,50,123
13,2,5,25,26,51
10,2,5,19,20,39
30,13,35,587,390,977
30,13,35,587,390,977
30,1,2,17,30,47
15,1,4,37,15,52
5,1,4,12,5,17
28,2,5,53,56,109
21,2,5,40,42,82
13,9,25,205,117,322
1,9,25,16,9,25
6,2,5,11,12,23
11,2,5,21,22,43
26,2,5,49,52,101
5,9,25,75,45,120
2,9,25,31,18,49
20,9,25,310,180,490
22,1,2,14,22,36
9,8,21,75,72,147
17,1,4,39,17,56
12,2,5,34,24,58
12,2,5,34,24,58
3,1,4,9,3,12
16,1,2,15,16,31
6,1,2,6,6,12
26,2,5,75,52,127
20,2,5,47,40,87
26,2,5,61,52,113
1,8,21,8,8,16
2,8,21,16,16,32
27,8,21,277,216,493
23,8,21,236,184,420
1,1482,2384,449,1482,1931
1,755,1215,436,755,1191
1,1482,2384,473,1482,1955
21,24,64,813,504,1317
8,45,120,581,360,941
7,45,120,407,315,722
6,45,120,443,270,713
7,45,120,491,315,806
30,2,5,89,60,149
6,2,5,18,12,30
16,2,5,46,32,78
9,2,5,17,18,35
19,2,5,55,38,93
18,2,5,52,36,88
13,2,5,30,26,56
22,3,9,128,66,194
9,3,9,52,27,79
27,2,5,51,54,105
1,2,5,2,2,4
25,2,5,70,50,120
14,3,9,81,42,123
21,3,9,122,63,185
3,4,10,18,12,30
14,4,10,83,56,139
2,2,5,6,4,10
15,2,5,44,30,74
20,2,5,58,40,98
3,2,5,9,6,15
15,7,9,29,105,134
6,7,9,11,42,53
16,7,9,31,112,143
22,7,9,36,154,190
19,7,9,35,133,168
6,7,9,10,42,52
3,3,8,15,9,24
8,8,22,108,64,172
21,8,22,285,168,453
11,8,22,137,88,225
14,8,22,141,112,253
28,8,22,386,224,610
26,8,22,358,208,566
30,8,22,413,240,653
22,9,24,235,198,433
8,13,35,173,104,277
27,13,35,386,351,737
13,13,35,268,169,437
14,13,35,274,182,456
15,13,35,215,195,410
28,13,35,400,364,764
11,13,35,227,143,370
12,13,35,260,156,416
19,13,35,411,247,658
25,13,35,541,325,866
18,13,35,390,234,624
26,13,35,454,338,792
11,13,35,157,143,300
28,13,35,479,364,843
2,13,35,35,26,61
4,13,35,82,52,134
29,13,35,618,377,995
27,13,35,386,351,737
27,13,35,471,351,822
28,13,35,577,364,941
17,13,35,362,221,583
23,13,35,361,299,660
5,21,55,167,105,272
16,21,55,526,336,862
29,42,54,332,1218,1550
26,38,50,286,988,1274
22,38,50,253,836,1089
19,42,54,218,798,1016
11,42,54,55,462,517
22,38,50,220,836,1056
1,1266,2320,544,1266,1810
1,1898,3375,1241,1898,3139
1,1252,2295,951,1252,2203
1,420,769,180,420,600
1,1266,2320,1008,1266,2274
1,1266,2320,1008,1266,2274
1,308,565,184,308,492
1,1266,2320,636,1266,1902
1,487,783,280,487,767
1,713,1120,385,713,1098
1,713,1120,362,713,1075
1,344,540,99,344,443
1,2171,3578,906,2171,3077
28,26,70,1193,728,1921
6,8,21,50,48,98
12,8,21,101,96,197
7,1,2,4,7,11
8,1,2,4,8,12
27,1,2,26,27,53
16,1,2,15,16,31
12,1,4,33,12,45
18,1,2,10,18,28
8,1,2,4,8,12
25,2,5,74,50,124
27,2,5,80,54,134
30,2,5,89,60,149
2,2,5,6,4,10
10,1,4,25,10,35
28,1,4,69,28,97
20,1,4,50,20,70
13,2,5,25,26,51
17,2,5,32,34,66
2,13,35,43,26,69
18,13,35,390,234,624
20,13,35,286,260,546
5,13,35,72,65,137
30,2,5,71,60,131
30,2,5,71,60,131
14,1,2,13,14,27
29,1,2,27,29,56
24,1,4,55,24,79
11,1,4,25,11,36
22,1,4,65,22,87
7,2,5,20,14,34
1,2,5,3,2,5
22,2,5,46,44,90
8,2,5,17,16,33
2,1,4,5,2,7
3,1,4,7,3,10
10,1,4,24,10,34
15,1,4,35,15,50
29,1,2,21,29,50
14,1,2,10,14,24
13,2,5,31,26,57
3,8,21,36,24,60
11,8,21,134,88,222
10,8,21,122,80,202
10,1,4,25,10,35
1,1482,2384,854,1482,2336
1,755,1215,436,755,1191
7,24,64,271,168,439
6,59,159,581,354,935
8,59,159,635,472,1107
16,3,9,73,48,121
30,3,9,137,90,227
8,2,5,18,16,34
4,2,5,9,8,17
30,2,5,71,60,131
23,2,5,51,46,97
19,2,5,42,38,80
14,2,5,25,28,53
11,2,5,20,22,42
25,2,5,73,50,123
8,2,5,15,16,31
2,2,5,4,4,8
4,2,5,8,8,16
29,2,5,57,58,115
13,2,5,38,26,64
9,2,5,26,18,44
28,2,5,83,56,139
17,3,9,82,51,133
26,3,9,126,78,204
29,2,5,68,58,126
13,2,5,31,26,57
26,7,9,22,182,204
8,7,9,6,56,62
21,7,9,17,147,164
17,7,9,28,119,147
24,7,9,9,168,177
13,7,9,25,91,116
5,7,9,3,35,38
22,3,8,71,66,137
11,3,8,41,33,74
20,8,22,223,160,383
12,8,22,163,96,259
30,8,22,407,240,647
17,9,24,182,153,335
18,9,24,179,162,341
18,9,24,201,162,363
3,9,24,44,27,71
25,9,24,351,225,576
22,9,24,235,198,433
26,9,24,365,234,599
5,13,35,98,65,163
23,13,35,450,299,749
20,13,35,426,260,686
5,13,35,87,65,152
29,13,35,618,377,995
23,13,35,329,299,628
15,13,35,309,195,504
22,13,35,453,286,739
17,13,35,350,221,571
27,13,35,462,351,813
22,13,35,299,286,585
5,13,35,73,65,138
1,13,35,22,13,35
13,13,35,204,169,373
1,13,35,21,13,34
8,13,35,126,104,230
15,13,35,325,195,520
14,13,35,244,182,426
23,13,35,490,299,789
28,13,35,489,364,853
15,21,55,403,315,718
6,38,50,60,228,288
19,38,50,95,722,817
25,42,54,57,1050,1107
22,42,54,15,924,939
13,38,50,130,494,624
27,42,54,134,1134,1268
10,38,50,110,380,490
13,38,50,143,494,637
2,38,50,6,76,82
9,42,54,103,378,481
27,42,54,134,1134,1268
1,1266,2320,892,1266,2158
1,1266,2320,752,1266,2018
1,308,565,184,308,492
1,420,769,241,420,661
1,1266,2320,1008,1266,2274
1,2171,3578,1264,2171,3435
1,487,783,132,487,619
1,487,783,280,487,767
1,344,540,185,344,529
1,2171,3578,835,2171,3006
1,1083,1701,499,1083,1582
1,2171,3578,942,2171,3113
1,1555,2443,302,1555,1857
1,344,540,83,344,427
1,344,540,126,344,470
1,2171,3578,835,2171,3006
1,2171,3578,620,2171,2791
22,26,70,953,572,1525
2,26,70,87,52,139
20,26,70,684,520,1204
30,3,9,177,90,267
21,3,9,122,63,185
25,3,9,103,75,178
29,1,2,16,29,45
3,1,2,2,3,5
15,1,2,8,15,23
6,1,4,13,6,19
12,9,25,129,108,237
19,2,5,53,38,91
13,2,5,36,26,62
29,2,5,81,58,139
27,1,2,18,27,45
16,1,4,38,16,54
30,1,2,29,30,59
12,1,2,12,12,24
8,1,2,8,8,16
30,8,21,277,240,517
15,8,21,138,120,258
15,8,21,138,120,258
14,1,2,14,14,28
29,9,25,334,261,595
1,9,25,12,9,21
29,12,33,408,348,756
25,12,33,352,300,652
24,1,2,16,24,40
10,2,5,29,20,49
1,2,5,3,2,5
9,2,5,27,18,45
6,2,5,13,12,25
6,2,5,13,12,25
1,2,5,2,2,4
26,2,5,49,52,101
25,2,5,48,50,98
4,11,30,59,44,103
16,2,5,46,32,78
28,2,5,81,56,137
14,11,29,155,154,309
13,11,29,144,143,287
30,11,29,331,330,661
6,1,2,4,6,10
17,1,2,11,17,28
24,1,2,13,24,37
28,2,5,78,56,134
12,2,5,34,24,58
18,2,5,50,36,86
20,2,5,58,40,98
5,2,5,15,10,25
16,1,4,47,16,63
14,1,4,35,14,49
25,1,4,62,25,87
22,2,5,48,44,92
6,1,4,17,6,23
12,1,4,34,12,46
18,1,4,51,18,69
1,1482,2384,401,1482,1883
1,1482,2384,854,1482,2336
1,755,1215,448,755,1203
1,1482,2384,521,1482,2003
1,461,742,266,461,727
7,45,120,508,315,823
4,2,5,9,8,17
9,2,5,27,18,45
9,3,9,52,27,79
30,3,9,175,90,265
24,2,5,55,48,103
27,2,5,62,54,116
25,2,5,53,50,103
5,2,5,10,10,20
23,2,5,44,46,90
11,2,5,21,22,43
27,2,5,53,54,107
11,2,5,32,22,54
9,2,5,27,18,45
25,3,9,141,75,216
5,3,9,28,15,43
27,3,9,109,81,190
9,7,9,15,63,78
11,7,9,1,77,78
2,7,9,4,14,18
26,7,9,22,182,204
30,7,9,1,210,211
24,7,9,46,168,214
16,7,9,0,112,112
8,3,8,26,24,50
11,3,8,38,33,71
8,8,22,100,64,164
8,8,22,108,64,172
19,8,22,258,152,410
24,8,22,241,192,433
17,8,22,234,136,370
6,8,22,83,48,131
24,9,24,348,216,564
26,9,24,303,234,537
22,9,24,319,198,517
30,13,35,618,390,1008
13,13,35,277,169,446
15,13,35,293,195,488
28,13,35,400,364,764
14,13,35,239,182,421
28,13,35,489,364,853
27,13,35,575,351,926
27,13,35,556,351,907
29,13,35,628,377,1005
3,13,35,43,39,82
2,13,35,43,26,69
6,13,35,128,78,206
10,13,35,157,130,287
30,13,35,639,390,1029
25,13,35,489,325,814
21,13,35,330,273,603
1,13,35,21,13,34
23,21,55,504,483,987
28,21,55,675,588,1263
1,42,54,5,42,47
30,38,50,330,1140,1470
15,38,50,15,570,585
7,38,50,7,266,273
16,42,54,183,672,855
20,42,54,100,840,940
9,42,54,1,378,379
9,42,54,98,378,476
10,42,54,98,420,518
9,42,54,40,378,418
1,1898,3375,1038,1898,2936
1,1266,2320,1008,1266,2274
1,1252,2295,882,1252,2134
1,344,540,185,344,529
1,1083,1701,380,1083,1463
1,713,1120,138,713,851
1,2171,3578,656,2171,2827
1,2171,3578,727,2171,2898
1,2171,3578,942,2171,3113
1,713,1120,250,713,963
1,2171,3578,656,2171,2827
1,713,1120,172,713,885
1,344,540,174,344,518
1,344,540,99,344,443
3,26,70,128,78,206
28,26,70,1154,728,1882
5,26,70,143,130,273
25,26,70,820,650,1470
1,3,9,6,3,9
27,3,9,160,81,241
27,3,9,157,81,238
7,2,5,13,14,27
1,9,25,11,9,20
4,9,25,63,36,99
20,1,2,18,20,38
7,2,5,20,14,34
13,2,5,38,26,64
21,2,5,62,42,104
25,1,4,74,25,99
20,1,4,59,20,79
3,2,5,8,6,14
10,2,5,28,20,48
27,2,5,76,54,130
14,13,35,274,182,456
29,13,35,567,377,944
6,12,33,124,72,196
13,1,2,9,13,22
4,1,2,3,4,7
1,2,5,2,2,4
15,2,5,27,30,57
17,2,5,31,34,65
19,12,33,317,228,545
4,12,33,67,48,115
1,12,33,17,12,29
2,2,5,6,4,10
10,1,4,23,10,33
10,1,4,23,10,33
23,1,4,52,23,75
18,2,5,34,36,70
18,2,5,34,36,70
3,2,5,6,6,12
22,1,4,50,22,72
20,1,4,46,20,66
22,1,2,20,22,42
18,1,2,17,18,35
6,1,2,4,6,10
26,1,2,19,26,45
9,1,2,7,9,16
1,1,4,3,1,4
29,1,2,28,29,57
25,1,2,24,25,49
20,1,2,20,20,40
17,1,2,10,17,27
21,1,2,12,21,33
9,2,5,26,18,44
11,1,2,6,11,17
10,1,2,6,10,16
1,755,1215,436,755,1191
1,1482,2384,878,1482,2360
1,461,742,274,461,735
4,2,5,10,8,18
19,2,5,47,38,85
6,2,5,11,12,23
17,2,5,32,34,66
5,3,9,30,15,45
3,3,9,18,9,27
15,2,5,44,30,74
3,2,5,9,6,15
20,2,5,38,40,78
25,2,5,48,50,98
7,2,5,16,14,30
1,2,5,2,2,4
13,2,5,30,26,56
23,2,5,53,46,99
25,2,5,73,50,123
28,4,10,118,112,230
25,4,10,105,100,205
30,2,5,59,60,119
8,2,5,16,16,32
13,2,5,36,26,62
8,7,9,1,56,57
30,7,9,25,210,235
27,7,9,49,189,238
30,7,9,55,210,265
29,3,8,113,87,200
6,3,8,30,18,48
7,3,8,34,21,55
26,8,22,353,208,561
6,8,22,55,48,103
21,8,22,285,168,453
5,8,22,50,40,90
22,8,22,303,176,479
14,8,22,137,112,249
8,9,24,93,72,165
23,13,35,490,299,789
29,13,35,415,377,792
15,13,35,309,195,504
17,13,35,332,221,553
1,13,35,15,13,28
7,13,35,110,91,201
29,13,35,455,377,832
3,13,35,51,39,90
6,13,35,88,78,166
11,13,35,173,143,316
7,13,35,120,91,211
4,13,35,66,52,118
1,13,35,14,13,27
29,13,35,506,377,883
4,13,35,57,52,109
4,13,35,66,52,118
3,13,35,46,39,85
9,21,55,301,189,490
13,38,50,130,494,624
17,42,54,103,714,817
30,38,50,345,1140,1485
22,38,50,33,836,869
3,38,50,35,114,149
18,42,54,90,756,846
14,38,50,21,532,553
1,38,50,5,38,43
13,38,50,143,494,637
18,38,50,72,684,756
1,1266,2320,1008,1266,2274
1,1252,2295,951,1252,2203
1,1252,2295,997,1252,2249
1,1252,2295,997,1252,2249
1,1252,2295,607,1252,1859
1,1083,1701,244,1083,1327
1,713,1120,250,713,963
1,487,783,155,487,642
1,713,1120,385,713,1098
1,1555,2443,497,1555,2052
1,487,783,194,487,681
1,487,783,132,487,619
1,1083,1701,312,1083,1395
1,344,540,110,344,454
18,26,70,779,468,1247
13,26,70,563,338,901
2,26,70,85,52,137
11,3,9,64,33,97
30,13,35,513,390,903
1,13,35,17,13,30
13,1,2,10,13,23
24,1,2,18,24,42
12,1,2,12,12,24
12,11,30,224,132,356
15,2,5,44,30,74
15,1,2,9,15,24
16,1,2,9,16,25
4,2,5,8,8,16
18,2,5,38,36,74
27,1,2,18,27,45
7,1,2,5,7,12
12,11,30,181,132,313
12,11,30,181,132,313
8,11,30,121,88,209
17,2,5,50,34,84
29,2,5,86,58,144
4,1,2,3,4,7
23,1,2,15,23,38
19,1,4,54,19,73
5,11,30,68,55,123
3,11,30,41,33,74
4,2,5,12,8,20
18,13,35,283,234,517
27,13,35,424,351,775
12,2,5,28,24,52
4,2,5,9,8,17
26,9,25,312,234,546
17,1,2,9,17,26
30,1,2,16,30,46
20,12,33,314,240,554
7,12,33,110,84,194
10,1,2,10,10,20
8,1,2,8,8,16
4,1,2,2,4,6
7,12,33,117,84,201
6,12,33,100,72,172
12,12,33,201,144,345
1,1482,2384,878,1482,2360
1,1482,2384,735,1482,2217
1,1482,2384,854,1482,2336
1,461,742,118,461,579
13,24,64,337,312,649
17,24,64,484,408,892
24,24,64,760,576,1336
25,4,10,118,100,218
1,4,10,5,4,9
18,4,10,68,72,140
30,4,10,114,120,234
27,2,5,62,54,116
17,2,5,40,34,74
20,2,5,47,40,87
2,2,5,4,4,8
4,2,5,9,8,17
17,2,5,49,34,83
4,2,5,12,8,20
25,7,9,19,175,194
6,7,9,6,42,48
10,3,8,49,30,79
1,3,8,5,3,8
21,3,8,103,63,166
2,8,22,22,16,38
21,8,22,285,168,453
11,9,24,128,99,227
13,9,24,189,117,306
26,9,24,303,234,537
29,9,24,421,261,682
22,13,35,476,286,762
18,13,35,390,234,624
15,13,35,320,195,515
27,13,35,462,351,813
18,13,35,390,234,624
8,13,35,114,104,218
6,13,35,103,78,181
7,13,35,120,91,211
23,13,35,393,299,692
8,13,35,170,104,274
4,13,35,85,52,137
19,13,35,371,247,618
8,21,55,268,168,436
10,42,54,50,420,470
7,38,50,35,266,301
19,38,50,95,722,817
27,38,50,135,1026,1161
29,42,54,317,1218,1535
9,42,54,1,378,379
11,38,50,72,418,490
1,1266,2320,636,1266,1902
1,1266,2320,567,1266,1833
1,1252,2295,997,1252,2249
1,2171,3578,942,2171,3113
1,2171,3578,1335,2171,3506
1,344,540,120,344,464
1,344,540,120,344,464
1,1083,1701,397,1083,1480
1,487,783,194,487,681
1,2171,3578,1335,2171,3506
12,26,70,410,312,722
27,26,70,1150,702,1852
3,26,70,128,78,206
22,26,70,629,572,1201
13,3,9,73,39,112
28,9,25,441,252,693
25,9,25,394,225,619
16,9,25,252,144,396
8,1,2,8,8,16
3,2,5,8,6,14
16,2,5,47,32,79
22,2,5,65,44,109
13,1,4,38,13,51
3,1,4,9,3,12
24,1,4,71,24,95
23,11,30,430,253,683
20,11,30,374,220,594
14,1,4,34,14,48
11,1,4,27,11,38
4,1,4,9,4,13
13,1,4,31,13,44
14,2,5,41,28,69
11,2,5,32,22,54
25,2,5,70,50,120
3,2,5,8,6,14
2,1,4,4,2,6
12,1,2,9,12,21
28,1,2,21,28,49
1,755,1215,436,755,1191
1,1482,2384,592,1482,2074
1,461,742,229,461,690
25,24,64,648,600,1248
2,45,120,148,90,238
1,45,120,74,45,119
26,3,9,154,78,232
24,3,9,142,72,214
11,2,5,31,22,53
28,2,5,78,56,134
15,4,10,89,60,149
8,2,5,15,16,31
13,2,5,25,26,51
5,2,5,15,10,25
11,2,5,32,22,54
29,2,5,84,58,142
15,2,5,44,30,74
19,2,5,44,38,82
22,2,5,51,44,95
11,2,5,31,22,53
12,2,5,34,24,58
10,3,9,56,30,86
20,3,9,113,60,173
8,3,9,39,24,63
14,3,9,75,42,117
30,3,9,161,90,251
1,2,5,2,2,4
15,2,5,32,30,62
14,7,9,27,98,125
4,7,9,7,28,35
3,7,9,2,21,23
17,7,9,14,119,133
18,7,9,7,126,133
28,7,9,1,196,197
23,7,9,42,161,203
15,7,9,2,105,107
5,8,22,69,40,109
18,8,22,244,144,388
28,8,22,293,224,517
11,8,22,101,88,189
6,8,22,83,48,131
21,8,22,229,168,397
24,8,22,267,192,459
22,8,22,303,176,479
11,8,22,149,88,237
8,9,24,118,72,190
8,9,24,95,72,167
26,9,24,278,234,512
17,13,35,279,221,500
26,13,35,563,338,901
30,13,35,618,390,1008
11,13,35,180,143,323
23,13,35,498,299,797
2,13,35,43,26,69
2,13,35,41,26,67
22,13,35,469,286,755
28,13,35,596,364,960
18,13,35,390,234,624
29,13,35,455,377,832
14,13,35,205,182,387
7,13,35,115,91,206
14,21,55,376,294,670
27,21,55,859,567,1426
12,42,54,27,504,531
16,38,50,136,608,744
4,38,50,40,152,192
24,38,50,276,912,1188
1,42,54,11,42,53
29,42,54,332,1218,1550
27,38,50,270,1026,1296
1,1266,2320,1008,1266,2274
1,1252,2295,1020,1252,2272
1,1266,2320,961,1266,2227
1,1252,2295,676,1252,1928
1,1266,2320,752,1266,2018
1,1266,2320,961,1266,2227
1,1266,2320,1008,1266,2274
1,295,540,234,295,529
1,1266,2320,636,1266,1902
1,344,540,174,344,518
1,2171,3578,1264,2171,3435
1,1555,2443,448,1555,2003
1,1555,2443,839,1555,2394
1,487,783,280,487,767
1,1083,1701,244,1083,1327
1,2171,3578,763,2171,2934
1,487,783,155,487,642
1,2171,3578,656,2171,2827
1,713,1120,250,713,963
1,2171,3578,1335,2171,3506
1,344,540,185,344,529
1,1083,1701,499,1083,1582
11,26,70,476,286,762
9,26,70,264,234,498
21,3,9,124,63,187
3,3,9,18,9,27
19,1,2,13,19,32
11,1,2,7,11,18
17,8,21,217,136,353
18,8,21,230,144,374
1,1,2,1,1,2
28,1,2,27,28,55
29,1,2,28,29,57
21,1,2,21,21,42
14,2,5,27,28,55
30,2,5,57,60,117
26,1,2,25,26,51
2,13,35,33,26,59
18,13,35,295,234,529
24,9,25,276,216,492
16,1,2,15,16,31
14,1,2,13,14,27
13,1,2,7,13,20
26,1,2,15,26,41
6,1,2,5,6,11
7,1,2,5,7,12
15,1,2,11,15,26
22,1,2,21,22,43
10,1,2,10,10,20
4,1,2,3,4,7
24,1,2,22,24,46
15,1,2,10,15,25
12,2,5,35,24,59
22,2,5,65,44,109
28,1,2,19,28,47
30,1,2,20,30,50
5,1,2,3,5,8
26,1,2,18,26,44
23,2,5,54,46,100
4,1,2,4,4,8
20,1,2,20,20,40
23,2,5,44,46,90
10,2,5,19,20,39
11,1,4,31,11,42
6,1,4,17,6,23
13,1,2,10,13,23
8,2,5,17,16,33
20,2,5,42,40,82
10,2,5,21,20,41
9,2,5,18,18,36
7,2,5,14,14,28
1,1482,2384,878,1482,2360
1,1482,2384,521,1482,2003
9,24,64,279,216,495
7,45,120,340,315,655
5,45,120,351,225,576
26,2,5,77,52,129
1,2,5,3,2,5
21,2,5,48,42,90
12,2,5,28,24,52
27,2,5,78,54,132
20,2,5,59,40,99
19,3,9,76,57,133
26,7,9,50,182,232
20,7,9,33,140,173
10,8,22,136,80,216
7,8,22,64,56,120
25,8,22,312,200,512
22,8,22,240,176,416
29,8,22,393,232,625
29,8,22,400,232,632
18,9,24,214,162,376
4,9,24,48,36,84
28,9,24,407,252,659
17,9,24,247,153,400
20,13,35,293,260,553
3,13,35,51,39,90
1,13,35,21,13,34
21,13,35,366,273,639
20,13,35,286,260,546
16,13,35,229,208,437
30,13,35,639,390,1029
8,13,35,131,104,235
11,13,35,238,143,381
3,13,35,51,39,90
22,13,35,430,286,716
15,13,35,262,195,457
5,13,35,87,65,152
18,21,55,602,378,980
9,42,54,1,378,379
11,42,54,25,462,487
11,42,54,120,462,582
4,42,54,44,168,212
1,1252,2295,722,1252,1974
1,1912,3400,1046,1912,2958
1,1252,2295,1020,1252,2272
1,1266,2320,752,1266,2018
1,1252,2295,1020,1252,2272
1,1252,2295,997,1252,2249
1,1266,2320,961,1266,2227
1,1266,2320,544,1266,1810
1,1266,2320,729,1266,1995
1,1266,2320,1008,1266,2274
1,1555,2443,839,1555,2394
1,1555,2443,351,1555,1906
1,1555,2443,497,1555,2052
1,1083,1701,550,1083,1633
1,1083,1701,550,1083,1633
1,344,540,126,344,470
23,26,70,948,598,1546
21,26,70,659,546,1205
23,26,70,980,598,1578
20,3,9,80,60,140
30,3,9,177,90,267
1,3,9,6,3,9
22,3,9,106,66,172
17,13,35,291,221,512
29,13,35,496,377,873
9,1,2,8,9,17
8,1,2,7,8,15
12,2,5,32,24,56
10,1,2,9,10,19
4,1,2,3,4,7
17,1,2,10,17,27
27,1,4,77,27,104
15,1,4,43,15,58
22,1,4,62,22,84
9,2,5,21,18,39
6,1,4,14,6,20
14,1,4,33,14,47
7,1,4,17,7,24
24,1,4,60,24,84
5,1,4,12,5,17
1,1,4,2,1,3
17,1,4,42,17,59
24,1,4,60,24,84
10,13,35,206,130,336
19,13,35,391,247,638
10,1,2,7,10,17
4,1,2,3,4,7
21,12,33,295,252,547
13,2,5,29,26,55
20,1,4,42,20,62
4,1,4,8,4,12
9,1,4,19,9,28
28,2,5,66,56,122
26,2,5,61,52,113
29,2,5,84,58,142
20,2,5,58,40,98
8,2,5,23,16,39
13,1,4,38,13,51
2,1,4,6,2,8
15,1,4,44,15,59
30,2,5,87,60,147
14,2,5,41,28,69
14,1,2,10,14,24
2,1,2,1,2,3
25,1,2,14,25,39
30,8,21,308,240,548
26,1,4,77,26,103
9,1,4,27,9,36
7,1,4,21,7,28
28,11,29,325,308,633
24,2,5,56,48,104
6,2,5,14,12,26
12,1,2,12,12,24
1,1482,2384,401,1482,1883
1,1482,2384,330,1482,1812
1,461,742,229,461,690
1,461,742,266,461,727
1,461,742,274,461,735
17,24,64,604,408,1012
27,45,120,1571,1215,2786
10,59,159,793,590,1383
19,2,5,56,38,94
19,2,5,56,38,94
28,2,5,74,56,130
26,2,5,73,52,125
30,2,5,84,60,144
26,3,9,151,78,229
25,3,9,146,75,221
1,2,5,2,2,4
7,2,5,16,14,30
12,2,5,28,24,52
15,4,10,57,60,117
1,4,10,4,4,8
25,2,5,73,50,123
4,2,5,12,8,20
26,4,10,151,104,255
2,2,5,6,4,10
27,2,5,78,54,132
2,4,10,12,8,20
11,2,5,32,22,54
13,2,5,31,26,57
2,2,5,5,4,9
13,2,5,25,26,51
21,3,9,100,63,163
2,2,5,4,4,8
6,2,5,11,12,23
23,3,9,92,69,161
2,3,9,8,6,14
5,2,5,15,10,25
10,4,10,39,40,79
8,4,10,31,32,63
20,7,9,0,140,140
4,7,9,8,28,36
28,7,9,23,196,219
30,7,9,41,210,251
19,3,8,71,57,128
25,3,8,117,75,192
19,3,8,75,57,132
20,8,22,271,160,431
16,8,22,150,128,278
6,8,22,67,48,115
17,8,22,186,136,322
21,8,22,234,168,402
26,9,24,384,234,618
16,9,24,156,144,300
7,13,35,110,91,201
5,13,35,103,65,168
22,13,35,376,286,662
13,13,35,268,169,437
8,13,35,173,104,277
21,13,35,366,273,639
14,13,35,220,182,402
24,13,35,511,312,823
13,13,35,227,169,396
11,13,35,173,143,316
17,13,35,243,221,464
29,13,35,597,377,974
3,21,55,81,63,144
18,42,54,2,756,758
14,42,54,2,588,590
20,42,54,197,840,1037
5,38,50,5,190,195
19,42,54,2,798,800
19,42,54,207,798,1005
3,42,54,33,126,159
19,42,54,95,798,893
28,38,50,322,1064,1386
25,38,50,38,950,988
11,38,50,61,418,479
21,42,54,229,882,1111
1,1898,3375,768,1898,2666
1,420,769,241,420,661
1,1252,2295,1020,1252,2272
1,295,540,207,295,502
1,2171,3578,1264,2171,3435
1,487,783,124,487,611
1,1555,2443,570,1555,2125
1,344,540,185,344,529
1,2171,3578,942,2171,3113
1,1083,1701,397,1083,1480
1,344,540,99,344,443
1,344,540,185,344,529
1,344,540,174,344,518
11,26,70,376,286,662
24,26,70,686,624,1310
14,26,70,400,364,764
5,26,70,213,130,343
18,26,70,767,468,1235
8,3,9,32,24,56
12,2,5,35,24,59
28,2,5,83,56,139
1,1,2,1,1,2
3,1,2,3,3,6
18,1,2,12,18,30
20,13,35,349,260,609
2,2,5,6,4,10
27,1,2,19,27,46
24,1,2,17,24,41
16,2,5,45,32,77
5,2,5,14,10,24
12,1,2,9,12,21
29,9,25,457,261,718
11,9,25,173,99,272
16,9,25,252,144,396
13,1,2,13,13,26
11,1,2,11,11,22
6,2,5,14,12,26
25,9,25,394,225,619
26,9,25,410,234,644
8,1,4,23,8,31
25,1,4,71,25,96
10,1,2,9,10,19
10,1,2,9,10,19
6,1,2,6,6,12
11,1,2,10,11,21
6,1,2,6,6,12
19,2,5,45,38,83
24,2,5,56,48,104
9,1,2,6,9,15
27,1,2,18,27,45
1,2,5,2,2,4
18,2,5,50,36,86
4,2,5,11,8,19
24,1,4,55,24,79
16,1,4,36,16,52
30,1,4,74,30,104
24,1,4,60,24,84
28,1,2,24,28,52
8,8,21,74,64,138
22,8,21,203,176,379
2,1,2,1,2,3
4,1,2,2,4,6
30,1,4,65,30,95
20,1,4,43,20,63
1,1482,2384,807,1482,2289
1,1482,2384,854,1482,2336
1,461,742,251,461,712
17,24,64,452,408,860
10,24,64,259,240,499
8,24,64,310,192,502
16,24,64,620,384,1004
5,45,120,363,225,588
1,59,159,98,59,157
22,2,5,52,44,96
13,2,5,31,26,57
16,2,5,45,32,77
4,2,5,11,8,19
25,2,5,73,50,123
18,2,5,52,36,88
19,2,5,55,38,93
12,2,5,35,24,59
28,2,5,81,56,137
16,2,5,34,32,66
16,2,5,34,32,66
25,2,5,48,50,98
9,2,5,17,18,35
5,2,5,13,10,23
17,2,5,49,34,83
13,2,5,38,26,64
14,2,5,32,28,60
28,2,5,64,56,120
5,2,5,15,10,25
30,2,5,87,60,147
15,3,9,85,45,130
21,7,9,34,147,181
2,7,9,3,14,17
20,7,9,33,140,173
5,3,8,16,15,31
28,8,22,380,224,604
25,8,22,279,200,479
9,8,22,122,72,194
24,8,22,325,192,517
14,8,22,190,112,302
20,8,22,218,160,378
2,9,24,29,18,47
15,13,35,325,195,520
22,13,35,361,286,647
5,13,35,72,65,137
11,13,35,215,143,358
29,13,35,445,377,822
2,13,35,31,26,57
22,13,35,384,286,670
27,13,35,575,351,926
4,13,35,57,52,109
24,13,35,511,312,823
27,13,35,575,351,926
20,13,35,342,260,602
20,13,35,391,260,651
18,13,35,314,234,548
4,13,35,59,52,111
9,21,55,296,189,485
27,21,55,903,567,1470
25,42,54,44,1050,1094
2,38,50,6,76,82
11,38,50,127,418,545
6,38,50,66,228,294
22,38,50,187,836,1023
30,42,54,328,1260,1588
1,1898,3375,1038,1898,2936
1,1266,2320,1008,1266,2274
1,1252,2295,630,1252,1882
1,420,769,334,420,754
1,1252,2295,997,1252,2249
1,295,540,234,295,529
1,295,540,234,295,529
1,308,565,246,308,554
1,2171,3578,942,2171,3113
1,2171,3578,835,2171,3006
1,2171,3578,763,2171,2934
1,1083,1701,550,1083,1633
1,1555,2443,570,1555,2125
1,2171,3578,1335,2171,3506
1,2171,3578,1335,2171,3506
1,344,540,158,344,502
1,2171,3578,620,2171,2791
14,26,70,400,364,764
3,26,70,128,78,206
30,26,70,1278,780,2058
17,1,2,16,17,33
22,1,2,20,22,42
7,13,35,152,91,243
27,13,35,585,351,936
17,2,5,50,34,84
8,2,5,24,16,40
21,2,5,62,42,104
22,9,25,253,198,451
29,9,25,334,261,595
20,2,5,46,40,86
30,2,5,89,60,149
27,2,5,80,54,134
19,1,2,19,19,38
29,1,2,28,29,57
16,2,5,46,32,78
23,2,5,67,46,113
1,2,5,2,2,4
5,2,5,12,10,22
5,11,30,74,55,129
30,11,30,444,330,774
10,1,4,25,10,35
2,1,4,5,2,7
5,1,4,12,5,17
4,9,25,60,36,96
23,9,25,345,207,552
10,9,25,150,90,240
29,2,5,68,58,126
2,2,5,5,4,9
30,2,5,87,60,147
1,2,5,3,2,5
15,1,4,44,15,59
1,1482,2384,807,1482,2289
1,1482,2384,807,1482,2289
1,1482,2384,401,1482,1883
1,1482,2384,854,1482,2336
1,461,742,274,461,735
11,45,120,812,495,1307
10,2,5,19,20,39
18,2,5,48,36,84
26,2,5,69,52,121
5,2,5,14,10,24
22,2,5,51,44,95
29,2,5,81,58,139
6,2,5,17,12,29
16,2,5,46,32,78
6,2,5,18,12,30
24,2,5,71,48,119
10,4,10,38,40,78
4,4,10,23,16,39
28,4,10,162,112,274
13,7,9,24,91,115
19,7,9,31,133,164
16,7,9,26,112,138
19,7,9,35,133,168
24,7,9,44,168,212
10,3,8,36,30,66
7,3,8,26,21,47
16,3,8,63,48,111
3,8,22,28,24,52
28,8,22,367,224,591
21,8,22,285,168,453
5,8,22,68,40,108
22,8,22,240,176,416
11,8,22,152,88,240
24,9,24,354,216,570
17,9,24,198,153,351
13,9,24,183,117,300
5,9,24,50,45,95
29,13,35,476,377,853
14,13,35,298,182,480
19,13,35,325,247,572
16,13,35,229,208,437
27,13,35,462,351,813
15,13,35,262,195,457
8,13,35,170,104,274
26,13,35,554,338,892
1,13,35,21,13,34
18,13,35,383,234,617
3,13,35,62,39,101
14,13,35,220,182,402
28,13,35,596,364,960
3,13,35,62,39,101
22,13,35,345,286,631
6,21,55,135,126,261
26,42,54,17,1092,1109
7,38,50,39,266,305
11,38,50,110,418,528
26,38,50,286,988,1274
19,42,54,95,798,893
4,38,50,44,152,196
1,1912,3400,774,1912,2686
1,1266,2320,892,1266,2158
1,1252,2295,951,1252,2203
1,295,540,175,295,470
1,420,769,249,420,669
1,1252,2295,997,1252,2249
1,1266,2320,1031,1266,2297
1,420,769,211,420,631
1,2171,3578,835,2171,3006
1,1555,2443,570,1555,2125
1,713,1120,362,713,1075
1,713,1120,228,713,941
1,1083,1701,550,1083,1633
1,344,540,174,344,518
1,344,540,83,344,427
26,26,70,1108,676,1784
19,26,70,823,494,1317
9,3,9,36,27,63
22,1,4,62,22,84
12,1,4,34,12,46
29,13,35,476,377,853
15,1,2,14,15,29
28,1,4,80,28,108
27,1,2,16,27,43
11,1,2,6,11,17
2,2,5,6,4,10
17,2,5,49,34,83
18,1,4,45,18,63
10,1,4,25,10,35
11,1,4,27,11,38
18,1,2,17,18,35
18,1,2,13,18,31
1,1,2,1,1,2
7,2,5,20,14,34
28,2,5,78,56,134
10,1,4,25,10,35
21,12,33,330,252,582
24,12,33,377,288,665
15,11,30,276,165,441
18,11,30,331,198,529
17,1,2,12,17,29
27,1,2,18,27,45
15,1,2,15,15,30
16,1,2,15,16,31
8,1,2,5,8,13
2,1,2,1,2,3
28,1,2,27,28,55
21,1,2,13,21,34
12,2,5,23,24,47
29,11,29,337,319,656
4,1,2,4,4,8
23,1,2,22,23,45
1,1482,2384,592,1482,2074
1,1482,2384,854,1482,2336
1,1482,2384,473,1482,1955
2,45,120,148,90,238
21,2,5,62,42,104
2,2,5,5,4,9
23,2,5,54,46,100
12,2,5,35,24,59
8,2,5,24,16,40
27,4,10,127,108,235
5,4,10,24,20,44
26,2,5,75,52,127
29,2,5,84,58,142
30,2,5,66,60,126
16,2,5,35,32,67
4,2,5,8,8,16
2,2,5,4,4,8
1,4,10,6,4,10
4,4,10,23,16,39
24,2,5,46,48,94
26,2,5,49,52,101
11,2,5,29,22,51
9,7,9,16,63,79
29,7,9,16,203,219
29,7,9,16,203,219
10,7,9,16,70,86
13,7,9,18,91,109
23,3,8,108,69,177
20,3,8,78,60,138
18,8,22,244,144,388
24,8,22,220,192,412
10,8,22,136,80,216
13,8,22,179,104,283
21,8,22,289,168,457
25,8,22,262,200,462
11,9,24,110,99,209
25,9,24,351,225,576
2,9,24,29,18,47
6,9,24,71,54,125
13,9,24,129,117,246
9,9,24,133,81,214
12,9,24,174,108,282
17,13,35,249,221,470
28,13,35,547,364,911
8,13,35,170,104,274
16,13,35,330,208,538
11,13,35,192,143,335
10,13,35,217,130,347
14,13,35,303,182,485
3,13,35,52,39,91
16,13,35,279,208,487
24,13,35,511,312,823
18,13,35,371,234,605
14,13,35,303,182,485
18,13,35,352,234,586
21,13,35,330,273,603
27,13,35,575,351,926
17,13,35,350,221,571
22,21,55,736,462,1198
16,21,55,403,336,739
2,21,55,66,42,108
30,21,55,657,630,1287
11,38,50,11,418,429
1,38,50,11,38,49
22,38,50,253,836,1089
16,38,50,16,608,624
26,38,50,104,988,1092
5,42,54,3,210,213
26,38,50,221,988,1209
4,38,50,44,152,196
19,42,54,43,798,841
19,42,54,95,798,893
15,38,50,83,570,653
14,42,54,9,588,597
26,38,50,260,988,1248
14,42,54,47,588,635
1,1266,2320,1031,1266,2297
1,1252,2295,745,1252,1997
1,1252,2295,745,1252,1997
1,1266,2320,1008,1266,2274
1,1266,2320,567,1266,1833
1,2171,3578,835,2171,3006
1,2171,3578,942,2171,3113
1,1083,1701,397,1083,1480
1,713,1120,172,713,885
1,487,783,132,487,619
1,344,540,126,344,470
14,26,70,606,364,970
24,26,70,703,624,1327
7,26,70,298,182,480
25,26,70,1065,650,1715
12,26,70,394,312,706
25,26,70,820,650,1470
9,3,9,53,27,80
8,13,35,137,104,241
21,13,35,359,273,632
23,1,2,22,23,45
10,1,2,10,10,20
21,13,35,359,273,632
30,13,35,513,390,903
25,13,35,541,325,866
18,13,35,390,234,624
14,12,33,276,168,444
27,11,30,481,297,778
5,11,30,89,55,144
30,2,5,71,60,131
26,13,35,554,338,892
30,2,5,57,60,117
5,1,4,14,5,19
5,1,4,14,5,19
4,1,2,2,4,6
12,1,2,7,12,19
8,1,2,7,8,15
23,1,2,20,23,43
16,1,2,15,16,31
22,1,2,20,22,42
3,1,4,9,3,12
9,2,5,26,18,44
28,1,4,64,28,92
6,1,4,14,6,20
6,2,5,13,12,25
20,2,5,42,40,82
14,1,4,41,14,55
15,1,4,44,15,59
24,1,2,13,24,37
6,1,2,3,6,9
7,1,2,4,7,11
20,2,5,56,40,96
22,2,5,62,44,106
13,1,4,37,13,50
29,9,25,305,261,566
10,9,25,105,90,195
4,1,4,10,4,14
20,1,4,50,20,70
16,2,5,30,32,62
29,9,25,450,261,711
1,1482,2384,807,1482,2289
1,1482,2384,807,1482,2289
1,461,742,251,461,712
1,755,1215,436,755,1191
23,24,64,596,552,1148
10,45,120,582,450,1032
2,45,120,140,90,230
6,59,159,590,354,944
6,59,159,447,354,801
12,2,5,32,24,56
24,4,10,139,96,235
11,2,5,25,22,47
21,3,9,118,63,181
26,3,9,147,78,225
16,4,10,93,64,157
12,4,10,70,48,118
16,2,5,45,32,77
6,2,5,17,12,29
25,2,5,70,50,120
25,2,5,70,50,120
9,3,9,51,27,78
15,7,9,8,105,113
18,7,9,0,126,126
7,7,9,10,49,59
16,7,9,13,112,125
2,7,9,1,14,15
4,7,9,7,28,35
3,7,9,5,21,26
1,7,9,0,7,7
17,3,8,84,51,135
18,3,8,87,54,141
13,3,8,42,39,81
29,3,8,94,87,181
7,8,22,64,56,120
30,8,22,407,240,647
26,8,22,353,208,561
21,8,22,289,168,457
16,8,22,220,128,348
26,8,22,244,208,452
5,9,24,73,45,118
7,9,24,103,63,166
24,9,24,337,216,553
21,13,35,308,273,581
2,13,35,43,26,69
6,13,35,128,78,206
6,13,35,128,78,206
24,13,35,520,312,832
6,13,35,117,78,195
30,13,35,618,390,1008
29,13,35,618,377,995
18,13,35,390,234,624
11,13,35,227,143,370
7,13,35,103,91,194
4,13,35,85,52,137
1,13,35,21,13,34
12,13,35,256,156,412
3,13,35,59,39,98
15,13,35,293,195,488
18,13,35,371,234,605
6,21,55,131,126,257
6,21,55,191,126,317
23,42,54,77,966,1043
1,38,50,10,38,48
4,38,50,46,152,198
14,38,50,42,532,574
2,42,54,10,84,94
12,42,54,40,504,544
22,42,54,110,924,1034
26,42,54,3,1092,1095
3,38,50,15,114,129
20,38,50,200,760,960
16,42,54,175,672,847
7,42,54,76,294,370
1,1898,3375,937,1898,2835
1,1266,2320,1008,1266,2274
1,420,769,341,420,761
1,1266,2320,752,1266,2018
1,1266,2320,1008,1266,2274
1,1252,2295,951,1252,2203
1,420,769,318,420,738
1,1083,1701,550,1083,1633
1,344,540,120,344,464
1,344,540,185,344,529
1,344,540,83,344,427
9,26,70,390,234,624
13,26,70,536,338,874
25,26,70,785,650,1435
26,3,9,154,78,232
10,9,25,128,90,218
18,9,25,230,162,392
14,1,2,14,14,28
1,1,2,1,1,2
9,1,2,9,9,18
1,8,21,9,8,17
26,13,35,554,338,892
7,1,2,7,7,14
15,1,2,14,15,29
14,1,2,13,14,27
27,2,5,76,54,130
22,2,5,62,44,106
20,2,5,56,40,96
16,1,2,12,16,28
23,1,2,17,23,40
2,2,5,6,4,10
29,9,25,370,261,631
29,9,25,370,261,631
19,9,25,242,171,413
2,11,30,37,22,59
11,1,4,26,11,37
16,2,5,47,32,79
5,1,4,15,5,20
1,1,4,3,1,4
13,2,5,38,26,64
9,2,5,27,18,45
8,2,5,24,16,40
9,2,5,25,18,43
28,2,5,66,56,122
10,1,4,28,10,38
20,1,4,57,20,77
25,1,4,71,25,96
26,1,2,25,26,51
11,1,2,11,11,22
19,2,5,37,38,75
1,2,5,2,2,4
14,1,2,12,14,26
5,1,2,4,5,9
13,1,2,9,13,22
3,1,2,2,3,5
14,1,2,10,14,24
3,1,2,2,3,5
24,1,2,13,24,37
25,1,2,19,25,44
3,1,2,2,3,5
26,1,2,19,26,45
1,1482,2384,807,1482,2289
1,1482,2384,735,1482,2217
1,461,742,274,461,735
1,755,1215,193,755,948
1,755,1215,375,755,1130
1,461,742,118,461,579
1,1482,2384,854,1482,2336
1,461,742,251,461,712
1,461,742,125,461,586
10,24,64,394,240,634
24,24,64,929,576,1505
29,24,64,1086,696,1782
9,45,120,664,405,1069
2,59,159,130,118,248
15,2,5,44,30,74
30,2,5,89,60,149
21,3,9,122,63,185
28,2,5,78,56,134
3,2,5,7,6,13
12,2,5,28,24,52
7,4,10,27,28,55
13,3,9,63,39,102
23,3,9,111,69,180
18,4,10,106,72,178
15,4,10,89,60,149
7,2,5,15,14,29
20,2,5,42,40,82
21,2,5,62,42,104
27,2,5,80,54,134
15,3,9,68,45,113
18,2,5,52,36,88
2,2,5,6,4,10
9,3,9,43,27,70
6,3,9,29,18,47
29,2,5,84,58,142
21,2,5,61,42,103
22,2,5,64,44,108
23,2,5,67,46,113
15,2,5,44,30,74
17,2,5,50,34,84
30,2,5,87,60,147
1,2,5,2,2,4
21,2,5,38,42,80
25,3,9,121,75,196
27,3,9,130,81,211
10,7,9,8,70,78
8,7,9,7,56,63
10,7,9,19,70,89
10,7,9,18,70,88
29,7,9,48,203,251
8,7,9,7,56,63
14,3,8,68,42,110
19,3,8,92,57,149
23,8,22,251,184,435
14,8,22,193,112,305
29,8,22,323,232,555
17,8,22,156,136,292
11,8,22,152,88,240
15,8,22,137,120,257
5,8,22,69,40,109
21,9,24,310,189,499
12,9,24,143,108,251
30,9,24,421,270,691
9,9,24,126,81,207
3,9,24,42,27,69
6,9,24,87,54,141
23,13,35,337,299,636
21,13,35,330,273,603
16,13,35,279,208,487
20,13,35,433,260,693
12,13,35,260,156,416
16,13,35,229,208,437
24,13,35,469,312,781
10,13,35,175,130,305
13,13,35,227,169,396
26,13,35,554,338,892
17,13,35,362,221,583
6,13,35,124,78,202
26,13,35,536,338,874
21,13,35,300,273,573
7,13,35,137,91,228
25,21,55,795,525,1320
30,21,55,806,630,1436
11,21,55,362,231,593
12,38,50,138,456,594
21,38,50,116,798,914
22,42,54,252,924,1176
29,38,50,334,1102,1436
7,38,50,28,266,294
5,38,50,55,190,245
4,38,50,44,152,196
18,38,50,90,684,774
17,42,54,2,714,716
26,38,50,260,988,1248
1,1252,2295,745,1252,1997
1,1266,2320,1008,1266,2274
1,1252,2295,630,1252,1882
1,1252,2295,722,1252,1974
1,1252,2295,951,1252,2203
1,1252,2295,745,1252,1997
1,420,769,334,420,754
1,1252,2295,997,1252,2249
1,1252,2295,997,1252,2249
1,1266,2320,1008,1266,2274
1,295,540,126,295,421
1,1266,2320,1031,1266,2297
1,1266,2320,1031,1266,2297
1,295,540,234,295,529
1,2171,3578,942,2171,3113
1,713,1120,161,713,874
1,1083,1701,312,1083,1395
1,344,540,174,344,518
1,344,540,174,344,518
2,26,70,82,52,134
10,26,70,412,260,672
21,26,70,865,546,1411
3,26,70,86,78,164
20,26,70,852,520,1372
25,26,70,1065,650,1715
21,26,70,895,546,1441
17,3,9,65,51,116
29,1,2,28,29,57
18,2,5,52,36,88
19,1,2,18,19,37
22,2,5,43,44,87
12,2,5,23,24,47
6,1,4,18,6,24
16,1,4,47,16,63
3,2,5,8,6,14
29,2,5,81,58,139
7,2,5,16,14,30
14,2,5,33,28,61
29,2,5,86,58,144
29,2,5,86,58,144
26,1,2,25,26,51
6,1,2,6,6,12
18,1,2,17,18,35
30,1,2,28,30,58
21,1,2,21,21,42
14,9,25,221,126,347
18,9,25,284,162,446
20,9,25,315,180,495
24,11,30,442,264,706
12,11,30,221,132,353
24,1,2,22,24,46
22,1,2,20,22,42
13,2,5,38,26,64
2,2,5,6,4,10
8,1,2,5,8,13
15,1,2,9,15,24
18,12,33,247,216,463
5,12,33,69,60,129
7,1,4,19,7,26
13,1,4,35,13,48
25,8,21,215,200,415
13,8,21,112,104,216
17,1,2,15,17,32
1,1,2,1,1,2
12,1,4,30,12,42
2,1,4,5,2,7
26,1,4,63,26,89
13,1,4,32,13,45
11,1,4,27,11,38
1,1482,2384,735,1482,2217
1,1482,2384,330,1482,1812
1,755,1215,436,755,1191
10,59,159,650,590,1240
29,4,10,113,116,229
8,4,10,35,32,67
13,4,10,57,52,109
16,4,10,86,64,150
20,4,10,118,80,198
14,2,5,39,28,67
27,2,5,49,54,103
1,2,5,2,2,4
30,4,10,168,120,288
8,4,10,45,32,77
9,2,5,24,18,42
4,2,5,12,8,20
29,2,5,84,58,142
27,2,5,57,54,111
16,2,5,35,32,67
28,2,5,62,56,118
28,7,9,51,196,247
22,7,9,40,154,194
2,7,9,3,14,17
18,7,9,7,126,133
25,7,9,41,175,216
18,3,8,58,54,112
5,3,8,23,15,38
16,8,22,199,128,327
29,9,24,345,261,606
4,9,24,53,36,89
29,9,24,428,261,689
26,13,35,536,338,874
12,13,35,172,156,328
7,13,35,122,91,213
27,13,35,471,351,822
12,13,35,247,156,403
19,13,35,405,247,652
28,13,35,547,364,911
14,13,35,298,182,480
29,13,35,455,377,832
11,13,35,227,143,370
8,13,35,131,104,235
26,21,55,569,546,1115
20,42,54,197,840,1037
15,38,50,150,570,720
18,38,50,198,684,882
23,38,50,265,874,1139
6,38,50,0,228,228
6,42,54,66,252,318
1,1266,2320,1008,1266,2274
1,1912,3400,774,1912,2686
1,1266,2320,636,1266,1902
1,1252,2295,997,1252,2249
1,1252,2295,951,1252,2203
1,1252,2295,951,1252,2203
1,420,769,334,420,754
1,1266,2320,961,1266,2227
1,713,1120,161,713,874
1,1083,1701,584,1083,1667
1,1083,1701,601,1083,1684
1,487,783,108,487,595
1,487,783,265,487,752
1,2171,3578,835,2171,3006
1,344,540,110,344,454
1,1083,1701,397,1083,1480
1,713,1120,228,713,941
1,2171,3578,1335,2171,3506
1,344,540,110,344,454
19,26,70,809,494,1303
7,26,70,298,182,480
19,3,9,112,57,169
18,3,9,82,54,136
3,3,9,14,9,23
6,1,2,6,6,12
20,1,2,20,20,40
28,1,2,18,28,46
29,1,2,19,29,48
2,13,35,41,26,67
16,13,35,330,208,538
27,13,35,556,351,907
11,11,30,196,121,317
21,2,5,62,42,104
11,13,35,192,143,335
22,13,35,384,286,670
19,11,30,355,209,564
11,11,30,206,121,327
3,2,5,6,6,12
30,2,5,57,60,117
27,1,2,20,27,47
19,1,2,18,19,37
24,1,2,23,24,47
11,2,5,32,22,54
12,2,5,35,24,59
8,2,5,24,16,40
26,2,5,73,52,125
22,2,5,62,44,106
16,2,5,46,32,78
9,2,5,26,18,44
10,1,2,7,10,17
15,2,5,29,30,59
1,2,5,2,2,4
3,9,25,38,27,65
12,9,25,153,108,261
18,8,21,226,144,370
15,8,21,189,120,309
6,8,21,75,48,123
8,1,2,5,8,13
21,1,2,13,21,34
11,1,2,7,11,18
21,12,33,330,252,582
26,8,21,316,208,524
14,8,21,170,112,282
15,1,2,14,15,29
17,1,2,17,17,34
25,1,2,25,25,50
28,1,2,26,28,54
5,1,2,5,5,10
16,2,5,35,32,67
3,2,5,7,6,13
3,2,5,7,6,13
1,1482,2384,759,1482,2241
1,755,1215,411,755,1166
1,755,1215,375,755,1130
1,755,1215,241,755,996
4,45,120,194,180,374
9,45,120,653,405,1058
8,59,159,571,472,1043
1,2,5,3,2,5
13,2,5,36,26,62
26,2,5,75,52,127
15,2,5,35,30,65
26,2,5,61,52,113
30,2,5,71,60,131
21,4,10,122,84,206
9,2,5,17,18,35
16,2,5,30,32,62
14,2,5,27,28,55
19,7,9,35,133,168
17,7,9,31,119,150
1,7,9,1,7,8
20,3,8,98,60,158
12,8,22,163,96,259
11,8,22,152,88,240
2,8,22,28,16,44
5,8,22,55,40,95
15,9,24,178,135,313
2,13,35,43,26,69
10,13,35,143,130,273
1,13,35,21,13,34
3,13,35,62,39,101
16,13,35,341,208,549
15,13,35,272,195,467
18,13,35,371,234,605
12,13,35,256,156,412
12,13,35,235,156,391
1,21,55,22,21,43
12,38,50,18,456,474
27,38,50,297,1026,1323
11,38,50,110,418,528
19,42,54,84,798,882
1,42,54,11,42,53
1,1252,2295,722,1252,1974
1,1912,3400,1454,1912,3366
1,1252,2295,997,1252,2249
1,2171,3578,1013,2171,3184
1,2171,3578,1335,2171,3506
1,2171,3578,1371,2171,3542
1,1083,1701,584,1083,1667
1,2171,3578,942,2171,3113
1,344,540,77,344,421
1,344,540,174,344,518
1,713,1120,172,713,885
1,2171,3578,1335,2171,3506
1,2171,3578,1335,2171,3506
1,344,540,126,344,470
6,26,70,172,156,328
5,3,9,24,15,39
1,3,9,4,3,7
10,1,2,10,10,20
15,2,5,44,30,74
25,11,29,334,275,609
8,11,29,107,88,195
19,1,2,18,19,37
10,13,35,213,130,343
28,13,35,596,364,960
18,2,5,50,36,86
7,9,25,105,63,168
29,9,25,435,261,696
10,1,2,6,10,16
8,1,2,6,8,14
13,2,5,31,26,57
19,2,5,45,38,83
20,2,5,47,40,87
27,2,5,51,54,105
24,1,2,13,24,37
3,1,2,2,3,5
22,12,33,302,264,566
7,12,33,96,84,180
7,1,4,16,7,23
8,1,4,18,8,26
28,9,25,420,252,672
16,9,25,240,144,384
6,8,21,62,48,110
20,1,4,58,20,78
15,1,4,44,15,59
3,1,4,9,3,12
10,1,4,28,10,38
13,8,21,150,104,254
3,8,21,35,24,59
1,461,742,229,461,690
10,24,64,374,240,614
9,59,159,671,531,1202
20,2,5,56,40,96
5,2,5,13,10,23
10,2,5,27,20,47
30,4,10,168,120,288
5,4,10,28,20,48
9,2,5,27,18,45
28,2,5,83,56,139
8,2,5,15,16,31
22,2,5,42,44,86
20,2,5,59,40,99
24,2,5,56,48,104
2,2,5,5,4,9
9,2,5,20,18,38
5,2,5,11,10,21
1,2,5,2,2,4
21,2,5,46,42,88
4,7,9,-1,28,27
18,7,9,34,126,160
9,7,9,16,63,79
15,7,9,27,105,132
27,7,9,44,189,233
3,7,9,1,21,22
30,3,8,116,90,206
20,3,8,97,60,157
29,3,8,108,87,195
4,3,8,19,12,31
6,8,22,83,48,131
7,8,22,95,56,151
8,8,22,108,64,172
28,8,22,263,224,487
22,8,22,192,176,368
30,8,22,334,240,574
3,8,22,31,24,55
15,8,22,167,120,287
17,9,24,251,153,404
18,9,24,253,162,415
18,9,24,214,162,376
9,9,24,87,81,168
7,9,24,103,63,166
25,9,24,279,225,504
16,9,24,186,144,330
14,9,24,166,126,292
27,13,35,575,351,926
19,13,35,411,247,658
24,13,35,494,312,806
15,13,35,325,195,520
7,13,35,137,91,228
9,13,35,192,117,309
22,13,35,476,286,762
24,13,35,394,312,706
19,13,35,292,247,539
20,13,35,433,260,693
14,13,35,244,182,426
20,13,35,391,260,651
16,13,35,330,208,538
27,13,35,575,351,926
9,13,35,132,117,249
12,13,35,197,156,353
5,13,35,107,65,172
26,13,35,408,338,746
18,13,35,308,234,542
12,21,55,302,252,554
19,21,55,510,399,909
17,21,55,382,357,739
24,42,54,262,1008,1270
23,38,50,35,874,909
22,38,50,253,836,1089
14,38,50,140,532,672
15,42,54,148,630,778
12,38,50,132,456,588
17,42,54,167,714,881
7,42,54,16,294,310
12,38,50,18,456,474
5,42,54,17,210,227
1,1266,2320,961,1266,2227
1,420,769,249,420,669
1,420,769,334,420,754
1,1266,2320,567,1266,1833
1,1252,2295,676,1252,1928
1,1252,2295,561,1252,1813
1,1266,2320,961,1266,2227
1,295,540,175,295,470
1,1252,2295,882,1252,2134
1,487,783,124,487,611
1,2171,3578,1264,2171,3435
1,2171,3578,835,2171,3006
1,344,540,185,344,529
1,2171,3578,835,2171,3006
1,1083,1701,499,1083,1582
1,2171,3578,727,2171,2898
1,2171,3578,1335,2171,3506
1,344,540,174,344,518
1,713,1120,172,713,885
1,713,1120,261,713,974
1,713,1120,261,713,974
1,713,1120,205,713,918
15,26,70,440,390,830
27,26,70,1169,702,1871
14,26,70,596,364,960
19,26,70,809,494,1303
2,26,70,66,52,118
24,3,9,135,72,207
2,1,4,6,2,8
29,1,2,28,29,57
15,1,2,15,15,30
10,13,35,171,130,301
4,13,35,68,52,120
14,9,25,179,126,305
10,13,35,213,130,343
27,13,35,575,351,926
7,1,2,5,7,12
23,1,2,16,23,39
2,9,25,22,18,40
24,2,5,71,48,119
27,1,4,64,27,91
16,1,4,38,16,54
5,11,30,94,55,149
25,11,30,468,275,743
23,2,5,68,46,114
24,1,2,23,24,47
15,1,2,14,15,29
16,1,2,12,16,28
17,1,2,13,17,30
21,1,2,14,21,35
20,1,2,14,20,34
6,1,2,4,6,10
21,12,33,351,252,603
15,12,33,251,180,431
24,2,5,56,48,104
28,9,25,441,252,693
3,9,25,47,27,74
12,1,2,9,12,21
6,1,2,4,6,10
26,2,5,75,52,127
4,2,5,12,8,20
15,2,5,44,30,74
12,1,4,34,12,46
10,1,4,28,10,38
18,2,5,34,36,70
27,2,5,51,54,105
28,2,5,53,56,109
28,1,2,27,28,55
7,1,2,7,7,14
26,1,4,76,26,102
16,1,4,47,16,63
21,11,30,386,231,617
3,11,30,55,33,88
30,8,21,308,240,548
11,8,21,113,88,201
28,11,29,398,308,706
27,11,29,384,297,681
2,2,5,5,4,9
13,2,5,25,26,51
27,2,5,51,54,105
20,9,25,250,180,430
27,9,25,338,243,581
30,1,2,29,30,59
10,1,2,10,10,20
3,1,4,9,3,12
17,1,4,48,17,65
1,755,1215,302,755,1057
1,755,1215,266,755,1021
4,45,120,281,180,461
4,45,120,194,180,374
5,59,159,468,295,763
2,59,159,187,118,305
28,2,5,83,56,139
25,2,5,74,50,124
10,2,5,21,20,41
1,2,5,2,2,4
23,4,10,94,92,186
18,4,10,74,72,146
5,2,5,15,10,25
4,2,5,12,8,20
18,2,5,42,36,78
5,2,5,12,10,22
14,2,5,33,28,61
19,2,5,45,38,83
19,2,5,37,38,75
13,2,5,25,26,51
21,3,9,105,63,168
2,3,9,10,6,16
21,2,5,40,42,82
20,2,5,58,40,98
7,2,5,20,14,34
24,4,10,139,96,235
8,4,10,46,32,78
12,2,5,35,24,59
16,2,5,30,32,62
19,2,5,55,38,93
15,2,5,44,30,74
21,2,5,61,42,103
3,2,5,9,6,15
21,2,5,61,42,103
4,2,5,9,8,17
3,2,5,7,6,13
3,3,9,17,9,26
30,3,9,169,90,259
11,3,9,53,33,86
2,3,9,10,6,16
24,2,5,67,48,115
3,2,5,8,6,14
28,7,9,3,196,199
5,7,9,8,35,43
4,7,9,7,28,35
7,7,9,6,49,55
30,7,9,55,210,265
11,7,9,20,77,97
21,7,9,38,147,185
16,7,9,29,112,141
9,3,8,44,27,71
12,3,8,40,36,76
7,8,22,69,56,125
4,8,22,45,32,77
3,8,22,41,24,65
18,8,22,244,144,388
12,9,24,177,108,285
17,9,24,177,153,330
7,9,24,70,63,133
21,9,24,260,189,449
19,9,24,276,171,447
15,13,35,220,195,415
12,13,35,256,156,412
15,13,35,309,195,504
3,13,35,52,39,91
21,13,35,366,273,639
29,13,35,506,377,883
4,13,35,71,52,123
2,13,35,29,26,55
5,13,35,108,65,173
30,13,35,639,390,1029
25,13,35,358,325,683
10,13,35,206,130,336
17,13,35,350,221,571
2,13,35,43,26,69
27,13,35,556,351,907
24,13,35,511,312,823
10,21,55,269,210,479
28,21,55,921,588,1509
3,42,54,15,126,141
13,42,54,65,546,611
9,38,50,104,342,446
17,38,50,187,646,833
2,42,54,22,84,106
7,42,54,76,294,370
1,1252,2295,630,1252,1882
1,1252,2295,630,1252,1882
1,1912,3400,842,1912,2754
1,1266,2320,1008,1266,2274
1,1266,2320,752,1266,2018
1,1266,2320,961,1266,2227
1,1252,2295,561,1252,1813
1,1266,2320,567,1266,1833
1,1266,2320,799,1266,2065
1,1266,2320,1008,1266,2274
1,420,769,249,420,669
1,420,769,318,420,738
1,420,769,249,420,669
1,308,565,184,308,492
1,420,769,249,420,669
1,487,783,280,487,767
1,1555,2443,717,1555,2272
1,487,783,155,487,642
1,713,1120,273,713,986
1,713,1120,385,713,1098
1,344,540,174,344,518
1,713,1120,362,713,1075
1,1083,1701,397,1083,1480
1,2171,3578,1335,2171,3506
1,2171,3578,1335,2171,3506
16,26,70,659,416,1075
26,26,70,744,676,1420
7,26,70,298,182,480
18,26,70,779,468,1247
6,3,9,27,18,45
14,1,4,30,14,44
25,8,21,320,200,520
10,1,2,10,10,20
4,9,25,48,36,84
3,9,25,36,27,63
22,9,25,264,198,462
26,1,4,74,26,100
30,1,4,85,30,115
18,8,21,155,144,299
21,8,21,180,168,348
1,2,5,2,2,4
19,2,5,40,38,78
27,2,5,57,54,111
20,1,4,57,20,77
10,1,4,28,10,38
8,2,5,22,16,38
2,2,5,6,4,10
21,1,2,20,21,41
1,1,2,1,1,2
1,13,35,16,13,29
4,1,2,4,4,8
17,1,2,17,17,34
1,1,2,1,1,2
27,1,2,20,27,47
11,1,4,27,11,38
5,13,35,72,65,137
3,13,35,43,39,82
26,11,30,486,286,772
20,11,30,374,220,594
16,1,2,9,16,25
13,1,2,8,13,21
4,1,2,2,4,6
29,1,2,17,29,46
10,2,5,29,20,49
21,2,5,61,42,103
21,2,5,62,42,104
18,2,5,53,36,89
6,1,2,6,6,12
4,1,4,9,4,13
8,1,4,17,8,25
25,1,4,54,25,79
1,2,5,3,2,5
28,8,21,352,224,576
8,8,21,101,64,165
17,8,21,214,136,350
25,2,5,73,50,123
27,2,5,78,54,132
1,461,742,185,461,646
1,755,1215,266,755,1021
1,461,742,251,461,712
1,1482,2384,807,1482,2289
1,461,742,125,461,586
1,461,742,266,461,727
28,24,64,1084,672,1756
17,24,64,636,408,1044
7,45,120,416,315,731
21,2,5,46,42,88
24,2,5,53,48,101
28,2,5,81,56,137
5,2,5,15,10,25
13,4,10,55,52,107
18,4,10,76,72,148
26,2,5,69,52,121
23,3,9,95,69,164
4,3,9,16,12,28
23,7,9,9,161,170
12,7,9,22,84,106
5,7,9,9,35,44
15,7,9,21,105,126
28,7,9,23,196,219
22,7,9,8,154,162
24,7,9,33,168,201
28,7,9,46,196,242
4,3,8,20,12,32
25,3,8,81,75,156
28,3,8,131,84,215
6,3,8,21,18,39
24,3,8,116,72,188
19,8,22,207,152,359
13,8,22,119,104,223
2,8,22,18,16,34
15,8,22,203,120,323
4,8,22,52,32,84
9,9,24,90,81,171
8,9,24,80,72,152
3,13,35,65,39,104
28,13,35,577,364,941
11,13,35,161,143,304
22,13,35,453,286,739
16,13,35,262,208,470
12,13,35,260,156,416
4,13,35,70,52,122
17,13,35,267,221,488
13,13,35,204,169,373
23,13,35,498,299,797
3,13,35,62,39,101
25,13,35,533,325,858
19,21,55,416,399,815
13,21,55,428,273,701
19,38,50,190,722,912
14,42,54,62,588,650
11,42,54,55,462,517
5,38,50,15,190,205
19,38,50,162,722,884
25,42,54,17,1050,1067
26,42,54,3,1092,1095
20,42,54,164,840,1004
2,38,50,11,76,87
1,1252,2295,745,1252,1997
1,420,769,249,420,669
1,295,540,148,295,443
1,420,769,249,420,669
1,420,769,188,420,608
1,1266,2320,544,1266,1810
1,1252,2295,630,1252,1882
1,1555,2443,839,1555,2394
1,2171,3578,1371,2171,3542
1,713,1120,385,713,1098
1,1519,2443,753,1519,2272
1,1555,2443,717,1555,2272
1,713,1120,329,713,1042
1,2171,3578,942,2171,3113
1,2171,3578,763,2171,2934
1,344,540,99,344,443
1,344,540,99,344,443
1,487,783,171,487,658
24,26,70,754,624,1378
15,26,70,650,390,1040
26,26,70,889,676,1565
16,26,70,558,416,974
16,26,70,693,416,1109
18,2,5,50,36,86
6,1,2,3,6,9
22,13,35,469,286,755
27,13,35,575,351,926
9,13,35,192,117,309
1,13,35,21,13,34
30,9,25,375,270,645
30,2,5,89,60,149
9,2,5,27,18,45
2,1,2,1,2,3
29,1,2,19,29,48
29,1,2,20,29,49
24,1,2,16,24,40
30,1,4,74,30,104
20,1,4,50,20,70
2,9,25,23,18,41
13,9,25,150,117,267
19,9,25,271,171,442
9,9,25,128,81,209
17,9,25,242,153,395
25,11,29,421,275,696
24,11,29,404,264,668
14,11,30,258,154,412
13,1,2,8,13,21
26,1,2,17,26,43
4,1,4,9,4,13
17,1,4,39,17,56
10,1,2,7,10,17
21,11,29,335,231,566
24,11,29,383,264,647
9,8,21,91,72,163
14,1,2,14,14,28
16,11,30,218,176,394
16,11,30,218,176,394
24,2,5,67,48,115
10,2,5,28,20,48
14,1,2,13,14,27
12,1,2,12,12,24
2,1,2,2,2,4
16,2,5,46,32,78
9,2,5,26,18,44
13,2,5,31,26,57
8,2,5,19,16,35
21,8,21,242,168,410
9,1,2,9,9,18
5,1,2,5,5,10
28,2,5,62,56,118
28,2,5,62,56,118
1,461,742,251,461,712
1,461,742,185,461,646
1,1482,2384,473,1482,1955
1,755,1215,436,755,1191
1,461,742,251,461,712
1,1482,2384,854,1482,2336
10,24,64,317,240,557
9,24,64,348,216,564
10,59,159,984,590,1574
23,2,5,48,46,94
11,2,5,23,22,45
11,4,10,40,44,84
11,4,10,40,44,84
20,2,5,42,40,82
10,2,5,21,20,41
26,2,5,61,52,113
3,2,5,7,6,13
30,2,5,87,60,147
6,2,5,17,12,29
30,2,5,80,60,140
17,2,5,33,34,67
1,2,5,2,2,4
4,2,5,9,8,17
25,2,5,74,50,124
3,2,5,9,6,15
27,2,5,76,54,130
17,3,9,81,51,132
5,3,9,24,15,39
13,2,5,36,26,62
28,2,5,78,56,134
3,2,5,7,6,13
15,2,5,35,30,65
15,7,9,6,105,111
10,7,9,18,70,88
26,7,9,50,182,232
20,7,9,8,140,148
1,3,8,5,3,8
20,3,8,66,60,126
22,8,22,245,176,421
4,9,24,59,36,95
10,9,24,97,90,187
8,9,24,74,72,146
2,9,24,29,18,47
20,9,24,281,180,461
20,9,24,295,180,475
20,13,35,314,260,574
13,13,35,254,169,423
7,13,35,152,91,243
27,13,35,556,351,907
17,13,35,267,221,488
4,13,35,54,52,106
9,13,35,195,117,312
1,13,35,21,13,34
4,13,35,78,52,130
17,13,35,243,221,464
18,13,35,390,234,624
2,13,35,31,26,57
11,13,35,192,143,335
28,21,55,921,588,1509
28,21,55,736,588,1324
8,38,50,92,304,396
20,38,50,230,760,990
12,42,54,1,504,505
12,38,50,132,456,588
25,42,54,111,1050,1161
10,38,50,55,380,435
14,38,50,154,532,686
1,1266,2320,892,1266,2158
1,1252,2295,676,1252,1928
1,1252,2295,1020,1252,2272
1,1252,2295,951,1252,2203
1,1266,2320,752,1266,2018
1,1266,2320,636,1266,1902
1,1266,2320,892,1266,2158
1,2171,3578,1371,2171,3542
1,2171,3578,1264,2171,3435
1,2171,3578,942,2171,3113
1,1083,1701,244,1083,1327
1,2171,3578,656,2171,2827
1,2171,3578,942,2171,3113
1,344,540,126,344,470
1,344,540,77,344,421
18,26,70,616,468,1084
18,3,9,106,54,160
11,3,9,53,33,86
16,1,2,16,16,32
16,1,2,16,16,32
16,1,2,16,16,32
12,13,35,260,156,416
2,1,2,2,2,4
28,1,2,27,28,55
5,1,2,4,5,9
3,1,2,2,3,5
18,1,2,13,18,31
27,12,33,531,324,855
6,1,2,4,6,10
28,1,2,20,28,48
4,11,30,75,44,119
24,2,5,70,48,118
28,2,5,81,56,137
23,2,5,68,46,114
29,2,5,86,58,144
23,2,5,68,46,114
2,2,5,6,4,10
12,11,30,142,132,274
28,11,30,330,308,638
24,1,2,18,24,42
27,1,2,20,27,47
5,1,2,4,5,9
10,11,29,160,110,270
24,2,5,71,48,119
20,2,5,59,40,99
15,1,2,14,15,29
4,1,2,4,4,8
16,2,5,47,32,79
7,2,5,21,14,35
6,1,4,18,6,24
23,1,4,68,23,91
5,1,4,14,5,19
30,1,2,17,30,47
16,1,2,9,16,25
24,2,5,56,48,104
26,2,5,61,52,113
10,1,4,28,10,38
12,1,4,34,12,46
5,1,4,14,5,19
30,2,5,87,60,147
27,2,5,78,54,132
25,1,2,23,25,48
18,1,2,17,18,35
20,1,2,19,20,39
17,1,2,16,17,33
20,1,2,13,20,33
7,2,5,13,14,27
11,2,5,21,22,43
30,2,5,63,60,123
16,2,5,34,32,66
6,2,5,13,12,25
6,2,5,17,12,29
1,1482,2384,807,1482,2289
1,461,742,103,461,564
1,461,742,177,461,638
1,1482,2384,854,1482,2336
8,24,64,300,192,492
7,3,9,33,21,54
29,2,5,64,58,122
13,2,5,29,26,55
15,4,10,57,60,117
11,4,10,42,44,86
29,2,5,86,58,144
29,2,5,84,58,142
24,2,5,71,48,119
30,2,5,89,60,149
20,2,5,59,40,99
27,2,5,80,54,134
11,2,5,26,22,48
3,3,9,14,9,23
15,3,9,71,45,116
16,2,5,31,32,63
10,7,9,8,70,78
18,7,9,-3,126,123
25,7,9,41,175,216
18,7,9,15,126,141
5,3,8,16,15,31
25,3,8,123,75,198
10,3,8,39,30,69
22,3,8,106,66,172
25,8,22,273,200,473
9,8,22,82,72,154
25,8,22,229,200,429
11,8,22,137,88,225
28,8,22,380,224,604
29,8,22,400,232,632
6,13,35,86,78,164
11,13,35,227,143,370
28,13,35,400,364,764
27,13,35,471,351,822
7,13,35,149,91,240
11,13,35,227,143,370
17,13,35,297,221,518
30,13,35,492,390,882
4,13,35,87,52,139
18,13,35,390,234,624
12,13,35,247,156,403
27,13,35,367,351,718
24,13,35,419,312,731
28,13,35,400,364,764
24,13,35,377,312,689
8,21,55,268,168,436
11,21,55,295,231,526
1,38,50,3,38,41
9,38,50,104,342,446
16,42,54,80,672,752
7,38,50,0,266,266
18,42,54,206,756,962
16,42,54,80,672,752
24,38,50,240,912,1152
14,42,54,70,588,658
12,42,54,60,504,564
1,1252,2295,722,1252,1974
1,1266,2320,752,1266,2018
1,1266,2320,1008,1266,2274
1,713,1120,138,713,851
1,487,783,194,487,681
1,2171,3578,942,2171,3113
1,2171,3578,835,2171,3006
1,1083,1701,601,1083,1684
1,344,540,174,344,518
1,344,540,83,344,427
1,2171,3578,906,2171,3077
14,26,70,410,364,774
7,26,70,244,182,426
25,3,9,119,75,194
9,3,9,43,27,70
18,2,5,53,36,89
19,2,5,56,38,94
17,13,35,279,221,500
24,13,35,394,312,706
18,13,35,295,234,529
26,1,2,25,26,51
25,11,29,356,275,631
19,2,5,36,38,74
23,2,5,64,46,110
24,2,5,67,48,115
16,2,5,30,32,62
4,1,4,11,4,15
15,1,2,15,15,30
27,1,2,26,27,53
1,2,5,3,2,5
21,2,5,62,42,104
4,2,5,12,8,20
10,1,2,7,10,17
14,1,2,10,14,24
22,1,2,20,22,42
8,1,2,7,8,15
8,9,25,102,72,174
28,9,25,357,252,609
1,1,2,1,1,2
29,1,2,28,29,57
24,8,21,241,192,433
28,8,21,282,224,506
17,8,21,171,136,307
14,2,5,25,28,53
7,1,2,4,7,11
24,1,2,15,24,39
29,2,5,61,58,119
1,2,5,2,2,4
18,1,2,17,18,35
2,1,2,2,2,4
29,8,21,353,232,585
14,8,21,170,112,282
1,461,742,185,461,646
1,461,742,185,461,646
12,24,64,357,288,645
30,24,64,778,720,1498
15,45,120,1053,675,1728
4,45,120,194,180,374
3,59,159,214,177,391
7,59,159,555,413,968
9,2,5,18,18,36
14,4,10,66,56,122
16,4,10,75,64,139
29,2,5,86,58,144
15,2,5,35,30,65
28,2,5,66,56,122
11,2,5,23,22,45
5,2,5,11,10,21
30,2,5,87,60,147
4,2,5,12,8,20
20,2,5,59,40,99
17,2,5,50,34,84
24,3,9,114,72,186
20,2,5,39,40,79
28,2,5,55,56,111
8,2,5,23,16,39
12,2,5,35,24,59
10,3,9,54,30,84
12,3,9,64,36,100
16,2,5,38,32,70
24,2,5,56,48,104
21,2,5,61,42,103
15,2,5,44,30,74
22,2,5,58,44,102
25,2,5,66,50,116
14,7,9,25,98,123
7,7,9,13,49,62
9,7,9,7,63,70
13,7,9,8,91,99
22,7,9,18,154,172
25,7,9,46,175,221
4,3,8,13,12,25
15,3,8,74,45,119
28,8,22,386,224,610
11,8,22,149,88,237
6,8,22,59,48,107
8,8,22,75,64,139
3,8,22,41,24,65
12,9,24,177,108,285
29,9,24,421,261,682
19,9,24,226,171,397
23,9,24,334,207,541
18,13,35,257,234,491
24,13,35,419,312,731
11,13,35,192,143,335
27,13,35,585,351,936
23,13,35,385,299,684
11,13,35,173,143,316
13,13,35,268,169,437
26,13,35,508,338,846
18,13,35,383,234,617
8,13,35,170,104,274
11,13,35,238,143,381
22,13,35,345,286,631
28,13,35,381,364,745
5,13,35,86,65,151
9,13,35,132,117,249
4,21,55,132,84,216
27,42,54,295,1134,1429
26,42,54,3,1092,1095
2,38,50,22,76,98
29,42,54,19,1218,1237
17,38,50,187,646,833
18,38,50,198,684,882
23,42,54,115,966,1081
15,38,50,83,570,653
1,1898,3375,836,1898,2734
1,1898,3375,768,1898,2666
1,1266,2320,892,1266,2158
1,420,769,249,420,669
1,1266,2320,961,1266,2227
1,2171,3578,1157,2171,3328
1,1555,2443,448,1555,2003
1,2171,3578,656,2171,2827
1,344,540,77,344,421
1,344,540,185,344,529
1,487,783,194,487,681
1,2171,3578,1335,2171,3506
29,26,70,1235,754,1989
8,26,70,341,208,549
7,3,9,41,21,62
11,2,5,21,22,43
29,2,5,55,58,113
24,2,5,50,48,98
15,2,5,32,30,62
6,1,2,5,6,11
28,1,2,24,28,52
10,1,2,9,10,19
20,12,33,301,240,541
12,12,33,181,144,325
2,2,5,6,4,10
25,2,5,74,50,124
23,2,5,64,46,110
21,2,5,59,42,101
17,12,33,284,204,488
15,12,33,251,180,431
19,11,30,236,209,445
30,2,5,68,60,128
5,2,5,11,10,21
2,2,5,4,4,8
26,2,5,55,52,107
11,9,25,140,99,239
20,9,25,255,180,435
16,1,2,15,16,31
11,11,30,156,121,277
19,2,5,45,38,83
6,2,5,14,12,26
5,2,5,15,10,25
2,2,5,6,4,10
4,2,5,12,8,20
14,2,5,41,28,69
29,2,5,84,58,142
5,1,2,5,5,10
23,1,4,67,23,90
22,1,2,22,22,44
9,1,2,9,9,18
15,1,2,11,15,26
19,1,4,47,19,66
21,1,4,52,21,73
28,1,4,82,28,110
15,2,5,44,30,74
22,1,4,55,22,77
3,1,4,7,3,10
1,1482,2384,807,1482,2289
1,1482,2384,330,1482,1812
1,1482,2384,854,1482,2336
1,1482,2384,854,1482,2336
1,1482,2384,854,1482,2336
30,24,64,1066,720,1786
6,24,64,167,144,311
3,45,120,218,135,353
6,45,120,436,270,706
22,2,5,42,44,86
20,2,5,38,40,78
14,2,5,41,28,69
7,2,5,21,14,35
7,2,5,13,14,27
5,2,5,12,10,22
9,2,5,17,18,35
24,2,5,56,48,104
25,2,5,59,50,109
22,2,5,48,44,92
29,2,5,64,58,122
26,4,10,146,104,250
11,4,10,62,44,106
20,2,5,44,40,84
6,2,5,13,12,25
5,4,10,19,20,39
17,3,9,99,51,150
27,2,5,78,54,132
18,2,5,52,36,88
2,2,5,6,4,10
12,2,5,35,24,59
18,2,5,52,36,88
3,2,5,9,6,15
24,7,9,9,168,177
18,7,9,34,126,160
20,7,9,17,140,157
12,7,9,22,84,106
9,7,9,16,63,79
3,7,9,1,21,22
3,7,9,0,21,21
14,7,9,12,98,110
18,3,8,71,54,125
24,3,8,78,72,150
5,3,8,24,15,39
17,8,22,178,136,314
25,8,22,339,200,539
11,8,22,144,88,232
17,9,24,239,153,392
12,9,24,120,108,228
19,9,24,276,171,447
27,9,24,327,243,570
18,9,24,201,162,363
16,13,35,229,208,437
27,13,35,575,351,926
16,13,35,279,208,487
19,13,35,405,247,652
6,13,35,98,78,176
27,13,35,386,351,737
1,13,35,22,13,35
8,13,35,173,104,277
22,13,35,453,286,739
18,13,35,283,234,517
1,13,35,21,13,34
20,13,35,286,260,546
12,13,35,260,156,416
28,13,35,440,364,804
20,13,35,286,260,546
16,13,35,251,208,459
7,13,35,125,91,216
16,13,35,262,208,470
19,21,55,625,399,1024
19,21,55,636,399,1035
3,21,55,79,63,142
15,42,54,75,630,705
10,38,50,110,380,490
6,38,50,69,228,297
13,38,50,13,494,507
16,42,54,80,672,752
5,42,54,17,210,227
25,42,54,17,1050,1067
9,38,50,90,342,432
6,42,54,14,252,266
15,38,50,60,570,630
27,38,50,162,1026,1188
1,1266,2320,683,1266,1949
1,420,769,334,420,754
1,1252,2295,997,1252,2249
1,1266,2320,1031,1266,2297
1,1266,2320,961,1266,2227
1,1252,2295,538,1252,1790
1,1266,2320,752,1266,2018
1,2171,3578,656,2171,2827
1,2171,3578,656,2171,2827
1,2171,3578,835,2171,3006
1,2171,3578,763,2171,2934
1,344,540,185,344,529
1,344,540,99,344,443
1,1083,1701,397,1083,1480
1,713,1120,172,713,885
27,26,70,1169,702,1871
10,26,70,286,260,546
11,26,70,322,286,608
25,3,9,103,75,178
7,13,35,149,91,240
9,13,35,192,117,309
10,2,5,29,20,49
2,2,5,6,4,10
29,2,5,81,58,139
24,2,5,67,48,115
6,1,2,6,6,12
14,1,2,14,14,28
7,9,25,89,63,152
24,9,25,306,216,522
17,9,25,196,153,349
2,2,5,6,4,10
18,9,25,194,162,356
2,9,25,22,18,40
26,13,35,554,338,892
8,2,5,18,16,34
30,2,5,69,60,129
29,2,5,77,58,135
10,1,2,9,10,19
5,2,5,10,10,20
16,11,30,294,176,470
29,11,30,534,319,853
30,2,5,89,60,149
4,2,5,12,8,20
25,2,5,74,50,124
3,9,25,38,27,65
17,9,25,217,153,370
19,1,2,10,19,29
9,2,5,27,18,45
13,2,5,38,26,64
23,9,25,357,207,564
12,9,25,186,108,294
29,1,2,20,29,49
27,1,2,19,27,46
16,1,2,12,16,28
28,8,21,288,224,512
1,8,21,10,8,18
23,2,5,54,46,100
23,11,30,285,253,538
25,11,30,310,275,585
24,11,30,442,264,706
25,11,30,460,275,735
2,12,33,33,24,57
17,11,29,217,187,404
27,11,29,345,297,642
6,2,5,16,12,28
21,2,5,50,42,92
17,2,5,41,34,75
23,2,5,44,46,90
13,2,5,25,26,51
4,1,2,3,4,7
7,1,2,6,7,13
1,1482,2384,878,1482,2360
1,755,1215,436,755,1191
1,1482,2384,378,1482,1860
14,24,64,497,336,833
18,24,64,478,432,910
3,45,120,221,135,356
2,45,120,119,90,209
8,59,159,596,472,1068
5,59,159,444,295,739
7,2,5,21,14,35
23,2,5,68,46,114
20,3,9,107,60,167
5,3,9,27,15,42
29,2,5,61,58,119
24,3,9,109,72,181
13,3,9,59,39,98
26,2,5,75,52,127
29,2,5,86,58,144
14,2,5,32,28,60
13,2,5,30,26,56
26,2,5,73,52,125
2,2,5,6,4,10
22,2,5,42,44,86
11,2,5,21,22,43
24,2,5,50,48,98
4,2,5,8,8,16
3,2,5,9,6,15
3,2,5,9,6,15
7,2,5,21,14,35
28,2,5,81,56,137
19,7,9,26,133,159
23,7,9,32,161,193
22,7,9,0,154,154
5,7,9,7,35,42
17,7,9,0,119,119
14,7,9,23,98,121
6,3,8,24,18,42
6,3,8,30,18,48
13,3,8,64,39,103
28,8,22,306,224,530
23,8,22,312,184,496
27,8,22,295,216,511
6,8,22,66,48,114
18,8,22,244,144,388
14,8,22,193,112,305
24,8,22,331,192,523
16,8,22,220,128,348
15,8,22,207,120,327
10,9,24,116,90,206
13,9,24,192,117,309
29,13,35,567,377,944
12,13,35,260,156,416
24,13,35,410,312,722
19,13,35,405,247,652
30,13,35,492,390,882
22,13,35,338,286,624
25,13,35,541,325,866
14,13,35,200,182,382
25,13,35,428,325,753
7,13,35,152,91,243
11,13,35,157,143,300
24,13,35,352,312,664
19,13,35,411,247,658
29,13,35,618,377,995
11,13,35,188,143,331
23,13,35,498,299,797
1,13,35,22,13,35
30,13,35,639,390,1029
24,13,35,469,312,781
15,13,35,320,195,515
3,13,35,64,39,103
23,13,35,401,299,700
3,21,55,100,63,163
20,21,55,669,420,1089
25,38,50,125,950,1075
10,42,54,23,420,443
20,38,50,230,760,990
1,42,54,2,42,44
18,38,50,153,684,837
19,38,50,219,722,941
12,42,54,131,504,635
6,42,54,69,252,321
10,38,50,10,380,390
10,38,50,55,380,435
1,1252,2295,722,1252,1974
1,1252,2295,1020,1252,2272
1,1266,2320,892,1266,2158
1,1252,2295,722,1252,1974
1,1252,2295,722,1252,1974
1,295,540,223,295,518
1,420,769,334,420,754
1,1266,2320,1008,1266,2274
1,420,769,318,420,738
1,1252,2295,882,1252,2134
1,1252,2295,997,1252,2249
1,420,769,211,420,631
1,1252,2295,538,1252,1790
1,2171,3578,1157,2171,3328
1,1519,2443,900,1519,2419
1,713,1120,396,713,1109
1,2171,3578,727,2171,2898
1,1083,1701,499,1083,1582
1,2171,3578,656,2171,2827
1,2171,3578,835,2171,3006
1,344,540,120,344,464
1,713,1120,161,713,874
1,2171,3578,835,2171,3006
1,344,540,77,344,421
1,344,540,185,344,529
1,713,1120,362,713,1075
1,1083,1701,397,1083,1480
1,713,1120,329,713,1042
25,26,70,1065,650,1715
30,26,70,1278,780,2058
4,26,70,137,104,241
9,26,70,383,234,617
19,3,9,90,57,147
5,3,9,30,15,45
12,3,9,68,36,104
27,2,5,80,54,134
28,2,5,83,56,139
9,2,5,27,18,45
2,1,2,1,2,3
18,11,30,337,198,535
13,1,2,12,13,25
6,1,2,6,6,12
2,1,2,1,2,3
9,1,2,5,9,14
27,1,2,16,27,43
27,11,29,431,297,728
29,11,29,463,319,782
21,9,25,242,189,431
9,9,25,104,81,185
3,9,25,35,27,62
11,1,4,23,11,34
30,1,2,29,30,59
21,1,2,21,21,42
14,1,2,14,14,28
24,12,33,361,288,649
12,1,2,9,12,21
18,1,2,13,18,31
29,1,2,20,29,49
21,1,2,14,21,35
2,1,4,6,2,8
6,1,4,18,6,24
7,11,30,129,77,206
16,11,30,294,176,470
10,2,5,30,20,50
10,2,5,30,20,50
12,1,2,12,12,24
1,13,35,15,13,28
15,13,35,220,195,415
13,1,4,28,13,41
3,1,4,6,3,9
28,1,2,26,28,54
24,2,5,71,48,119
28,2,5,83,56,139
11,1,4,31,11,42
23,1,4,65,23,88
10,2,5,23,20,43
7,2,5,16,14,30
6,1,4,16,6,22
7,2,5,16,14,30
16,2,5,37,32,69
10,2,5,29,20,49
5,2,5,15,10,25
1,1,2,1,1,2
18,11,29,256,198,454
16,9,25,228,144,372
18,9,25,257,162,419
14,9,25,200,126,326
6,1,4,17,6,23
20,9,25,310,180,490
13,9,25,202,117,319
1,1482,2384,473,1482,1955
1,755,1215,436,755,1191
1,1482,2384,521,1482,2003
19,24,64,565,456,1021
3,45,120,146,135,281
10,45,120,486,450,936
14,2,5,39,28,67
8,2,5,22,16,38
12,2,5,34,24,58
12,2,5,35,24,59
30,2,5,89,60,149
9,2,5,27,18,45
30,2,5,87,60,147
6,2,5,18,12,30
15,2,5,44,30,74
27,2,5,72,54,126
14,2,5,37,28,65
22,4,10,130,88,218
18,4,10,106,72,178
9,2,5,19,18,37
24,2,5,50,48,98
2,2,5,6,4,10
17,2,5,50,34,84
23,7,9,9,161,170
6,7,9,11,42,53
14,7,9,12,98,110
8,7,9,2,56,58
27,7,9,44,189,233
15,7,9,27,105,132
24,7,9,20,168,188
5,7,9,8,35,43
12,7,9,5,84,89
16,7,9,31,112,143
22,3,8,87,66,153
3,3,8,15,9,24
17,3,8,55,51,106
7,8,22,64,56,120
1,8,22,9,8,17
10,8,22,98,80,178
30,8,22,334,240,574
7,9,24,102,63,165
20,9,24,194,180,374
28,9,24,407,252,659
15,9,24,221,135,356
19,9,24,280,171,451
4,9,24,47,36,83
9,13,35,132,117,249
22,13,35,384,286,670
15,13,35,325,195,520
23,13,35,490,299,789
6,13,35,94,78,172
18,13,35,383,234,617
14,13,35,288,182,470
18,13,35,390,234,624
10,13,35,175,130,305
30,13,35,471,390,861
21,13,35,322,273,595
24,13,35,410,312,722
27,13,35,556,351,907
17,13,35,249,221,470
1,13,35,21,13,34
5,13,35,103,65,168
24,13,35,494,312,806
6,13,35,128,78,206
20,13,35,286,260,546
13,21,55,435,273,708
12,21,55,382,252,634
1,21,55,22,21,43
9,42,54,103,378,481
3,42,54,15,126,141
30,38,50,90,1140,1230
3,38,50,9,114,123
25,42,54,287,1050,1337
16,38,50,40,608,648
24,38,50,132,912,1044
10,42,54,50,420,470
20,42,54,67,840,907
20,38,50,230,760,990
1,42,54,11,42,53
1,1252,2295,538,1252,1790
1,1252,2295,882,1252,2134
1,295,540,148,295,443
1,1266,2320,961,1266,2227
1,1266,2320,961,1266,2227
1,308,565,251,308,559
1,2171,3578,1264,2171,3435
1,2171,3578,763,2171,2934
1,1555,2443,864,1555,2419
1,1555,2443,790,1555,2345
1,2171,3578,656,2171,2827
1,1083,1701,601,1083,1684
1,1083,1701,397,1083,1480
1,344,540,185,344,529
1,713,1120,261,713,974
1,2171,3578,1335,2171,3506
1,713,1120,329,713,1042
28,26,70,1212,728,1940
20,3,9,80,60,140
16,1,2,16,16,32
25,1,2,25,25,50
9,2,5,26,18,44
25,2,5,73,50,123
29,2,5,84,58,142
19,1,2,18,19,37
10,1,2,10,10,20
21,12,33,392,252,644
27,1,2,15,27,42
25,2,5,74,50,124
7,2,5,21,14,35
19,9,25,242,171,413
29,9,25,370,261,631
15,2,5,42,30,72
19,1,2,16,19,35
23,1,4,65,23,88
9,1,4,26,9,35
24,12,33,401,288,689
20,12,33,334,240,574
12,1,2,11,12,23
24,1,2,22,24,46
8,1,2,7,8,15
23,1,4,52,23,75
27,11,30,335,297,632
15,11,30,186,165,351
30,1,2,29,30,59
16,1,2,15,16,31
18,12,33,283,216,499
28,12,33,440,336,776
12,1,4,35,12,47
6,1,4,18,6,24
12,1,2,7,12,19
30,1,2,17,30,47
11,2,5,31,22,53
21,2,5,59,42,101
7,2,5,16,14,30
5,2,5,12,10,22
27,2,5,63,54,117
1,1482,2384,401,1482,1883
1,461,742,147,461,608
1,755,1215,266,755,1021
1,755,1215,436,755,1191
1,1482,2384,473,1482,1955
1,461,742,274,461,735
1,461,742,274,461,735
5,45,120,369,225,594
19,2,5,53,38,91
8,4,10,47,32,79
4,2,5,9,8,17
5,2,5,15,10,25
26,2,5,77,52,129
14,2,5,41,28,69
16,2,5,46,32,78
5,2,5,15,10,25
10,2,5,30,20,50
9,2,5,20,18,38
9,2,5,20,18,38
1,2,5,2,2,4
22,2,5,46,44,90
23,2,5,53,46,99
17,2,5,39,34,73
3,2,5,7,6,13
30,2,5,71,60,131
28,2,5,66,56,122
16,2,5,34,32,66
3,2,5,6,6,12
26,3,9,119,78,197
12,7,9,7,84,91
4,7,9,2,28,30
11,7,9,4,77,81
5,7,9,4,35,39
16,3,8,62,48,110
7,3,8,34,21,55
22,3,8,87,66,153
11,3,8,44,33,77
15,8,22,164,120,284
9,8,22,104,72,176
1,8,22,14,8,22
22,8,22,274,176,450
26,8,22,238,208,446
4,8,22,54,32,86
19,9,24,276,171,447
5,9,24,59,45,104
10,9,24,148,90,238
1,13,35,21,13,34
5,13,35,107,65,172
9,13,35,132,117,249
21,13,35,433,273,706
14,13,35,244,182,426
26,13,35,536,338,874
2,13,35,34,26,60
6,13,35,128,78,206
2,13,35,34,26,60
14,13,35,298,182,480
9,13,35,192,117,309
8,13,35,140,104,244
2,13,35,43,26,69
24,13,35,511,312,823
29,13,35,455,377,832
22,13,35,315,286,601
22,21,55,579,462,1041
4,21,55,132,84,216
30,21,55,756,630,1386
25,38,50,25,950,975
24,38,50,276,912,1188
8,42,54,87,336,423
10,38,50,55,380,435
15,38,50,38,570,608
25,42,54,273,1050,1323
29,42,54,317,1218,1535
4,38,50,0,152,152
1,1266,2320,799,1266,2065
1,1252,2295,1020,1252,2272
1,1252,2295,745,1252,1997
1,295,540,234,295,529
1,2171,3578,942,2171,3113
1,1083,1701,550,1083,1633
1,2171,3578,835,2171,3006
1,713,1120,250,713,963
1,344,540,99,344,443
1,344,540,120,344,464
1,713,1120,261,713,974
1,344,540,185,344,529
1,713,1120,194,713,907
1,1519,2443,900,1519,2419
2,26,70,82,52,134
26,26,70,907,676,1583
5,26,70,213,130,343
10,26,70,426,260,686
9,26,70,245,234,479
17,3,9,96,51,147
7,3,9,34,21,55
11,3,9,64,33,97
19,1,2,15,19,34
19,1,2,19,19,38
19,1,2,19,19,38
14,1,2,13,14,27
15,1,2,14,15,29
19,13,35,411,247,658
22,13,35,476,286,762
14,11,30,262,154,416
3,11,30,56,33,89
17,13,35,332,221,553
18,12,33,271,216,487
9,12,33,136,108,244
9,1,2,5,9,14
24,1,2,13,24,37
10,2,5,30,20,50
4,2,5,12,8,20
16,2,5,47,32,79
22,2,5,62,44,106
16,2,5,45,32,77
22,1,2,14,22,36
21,2,5,59,42,101
22,1,2,16,22,38
13,2,5,38,26,64
19,2,5,55,38,93
16,9,25,248,144,392
14,2,5,33,28,61
5,1,2,5,5,10
19,1,2,17,19,36
11,2,5,32,22,54
22,2,5,52,44,96
20,2,5,47,40,87
27,2,5,51,54,105
26,2,5,53,52,105
17,2,5,35,34,69
28,1,2,27,28,55
15,1,2,14,15,29
5,8,21,63,40,103
9,1,2,5,9,14
26,1,2,15,26,41
28,2,5,78,56,134
8,2,5,22,16,38
12,1,4,29,12,41
1,1482,2384,592,1482,2074
1,461,742,147,461,608
15,24,64,590,360,950
2,59,159,130,118,248
7,59,159,678,413,1091
18,2,5,35,36,71
17,2,5,33,34,67
15,2,5,44,30,74
11,2,5,32,22,54
4,4,10,22,16,38
27,4,10,151,108,259
10,2,5,19,20,39
23,2,5,48,46,94
16,4,10,67,64,131
25,4,10,95,100,195
20,4,10,76,80,156
24,2,5,56,48,104
29,2,5,68,58,126
7,2,5,13,14,27
7,2,5,13,14,27
6,2,5,18,12,30
26,2,5,61,52,113
8,2,5,19,16,35
26,2,5,61,52,113
7,2,5,16,14,30
9,7,9,7,63,70
27,3,8,131,81,212
4,3,8,19,12,31
5,3,8,23,15,38
26,8,22,353,208,561
15,8,22,151,120,271
5,8,22,46,40,86
12,8,22,163,96,259
26,8,22,358,208,566
26,8,22,358,208,566
21,9,24,305,189,494
13,9,24,154,117,271
6,9,24,67,54,121
9,13,35,141,117,258
7,13,35,122,91,213
16,13,35,262,208,470
12,13,35,256,156,412
16,13,35,313,208,521
12,13,35,260,156,416
21,13,35,366,273,639
11,13,35,173,143,316
20,13,35,286,260,546
17,13,35,368,221,589
16,13,35,251,208,459
25,13,35,436,325,761
24,13,35,410,312,722
1,13,35,17,13,30
19,13,35,332,247,579
1,13,35,21,13,34
13,13,35,186,169,355
26,13,35,390,338,728
2,21,55,67,42,109
22,21,55,724,462,1186
10,42,54,44,420,464
7,38,50,77,266,343
26,38,50,130,988,1118
1,1252,2295,676,1252,1928
1,308,565,155,308,463
1,1252,2295,997,1252,2249
1,1252,2295,997,1252,2249
1,1266,2320,636,1266,1902
1,1266,2320,1008,1266,2274
1,2171,3578,763,2171,2934
1,1519,2443,753,1519,2272
1,2171,3578,942,2171,3113
1,2171,3578,835,2171,3006
1,2171,3578,942,2171,3113
1,344,540,77,344,421
1,1555,2443,375,1555,1930
1,1555,2443,570,1555,2125
1,344,540,77,344,421
1,713,1120,261,713,974
1,2171,3578,1335,2171,3506
1,1519,2443,900,1519,2419
1,1083,1701,550,1083,1633
17,26,70,462,442,904
4,2,5,12,8,20
7,2,5,21,14,35
11,13,35,238,143,381
16,13,35,346,208,554
24,2,5,70,48,118
1,2,5,3,2,5
9,1,2,5,9,14
18,1,2,10,18,28
6,1,2,3,6,9
26,11,29,415,286,701
15,1,2,10,15,25
26,1,2,18,26,44
23,9,25,362,207,569
21,9,25,331,189,520
11,1,2,9,11,20
1,1,2,1,1,2
3,1,2,3,3,6
2,2,5,5,4,9
9,1,2,9,9,18
12,1,2,12,12,24
30,2,5,69,60,129
20,2,5,46,40,86
25,1,2,18,25,43
19,1,2,18,19,37
12,1,2,12,12,24
24,2,5,67,48,115
9,2,5,25,18,43
30,8,21,377,240,617
11,8,21,138,88,226
3,2,5,9,6,15
8,2,5,23,16,39
19,2,5,55,38,93
17,1,4,50,17,67
23,1,4,67,23,90
11,1,4,32,11,43
2,8,21,25,16,41
23,8,21,289,184,473
18,1,2,11,18,29
7,1,2,4,7,11
21,2,5,46,42,88
2,2,5,4,4,8
11,2,5,32,22,54
7,2,5,20,14,34
1,461,742,185,461,646
1,1482,2384,807,1482,2289
1,1482,2384,854,1482,2336
1,1482,2384,854,1482,2336
30,24,64,1181,720,1901
28,45,120,1865,1260,3125
2,59,159,187,118,305
17,4,10,100,68,168
15,4,10,57,60,117
29,4,10,162,116,278
10,4,10,56,40,96
2,2,5,5,4,9
13,2,5,25,26,51
8,3,9,39,24,63
9,3,9,43,27,70
1,2,5,3,2,5
13,2,5,34,26,60
21,2,5,61,42,103
9,2,5,19,18,37
2,3,9,11,6,17
11,3,9,59,33,92
4,2,5,11,8,19
28,2,5,78,56,134
29,2,5,84,58,142
27,2,5,78,54,132
17,2,5,50,34,84
7,2,5,21,14,35
3,7,9,0,21,21
11,7,9,21,77,98
25,7,9,41,175,216
30,7,9,41,210,251
25,7,9,3,175,178
4,3,8,20,12,32
18,3,8,58,54,112
18,8,22,169,144,313
15,8,22,203,120,323
16,8,22,217,128,345
27,9,24,399,243,642
1,9,24,14,9,23
11,9,24,162,99,261
30,9,24,335,270,605
13,9,24,189,117,306
18,9,24,266,162,428
4,13,35,78,52,130
13,13,35,227,169,396
5,13,35,103,65,168
25,13,35,541,325,866
14,13,35,288,182,470
23,13,35,474,299,773
30,13,35,639,390,1029
8,13,35,114,104,218
15,13,35,309,195,504
2,13,35,41,26,67
21,13,35,433,273,706
20,13,35,328,260,588
14,13,35,298,182,480
28,13,35,440,364,804
21,13,35,366,273,639
26,13,35,536,338,874
24,13,35,520,312,832
15,13,35,204,195,399
25,13,35,393,325,718
11,13,35,157,143,300
8,13,35,165,104,269
6,13,35,86,78,164
15,13,35,257,195,452
23,21,55,769,483,1252
17,42,54,167,714,881
22,42,54,15,924,939
17,42,54,167,714,881
8,38,50,24,304,328
13,38,50,13,494,507
17,38,50,196,646,842
9,38,50,90,342,432
6,42,54,14,252,266
5,42,54,22,210,232
25,42,54,125,1050,1175
26,38,50,286,988,1274
17,42,54,140,714,854
4,42,54,44,168,212
27,42,54,295,1134,1429
1,1912,3400,774,1912,2686
1,1912,3400,1046,1912,2958
1,1266,2320,892,1266,2158
1,1266,2320,683,1266,1949
1,1252,2295,951,1252,2203
1,1252,2295,997,1252,2249
1,295,540,169,295,464
1,1555,2443,790,1555,2345
1,2171,3578,942,2171,3113
1,2171,3578,656,2171,2827
1,2171,3578,942,2171,3113
1,1555,2443,351,1555,1906
1,344,540,77,344,421
1,344,540,126,344,470
1,713,1120,329,713,1042
1,344,540,174,344,518
1,1083,1701,397,1083,1480
1,713,1120,329,713,1042
1,344,540,66,344,410
27,26,70,1150,702,1852
30,3,9,175,90,265
2,9,25,22,18,40
21,2,5,40,42,82
7,2,5,13,14,27
26,2,5,49,52,101
16,2,5,30,32,62
14,1,2,13,14,27
8,1,2,7,8,15
24,2,5,67,48,115
10,2,5,28,20,48
5,1,2,5,5,10
7,11,29,118,77,195
14,11,29,236,154,390
14,1,4,33,14,47
8,2,5,17,16,33
27,2,5,57,54,111
6,2,5,13,12,25
8,12,33,126,96,222
29,12,33,456,348,804
6,1,4,14,6,20
2,13,35,29,26,55
18,1,2,18,18,36
24,1,2,22,24,46
12,2,5,35,24,59
24,2,5,70,48,118
1,2,5,3,2,5
3,2,5,9,6,15
11,2,5,32,22,54
15,8,21,154,120,274
26,8,21,267,208,475
15,9,25,191,135,326
25,9,25,319,225,544
12,9,25,153,108,261
23,2,5,41,46,87
5,2,5,9,10,19
26,11,30,478,286,764
27,11,30,497,297,794
23,1,2,17,23,40
19,2,5,53,38,91
20,2,5,56,40,96
21,2,5,61,42,103
18,2,5,52,36,88
19,1,4,54,19,73
19,1,4,54,19,73
30,2,5,57,60,117
22,2,5,42,44,86
24,1,4,70,24,94
19,1,4,55,19,74
19,1,2,11,19,30
17,1,2,16,17,33
21,1,2,20,21,41
16,1,2,15,16,31
25,1,2,24,25,49
14,1,2,14,14,28
16,1,2,16,16,32
14,1,2,14,14,28
1,1482,2384,807,1482,2289
1,755,1215,375,755,1130
6,45,120,356,270,626
18,3,9,79,54,133
23,3,9,101,69,170
28,2,5,66,56,122
13,2,5,31,26,57
25,2,5,73,50,123
17,2,5,49,34,83
11,4,10,42,44,86
25,2,5,73,50,123
16,2,5,35,32,67
15,2,5,44,30,74
24,7,9,0,168,168
16,7,9,6,112,118
20,7,9,33,140,173
3,7,9,5,21,26
28,7,9,46,196,242
13,7,9,5,91,96
4,3,8,19,12,31
25,8,22,218,200,418
19,9,24,203,171,374
10,9,24,97,90,187
6,9,24,87,54,141
25,9,24,285,225,510
15,9,24,167,135,302
28,13,35,400,364,764
24,13,35,377,312,689
7,13,35,144,91,235
14,13,35,200,182,382
29,13,35,476,377,853
3,13,35,64,39,103
26,13,35,554,338,892
3,13,35,65,39,104
4,13,35,85,52,137
25,13,35,410,325,735
15,13,35,246,195,441
28,13,35,440,364,804
19,13,35,411,247,658
23,13,35,474,299,773
24,13,35,494,312,806
28,13,35,489,364,853
18,13,35,283,234,517
3,13,35,62,39,101
10,13,35,206,130,336
23,13,35,361,299,660
28,21,55,675,588,1263
1,21,55,33,21,54
11,21,55,229,231,460
27,21,55,591,567,1158
13,42,54,58,546,604
18,42,54,60,756,816
27,38,50,297,1026,1323
9,42,54,30,378,408
18,38,50,99,684,783
18,42,54,41,756,797
22,42,54,74,924,998
1,1898,3375,870,1898,2768
1,1252,2295,745,1252,1997
1,1252,2295,538,1252,1790
1,1912,3400,876,1912,2788
1,420,769,211,420,631
1,1252,2295,538,1252,1790
1,1912,3400,1420,1912,3332
1,2171,3578,906,2171,3077
1,2171,3578,835,2171,3006
1,344,540,174,344,518
1,713,1120,362,713,1075
1,713,1120,205,713,918
18,26,70,565,468,1033
27,26,70,772,702,1474
27,26,70,772,702,1474
4,26,70,114,104,218
19,26,70,809,494,1303
3,26,70,130,78,208
12,3,9,55,36,91
18,3,9,106,54,160
16,2,5,30,32,62
14,1,2,13,14,27
8,1,2,8,8,16
12,9,25,153,108,261
10,9,25,128,90,218
13,2,5,36,26,62
15,1,2,15,15,30
16,1,4,34,16,50
11,1,4,23,11,34
6,2,5,17,12,29
18,2,5,50,36,86
28,2,5,78,56,134
28,12,33,579,336,915
23,12,33,475,276,751
26,1,2,24,26,50
3,1,2,2,3,5
18,1,2,12,18,30
3,2,5,9,6,15
14,2,5,41,28,69
11,1,2,11,11,22
25,1,2,16,25,41
6,12,33,90,72,162
11,12,33,166,132,298
1,12,33,15,12,27
10,11,30,178,110,288
6,1,2,3,6,9
3,1,2,2,3,5
28,8,21,252,224,476
8,1,2,8,8,16
28,11,29,398,308,706
28,11,29,398,308,706
10,2,5,28,20,48
9,2,5,25,18,43
5,1,2,4,5,9
1,1482,2384,878,1482,2360
1,1482,2384,854,1482,2336
1,1482,2384,521,1482,2003
6,45,120,320,270,590
24,2,5,67,48,115
2,2,5,6,4,10
15,3,9,87,45,132
9,3,9,52,27,79
30,2,5,87,60,147
19,2,5,55,38,93
6,2,5,16,12,28
25,2,5,53,50,103
1,2,5,2,2,4
21,3,9,86,63,149
8,3,9,33,24,57
14,2,5,29,28,57
6,7,9,11,42,53
13,7,9,11,91,102
6,7,9,2,42,44
4,3,8,13,12,25
5,3,8,24,15,39
8,3,8,27,24,51
18,8,22,197,144,341
18,8,22,248,144,392
22,9,24,293,198,491
19,9,24,203,171,374
6,13,35,124,78,202
16,13,35,229,208,437
16,13,35,330,208,538
11,13,35,238,143,381
30,13,35,618,390,1008
1,13,35,14,13,27
3,13,35,43,39,82
16,13,35,330,208,538
22,21,55,663,462,1125
20,21,55,603,420,1023
30,21,55,674,630,1304
4,21,55,132,84,216
13,38,50,39,494,533
16,38,50,88,608,696
4,38,50,46,152,198
1,1266,2320,636,1266,1902
1,1252,2295,997,1252,2249
1,1266,2320,961,1266,2227
1,295,540,240,295,535
1,2171,3578,942,2171,3113
1,487,783,155,487,642
1,713,1120,385,713,1098
1,487,783,241,487,728
1,1519,2443,606,1519,2125
1,1083,1701,397,1083,1480
1,2171,3578,1371,2171,3542
1,1083,1701,550,1083,1633
1,1083,1701,261,1083,1344
1,2171,3578,1335,2171,3506
1,2171,3578,1335,2171,3506
27,26,70,1150,702,1852
2,26,70,85,52,137
9,26,70,314,234,548
21,3,9,100,63,163
5,3,9,30,15,45
13,3,9,62,39,101
17,13,35,243,221,464
24,13,35,343,312,655
25,13,35,358,325,683
23,1,2,15,23,38
26,1,2,17,26,43
17,2,5,48,34,82
7,2,5,20,14,34
7,1,4,20,7,27
16,1,4,45,16,61
19,13,35,405,247,652
17,13,35,362,221,583
20,11,30,374,220,594
13,11,30,243,143,386
2,11,30,25,22,47
3,11,30,37,33,70
25,2,5,66,50,116
2,2,5,5,4,9
28,1,4,69,28,97
18,1,4,45,18,63
3,2,5,8,6,14
13,11,30,177,143,320
7,11,30,95,77,172
1,13,35,21,13,34
13,2,5,34,26,60
14,2,5,37,28,65
22,1,2,12,22,34
9,1,2,5,9,14
4,2,5,8,8,16
24,2,5,43,48,91
9,1,2,7,9,16
28,1,2,15,28,43
8,1,2,5,8,13
12,1,2,9,12,21
9,1,2,6,9,15
11,1,4,32,11,43
26,1,4,76,26,102
2,9,25,26,18,44
3,1,4,9,3,12
1,1482,2384,807,1482,2289
1,1482,2384,807,1482,2289
1,755,1215,193,755,948
5,45,120,243,225,468
1,2,5,2,2,4
19,2,5,36,38,74
28,2,5,66,56,122
29,2,5,68,58,126
18,2,5,52,36,88
26,2,5,75,52,127
21,2,5,61,42,103
26,2,5,75,52,127
30,2,5,80,60,140
15,3,9,87,45,132
12,2,5,34,24,58
15,2,5,44,30,74
9,2,5,26,18,44
16,2,5,46,32,78
5,7,9,10,35,45
22,7,9,42,154,196
26,7,9,50,182,232
29,7,9,24,203,227
16,7,9,2,112,114
19,3,8,63,57,120
3,8,22,30,24,54
12,8,22,163,96,259
29,8,22,393,232,625
9,8,22,100,72,172
15,8,22,167,120,287
24,9,24,354,216,570
19,9,24,226,171,397
8,9,24,116,72,188
7,9,24,102,63,165
19,13,35,325,247,572
25,13,35,533,325,858
1,13,35,22,13,35
18,13,35,314,234,548
12,13,35,205,156,361
28,13,35,606,364,970
2,13,35,35,26,61
5,13,35,103,65,168
16,13,35,346,208,554
25,13,35,533,325,858
27,13,35,585,351,936
8,13,35,170,104,274
16,13,35,341,208,549
28,13,35,577,364,941
27,13,35,424,351,775
11,38,50,127,418,545
6,42,54,27,252,279
21,38,50,231,798,1029
11,42,54,126,462,588
19,38,50,219,722,941
18,38,50,54,684,738
12,42,54,40,504,544
16,38,50,184,608,792
26,42,54,17,1092,1109
8,38,50,44,304,348
1,1252,2295,538,1252,1790
1,420,769,334,420,754
1,420,769,334,420,754
1,1252,2295,676,1252,1928
1,295,540,234,295,529
1,1266,2320,1008,1266,2274
1,713,1120,396,713,1109
1,1083,1701,550,1083,1633
1,2171,3578,656,2171,2827
1,2171,3578,942,2171,3113
1,713,1120,396,713,1109
1,344,540,174,344,518
1,2171,3578,1371,2171,3542
1,1083,1701,312,1083,1395
1,1083,1701,261,1083,1344
15,26,70,650,390,1040
18,26,70,779,468,1247
18,26,70,628,468,1096
1,3,9,5,3,8
28,3,9,158,84,242
10,1,2,7,10,17
6,2,5,14,12,26
12,13,35,256,156,412
13,13,35,277,169,446
29,1,4,86,29,115
9,2,5,26,18,44
25,2,5,73,50,123
11,2,5,31,22,53
23,1,2,20,23,43
7,1,2,6,7,13
19,2,5,53,38,91
1,1,2,1,1,2
9,1,2,7,9,16
22,2,5,64,44,108
7,2,5,20,14,34
27,1,2,19,27,46
9,1,2,6,9,15
15,1,2,13,15,28
28,2,5,83,56,139
22,2,5,65,44,109
30,2,5,89,60,149
29,1,2,19,29,48
15,2,5,44,30,74
25,2,5,74,50,124
1,1,2,1,1,2
8,1,2,6,8,14
11,1,2,8,11,19
19,8,21,175,152,327
2,8,21,18,16,34
13,1,2,7,13,20
6,1,2,3,6,9
17,2,5,32,34,66
6,2,5,11,12,23
21,1,2,15,21,36
23,1,2,17,23,40
24,1,4,59,24,83
13,1,4,32,13,45
24,2,5,56,48,104
18,2,5,52,36,88
8,1,4,23,8,31
1,1482,2384,401,1482,1883
1,1482,2384,807,1482,2289
1,755,1215,241,755,996
8,24,64,300,192,492
8,45,120,581,360,941
1,59,159,98,59,157
26,2,5,59,52,111
4,2,5,9,8,17
30,2,5,57,60,117
5,2,5,10,10,20
26,2,5,61,52,113
23,2,5,54,46,100
14,2,5,32,28,60
13,2,5,30,26,56
8,2,5,18,16,34
11,2,5,23,22,45
6,2,5,12,12,24
24,2,5,59,48,107
18,2,5,52,36,88
10,3,9,58,30,88
19,2,5,39,38,77
26,7,9,43,182,225
20,7,9,8,140,148
20,7,9,6,140,146
22,7,9,22,154,176
30,7,9,22,210,232
14,7,9,23,98,121
8,3,8,28,24,52
27,3,8,100,81,181
13,3,8,45,39,84
14,8,22,131,112,243
18,8,22,165,144,309
10,8,22,111,80,191
25,8,22,345,200,545
7,9,24,70,63,133
7,9,24,81,63,144
29,13,35,415,377,792
26,13,35,372,338,710
11,13,35,227,143,370
19,13,35,272,247,519
27,13,35,585,351,936
4,13,35,63,52,115
18,13,35,383,234,617
8,13,35,173,104,277
3,13,35,64,39,103
14,13,35,303,182,485
9,13,35,195,117,312
17,13,35,362,221,583
17,13,35,297,221,518
14,13,35,244,182,426
18,13,35,371,234,605
28,13,35,489,364,853
27,13,35,462,351,813
8,21,55,215,168,383
3,42,54,33,126,159
19,42,54,13,798,811
24,38,50,264,912,1176
3,42,54,30,126,156
16,42,54,175,672,847
17,42,54,75,714,789
16,38,50,80,608,688
2,42,54,20,84,104
15,38,50,150,570,720
1,1912,3400,774,1912,2686
1,1912,3400,944,1912,2856
1,1252,2295,607,1252,1859
1,1266,2320,544,1266,1810
1,1252,2295,722,1252,1974
1,295,540,148,295,443
1,420,769,318,420,738
1,1252,2295,630,1252,1882
1,1555,2443,839,1555,2394
1,713,1120,385,713,1098
1,2171,3578,656,2171,2827
1,2171,3578,727,2171,2898
1,487,783,194,487,681
1,1519,2443,533,1519,2052
1,344,540,174,344,518
1,713,1120,194,713,907
1,713,1120,172,713,885
1,2171,3578,1335,2171,3506
11,26,70,376,286,662
21,26,70,718,546,1264
3,26,70,101,78,179
15,26,70,471,390,861
11,3,9,64,33,97
29,3,9,164,87,251
11,1,2,9,11,20
7,1,2,6,7,13
30,2,5,84,60,144
20,2,5,56,40,96
18,2,5,50,36,86
27,1,2,25,27,52
20,1,2,18,20,38
28,1,2,15,28,43
26,1,2,14,26,40
21,2,5,62,42,104
17,9,25,183,153,336
28,1,2,27,28,55
10,1,4,28,10,38
5,1,4,14,5,19
6,1,2,6,6,12
25,1,2,25,25,50
2,2,5,6,4,10
8,2,5,22,16,38
25,13,35,533,325,858
23,13,35,490,299,789
5,1,4,12,5,17
1,1,2,1,1,2
6,1,2,6,6,12
23,2,5,67,46,113
23,2,5,67,46,113
26,11,30,478,286,764
11,11,30,202,121,323
2,1,2,1,2,3
24,1,2,18,24,42
26,1,2,17,26,43
30,1,2,19,30,49
28,1,2,18,28,46
28,1,4,66,28,94
26,2,5,77,52,129
15,1,2,15,15,30
28,1,2,27,28,55
9,11,30,168,99,267
4,11,30,75,44,119
10,11,30,187,110,297
14,8,21,170,112,282
20,12,33,295,240,535
30,12,33,442,360,802
4,1,2,4,4,8
21,1,2,21,21,42
8,1,2,4,8,12
14,1,2,8,14,22
20,2,5,47,40,87
14,2,5,33,28,61
14,1,2,14,14,28
8,1,2,8,8,16
29,1,2,21,29,50
29,1,2,21,29,50
1,1,2,1,1,2
21,1,2,16,21,37
25,2,5,59,50,109
19,2,5,45,38,83
1,2,5,2,2,4
11,1,2,11,11,22
24,8,21,292,192,484
22,1,4,54,22,76
17,1,4,41,17,58
1,755,1215,193,755,948
1,755,1215,278,755,1033
1,1482,2384,854,1482,2336
1,1482,2384,592,1482,2074
8,45,120,590,360,950
16,2,5,34,32,66
25,2,5,53,50,103
29,2,5,86,58,144
17,2,5,50,34,84
21,2,5,40,42,82
14,2,5,27,28,55
25,2,5,70,50,120
27,2,5,76,54,130
20,2,5,38,40,78
10,2,5,30,20,50
19,3,9,111,57,168
17,3,9,99,51,150
22,7,9,12,154,166
27,7,9,1,189,190
1,7,9,1,7,8
9,3,8,35,27,62
19,8,22,174,152,326
27,8,22,366,216,582
26,8,22,238,208,446
1,8,22,14,8,22
8,8,22,89,64,153
19,8,22,262,152,414
22,8,22,274,176,450
20,8,22,276,160,436
16,8,22,178,128,306
6,9,24,71,54,125
12,9,24,143,108,251
3,9,24,44,27,71
4,9,24,40,36,76
2,13,35,35,26,61
9,13,35,148,117,265
21,13,35,447,273,720
9,13,35,185,117,302
18,13,35,390,234,624
21,13,35,366,273,639
17,13,35,249,221,470
3,13,35,43,39,82
6,13,35,86,78,164
8,13,35,170,104,274
14,13,35,205,182,387
21,13,35,300,273,573
28,21,55,752,588,1340
11,21,55,277,231,508
14,21,55,307,294,601
11,21,55,368,231,599
11,42,54,7,462,469
12,42,54,60,504,564
24,38,50,264,912,1176
26,38,50,26,988,1014
22,42,54,3,924,927
14,38,50,161,532,693
10,38,50,55,380,435
21,38,50,63,798,861
22,42,54,252,924,1176
8,42,54,40,336,376
5,42,54,55,210,265
9,38,50,99,342,441
8,42,54,40,336,376
1,42,54,5,42,47
1,42,54,5,42,47
17,38,50,51,646,697
1,1898,3375,937,1898,2835
1,1266,2320,683,1266,1949
1,420,769,249,420,669
1,1266,2320,544,1266,1810
1,1266,2320,1031,1266,2297
1,1266,2320,961,1266,2227
1,1252,2295,538,1252,1790
1,1083,1701,550,1083,1633
1,2171,3578,727,2171,2898
1,713,1120,385,713,1098
1,2171,3578,620,2171,2791
3,26,70,128,78,206
17,26,70,486,442,928
30,26,70,1047,780,1827
18,26,70,704,468,1172
12,3,9,48,36,84
30,3,9,175,90,265
20,1,2,15,20,35
18,2,5,53,36,89
16,2,5,47,32,79
24,9,25,378,216,594
24,1,2,24,24,48
27,1,2,14,27,41
9,1,2,5,9,14
19,9,25,219,171,390
28,9,25,322,252,574
6,9,25,65,54,119
19,9,25,204,171,375
20,1,2,14,20,34
3,9,25,47,27,74
22,9,25,347,198,545
10,1,2,9,10,19
27,2,5,63,54,117
15,2,5,35,30,65
23,1,4,54,23,77
9,1,4,21,9,30
12,11,30,214,132,346
19,11,30,338,209,547
21,11,30,374,231,605
6,2,5,14,12,26
24,2,5,56,48,104
18,2,5,53,36,89
14,2,5,41,28,69
16,11,29,256,176,432
20,11,29,319,220,539
20,1,2,20,20,40
19,1,2,19,19,38
10,1,2,10,10,20
19,1,2,19,19,38
4,1,2,2,4,6
28,1,2,16,28,44
12,12,33,244,144,388
9,12,33,183,108,291
7,2,5,14,14,28
28,1,2,20,28,48
29,1,2,21,29,50
27,2,5,57,54,111
9,1,2,9,9,18
12,1,2,12,12,24
1,461,742,266,461,727
1,461,742,185,461,646
5,45,120,369,225,594
9,45,120,653,405,1058
11,4,10,62,44,106
23,4,10,129,92,221
3,2,5,9,6,15
8,2,5,19,16,35
25,2,5,59,50,109
6,2,5,17,12,29
30,2,5,87,60,147
17,2,5,50,34,84
12,4,10,56,48,104
14,2,5,33,28,61
29,2,5,68,58,126
1,7,9,2,7,9
15,7,9,27,105,132
7,3,8,34,21,55
20,8,22,183,160,343
5,9,24,70,45,115
28,9,24,333,252,585
30,13,35,650,390,1040
27,13,35,575,351,926
25,13,35,436,325,761
15,13,35,325,195,520
19,13,35,391,247,638
2,13,35,43,26,69
7,13,35,137,91,228
26,13,35,454,338,792
8,13,35,165,104,269
9,13,35,157,117,274
2,21,55,66,42,108
6,38,50,60,228,288
1,38,50,6,38,44
19,38,50,19,722,741
19,38,50,105,722,827
20,38,50,110,760,870
1,308,565,155,308,463
1,1252,2295,951,1252,2203
1,1252,2295,951,1252,2203
1,1266,2320,752,1266,2018
1,1266,2320,544,1266,1810
1,420,769,249,420,669
1,713,1120,385,713,1098
1,1083,1701,397,1083,1480
1,713,1120,261,713,974
1,344,540,126,344,470
8,26,70,229,208,437
7,26,70,303,182,485
30,26,70,1278,780,2058
6,26,70,205,156,361
28,3,9,163,84,247
12,8,21,103,96,199
9,8,21,77,72,149
7,8,21,60,56,116
26,1,2,25,26,51
15,1,2,14,15,29
2,1,2,2,2,4
29,2,5,86,58,144
30,2,5,89,60,149
27,2,5,80,54,134
8,2,5,24,16,40
14,2,5,41,28,69
17,2,5,32,34,66
28,2,5,66,56,122
23,2,5,54,46,100
26,2,5,75,52,127
21,2,5,61,42,103
10,1,2,9,10,19
28,2,5,50,56,106
2,2,5,4,4,8
17,1,2,17,17,34
25,9,25,394,225,619
29,9,25,457,261,718
20,1,4,54,20,74
14,1,2,13,14,27
25,1,2,23,25,48
10,8,21,126,80,206
22,8,21,277,176,453
1,2,5,2,2,4
6,2,5,13,12,25
3,2,5,6,6,12
27,2,5,57,54,111
5,11,29,80,55,135
30,2,5,63,60,123
28,9,25,434,252,686
3,9,25,47,27,74
1,755,1215,302,755,1057
1,1482,2384,735,1482,2217
8,4,10,31,32,63
3,4,10,12,12,24
18,2,5,53,36,89
16,2,5,46,32,78
30,3,9,145,90,235
17,3,9,82,51,133
27,3,9,130,81,211
11,4,10,52,44,96
26,4,10,122,104,226
11,2,5,32,22,54
7,2,5,20,14,34
25,4,10,145,100,245
1,4,10,6,4,10
22,2,5,42,44,86
20,2,5,38,40,78
5,4,10,19,20,39
7,4,10,27,28,55
15,2,5,36,30,66
23,2,5,68,46,114
8,2,5,24,16,40
16,7,9,9,112,121
23,7,9,13,161,174
23,7,9,42,161,203
18,7,9,13,126,139
23,3,8,91,69,160
1,3,8,4,3,7
26,8,22,353,208,561
7,8,22,76,56,132
3,8,22,39,24,63
19,8,22,212,152,364
26,9,24,384,234,618
11,9,24,107,99,206
9,9,24,133,81,214
17,13,35,291,221,512
5,13,35,108,65,173
23,13,35,401,299,700
2,13,35,43,26,69
18,13,35,371,234,605
22,13,35,315,286,601
18,13,35,314,234,548
28,13,35,596,364,960
21,13,35,366,273,639
18,13,35,295,234,529
22,13,35,384,286,670
17,13,35,362,221,583
21,13,35,447,273,720
10,13,35,217,130,347
28,13,35,606,364,970
22,13,35,476,286,762
7,13,35,149,91,240
30,13,35,587,390,977
17,13,35,243,221,464
3,38,50,35,114,149
17,38,50,196,646,842
15,42,54,75,630,705
17,42,54,85,714,799
13,42,54,65,546,611
24,42,54,55,1008,1063
1,295,540,175,295,470
1,420,769,249,420,669
1,420,769,249,420,669
1,1266,2320,1031,1266,2297
1,713,1120,205,713,918
1,2171,3578,942,2171,3113
1,2171,3578,835,2171,3006
1,2171,3578,942,2171,3113
1,487,783,155,487,642
1,1555,2443,839,1555,2394
1,2171,3578,1335,2171,3506
1,344,540,83,344,427
1,2171,3578,1335,2171,3506
1,2171,3578,1335,2171,3506
9,26,70,383,234,617
29,3,9,169,87,256
29,8,21,371,232,603
3,2,5,8,6,14
30,13,35,650,390,1040
20,13,35,433,260,693
14,13,35,303,182,485
4,1,2,4,4,8
6,1,2,6,6,12
10,13,35,171,130,301
4,13,35,68,52,120
17,1,2,17,17,34
1,2,5,3,2,5
2,2,5,6,4,10
30,1,4,65,30,95
29,1,4,63,29,92
10,12,33,197,120,317
27,12,33,531,324,855
7,12,33,138,84,222
17,1,2,17,17,34
16,1,2,16,16,32
14,1,2,8,14,22
27,1,2,15,27,42
23,1,2,13,23,36
8,1,2,4,8,12
16,13,35,330,208,538
20,13,35,412,260,672
24,12,33,377,288,665
25,12,33,393,300,693
12,1,2,7,12,19
24,2,5,70,48,118
8,2,5,23,16,39
10,1,2,10,10,20
12,1,2,12,12,24
2,1,2,2,2,4
7,9,25,89,63,152
29,9,25,370,261,631
17,2,5,40,34,74
27,2,5,63,54,117
16,2,5,38,32,70
13,2,5,38,26,64
15,2,5,44,30,74
28,11,30,515,308,823
24,11,30,442,264,706
23,11,29,294,253,547
7,1,2,4,7,11
11,1,2,6,11,17
28,1,2,16,28,44
17,1,2,10,17,27
24,11,29,307,264,571
1,461,742,251,461,712
1,755,1215,375,755,1130
1,1482,2384,592,1482,2074
1,24,64,26,24,50
26,24,64,1007,624,1631
18,24,64,478,432,910
3,45,120,211,135,346
15,2,5,29,30,59
25,2,5,49,50,99
18,2,5,41,36,77
5,2,5,12,10,22
29,4,10,110,116,226
19,3,9,92,57,149
15,3,9,72,45,117
11,2,5,31,22,53
8,2,5,22,16,38
16,2,5,30,32,62
27,2,5,76,54,130
27,2,5,80,54,134
19,2,5,56,38,94
14,2,5,29,28,57
6,2,5,16,12,28
5,2,5,12,10,22
20,4,10,116,80,196
2,4,10,12,8,20
28,2,5,59,56,115
9,2,5,19,18,37
25,2,5,53,50,103
3,2,5,8,6,14
5,3,9,28,15,43
4,3,9,23,12,35
29,2,5,68,58,126
4,2,5,9,8,17
10,7,9,18,70,88
12,7,9,0,84,84
13,7,9,11,91,102
8,7,9,3,56,59
17,7,9,2,119,121
21,7,9,34,147,181
24,7,9,20,168,188
10,3,8,49,30,79
17,3,8,66,51,117
17,3,8,80,51,131
25,3,8,89,75,164
16,8,22,161,128,289
13,8,22,142,104,246
25,8,22,345,200,545
6,9,24,71,54,125
21,9,24,295,189,484
21,9,24,249,189,438
2,9,24,24,18,42
1,13,35,21,13,34
21,13,35,447,273,720
14,13,35,244,182,426
26,13,35,554,338,892
15,13,35,215,195,410
30,13,35,471,390,861
13,13,35,268,169,437
3,13,35,47,39,86
27,13,35,471,351,822
9,13,35,192,117,309
1,13,35,17,13,30
16,13,35,341,208,549
16,13,35,274,208,482
18,13,35,257,234,491
25,13,35,366,325,691
20,21,55,669,420,1089
15,21,55,362,315,677
9,21,55,242,189,431
30,38,50,120,1140,1260
24,42,54,120,1008,1128
19,42,54,95,798,893
16,42,54,36,672,708
28,38,50,322,1064,1386
17,42,54,186,714,900
22,38,50,121,836,957
1,1252,2295,630,1252,1882
1,1252,2295,745,1252,1997
1,1266,2320,961,1266,2227
1,487,783,124,487,611
1,2171,3578,942,2171,3113
1,487,783,265,487,752
1,487,783,155,487,642
1,344,540,126,344,470
1,1083,1701,397,1083,1480
1,344,540,99,344,443
30,26,70,1299,780,2079
17,26,70,724,442,1166
27,1,2,15,27,42
5,1,2,3,5,8
6,2,5,16,12,28
1,2,5,3,2,5
28,9,25,350,252,602
15,9,25,188,135,323
13,1,4,38,13,51
29,1,4,86,29,115
11,2,5,31,22,53
20,1,2,19,20,39
17,1,2,16,17,33
21,2,5,49,42,91
12,2,5,28,24,52
17,2,5,37,34,71
18,2,5,50,36,86
20,2,5,56,40,96
5,1,2,3,5,8
13,1,2,8,13,21
11,2,5,31,22,53
25,2,5,70,50,120
3,1,4,9,3,12
16,1,4,45,16,61
5,9,25,64,45,109
19,9,25,242,171,413
29,2,5,84,58,142
9,2,5,26,18,44
12,1,2,9,12,21
19,1,2,14,19,33
11,2,5,32,22,54
13,2,5,38,26,64
29,12,33,590,348,938
11,12,33,224,132,356
5,1,2,3,5,8
21,1,2,12,21,33
7,8,21,85,56,141
11,12,33,155,132,287
29,1,2,28,29,57
16,1,2,15,16,31
9,1,2,8,9,17
18,2,5,42,36,78
6,2,5,14,12,26
1,1482,2384,592,1482,2074
1,1482,2384,592,1482,2074
1,1482,2384,854,1482,2336
1,1482,2384,854,1482,2336
1,755,1215,436,755,1191
1,1482,2384,401,1482,1883
6,45,120,349,270,619
6,59,159,581,354,935
16,2,5,47,32,79
2,2,5,6,4,10
3,4,10,12,12,24
26,4,10,101,104,205
14,4,10,81,56,137
27,4,10,157,108,265
29,2,5,57,58,115
18,2,5,35,36,71
9,2,5,26,18,44
20,2,5,58,40,98
15,4,10,87,60,147
5,4,10,29,20,49
8,4,10,46,32,78
8,2,5,22,16,38
29,2,5,86,58,144
6,2,5,18,12,30
27,3,9,145,81,226
22,3,9,118,66,184
10,4,10,47,40,87
16,2,5,46,32,78
22,2,5,64,44,108
30,7,9,41,210,251
11,7,9,9,77,86
17,7,9,28,119,147
7,7,9,13,49,62
6,7,9,11,42,53
24,3,8,78,72,150
23,3,8,86,69,155
18,3,8,71,54,125
19,8,22,212,152,364
1,8,22,13,8,21
5,8,22,69,40,109
6,8,22,81,48,129
26,8,22,341,208,549
17,9,24,182,153,335
8,9,24,85,72,157
8,9,24,112,72,184
4,9,24,39,36,75
6,9,24,67,54,121
18,13,35,257,234,491
13,13,35,281,169,450
29,13,35,597,377,974
1,13,35,15,13,28
2,13,35,35,26,61
27,13,35,556,351,907
26,13,35,454,338,792
17,13,35,368,221,589
24,13,35,494,312,806
4,13,35,85,52,137
11,13,35,234,143,377
9,13,35,157,117,274
23,13,35,498,299,797
11,13,35,234,143,377
24,13,35,511,312,823
6,13,35,94,78,172
9,13,35,195,117,312
24,13,35,377,312,689
9,13,35,185,117,302
24,13,35,343,312,655
5,21,55,126,105,231
14,21,55,461,294,755
3,21,55,99,63,162
10,38,50,115,380,495
12,38,50,102,456,558
4,42,54,33,168,201
11,42,54,126,462,588
11,38,50,110,418,528
5,42,54,11,210,221
12,38,50,120,456,576
10,42,54,50,420,470
8,42,54,66,336,402
29,38,50,319,1102,1421
1,1898,3375,1342,1898,3240
1,1266,2320,1031,1266,2297
1,1252,2295,538,1252,1790
1,1252,2295,951,1252,2203
1,1266,2320,1008,1266,2274
1,1266,2320,752,1266,2018
1,1252,2295,745,1252,1997
1,1252,2295,1020,1252,2272
1,295,540,234,295,529
1,420,769,226,420,646
1,295,540,223,295,518
1,1252,2295,745,1252,1997
1,1555,2443,448,1555,2003
1,487,783,280,487,767
1,1083,1701,312,1083,1395
1,2171,3578,656,2171,2827
1,713,1120,385,713,1098
1,1083,1701,397,1083,1480
1,2171,3578,1335,2171,3506
29,26,70,1235,754,1989
14,3,9,68,42,110
11,13,35,188,143,331
14,1,2,14,14,28
22,2,5,42,44,86
24,13,35,520,312,832
18,2,5,50,36,86
20,12,33,394,240,634
27,12,33,531,324,855
30,11,29,531,330,861
15,11,29,266,165,431
10,2,5,19,20,39
26,2,5,75,52,127
9,2,5,26,18,44
24,2,5,46,48,94
13,2,5,25,26,51
1,2,5,3,2,5
7,2,5,20,14,34
28,1,4,69,28,97
26,1,2,25,26,51
1,1,2,1,1,2
26,1,2,25,26,51
12,2,5,34,24,58
24,2,5,67,48,115
4,2,5,9,8,17
16,2,5,38,32,70
8,2,5,19,16,35
8,9,25,114,72,186
25,1,2,23,25,48
29,1,2,27,29,56
12,13,35,197,156,353
2,13,35,33,26,59
10,13,35,164,130,294
27,2,5,78,54,132
20,2,5,58,40,98
30,1,4,85,30,115
10,1,4,28,10,38
23,2,5,54,46,100
28,2,5,66,56,122
6,1,2,6,6,12
5,1,2,5,5,10
20,1,2,20,20,40
25,11,30,310,275,585
24,1,2,13,24,37
23,1,4,67,23,90
1,1,4,3,1,4
1,1,4,3,1,4
11,12,33,224,132,356
25,1,4,73,25,98
21,1,4,61,21,82
8,1,2,8,8,16
12,1,2,12,12,24
6,2,5,18,12,30
7,2,5,21,14,35
15,8,21,129,120,249
29,8,21,249,232,481
18,8,21,185,144,329
2,8,21,21,16,37
20,2,5,58,40,98
7,2,5,16,14,30
28,1,4,68,28,96
5,1,4,12,5,17
1,461,742,251,461,712
25,24,64,968,600,1568
7,45,120,491,315,806
9,45,120,632,405,1037
9,45,120,524,405,929
10,59,159,968,590,1558
6,59,159,562,354,916
1,2,5,2,2,4
27,2,5,63,54,117
20,3,9,113,60,173
18,3,9,102,54,156
22,3,9,124,66,190
11,2,5,21,22,43
25,2,5,48,50,98
24,2,5,70,48,118
8,2,5,23,16,39
17,2,5,49,34,83
21,2,5,41,42,83
30,3,9,161,90,251
12,3,9,64,36,100
27,7,9,22,189,211
16,7,9,29,112,141
13,7,9,21,91,112
2,7,9,1,14,15
21,7,9,40,147,187
14,3,8,45,42,87
6,8,22,55,48,103
29,8,22,393,232,625
10,8,22,125,80,205
25,9,24,369,225,594
21,9,24,244,189,433
27,9,24,392,243,635
13,13,35,227,169,396
3,13,35,43,39,82
15,13,35,262,195,457
29,13,35,597,377,974
29,13,35,618,377,995
6,13,35,94,78,172
29,13,35,506,377,883
5,13,35,82,65,147
30,13,35,492,390,882
25,13,35,366,325,691
29,13,35,567,377,944
14,13,35,303,182,485
6,13,35,130,78,208
15,13,35,320,195,515
26,13,35,554,338,892
4,13,35,78,52,130
27,13,35,386,351,737
1,13,35,14,13,27
4,21,55,90,84,174
23,42,54,264,966,1230
11,42,54,108,462,570
18,38,50,90,684,774
11,42,54,126,462,588
9,38,50,50,342,392
8,42,54,87,336,423
14,38,50,154,532,686
1,1266,2320,567,1266,1833
1,1252,2295,951,1252,2203
1,420,769,334,420,754
1,420,769,334,420,754
1,420,769,249,420,669
1,487,783,132,487,619
1,487,783,280,487,767
1,2171,3578,835,2171,3006
1,2171,3578,656,2171,2827
1,713,1120,161,713,874
1,1555,2443,570,1555,2125
1,344,540,110,344,454
1,2171,3578,1335,2171,3506
12,26,70,410,312,722
10,26,70,426,260,686
18,26,70,527,468,995
3,26,70,130,78,208
8,1,4,24,8,32
4,2,5,8,8,16
9,2,5,17,18,35
27,1,2,15,27,42
20,1,2,11,20,31
10,1,2,6,10,16
18,2,5,48,36,84
10,2,5,27,20,47
12,2,5,28,24,52
4,2,5,9,8,17
28,2,5,66,56,122
2,1,2,2,2,4
11,1,2,10,11,21
7,2,5,13,14,27
12,2,5,23,24,47
12,2,5,23,24,47
13,2,5,25,26,51
3,1,2,3,3,6
5,1,2,5,5,10
3,1,2,3,3,6
6,2,5,14,12,26
19,2,5,45,38,83
4,2,5,8,8,16
25,2,5,48,50,98
20,1,2,14,20,34
2,1,2,1,2,3
28,8,21,241,224,465
23,8,21,198,184,382
27,8,21,232,216,448
3,1,4,7,3,10
8,1,4,18,8,26
19,1,2,14,19,33
5,2,5,15,10,25
3,2,5,9,6,15
15,2,5,44,30,74
18,1,2,17,18,35
22,1,2,20,22,42
15,1,2,15,15,30
24,1,2,24,24,48
8,2,5,18,16,34
24,2,5,55,48,103
18,1,2,17,18,35
3,1,2,3,3,6
2,1,4,6,2,8
17,1,4,48,17,65
27,1,4,79,27,106
8,1,4,23,8,31
22,1,4,60,22,82
13,1,4,35,13,48
27,1,4,73,27,100
8,1,2,4,8,12
12,9,25,150,108,258
19,9,25,238,171,409
1,1482,2384,592,1482,2074
1,1482,2384,807,1482,2289
1,1482,2384,807,1482,2289
1,1482,2384,735,1482,2217
1,755,1215,241,755,996
1,461,742,140,461,601
26,24,64,774,624,1398
10,59,159,889,590,1479
7,59,159,655,413,1068
13,3,9,65,39,104
29,3,9,145,87,232
2,2,5,6,4,10
19,2,5,55,38,93
19,2,5,44,38,82
9,2,5,25,18,43
28,2,5,78,56,134
3,2,5,6,6,12
18,2,5,52,36,88
28,2,5,81,56,137
23,3,9,134,69,203
4,3,9,23,12,35
27,3,9,157,81,238
14,2,5,39,28,67
25,2,5,70,50,120
17,2,5,49,34,83
22,2,5,64,44,108
2,2,5,4,4,8
26,2,5,57,52,109
24,2,5,47,48,95
18,2,5,35,36,71
8,7,9,15,56,71
9,7,9,0,63,63
29,7,9,53,203,256
1,7,9,1,7,8
12,7,9,20,84,104
5,7,9,1,35,36
25,3,8,121,75,196
15,3,8,59,45,104
10,3,8,32,30,62
29,8,22,393,232,625
12,9,24,120,108,228
13,9,24,145,117,262
17,9,24,190,153,343
20,13,35,363,260,623
14,13,35,205,182,387
3,13,35,65,39,104
19,13,35,391,247,638
28,13,35,410,364,774
29,13,35,618,377,995
25,13,35,515,325,840
17,13,35,297,221,518
11,13,35,192,143,335
15,13,35,246,195,441
4,13,35,66,52,118
29,13,35,618,377,995
12,13,35,256,156,412
26,13,35,536,338,874
9,13,35,195,117,312
5,13,35,79,65,144
25,21,55,603,525,1128
3,21,55,90,63,153
10,21,55,329,210,539
5,38,50,55,190,245
27,42,54,134,1134,1268
17,42,54,186,714,900
19,38,50,105,722,827
1,1252,2295,745,1252,1997
1,1266,2320,892,1266,2158
1,1252,2295,882,1252,2134
1,1252,2295,676,1252,1928
1,1252,2295,722,1252,1974
1,1252,2295,561,1252,1813
1,2171,3578,1013,2171,3184
1,2171,3578,1264,2171,3435
1,2171,3578,835,2171,3006
1,2171,3578,942,2171,3113
1,713,1120,362,713,1075
1,1555,2443,497,1555,2052
1,344,540,185,344,529
1,344,540,174,344,518
1,713,1120,172,713,885
22,26,70,768,572,1340
9,26,70,308,234,542
5,26,70,217,130,347
4,26,70,173,104,277
27,8,21,345,216,561
25,1,2,16,25,41
2,9,25,22,18,40
7,9,25,75,63,138
10,1,2,7,10,17
4,1,2,3,4,7
8,1,2,8,8,16
7,1,2,7,7,14
29,1,2,28,29,57
12,2,5,35,24,59
19,2,5,55,38,93
17,2,5,39,34,73
20,1,4,50,20,70
5,1,4,12,5,17
16,9,25,204,144,348
3,11,30,45,33,78
17,1,2,10,17,27
20,1,2,11,20,31
27,1,2,15,27,42
28,2,5,81,56,137
7,1,4,20,7,27
24,1,4,68,24,92
4,1,2,3,4,7
26,1,2,17,26,43
30,1,2,19,30,49
21,9,25,268,189,457
2,9,25,26,18,44
16,11,30,198,176,374
29,11,30,360,319,679
30,1,4,73,30,103
22,1,4,54,22,76
24,1,4,68,24,92
25,2,5,58,50,108
3,1,2,3,3,6
11,1,2,11,11,22
12,2,5,35,24,59
16,8,21,148,128,276
1,1482,2384,807,1482,2289
1,1482,2384,592,1482,2074
1,1482,2384,854,1482,2336
1,755,1215,436,755,1191
1,755,1215,436,755,1191
1,755,1215,436,755,1191
30,24,64,854,720,1574
16,24,64,497,384,881
9,59,159,628,531,1159
15,4,10,66,60,126
19,4,10,84,76,160
11,4,10,65,44,109
27,4,10,159,108,267
17,4,10,99,68,167
2,4,10,12,8,20
22,4,10,128,88,216
1,4,10,6,4,10
15,2,5,29,30,59
17,2,5,48,34,82
7,2,5,20,14,34
20,3,9,107,60,167
21,2,5,59,42,101
12,2,5,34,24,58
28,2,5,66,56,122
16,2,5,38,32,70
23,2,5,54,46,100
28,2,5,66,56,122
12,2,5,35,24,59
27,2,5,80,54,134
6,2,5,17,12,29
25,2,5,73,50,123
23,2,5,67,46,113
22,2,5,64,44,108
4,4,10,19,16,35
12,4,10,56,48,104
18,2,5,52,36,88
17,7,9,14,119,133
26,7,9,47,182,229
5,7,9,9,35,44
9,7,9,0,63,63
4,7,9,7,28,35
24,7,9,46,168,214
18,7,9,15,126,141
24,3,8,107,72,179
5,3,8,23,15,38
3,3,8,15,9,24
17,8,22,231,136,367
16,8,22,147,128,275
27,8,22,336,216,552
27,8,22,366,216,582
8,8,22,89,64,153
18,8,22,165,144,309
10,8,22,138,80,218
22,8,22,231,176,407
25,8,22,251,200,451
21,8,22,192,168,360
17,8,22,234,136,370
7,9,24,98,63,161
4,9,24,59,36,95
28,9,24,407,252,659
23,13,35,377,299,676
16,13,35,234,208,442
3,13,35,64,39,103
19,13,35,272,247,519
7,13,35,152,91,243
4,13,35,85,52,137
19,13,35,298,247,545
23,13,35,377,299,676
23,13,35,329,299,628
24,13,35,520,312,832
14,13,35,200,182,382
22,13,35,315,286,601
24,13,35,419,312,731
4,21,55,88,84,172
15,21,55,502,315,817
17,21,55,559,357,916
9,42,54,1,378,379
3,38,50,33,114,147
7,42,54,35,294,329
18,38,50,18,684,702
1,38,50,11,38,49
11,38,50,61,418,479
23,42,54,102,966,1068
1,1252,2295,538,1252,1790
1,420,769,180,420,600
1,1252,2295,1020,1252,2272
1,1252,2295,882,1252,2134
1,420,769,249,420,669
1,1266,2320,961,1266,2227
1,420,769,341,420,761
1,1266,2320,636,1266,1902
1,1252,2295,997,1252,2249
1,1266,2320,1008,1266,2274
1,1266,2320,1008,1266,2274
1,2171,3578,942,2171,3113
1,2171,3578,656,2171,2827
1,713,1120,362,713,1075
1,713,1120,385,713,1098
1,344,540,77,344,421
1,2171,3578,1371,2171,3542
1,1083,1701,397,1083,1480
1,344,540,126,344,470
6,26,70,256,156,412
6,3,9,24,18,42
26,3,9,126,78,204
13,1,4,28,13,41
7,8,21,60,56,116
27,8,21,232,216,448
18,8,21,155,144,299
9,13,35,195,117,312
15,13,35,325,195,520
2,2,5,4,4,8
25,1,2,24,25,49
1,1,4,3,1,4
21,1,4,60,21,81
2,11,30,37,22,59
1,11,30,19,11,30
10,11,30,187,110,297
11,2,5,32,22,54
3,2,5,9,6,15
6,2,5,18,12,30
12,2,5,35,24,59
21,2,5,62,42,104
28,2,5,83,56,139
27,12,33,558,324,882
3,12,33,62,36,98
8,11,30,121,88,209
25,11,30,378,275,653
28,13,35,577,364,941
24,13,35,494,312,806
6,13,35,124,78,202
1,1,2,1,1,2
20,2,5,46,40,86
3,2,5,7,6,13
1,2,5,2,2,4
7,9,25,79,63,142
19,9,25,214,171,385
8,1,4,23,8,31
9,1,2,5,9,14
2,12,33,42,24,66
20,2,5,38,40,78
28,2,5,53,56,109
17,1,2,16,17,33
24,1,2,22,24,46
22,1,4,62,22,84
29,1,4,82,29,111
21,8,21,242,168,410
17,11,29,242,187,429
21,11,29,299,231,530
1,1482,2384,521,1482,2003
1,755,1215,411,755,1166
1,461,742,251,461,712
1,1482,2384,854,1482,2336
1,1482,2384,854,1482,2336
3,24,64,78,72,150
21,24,64,813,504,1317
21,24,64,827,504,1331
21,24,64,585,504,1089
28,24,64,726,672,1398
25,24,64,792,600,1392
1,59,159,65,59,124
19,2,5,46,38,84
4,2,5,10,8,18
21,2,5,59,42,101
9,2,5,25,18,43
13,2,5,38,26,64
12,4,10,46,48,94
6,4,10,23,24,47
23,2,5,48,46,94
26,2,5,55,52,107
17,2,5,49,34,83
13,2,5,38,26,64
14,2,5,41,28,69
27,2,5,59,54,113
21,2,5,46,42,88
5,4,10,29,20,49
27,4,10,157,108,265
26,4,10,120,104,224
13,4,10,60,52,112
27,2,5,53,54,107
3,3,9,14,9,23
16,3,9,77,48,125
26,2,5,57,52,109
7,2,5,15,14,29
6,3,9,34,18,52
6,2,5,17,12,29
25,2,5,70,50,120
6,7,9,10,42,52
21,7,9,38,147,185
29,7,9,53,203,256
27,7,9,22,189,211
30,7,9,22,210,232
10,7,9,4,70,74
25,3,8,117,75,192
28,3,8,131,84,215
5,8,22,47,40,87
17,8,22,156,136,292
26,8,22,238,208,446
27,8,22,295,216,511
24,8,22,325,192,517
14,8,22,190,112,302
11,8,22,149,88,237
8,8,22,89,64,153
30,8,22,413,240,653
5,8,22,69,40,109
7,8,22,78,56,134
24,8,22,267,192,459
16,9,24,225,144,369
29,9,24,351,261,612
16,9,24,156,144,300
3,9,24,36,27,63
5,9,24,50,45,95
23,9,24,273,207,480
25,13,35,515,325,840
2,13,35,35,26,61
23,13,35,498,299,797
10,13,35,147,130,277
1,13,35,17,13,30
30,13,35,618,390,1008
19,13,35,272,247,519
9,13,35,195,117,312
6,13,35,105,78,183
10,13,35,213,130,343
24,13,35,520,312,832
30,13,35,513,390,903
5,13,35,72,65,137
3,13,35,64,39,103
7,13,35,149,91,240
11,13,35,234,143,377
2,13,35,41,26,67
4,13,35,70,52,122
25,13,35,515,325,840
21,21,55,506,441,947
17,21,55,382,357,739
21,38,50,210,798,1008
14,38,50,161,532,693
23,42,54,189,966,1155
13,42,54,58,546,604
23,38,50,253,874,1127
15,42,54,10,630,640
3,38,50,3,114,117
12,38,50,12,456,468
13,38,50,150,494,644
26,42,54,129,1092,1221
15,42,54,164,630,794
23,38,50,35,874,909
17,38,50,51,646,697
8,42,54,40,336,376
30,38,50,330,1140,1470
17,42,54,85,714,799
28,42,54,94,1176,1270
16,42,54,175,672,847
2,42,54,22,84,106
9,42,54,45,378,423
1,1898,3375,1038,1898,2936
1,1898,3375,937,1898,2835
1,1252,2295,561,1252,1813
1,1266,2320,961,1266,2227
1,1266,2320,683,1266,1949
1,1252,2295,997,1252,2249
1,308,565,184,308,492
1,308,565,184,308,492
1,295,540,148,295,443
1,1252,2295,538,1252,1790
1,1266,2320,544,1266,1810
1,487,783,280,487,767
1,1555,2443,839,1555,2394
1,344,540,185,344,529
1,344,540,120,344,464
1,344,540,120,344,464
1,344,540,191,344,535
1,344,540,83,344,427
3,26,70,130,78,208
15,26,70,639,390,1029
7,26,70,239,182,421
1,26,70,43,26,69
29,26,70,1012,754,1766
5,3,9,22,15,37
18,1,2,17,18,35
28,1,2,26,28,54
4,9,25,48,36,84
27,9,25,324,243,567
29,9,25,348,261,609
17,2,5,32,34,66
2,2,5,4,4,8
27,1,2,20,27,47
6,1,2,4,6,10
3,1,2,3,3,6
30,1,2,28,30,58
9,1,2,9,9,18
16,12,33,315,192,507
8,12,33,157,96,253
7,12,33,138,84,222
19,1,4,56,19,75
17,11,30,318,187,505
11,11,30,206,121,327
28,11,30,524,308,832
21,1,2,12,21,33
25,1,2,14,25,39
8,1,2,4,8,12
24,2,5,55,48,103
11,2,5,25,22,47
28,9,25,434,252,686
11,1,4,30,11,41
26,1,4,71,26,97
24,1,4,65,24,89
23,2,5,64,46,110
10,2,5,28,20,48
11,2,5,31,22,53
12,2,5,23,24,47
7,2,5,19,14,33
9,2,5,24,18,42
9,2,5,24,18,42
9,1,2,7,9,16
17,1,2,13,17,30
11,2,5,32,22,54
28,2,5,83,56,139
12,9,25,180,108,288
19,9,25,285,171,456
27,8,21,249,216,465
7,1,4,19,7,26
18,2,5,42,36,78
26,1,2,25,26,51
13,2,5,38,26,64
18,1,2,13,18,31
25,1,2,15,25,40
10,1,2,6,10,16
16,2,5,45,32,77
22,1,4,64,22,86
4,1,4,12,4,16
15,1,4,44,15,59
16,2,5,45,32,77
30,2,5,84,60,144
11,2,5,31,22,53
6,2,5,14,12,26
28,2,5,66,56,122
13,1,4,30,13,43
18,2,5,50,36,86
1,1482,2384,616,1482,2098
1,755,1215,411,755,1166
1,1482,2384,378,1482,1860
1,1482,2384,854,1482,2336
1,755,1215,193,755,948
1,755,1215,436,755,1191
1,1482,2384,807,1482,2289
5,2,5,11,10,21
23,2,5,48,46,94
14,4,10,83,56,139
9,4,10,53,36,89
13,2,5,38,26,64
20,2,5,59,40,99
30,2,5,89,60,149
9,2,5,26,18,44
23,2,5,67,46,113
13,4,10,73,52,125
8,4,10,45,32,77
29,3,9,117,87,204
5,3,9,20,15,35
13,4,10,77,52,129
27,4,10,159,108,267
18,2,5,50,36,86
20,2,5,56,40,96
18,7,9,33,126,159
3,7,9,5,21,26
3,7,9,1,21,22
29,7,9,48,203,251
11,8,22,149,88,237
28,8,22,386,224,610
28,8,22,386,224,610
12,8,22,113,96,209
26,8,22,341,208,549
23,8,22,302,184,486
5,9,24,74,45,119
13,9,24,192,117,309
21,9,24,295,189,484
18,9,24,253,162,415
25,9,24,243,225,468
23,9,24,268,207,475
11,9,24,128,99,227
1,13,35,14,13,27
21,13,35,322,273,595
14,13,35,298,182,480
25,13,35,358,325,683
5,13,35,73,65,138
1,13,35,21,13,34
8,13,35,165,104,269
15,13,35,236,195,431
30,13,35,618,390,1008
15,13,35,325,195,520
24,13,35,520,312,832
23,13,35,498,299,797
10,13,35,217,130,347
22,13,35,469,286,755
7,13,35,144,91,235
14,13,35,239,182,421
10,38,50,30,380,410
22,38,50,253,836,1089
3,38,50,3,114,117
5,42,54,25,210,235
28,38,50,280,1064,1344
21,38,50,210,798,1008
29,38,50,319,1102,1421
27,38,50,27,1026,1053
20,38,50,220,760,980
4,42,54,44,168,212
14,42,54,138,588,726
3,42,54,33,126,159
2,42,54,22,84,106
5,38,50,50,190,240
8,38,50,40,304,344
1,1252,2295,630,1252,1882
1,1266,2320,1008,1266,2274
1,295,540,234,295,529
1,1266,2320,1008,1266,2274
1,1519,2443,387,1519,1906
1,713,1120,385,713,1098
1,1555,2443,790,1555,2345
1,487,783,288,487,775
1,2171,3578,835,2171,3006
1,713,1120,396,713,1109
1,344,540,185,344,529
1,487,783,194,487,681
1,713,1120,205,713,918
10,26,70,426,260,686
25,2,5,48,50,98
20,2,5,38,40,78
29,2,5,55,58,113
26,13,35,445,338,783
21,2,5,43,42,85
28,2,5,64,56,120
13,1,2,7,13,20
23,1,4,68,23,91
2,2,5,5,4,9
10,2,5,30,20,50
20,2,5,59,40,99
2,2,5,4,4,8
9,2,5,25,18,43
14,2,5,39,28,67
12,2,5,35,24,59
6,1,2,4,6,10
11,1,2,7,11,18
14,1,2,9,14,23
6,1,2,4,6,10
18,2,5,38,36,74
27,1,2,26,27,53
21,11,30,393,231,624
2,1,2,2,2,4
24,2,5,46,48,94
2,2,5,4,4,8
11,2,5,21,22,43
10,1,2,6,10,16
17,2,5,50,34,84
2,2,5,6,4,10
21,12,33,289,252,541
14,12,33,192,168,360
10,1,4,24,10,34
19,2,5,44,38,82
3,1,4,9,3,12
1,8,21,12,8,20
20,8,21,243,160,403
18,12,33,247,216,463
18,2,5,50,36,86
9,2,5,25,18,43
4,1,4,9,4,13
5,8,21,63,40,103
9,8,21,113,72,185
24,1,2,24,24,48
29,1,2,28,29,57
1,1482,2384,807,1482,2289
1,1482,2384,854,1482,2336
1,1482,2384,473,1482,1955
1,1482,2384,807,1482,2289
1,755,1215,411,755,1166
8,2,5,19,16,35
6,2,5,14,12,26
14,4,10,53,56,109
3,3,9,14,9,23
22,3,9,100,66,166
26,2,5,55,52,107
22,2,5,46,44,90
2,2,5,4,4,8
25,2,5,48,50,98
27,2,5,78,54,132
2,2,5,6,4,10
16,2,5,30,32,62
29,2,5,84,58,142
12,2,5,35,24,59
1,2,5,2,2,4
12,2,5,28,24,52
5,2,5,15,10,25
28,2,5,81,56,137
7,4,10,29,28,57
11,4,10,46,44,90
17,2,5,32,34,66
24,2,5,46,48,94
9,4,10,52,36,88
13,4,10,75,52,127
7,2,5,16,14,30
4,3,9,23,12,35
24,3,9,140,72,212
27,3,9,157,81,238
15,3,9,87,45,132
15,2,5,41,30,71
27,3,9,152,81,233
18,7,9,30,126,156
11,7,9,8,77,85
21,7,9,38,147,185
10,7,9,8,70,78
11,7,9,9,77,86
28,7,9,8,196,204
22,3,8,106,66,172
11,3,8,53,33,86
9,8,22,100,72,172
10,8,22,109,80,189
23,8,22,312,184,496
4,8,22,55,32,87
19,8,22,258,152,410
26,8,22,358,208,566
13,8,22,179,104,283
25,8,22,345,200,545
28,8,22,281,224,505
2,8,22,20,16,36
4,8,22,55,32,87
11,9,24,162,99,261
5,9,24,53,45,98
21,9,24,295,189,484
14,9,24,166,126,292
4,9,24,45,36,81
29,9,24,324,261,585
6,9,24,89,54,143
16,13,35,346,208,554
15,13,35,236,195,431
4,13,35,82,52,134
25,13,35,436,325,761
30,13,35,618,390,1008
25,13,35,533,325,858
3,13,35,52,39,91
18,13,35,257,234,491
9,13,35,192,117,309
23,13,35,401,299,700
29,13,35,628,377,1005
26,13,35,454,338,792
29,13,35,618,377,995
22,13,35,469,286,755
2,13,35,43,26,69
2,13,35,43,26,69
10,13,35,217,130,347
7,13,35,122,91,213
2,13,35,33,26,59
7,13,35,115,91,206
26,21,55,584,546,1130
26,21,55,870,546,1416
20,21,55,658,420,1078
30,38,50,345,1140,1485
5,42,54,57,210,267
5,42,54,11,210,221
9,38,50,99,342,441
1,42,54,5,42,47
10,42,54,1,420,421
25,42,54,246,1050,1296
17,42,54,140,714,854
5,38,50,13,190,203
17,42,54,75,714,789
1,1252,2295,722,1252,1974
1,1266,2320,567,1266,1833
1,1252,2295,745,1252,1997
1,1252,2295,997,1252,2249
1,420,769,334,420,754
1,420,769,334,420,754
1,1266,2320,544,1266,1810
1,1252,2295,676,1252,1928
1,1252,2295,538,1252,1790
1,308,565,155,308,463
1,295,540,234,295,529
1,1252,2295,630,1252,1882
1,2171,3578,1264,2171,3435
1,1555,2443,790,1555,2345
1,2171,3578,656,2171,2827
1,2171,3578,835,2171,3006
1,2171,3578,942,2171,3113
1,2171,3578,942,2171,3113
1,713,1120,161,713,874
1,2171,3578,942,2171,3113
1,713,1120,340,713,1053
1,1083,1701,550,1083,1633
1,344,540,185,344,529
1,713,1120,194,713,907
1,2171,3578,1371,2171,3542
9,26,70,390,234,624
27,26,70,923,702,1625
18,26,70,515,468,983
27,3,9,160,81,241
16,3,9,90,48,138
28,3,9,165,84,249
5,3,9,30,15,45
24,2,5,70,48,118
29,2,5,84,58,142
5,2,5,15,10,25
10,2,5,19,20,39
1,2,5,2,2,4
29,1,2,21,29,50
14,1,2,10,14,24
30,1,4,89,30,119
25,2,5,74,50,124
15,2,5,44,30,74
4,2,5,12,8,20
27,2,5,80,54,134
12,1,2,9,12,21
2,1,2,1,2,3
19,1,2,13,19,32
12,1,2,8,12,20
24,1,2,23,24,47
27,1,2,26,27,53
25,1,2,19,25,44
12,1,4,27,12,39
2,1,4,5,2,7
28,1,4,64,28,92
13,2,5,31,26,57
8,2,5,19,16,35
29,2,5,68,58,126
11,1,2,7,11,18
8,12,33,126,96,222
1,12,33,16,12,28
27,1,4,64,27,91
6,1,2,6,6,12
10,1,2,9,10,19
18,2,5,52,36,88
18,2,5,42,36,78
2,2,5,6,4,10
10,2,5,24,20,44
15,2,5,35,30,65
29,1,2,21,29,50
21,1,2,16,21,37
11,2,5,31,22,53
23,1,2,21,23,44
9,1,2,8,9,17
13,2,5,30,26,56
4,2,5,9,8,17
18,1,2,13,18,31
5,1,2,4,5,9
4,2,5,8,8,16
14,2,5,27,28,55
30,2,5,87,60,147
29,2,5,84,58,142
10,2,5,29,20,49
29,2,5,84,58,142
9,2,5,26,18,44
18,2,5,52,36,88
7,1,4,15,7,22
1,1,4,2,1,3
1,1482,2384,473,1482,1955
1,755,1215,266,755,1021
1,461,742,162,461,623
1,461,742,185,461,646
1,755,1215,436,755,1191
1,1482,2384,854,1482,2336
17,24,64,658,408,1066
17,24,64,539,408,947
20,24,64,774,480,1254
28,24,64,1048,672,1720
10,45,120,594,450,1044
4,59,159,298,236,534
11,2,5,31,22,53
19,2,5,53,38,91
15,4,10,80,60,140
11,2,5,32,22,54
24,2,5,71,48,119
21,2,5,48,42,90
19,2,5,44,38,82
15,2,5,29,30,59
20,2,5,39,40,79
2,2,5,6,4,10
20,2,5,59,40,99
24,4,10,91,96,187
13,4,10,49,52,101
5,2,5,10,10,20
19,2,5,37,38,75
13,2,5,25,26,51
16,2,5,45,32,77
13,2,5,36,26,62
11,2,5,32,22,54
14,2,5,41,28,69
10,3,9,59,30,89
15,3,9,89,45,134
28,2,5,83,56,139
15,2,5,44,30,74
29,2,5,84,58,142
24,2,5,70,48,118
14,4,10,66,56,122
13,4,10,61,52,113
8,7,9,13,56,69
8,7,9,15,56,71
5,7,9,4,35,39
7,7,9,13,49,62
9,7,9,3,63,66
29,7,9,53,203,256
13,7,9,-2,91,89
29,7,9,3,203,206
19,3,8,92,57,149
5,8,22,68,40,108
14,8,22,190,112,302
6,8,22,63,48,111
24,8,22,220,192,412
20,9,24,199,180,379
3,9,24,42,27,69
24,13,35,520,312,832
11,13,35,192,143,335
8,13,35,156,104,260
29,13,35,425,377,802
20,13,35,433,260,693
18,13,35,295,234,529
9,13,35,185,117,302
30,13,35,513,390,903
9,13,35,185,117,302
5,13,35,79,65,144
2,13,35,41,26,67
16,13,35,346,208,554
12,13,35,197,156,353
18,21,55,543,378,921
19,21,55,416,399,815
13,38,50,150,494,644
19,38,50,190,722,912
26,42,54,-25,1092,1067
21,38,50,84,798,882
28,42,54,276,1176,1452
30,38,50,30,1140,1170
11,42,54,25,462,487
26,42,54,256,1092,1348
7,42,54,58,294,352
1,1898,3375,1342,1898,3240
1,1266,2320,1008,1266,2274
1,1252,2295,745,1252,1997
1,1266,2320,497,1266,1763
1,1266,2320,683,1266,1949
1,420,769,318,420,738
1,1266,2320,1008,1266,2274
1,1519,2443,826,1519,2345
1,344,540,158,344,502
28,26,70,1154,728,1882
3,26,70,103,78,181
22,9,25,237,198,435
30,9,25,323,270,593
23,1,2,22,23,45
18,1,2,17,18,35
3,1,2,2,3,5
29,1,2,17,29,46
30,2,5,89,60,149
17,2,5,50,34,84
1,2,5,3,2,5
5,2,5,15,10,25
4,9,25,60,36,96
12,9,25,180,108,288
23,2,5,53,46,99
25,1,2,24,25,49
14,1,2,13,14,27
16,1,2,15,16,31
25,9,25,356,225,581
11,1,2,10,11,21
14,1,2,13,14,27
25,1,4,74,25,99
8,1,4,24,8,32
2,1,2,1,2,3
4,1,2,4,4,8
16,1,2,16,16,32
22,1,4,64,22,86
26,1,4,76,26,102
18,2,5,34,36,70
24,2,5,46,48,94
29,2,5,55,58,113
21,1,2,16,21,37
18,1,2,14,18,32
29,1,2,23,29,52
19,8,21,195,152,347
22,8,21,226,176,402
13,8,21,134,104,238
15,2,5,44,30,74
24,2,5,70,48,118
3,1,2,3,3,6
4,1,2,4,4,8
5,1,2,5,5,10
8,1,2,8,8,16
26,1,2,25,26,51
7,8,21,88,56,144
11,9,25,171,99,270
4,9,25,62,36,98
27,1,4,77,27,104
6,1,4,17,6,23
9,1,4,26,9,35
13,1,4,38,13,51
30,9,25,345,270,615
1,9,25,12,9,21
2,9,25,23,18,41
18,1,4,53,18,71
6,1,4,18,6,24
1,461,742,274,461,735
1,755,1215,266,755,1021
1,1482,2384,473,1482,1955
1,461,742,274,461,735
1,1482,2384,854,1482,2336
1,461,742,251,461,712
1,461,742,266,461,727
1,461,742,251,461,712
1,1482,2384,401,1482,1883
1,24,64,39,24,63
16,24,64,620,384,1004
2,45,120,97,90,187
3,45,120,218,135,353
5,59,159,357,295,652
20,2,5,47,40,87
12,2,5,28,24,52
11,4,10,65,44,109
13,2,5,38,26,64
6,2,5,17,12,29
10,3,9,40,30,70
3,3,9,12,9,21
13,2,5,30,26,56
15,2,5,35,30,65
25,2,5,58,50,108
13,2,5,38,26,64
4,2,5,12,8,20
22,2,5,42,44,86
15,2,5,29,30,59
3,2,5,8,6,14
6,2,5,17,12,29
19,2,5,53,38,91
6,2,5,11,12,23
16,2,5,29,32,61
21,2,5,59,42,101
1,2,5,3,2,5
18,3,9,105,54,159
14,3,9,81,42,123
3,3,9,12,9,21
11,3,9,45,33,78
15,7,9,12,105,117
30,7,9,49,210,259
14,7,9,23,98,121
17,7,9,23,119,142
24,7,9,20,168,188
22,7,9,0,154,154
21,3,8,102,63,165
13,3,8,51,39,90
8,3,8,26,24,50
5,3,8,20,15,35
15,8,22,137,120,257
14,8,22,190,112,302
3,8,22,33,24,57
21,8,22,285,168,453
5,8,22,68,40,108
14,8,22,184,112,296
24,8,22,299,192,491
1,9,24,15,9,24
8,9,24,95,72,167
7,9,24,68,63,131
30,9,24,436,270,706
12,13,35,247,156,403
14,13,35,303,182,485
10,13,35,217,130,347
17,13,35,350,221,571
4,13,35,85,52,137
21,13,35,455,273,728
2,13,35,29,26,55
23,13,35,450,299,749
2,13,35,39,26,65
29,13,35,618,377,995
12,13,35,172,156,328
14,13,35,220,182,402
27,21,55,725,567,1292
4,21,55,105,84,189
23,21,55,554,483,1037
16,38,50,160,608,768
23,38,50,230,874,1104
7,42,54,80,294,374
13,38,50,143,494,637
3,42,54,0,126,126
1,38,50,11,38,49
10,42,54,109,420,529
1,1252,2295,492,1252,1744
1,1266,2320,961,1266,2227
1,1266,2320,961,1266,2227
1,1266,2320,752,1266,2018
1,1252,2295,722,1252,1974
1,420,769,341,420,761
1,1252,2295,745,1252,1997
1,1252,2295,997,1252,2249
1,344,540,174,344,518
1,487,783,280,487,767
1,2171,3578,942,2171,3113
1,2171,3578,835,2171,3006
1,713,1120,362,713,1075
1,713,1120,161,713,874
1,1083,1701,584,1083,1667
11,26,70,476,286,762
29,26,70,1256,754,2010
22,1,2,21,22,43
14,1,2,13,14,27
6,2,5,18,12,30
30,2,5,89,60,149
8,2,5,24,16,40
16,2,5,47,32,79
3,2,5,9,6,15
4,9,25,43,36,79
2,2,5,6,4,10
1,2,5,3,2,5
15,2,5,44,30,74
10,11,30,151,110,261
16,11,30,242,176,418
4,1,2,4,4,8
14,1,4,38,14,52
20,1,2,11,20,31
14,8,21,117,112,229
13,13,35,204,169,373
16,13,35,251,208,459
6,13,35,94,78,172
23,1,2,13,23,36
26,9,25,332,234,566
30,1,2,17,30,47
16,1,4,36,16,52
12,1,4,33,12,45
19,1,4,52,19,71
1,11,30,18,11,29
1,11,30,18,11,29
15,8,21,154,120,274
17,8,21,175,136,311
10,8,21,103,80,183
11,8,21,113,88,201
15,8,21,182,120,302
30,8,21,365,240,605
27,2,5,78,54,132
24,2,5,70,48,118
1,8,21,9,8,17
20,1,2,11,20,31
25,1,2,24,25,49
6,1,2,6,6,12
6,2,5,13,12,25
18,1,2,17,18,35
15,1,2,14,15,29
2,1,2,1,2,3
5,1,2,3,5,8
1,755,1215,193,755,948
11,24,64,341,264,605
4,59,159,324,236,560
8,4,10,46,32,78
11,4,10,64,44,108
1,2,5,3,2,5
4,2,5,9,8,17
21,2,5,48,42,90
16,2,5,45,32,77
20,2,5,56,40,96
1,2,5,2,2,4
3,2,5,6,6,12
29,2,5,64,58,122
11,2,5,24,22,46
17,2,5,45,34,79
19,2,5,50,38,88
4,2,5,12,8,20
1,2,5,3,2,5
23,2,5,68,46,114
16,2,5,47,32,79
16,2,5,47,32,79
21,2,5,44,42,86
3,2,5,6,6,12
15,7,9,29,105,134
5,7,9,9,35,44
18,7,9,33,126,159
24,7,9,44,168,212
19,3,8,92,57,149
26,8,22,284,208,492
1,8,22,14,8,22
9,8,22,118,72,190
9,8,22,124,72,196
18,9,24,192,162,354
30,13,35,650,390,1040
10,13,35,171,130,301
4,13,35,85,52,137
16,13,35,330,208,538
30,13,35,639,390,1029
29,13,35,506,377,883
20,13,35,426,260,686
6,13,35,117,78,195
23,13,35,377,299,676
15,13,35,262,195,457
12,13,35,260,156,416
17,13,35,249,221,470
7,13,35,103,91,194
14,21,55,445,294,739
30,38,50,30,1140,1170
16,42,54,36,672,708
23,38,50,92,874,966
8,42,54,27,336,363
11,38,50,110,418,528
30,38,50,45,1140,1185
1,42,54,11,42,53
20,38,50,220,760,980
8,38,50,88,304,392
11,38,50,121,418,539
1,1252,2295,1020,1252,2272
1,1252,2295,768,1252,2020
1,1898,3375,937,1898,2835
1,1266,2320,729,1266,1995
1,1252,2295,745,1252,1997
1,1266,2320,961,1266,2227
1,1266,2320,892,1266,2158
1,295,540,223,295,518
1,308,565,251,308,559
1,344,540,191,344,535
1,1555,2443,546,1555,2101
1,713,1120,385,713,1098
1,487,783,280,487,767
1,487,783,124,487,611
1,2171,3578,835,2171,3006
1,713,1120,396,713,1109
1,1555,2443,570,1555,2125
18,26,70,767,468,1235
5,26,70,143,130,273
18,26,70,767,468,1235
10,11,30,154,110,264
2,11,30,31,22,53
25,11,29,334,275,609
3,11,29,40,33,73
10,9,25,108,90,198
8,9,25,86,72,158
6,1,4,14,6,20
8,1,4,19,8,27
24,1,2,23,24,47
21,1,2,20,21,41
4,1,2,3,4,7
20,2,5,58,40,98
25,2,5,73,50,123
25,1,4,53,25,78
15,1,4,32,15,47
2,2,5,4,4,8
21,2,5,49,42,91
29,2,5,68,58,126
22,12,33,310,264,574
20,12,33,281,240,521
9,2,5,20,18,38
10,2,5,22,20,42
3,1,4,9,3,12
11,1,4,31,11,42
27,1,4,77,27,104
19,13,35,391,247,638
25,13,35,515,325,840
2,13,35,41,26,67
22,11,30,372,242,614
29,11,30,490,319,809
22,11,30,411,242,653
27,11,30,505,297,802
18,1,2,13,18,31
13,1,2,9,13,22
12,1,2,9,12,21
15,1,4,44,15,59
16,8,21,201,128,329
24,9,25,372,216,588
15,9,25,233,135,368
19,9,25,295,171,466
1,1482,2384,521,1482,2003
1,1482,2384,521,1482,2003
1,755,1215,241,755,996
1,1482,2384,854,1482,2336
1,755,1215,436,755,1191
6,24,64,156,144,300
3,59,159,290,177,467
11,2,5,29,22,51
2,2,5,5,4,9
7,4,10,29,28,57
12,4,10,50,48,98
7,2,5,20,14,34
13,4,10,60,52,112
9,4,10,52,36,88
17,4,10,65,68,133
21,4,10,80,84,164
11,2,5,32,22,54
14,2,5,41,28,69
24,2,5,71,48,119
27,3,9,109,81,190
7,3,9,28,21,49
22,7,9,18,154,172
3,3,8,12,9,21
28,8,22,367,224,591
25,8,22,262,200,462
28,8,22,380,224,604
25,9,24,369,225,594
1,9,24,11,9,20
22,9,24,214,198,412
3,9,24,41,27,68
19,13,35,405,247,652
15,13,35,246,195,441
12,13,35,188,156,344
20,13,35,349,260,609
4,13,35,87,52,139
8,13,35,173,104,277
15,13,35,309,195,504
17,13,35,249,221,470
28,13,35,381,364,745
26,13,35,508,338,846
22,13,35,469,286,755
28,13,35,606,364,970
4,13,35,68,52,120
29,13,35,425,377,802
28,13,35,577,364,941
1,13,35,16,13,29
8,13,35,114,104,218
24,13,35,511,312,823
24,13,35,520,312,832
22,13,35,469,286,755
3,13,35,62,39,101
28,21,55,752,588,1340
5,21,55,159,105,264
23,42,54,264,966,1230
30,42,54,295,1260,1555
18,42,54,90,756,846
8,42,54,1,336,337
21,42,54,229,882,1111
4,42,54,20,168,188
6,38,50,60,228,288
1,1252,2295,951,1252,2203
1,1266,2320,683,1266,1949
1,308,565,234,308,542
1,1266,2320,1031,1266,2297
1,1252,2295,882,1252,2134
1,1252,2295,997,1252,2249
1,2171,3578,763,2171,2934
1,2171,3578,763,2171,2934
1,2171,3578,942,2171,3113
1,1555,2443,448,1555,2003
1,2171,3578,942,2171,3113
1,2171,3578,942,2171,3113
1,487,783,155,487,642
1,344,540,77,344,421
1,344,540,126,344,470
1,344,540,99,344,443
1,344,540,174,344,518
14,26,70,606,364,970
14,26,70,596,364,960
5,3,9,28,15,43
3,13,35,64,39,103
13,13,35,277,169,446
21,1,4,60,21,81
28,2,5,59,56,115
29,1,2,21,29,50
5,1,2,4,5,9
2,2,5,6,4,10
14,2,5,41,28,69
7,2,5,13,14,27
17,2,5,31,34,65
3,2,5,8,6,14
23,2,5,64,46,110
23,2,5,64,46,110
30,2,5,84,60,144
18,2,5,38,36,74
29,8,21,292,232,524
22,8,21,221,176,397
8,1,4,23,8,31
28,1,4,80,28,108
9,1,4,26,9,35
7,1,2,4,7,11
22,1,2,13,22,35
8,2,5,19,16,35
20,2,5,42,40,82
27,2,5,57,54,111
2,2,5,4,4,8
24,1,2,22,24,46
19,1,2,17,19,36
3,2,5,9,6,15
10,2,5,29,20,49
12,2,5,34,24,58
10,2,5,28,20,48
9,1,4,26,9,35
24,1,4,68,24,92
4,2,5,12,8,20
8,2,5,23,16,39
14,1,2,14,14,28
10,1,2,10,10,20
15,1,2,15,15,30
13,8,21,164,104,268
7,1,2,4,7,11
8,1,2,4,8,12
14,1,2,12,14,26
18,1,2,16,18,34
13,2,5,31,26,57
23,2,5,54,46,100
1,461,742,162,461,623
1,755,1215,448,755,1203
1,755,1215,193,755,948
2,24,64,60,48,108
7,45,120,416,315,731
3,59,159,281,177,458
12,2,5,25,24,49
11,4,10,64,44,108
9,4,10,52,36,88
13,4,10,77,52,129
17,4,10,100,68,168
10,4,10,58,40,98
9,2,5,26,18,44
8,2,5,23,16,39
21,2,5,61,42,103
4,2,5,12,8,20
4,2,5,9,8,17
10,2,5,24,20,44
19,2,5,36,38,74
9,2,5,17,18,35
3,2,5,9,6,15
25,2,5,74,50,124
5,2,5,10,10,20
26,3,9,154,78,232
4,3,9,24,12,36
17,7,9,14,119,133
22,7,9,18,154,172
16,7,9,13,112,125
21,7,9,34,147,181
30,3,8,148,90,238
2,3,8,10,6,16
10,8,22,111,80,191
19,9,24,203,171,374
22,9,24,319,198,517
19,13,35,298,247,545
16,13,35,346,208,554
8,13,35,117,104,221
17,13,35,362,221,583
1,13,35,21,13,34
6,13,35,130,78,208
7,13,35,152,91,243
4,13,35,70,52,122
6,13,35,128,78,206
5,13,35,72,65,137
17,21,55,569,357,926
29,21,55,699,609,1308
25,21,55,823,525,1348
27,21,55,725,567,1292
30,38,50,345,1140,1485
9,42,54,6,378,384
30,42,54,20,1260,1280
9,42,54,45,378,423
30,42,54,149,1260,1409
25,42,54,273,1050,1323
29,38,50,29,1102,1131
9,38,50,99,342,441
2,42,54,5,84,89
1,1252,2295,997,1252,2249
1,1266,2320,544,1266,1810
1,1266,2320,636,1266,1902
1,1266,2320,636,1266,1902
1,420,769,334,420,754
1,420,769,334,420,754
1,1266,2320,1008,1266,2274
1,1519,2443,387,1519,1906
1,1519,2443,900,1519,2419
1,1083,1701,601,1083,1684
1,1555,2443,790,1555,2345
1,2171,3578,656,2171,2827
1,2171,3578,942,2171,3113
1,713,1120,161,713,874
1,1555,2443,497,1555,2052
1,344,540,185,344,529
1,713,1120,261,713,974
21,3,9,124,63,187
15,3,9,72,45,117
30,2,5,57,60,117
23,13,35,490,299,789
21,13,35,447,273,720
13,11,29,230,143,373
20,11,29,354,220,574
30,1,2,29,30,59
15,1,2,14,15,29
24,2,5,71,48,119
23,2,5,68,46,114
16,2,5,45,32,77
4,2,5,11,8,19
17,2,5,48,34,82
26,2,5,49,52,101
27,2,5,51,54,105
26,2,5,49,52,101
25,2,5,74,50,124
4,2,5,12,8,20
28,2,5,53,56,109
1,2,5,2,2,4
3,1,2,3,3,6
27,1,2,25,27,52
15,1,2,15,15,30
19,2,5,56,38,94
6,2,5,18,12,30
25,2,5,74,50,124
19,2,5,55,38,93
5,2,5,15,10,25
17,2,5,49,34,83
6,2,5,17,12,29
19,11,30,355,209,564
25,11,30,468,275,743
6,2,5,14,12,26
19,2,5,45,38,83
4,1,2,4,4,8
22,1,2,22,22,44
14,1,2,14,14,28
2,9,25,21,18,39
8,1,2,8,8,16
2,1,2,2,2,4
21,2,5,40,42,82
13,1,2,12,13,25
26,1,2,25,26,51
1,1482,2384,735,1482,2217
1,1482,2384,854,1482,2336
1,755,1215,411,755,1166
18,24,64,570,432,1002
10,45,120,486,450,936
8,2,5,19,16,35
9,2,5,21,18,39
26,3,9,154,78,232
17,2,5,33,34,67
5,2,5,10,10,20
27,4,10,151,108,259
9,2,5,25,18,43
5,2,5,15,10,25
6,2,5,17,12,29
4,2,5,12,8,20
19,2,5,55,38,93
23,2,5,67,46,113
15,2,5,44,30,74
22,2,5,64,44,108
18,2,5,53,36,89
2,2,5,6,4,10
4,2,5,12,8,20
5,2,5,15,10,25
22,7,9,42,154,196
15,7,9,27,105,132
29,7,9,55,203,258
18,7,9,0,126,126
25,3,8,83,75,158
13,3,8,48,39,87
3,3,8,10,9,19
3,8,22,27,24,51
3,8,22,33,24,57
8,8,22,73,64,137
29,8,22,304,232,536
10,9,24,148,90,238
11,9,24,110,99,209
7,9,24,102,63,165
29,9,24,421,261,682
24,13,35,352,312,664
4,13,35,59,52,111
11,13,35,192,143,335
20,13,35,349,260,609
1,13,35,21,13,34
27,13,35,556,351,907
26,13,35,554,338,892
16,13,35,346,208,554
26,13,35,554,338,892
11,13,35,192,143,335
7,13,35,149,91,240
10,13,35,217,130,347
3,13,35,64,39,103
28,13,35,606,364,970
24,13,35,469,312,781
11,13,35,238,143,381
20,21,55,449,420,869
29,38,50,29,1102,1131
29,38,50,290,1102,1392
15,42,54,2,630,632
15,42,54,67,630,697
13,42,54,65,546,611
30,42,54,328,1260,1588
23,38,50,265,874,1139
18,42,54,206,756,962
18,42,54,90,756,846
10,38,50,10,380,390
30,38,50,165,1140,1305
1,1912,3400,1046,1912,2958
1,1252,2295,745,1252,1997
1,1266,2320,1008,1266,2274
1,420,769,334,420,754
1,1266,2320,544,1266,1810
1,487,783,280,487,767
1,487,783,186,487,673
1,487,783,124,487,611
1,2171,3578,656,2171,2827
1,2171,3578,835,2171,3006
1,344,540,77,344,421
1,2171,3578,835,2171,3006
1,344,540,158,344,502
1,2171,3578,1371,2171,3542
1,1555,2443,864,1555,2419
1,2171,3578,1335,2171,3506
23,26,70,996,598,1594
23,26,70,996,598,1594
10,26,70,342,260,602
8,26,70,229,208,437
7,26,70,239,182,421
12,26,70,419,312,731
19,3,9,92,57,149
19,3,9,92,57,149
12,13,35,260,156,416
4,13,35,87,52,139
13,13,35,277,169,446
5,13,35,107,65,172
24,13,35,520,312,832
30,13,35,650,390,1040
2,13,35,43,26,69
21,1,2,20,21,41
19,1,4,47,19,66
24,2,5,47,48,95
24,2,5,47,48,95
4,2,5,12,8,20
21,2,5,62,42,104
12,2,5,35,24,59
28,2,5,81,56,137
25,9,25,375,225,600
23,9,25,345,207,552
8,1,2,7,8,15
24,1,2,22,24,46
17,1,2,12,17,29
24,1,2,16,24,40
26,1,2,25,26,51
6,1,2,6,6,12
19,1,4,43,19,62
14,1,4,32,14,46
12,8,21,138,96,234
26,1,4,55,26,81
18,1,4,38,18,56
17,1,4,36,17,53
20,1,2,19,20,39
7,1,4,20,7,27
19,2,5,45,38,83
8,2,5,19,16,35
22,1,2,16,22,38
4,1,2,3,4,7
1,1,2,1,1,2
6,1,4,12,6,18
18,1,4,37,18,55
3,11,29,52,33,85
13,11,29,226,143,369
24,2,5,70,48,118
24,2,5,46,48,94
20,2,5,38,40,78
28,2,5,53,56,109
16,2,5,30,32,62
14,2,5,37,28,65
5,2,5,13,10,23
11,2,5,29,22,51
1,755,1215,411,755,1166
1,461,742,274,461,735
1,1482,2384,854,1482,2336
1,1482,2384,854,1482,2336
1,755,1215,436,755,1191
1,461,742,229,461,690
1,461,742,274,461,735
1,1482,2384,592,1482,2074
1,24,64,39,24,63
9,59,159,585,531,1116
1,59,159,94,59,153
9,4,10,53,36,89
29,4,10,162,116,278
15,4,10,84,60,144
18,2,5,50,36,86
19,2,5,53,38,91
18,2,5,48,36,84
3,2,5,8,6,14
24,2,5,70,48,118
27,2,5,78,54,132
13,2,5,38,26,64
27,4,10,113,108,221
7,4,10,29,28,57
19,4,10,72,76,148
30,4,10,114,120,234
16,2,5,30,32,62
13,2,5,25,26,51
18,2,5,49,36,85
10,2,5,23,20,43
28,2,5,59,56,115
7,2,5,15,14,29
27,3,9,157,81,238
11,3,9,64,33,97
8,3,9,47,24,71
13,3,9,76,39,115
17,2,5,49,34,83
2,2,5,5,4,9
28,2,5,66,56,122
18,2,5,53,36,89
5,2,5,15,10,25
21,3,9,86,63,149
16,3,9,66,48,114
29,2,5,61,58,119
14,2,5,29,28,57
30,7,9,55,210,265
28,7,9,46,196,242
25,7,9,10,175,185
12,7,9,22,84,106
13,7,9,1,91,92
22,3,8,78,66,144
27,3,8,131,81,212
21,3,8,68,63,131
12,8,22,157,96,253
3,8,22,39,24,63
11,8,22,101,88,189
21,8,22,211,168,379
29,8,22,380,232,612
4,8,22,55,32,87
24,9,24,337,216,553
30,9,24,356,270,626
8,9,24,85,72,157
9,9,24,131,81,212
20,9,24,271,180,451
30,9,24,292,270,562
26,9,24,253,234,487
23,9,24,273,207,480
5,9,24,73,45,118
16,13,35,346,208,554
25,13,35,358,325,683
14,13,35,303,182,485
20,13,35,286,260,546
30,13,35,440,390,830
15,13,35,262,195,457
7,13,35,120,91,211
13,13,35,254,169,423
7,13,35,100,91,191
5,13,35,103,65,168
25,13,35,428,325,753
19,13,35,405,247,652
2,13,35,35,26,61
27,13,35,575,351,926
25,13,35,533,325,858
10,13,35,171,130,301
20,21,55,537,420,957
30,21,55,987,630,1617
29,42,54,285,1218,1503
22,42,54,252,924,1176
15,38,50,150,570,720
16,38,50,48,608,656
23,38,50,253,874,1127
30,38,50,330,1140,1470
1,1252,2295,1020,1252,2272
1,1252,2295,538,1252,1790
1,1266,2320,1008,1266,2274
1,1266,2320,1008,1266,2274
1,1252,2295,951,1252,2203
1,308,565,234,308,542
1,308,565,178,308,486
1,1519,2443,484,1519,2003
1,1519,2443,753,1519,2272
1,344,540,77,344,421
1,1083,1701,584,1083,1667
1,1083,1701,584,1083,1667
1,1083,1701,261,1083,1344
1,1555,2443,864,1555,2419
5,26,70,206,130,336
27,3,9,152,81,233
24,3,9,109,72,181
5,9,25,79,45,124
20,9,25,315,180,495
7,2,5,13,14,27
1,2,5,2,2,4
10,1,2,10,10,20
26,1,2,25,26,51
26,13,35,554,338,892
13,2,5,38,26,64
4,12,33,79,48,127
10,12,33,197,120,317
8,2,5,24,16,40
18,2,5,53,36,89
2,13,35,43,26,69
29,13,35,618,377,995
17,1,2,16,17,33
5,1,2,5,5,10
5,13,35,107,65,172
28,13,35,596,364,960
23,1,4,57,23,80
29,2,5,67,58,125
24,2,5,55,48,103
2,1,2,1,2,3
1,2,5,2,2,4
19,1,2,16,19,35
4,11,30,60,44,104
12,11,30,181,132,313
16,2,5,30,32,62
6,2,5,11,12,23
13,2,5,25,26,51
16,2,5,30,32,62
20,2,5,38,40,78
22,1,2,16,22,38
8,2,5,23,16,39
16,1,4,36,16,52
8,1,2,7,8,15
2,1,2,2,2,4
12,2,5,23,24,47
19,2,5,36,38,74
30,2,5,57,60,117
14,1,2,8,14,22
27,1,2,15,27,42
17,2,5,45,34,79
1,2,5,3,2,5
20,1,2,11,20,31
24,1,2,13,24,37
6,1,4,18,6,24
1,1,4,3,1,4
1,1,4,3,1,4
9,1,4,26,9,35
2,1,4,6,2,8
21,1,4,61,21,82
4,2,5,8,8,16
30,2,5,57,60,117
6,1,4,15,6,21
4,1,4,10,4,14
1,1482,2384,473,1482,1955
1,461,742,125,461,586
1,1482,2384,735,1482,2217
1,755,1215,448,755,1203
1,1482,2384,401,1482,1883
1,1482,2384,592,1482,2074
1,1482,2384,521,1482,2003
23,24,64,861,552,1413
23,24,64,714,552,1266
10,3,9,46,30,76
4,3,9,18,12,30
6,2,5,17,12,29
19,2,5,55,38,93
23,2,5,67,46,113
21,4,10,122,84,206
6,4,10,35,24,59
4,2,5,8,8,16
19,2,5,37,38,75
29,2,5,84,58,142
28,2,5,83,56,139
22,7,9,12,154,166
22,7,9,18,154,172
25,7,9,1,175,176
29,7,9,16,203,219
7,7,9,13,49,62
4,7,9,7,28,35
8,7,9,13,56,69
16,7,9,31,112,143
25,3,8,123,75,198
3,8,22,41,24,65
2,8,22,20,16,36
19,8,22,199,152,351
13,8,22,176,104,280
15,9,24,218,135,353
10,13,35,213,130,343
10,13,35,164,130,294
8,13,35,137,104,241
19,13,35,405,247,652
21,13,35,447,273,720
23,21,55,769,483,1252
30,38,50,330,1140,1470
27,38,50,270,1026,1296
2,38,50,6,76,82
10,38,50,100,380,480
9,42,54,30,378,408
15,42,54,164,630,794
20,42,54,218,840,1058
1,1252,2295,676,1252,1928
1,1252,2295,997,1252,2249
1,1252,2295,951,1252,2203
1,1266,2320,1031,1266,2297
1,1266,2320,1008,1266,2274
1,2171,3578,1264,2171,3435
1,487,783,280,487,767
1,487,783,280,487,767
1,1083,1701,550,1083,1633
1,1519,2443,411,1519,1930
7,26,70,298,182,480
26,26,70,816,676,1492
29,3,9,169,87,256
5,3,9,29,15,44
16,3,9,93,48,141
12,13,35,205,156,361
1,13,35,17,13,30
3,2,5,8,6,14
17,2,5,48,34,82
21,1,2,20,21,41
13,9,25,166,117,283
5,1,2,5,5,10
13,1,2,12,13,25
13,1,2,12,13,25
29,2,5,84,58,142
12,9,25,129,108,237
11,13,35,234,143,377
9,1,2,9,9,18
20,1,2,19,20,39
2,1,2,2,2,4
26,1,4,77,26,103
18,11,30,331,198,529
7,1,2,7,7,14
29,1,2,28,29,57
13,2,5,29,26,55
20,2,5,56,40,96
23,2,5,64,46,110
22,11,30,326,242,568
14,11,30,207,154,361
24,1,2,13,24,37
2,1,2,1,2,3
25,11,29,443,275,718
5,1,4,10,5,15
27,1,4,55,27,82
17,2,5,48,34,82
19,2,5,53,38,91
20,8,21,252,160,412
5,8,21,63,40,103
1,1482,2384,330,1482,1812
1,1482,2384,854,1482,2336
1,1482,2384,854,1482,2336
1,755,1215,193,755,948
1,1482,2384,521,1482,2003
25,3,9,114,75,189
29,3,9,132,87,219
29,2,5,86,58,144
16,2,5,34,32,66
19,2,5,40,38,78
7,2,5,20,14,34
24,2,5,67,48,115
3,4,10,18,12,30
9,2,5,27,18,45
4,2,5,12,8,20
27,4,10,157,108,265
4,3,9,16,12,28
1,3,9,4,3,7
1,3,9,5,3,8
23,3,9,124,69,193
21,2,5,49,42,91
8,2,5,19,16,35
23,7,9,38,161,199
6,7,9,10,42,52
7,3,8,23,21,44
20,3,8,98,60,158
27,3,8,131,81,212
26,3,8,93,78,171
22,3,8,108,66,174
9,8,22,100,72,172
11,8,22,149,88,237
4,8,22,40,32,72
23,8,22,302,184,486
17,9,24,198,153,351
12,9,24,143,108,251
20,9,24,238,180,418
16,13,35,229,208,437
12,13,35,209,156,365
1,13,35,21,13,34
13,13,35,268,169,437
3,13,35,64,39,103
26,13,35,536,338,874
3,13,35,52,39,91
1,13,35,17,13,30
21,13,35,447,273,720
7,13,35,100,91,191
30,13,35,524,390,914
10,21,55,335,210,545
1,21,55,33,21,54
14,42,54,70,588,658
9,38,50,14,342,356
2,42,54,0,84,84
18,42,54,177,756,933
1,1266,2320,636,1266,1902
1,1266,2320,961,1266,2227
1,1252,2295,676,1252,1928
1,1252,2295,745,1252,1997
1,420,769,249,420,669
1,308,565,178,308,486
1,420,769,249,420,669
1,1266,2320,961,1266,2227
1,2171,3578,763,2171,2934
1,2171,3578,942,2171,3113
1,2171,3578,942,2171,3113
1,2171,3578,942,2171,3113
1,2171,3578,727,2171,2898
1,1555,2443,351,1555,1906
1,2171,3578,942,2171,3113
1,344,540,126,344,470
1,713,1120,205,713,918
1,487,783,171,487,658
1,2171,3578,1371,2171,3542
14,26,70,489,364,853
3,26,70,130,78,208
22,26,70,691,572,1263
26,3,9,154,78,232
14,3,9,60,42,102
13,3,9,76,39,115
28,2,5,66,56,122
23,1,4,49,23,72
9,9,25,115,81,196
11,9,25,140,99,239
20,8,21,172,160,332
4,8,21,34,32,66
18,1,2,18,18,36
3,1,2,3,3,6
3,11,30,56,33,89
28,11,30,524,308,832
30,11,30,561,330,891
5,2,5,14,10,24
24,2,5,67,48,115
1,2,5,3,2,5
11,1,2,7,11,18
21,1,2,13,21,34
12,9,25,135,108,243
7,9,25,79,63,142
29,1,2,19,29,48
18,1,2,12,18,30
2,2,5,6,4,10
27,9,25,344,243,587
10,9,25,128,90,218
27,12,33,424,324,748
13,1,2,12,13,25
21,1,2,19,21,40
18,11,30,266,198,464
17,1,2,16,17,33
25,8,21,215,200,415
4,8,21,34,32,66
27,1,2,26,27,53
3,1,2,3,3,6
10,2,5,30,20,50
10,2,5,29,20,49
22,2,5,64,44,108
17,9,25,217,153,370
30,1,2,29,30,59
4,9,25,62,36,98
27,9,25,419,243,662
16,1,2,9,16,25
19,1,2,11,19,30
17,9,25,264,153,417
30,1,4,88,30,118
14,1,4,41,14,55
1,461,742,185,461,646
1,461,742,229,461,690
16,24,64,456,384,840
12,24,64,465,288,753
7,45,120,508,315,823
10,59,159,793,590,1383
22,2,5,46,44,90
15,4,10,63,60,123
18,2,5,38,36,74
24,2,5,56,48,104
6,2,5,14,12,26
25,2,5,59,50,109
24,2,5,71,48,119
15,2,5,44,30,74
12,3,9,49,36,85
13,3,9,53,39,92
12,2,5,28,24,52
10,2,5,24,20,44
15,2,5,35,30,65
30,7,9,1,210,211
18,7,9,15,126,141
1,7,9,2,7,9
19,7,9,16,133,149
7,7,9,13,49,62
20,7,9,17,140,157
24,7,9,46,168,214
30,7,9,49,210,259
14,3,8,69,42,111
20,3,8,97,60,157
22,8,22,240,176,416
14,8,22,190,112,302
24,8,22,325,192,517
19,8,22,262,152,414
30,8,22,301,240,541
14,8,22,128,112,240
2,9,24,30,18,48
11,9,24,162,99,261
6,9,24,89,54,143
27,9,24,392,243,635
3,13,35,62,39,101
28,13,35,577,364,941
11,13,35,238,143,381
13,13,35,254,169,423
3,13,35,43,39,82
10,13,35,175,130,305
4,13,35,85,52,137
13,13,35,268,169,437
29,13,35,506,377,883
6,13,35,128,78,206
20,13,35,440,260,700
23,13,35,498,299,797
13,13,35,281,169,450
11,13,35,234,143,377
6,13,35,88,78,166
4,21,55,134,84,218
3,21,55,81,63,144
18,21,55,434,378,812
4,21,55,96,84,180
13,42,54,58,546,604
19,38,50,19,722,741
25,38,50,213,950,1163
16,38,50,16,608,624
16,38,50,160,608,768
18,38,50,27,684,711
1,1898,3375,768,1898,2666
1,1912,3400,1046,1912,2958
1,1266,2320,961,1266,2227
1,1252,2295,722,1252,1974
1,1266,2320,683,1266,1949
1,420,769,249,420,669
1,295,540,126,295,421
1,2171,3578,942,2171,3113
1,487,783,280,487,767
1,487,783,280,487,767
1,1555,2443,351,1555,1906
1,2171,3578,942,2171,3113
1,2171,3578,835,2171,3006
1,1083,1701,550,1083,1633
1,344,540,185,344,529
1,344,540,99,344,443
1,1083,1701,261,1083,1344
16,26,70,693,416,1109
2,26,70,87,52,139
28,26,70,1193,728,1921
15,26,70,513,390,903
14,26,70,400,364,764
9,3,9,39,27,66
25,3,9,146,75,221
8,3,9,38,24,62
21,2,5,61,42,103
28,2,5,81,56,137
28,1,2,27,28,55
24,1,2,23,24,47
30,1,2,29,30,59
22,1,2,21,22,43
13,1,2,10,13,23
27,1,2,20,27,47
23,1,2,17,23,40
8,11,30,150,88,238
13,13,35,281,169,450
4,13,35,87,52,139
10,2,5,27,20,47
7,2,5,21,14,35
2,2,5,6,4,10
13,2,5,25,26,51
18,2,5,34,36,70
25,2,5,48,50,98
9,9,25,115,81,196
9,9,25,115,81,196
25,12,33,517,300,817
24,2,5,50,48,98
22,2,5,46,44,90
5,1,2,3,5,8
2,1,2,1,2,3
1,1,2,1,1,2
13,2,5,39,26,65
4,2,5,12,8,20
7,1,2,7,7,14
12,1,4,30,12,42
5,2,5,15,10,25
12,2,5,35,24,59
13,1,4,38,13,51
1,1,4,3,1,4
20,1,4,58,20,78
13,1,2,7,13,20
26,1,2,15,26,41
8,1,2,6,8,14
22,1,2,21,22,43
13,1,2,12,13,25
8,2,5,24,16,40
13,2,5,38,26,64
30,2,5,87,60,147
4,1,2,3,4,7
1,1,2,1,1,2
15,1,2,13,15,28
1,461,742,266,461,727
1,755,1215,193,755,948
1,1482,2384,854,1482,2336
1,461,742,274,461,735
1,1482,2384,592,1482,2074
1,755,1215,411,755,1166
8,24,64,310,192,502
16,24,64,415,384,799
14,24,64,399,336,735
5,59,159,492,295,787
3,59,159,214,177,391
14,3,9,79,42,121
22,3,9,118,66,184
11,3,9,59,33,92
23,2,5,53,46,99
12,2,5,28,24,52
17,2,5,32,34,66
13,2,5,25,26,51
22,2,5,43,44,87
12,4,10,70,48,118
16,4,10,93,64,157
19,2,5,55,38,93
5,2,5,15,10,25
19,3,9,92,57,149
3,3,9,14,9,23
27,2,5,80,54,134
13,2,5,38,26,64
24,2,5,56,48,104
26,2,5,61,52,113
17,2,5,40,34,74
3,2,5,7,6,13
25,7,9,21,175,196
25,7,9,3,175,178
19,3,8,63,57,120
11,3,8,49,33,82
21,8,22,276,168,444
28,8,22,386,224,610
16,8,22,217,128,345
19,8,22,212,152,364
23,9,24,306,207,513
13,9,24,154,117,271
9,13,35,195,117,312
3,13,35,52,39,91
30,13,35,618,390,1008
11,13,35,227,143,370
11,13,35,173,143,316
18,13,35,295,234,529
29,13,35,506,377,883
1,13,35,21,13,34
20,13,35,286,260,546
16,13,35,234,208,442
24,13,35,494,312,806
28,13,35,410,364,774
10,21,55,302,210,512
24,38,50,132,912,1044
23,38,50,35,874,909
21,42,54,241,882,1123
9,38,50,9,342,351
4,38,50,44,152,196
27,38,50,311,1026,1337
29,38,50,290,1102,1392
1,1252,2295,882,1252,2134
1,1252,2295,997,1252,2249
1,1266,2320,1031,1266,2297
1,1266,2320,752,1266,2018
1,1252,2295,722,1252,1974
1,420,769,318,420,738
1,1252,2295,882,1252,2134
1,308,565,184,308,492
1,1252,2295,997,1252,2249
1,2171,3578,942,2171,3113
1,2171,3578,942,2171,3113
1,1519,2443,826,1519,2345
1,2171,3578,656,2171,2827
1,344,540,174,344,518
1,344,540,174,344,518
1,713,1120,228,713,941
1,344,540,174,344,518
1,713,1120,172,713,885
30,26,70,1278,780,2058
28,1,2,21,28,49
4,1,2,3,4,7
16,1,2,9,16,25
1,1,2,1,1,2
13,2,5,38,26,64
10,2,5,30,20,50
14,9,25,161,126,287
7,9,25,81,63,144
24,1,2,23,24,47
13,1,2,12,13,25
18,1,2,17,18,35
9,2,5,19,18,37
29,1,4,79,29,108
16,1,4,44,16,60
1,1,4,3,1,4
10,2,5,21,20,41
27,2,5,57,54,111
23,8,21,212,184,396
22,12,33,447,264,711
23,12,33,468,276,744
11,12,33,224,132,356
5,1,2,5,5,10
12,1,2,12,12,24
29,1,2,28,29,57
5,2,5,15,10,25
28,2,5,53,56,109
5,2,5,10,10,20
13,1,2,12,13,25
11,2,5,31,22,53
22,2,5,62,44,106
18,2,5,50,36,86
7,1,4,20,7,27
5,1,4,14,5,19
14,2,5,31,28,59
14,2,5,31,28,59
1,1482,2384,521,1482,2003
1,755,1215,448,755,1203
1,1482,2384,807,1482,2289
1,461,742,266,461,727
1,755,1215,193,755,948
1,1482,2384,592,1482,2074
6,45,120,436,270,706
3,59,159,238,177,415
20,4,10,116,80,196
24,2,5,67,48,115
20,2,5,56,40,96
15,2,5,44,30,74
17,2,5,49,34,83
23,2,5,67,46,113
9,2,5,27,18,45
1,2,5,2,2,4
27,2,5,63,54,117
6,3,9,34,18,52
17,3,9,96,51,147
7,7,9,11,49,60
28,7,9,23,196,219
4,3,8,19,12,31
24,3,8,80,72,152
6,3,8,24,18,42
23,3,8,89,69,158
14,3,8,68,42,110
2,3,8,10,6,16
28,8,22,367,224,591
28,8,22,281,224,505
3,8,22,41,24,65
1,8,22,11,8,19
8,8,22,105,64,169
18,8,22,201,144,345
27,8,22,301,216,517
6,8,22,55,48,103
21,9,24,204,189,393
14,9,24,139,126,265
4,13,35,57,52,109
12,13,35,256,156,412
24,13,35,419,312,731
19,13,35,391,247,638
19,13,35,411,247,658
12,13,35,247,156,403
22,13,35,469,286,755
7,13,35,110,91,201
21,13,35,447,273,720
23,13,35,474,299,773
22,13,35,384,286,670
18,13,35,383,234,617
4,13,35,87,52,139
18,13,35,371,234,605
28,13,35,410,364,774
23,13,35,329,299,628
13,13,35,268,169,437
22,13,35,469,286,755
18,13,35,257,234,491
21,13,35,366,273,639
20,21,55,449,420,869
11,21,55,265,231,496
5,21,55,134,105,239
30,38,50,330,1140,1470
22,42,54,252,924,1176
19,42,54,95,798,893
17,38,50,170,646,816
8,42,54,40,336,376
1,1266,2320,1008,1266,2274
1,420,769,318,420,738
1,420,769,334,420,754
1,1252,2295,951,1252,2203
1,1266,2320,636,1266,1902
1,487,783,280,487,767
1,344,540,185,344,529
1,2171,3578,656,2171,2827
1,2171,3578,942,2171,3113
1,344,540,174,344,518
1,344,540,174,344,518
15,26,70,650,390,1040
4,2,5,8,8,16
25,2,5,48,50,98
17,1,2,10,17,27
16,1,2,9,16,25
10,1,2,10,10,20
30,2,5,89,60,149
20,2,5,59,40,99
19,1,2,17,19,36
4,1,2,3,4,7
23,1,2,15,23,38
5,2,5,15,10,25
4,2,5,12,8,20
18,13,35,383,234,617
28,1,4,80,28,108
30,1,4,85,30,115
16,2,5,47,32,79
14,1,2,13,14,27
27,1,2,26,27,53
2,1,2,2,2,4
13,1,2,13,13,26
27,1,2,17,27,44
2,2,5,5,4,9
12,2,5,28,24,52
30,2,5,87,60,147
15,2,5,44,30,74
19,2,5,44,38,82
25,2,5,58,50,108
5,1,2,5,5,10
3,1,2,3,3,6
27,1,2,26,27,53
4,9,25,60,36,96
1,9,25,15,9,24
7,1,4,20,7,27
14,9,25,179,126,305
11,9,25,140,99,239
24,9,25,306,216,522
15,1,2,14,15,29
12,1,2,11,12,23
26,2,5,57,52,109
22,2,5,48,44,92
28,2,5,62,56,118
10,1,2,10,10,20
26,1,2,25,26,51
22,2,5,65,44,109
3,11,30,45,33,78
2,11,30,30,22,52
4,11,29,64,44,108
23,1,4,67,23,90
2,1,4,6,2,8
17,2,5,39,34,73
25,2,5,58,50,108
18,2,5,41,36,77
4,1,2,2,4,6
9,1,2,5,9,14
29,2,5,68,58,126
18,2,5,42,36,78
15,2,5,35,30,65
11,2,5,26,22,48
14,2,5,41,28,69
1,461,742,185,461,646
22,24,64,824,528,1352
24,24,64,622,576,1198
3,45,120,211,135,346
2,59,159,194,118,312
18,2,5,53,36,89
15,3,9,85,45,130
28,3,9,158,84,242
2,2,5,6,4,10
15,2,5,44,30,74
21,2,5,61,42,103
23,2,5,51,46,97
18,2,5,40,36,76
18,2,5,40,36,76
18,2,5,50,36,86
21,2,5,59,42,101
13,2,5,38,26,64
2,2,5,6,4,10
6,7,9,3,42,45
17,7,9,0,119,119
22,7,9,42,154,196
17,7,9,10,119,129
25,3,8,123,75,198
22,3,8,73,66,139
14,3,8,55,42,97
8,8,22,108,64,172
5,8,22,55,40,95
5,8,22,46,40,86
24,8,22,331,192,523
25,8,22,328,200,528
5,8,22,69,40,109
20,9,24,295,180,475
26,9,24,303,234,537
28,9,24,393,252,645
3,9,24,42,27,69
18,13,35,390,234,624
3,13,35,64,39,103
25,13,35,515,325,840
29,13,35,628,377,1005
14,13,35,230,182,412
21,13,35,455,273,728
2,13,35,35,26,61
18,13,35,283,234,517
3,13,35,46,39,85
11,13,35,227,143,370
3,13,35,65,39,104
16,13,35,341,208,549
21,13,35,455,273,728
10,13,35,213,130,343
5,13,35,79,65,144
24,13,35,377,312,689
20,13,35,328,260,588
13,21,55,428,273,701
29,42,54,285,1218,1503
19,38,50,19,722,741
12,38,50,48,456,504
29,42,54,129,1218,1347
23,42,54,115,966,1081
16,42,54,11,672,683
29,42,54,97,1218,1315
12,38,50,102,456,558
1,1266,2320,752,1266,2018
1,1252,2295,722,1252,1974
1,1266,2320,729,1266,1995
1,420,769,318,420,738
1,308,565,234,308,542
1,344,540,191,344,535
1,2171,3578,942,2171,3113
1,2171,3578,1264,2171,3435
1,1555,2443,864,1555,2419
1,1555,2443,570,1555,2125
1,2171,3578,656,2171,2827
1,2171,3578,656,2171,2827
1,713,1120,385,713,1098
1,713,1120,385,713,1098
1,1555,2443,448,1555,2003
1,344,540,185,344,529
1,344,540,99,344,443
1,1083,1701,346,1083,1429
14,26,70,596,364,960
3,26,70,128,78,206
14,26,70,400,364,764
13,3,9,56,39,95
10,3,9,58,30,88
26,3,9,119,78,197
22,3,9,128,66,194
18,1,2,17,18,35
20,1,2,20,20,40
27,1,2,26,27,53
21,1,2,13,21,34
13,1,2,10,13,23
17,2,5,48,34,82
8,2,5,22,16,38
21,2,5,59,42,101
20,11,30,374,220,594
24,2,5,53,48,101
24,2,5,53,48,101
25,2,5,58,50,108
9,2,5,21,18,39
7,1,4,17,7,24
3,1,4,7,3,10
12,2,5,35,24,59
19,2,5,42,38,80
6,9,25,65,54,119
30,9,25,323,270,593
13,1,2,12,13,25
26,1,2,25,26,51
10,1,2,6,10,16
12,1,2,7,12,19
21,2,5,46,42,88
30,2,5,66,60,126
10,2,5,30,20,50
11,2,5,32,22,54
30,11,30,453,330,783
17,11,30,257,187,444
29,1,4,66,29,95
23,1,4,52,23,75
17,1,2,16,17,33
23,1,2,21,23,44
14,1,4,34,14,48
2,1,4,5,2,7
10,1,4,23,10,33
13,8,21,164,104,268
2,1,2,1,2,3
17,1,2,13,17,30
8,1,2,6,8,14
1,1482,2384,807,1482,2289
1,1482,2384,521,1482,2003
6,59,159,466,354,820
21,2,5,40,42,82
4,2,5,8,8,16
24,2,5,70,48,118
17,2,5,36,34,70
6,2,5,13,12,25
25,2,5,59,50,109
23,2,5,54,46,100
7,2,5,20,14,34
10,2,5,28,20,48
8,2,5,15,16,31
14,2,5,41,28,69
21,2,5,61,42,103
1,2,5,3,2,5
6,4,10,23,24,47
7,4,10,27,28,55
10,2,5,24,20,44
18,2,5,50,36,86
3,2,5,8,6,14
12,2,5,34,24,58
16,2,5,45,32,77
19,2,5,56,38,94
24,4,10,101,96,197
17,4,10,71,68,139
12,2,5,26,24,50
17,2,5,37,34,71
11,7,9,0,77,77
9,7,9,1,63,64
9,7,9,17,63,80
7,3,8,23,21,44
12,3,8,43,36,79
13,3,8,64,39,103
17,3,8,67,51,118
26,8,22,255,208,463
2,8,22,19,16,35
14,8,22,190,112,302
11,8,22,137,88,225
1,8,22,9,8,17
10,8,22,92,80,172
30,8,22,407,240,647
25,8,22,345,200,545
29,9,24,428,261,689
18,9,24,192,162,354
23,9,24,323,207,530
21,9,24,249,189,438
21,9,24,224,189,413
15,9,24,167,135,302
22,9,24,246,198,444
4,9,24,45,36,81
1,13,35,14,13,27
7,13,35,149,91,240
25,13,35,436,325,761
30,13,35,461,390,851
13,13,35,186,169,355
12,13,35,209,156,365
5,13,35,82,65,147
8,13,35,170,104,274
18,13,35,383,234,617
24,13,35,520,312,832
5,13,35,72,65,137
18,13,35,390,234,624
13,13,35,186,169,355
15,13,35,215,195,410
21,13,35,433,273,706
1,13,35,14,13,27
25,13,35,541,325,866
20,13,35,293,260,553
13,13,35,200,169,369
4,13,35,85,52,137
18,13,35,390,234,624
19,13,35,391,247,638
26,13,35,563,338,901
30,13,35,545,390,935
19,13,35,312,247,559
12,21,55,395,252,647
14,21,55,468,294,762
28,21,55,706,588,1294
16,42,54,28,672,700
21,42,54,229,882,1111
5,42,54,55,210,265
7,38,50,77,266,343
26,38,50,260,988,1248
23,38,50,23,874,897
19,38,50,29,722,751
28,42,54,64,1176,1240
1,1898,3375,768,1898,2666
1,1252,2295,607,1252,1859
1,1266,2320,567,1266,1833
1,1252,2295,951,1252,2203
1,1266,2320,892,1266,2158
1,1266,2320,636,1266,1902
1,1252,2295,561,1252,1813
1,1252,2295,951,1252,2203
1,1266,2320,1008,1266,2274
1,1555,2443,351,1555,1906
1,713,1120,161,713,874
1,487,783,280,487,767
1,487,783,280,487,767
1,2171,3578,942,2171,3113
1,713,1120,385,713,1098
1,1083,1701,397,1083,1480
1,487,783,171,487,658
28,26,70,1212,728,1940
11,26,70,361,286,647
6,26,70,176,156,332
6,26,70,256,156,412
18,3,9,97,54,151
17,1,2,10,17,27
16,1,2,9,16,25
1,13,35,14,13,27
13,13,35,186,169,355
28,1,2,17,28,45
1,2,5,2,2,4
23,2,5,54,46,100
8,1,2,7,8,15
20,8,21,172,160,332
18,8,21,155,144,299
28,8,21,241,224,465
8,13,35,173,104,277
7,1,2,7,7,14
30,1,2,29,30,59
23,2,5,61,46,107
16,2,5,42,32,74
5,1,4,14,5,19
1,1,4,3,1,4
1,1,4,2,1,3
3,2,5,6,6,12
10,2,5,21,20,41
16,1,2,16,16,32
14,1,2,14,14,28
13,2,5,38,26,64
12,2,5,35,24,59
10,2,5,30,20,50
2,1,2,1,2,3
1,1,2,1,1,2
24,1,4,71,24,95
25,8,21,215,200,415
13,8,21,112,104,216
16,1,2,9,16,25
20,1,2,12,20,32
6,1,2,4,6,10
28,1,2,17,28,45
30,11,30,534,330,864
16,11,30,285,176,461
21,1,2,16,21,37
17,1,2,13,17,30
2,1,2,2,2,4
17,1,2,16,17,33
27,1,2,15,27,42
14,1,2,9,14,23
22,1,2,14,22,36
4,1,2,3,4,7
22,1,2,16,22,38
15,1,2,11,15,26
20,1,2,14,20,34
28,2,5,66,56,122
30,2,5,71,60,131
2,1,2,1,2,3
28,1,2,21,28,49
1,1482,2384,473,1482,1955
1,1482,2384,378,1482,1860
1,1482,2384,378,1482,1860
1,461,742,118,461,579
1,1482,2384,521,1482,2003
14,24,64,444,336,780
4,45,120,223,180,403
8,45,120,581,360,941
8,59,159,775,472,1247
8,3,9,45,24,69
3,3,9,17,9,26
23,2,5,67,46,113
30,2,5,87,60,147
1,2,5,3,2,5
19,2,5,50,38,88
30,2,5,80,60,140
19,2,5,56,38,94
9,4,10,41,36,77
24,4,10,110,96,206
18,4,10,94,72,166
8,4,10,42,32,74
1,2,5,3,2,5
15,2,5,35,30,65
15,2,5,35,30,65
24,2,5,43,48,91
3,2,5,9,6,15
19,2,5,55,38,93
29,2,5,84,58,142
5,2,5,14,10,24
11,2,5,30,22,52
9,3,9,43,27,70
24,3,9,116,72,188
26,4,10,153,104,257
23,3,9,111,69,180
16,3,9,77,48,125
20,7,9,8,140,148
28,7,9,-4,196,192
2,7,9,1,14,15
27,7,9,44,189,233
29,7,9,24,203,227
11,7,9,20,77,97
18,7,9,30,126,156
2,7,9,0,14,14
20,7,9,33,140,173
7,3,8,25,21,46
29,3,8,140,87,227
24,3,8,118,72,190
25,8,22,273,200,473
24,8,22,325,192,517
27,8,22,372,216,588
29,8,22,393,232,625
10,8,22,109,80,189
9,8,22,122,72,194
8,8,22,73,64,137
16,8,22,210,128,338
7,8,22,73,56,129
15,9,24,218,135,353
29,13,35,506,377,883
22,13,35,430,286,716
27,13,35,575,351,926
9,13,35,129,117,246
24,13,35,343,312,655
22,13,35,315,286,601
1,13,35,14,13,27
29,13,35,597,377,974
17,13,35,350,221,571
18,13,35,314,234,548
24,13,35,377,312,689
4,13,35,70,52,122
19,13,35,411,247,658
22,13,35,299,286,585
4,13,35,82,52,134
8,13,35,114,104,218
22,13,35,345,286,631
22,21,55,724,462,1186
3,21,55,95,63,158
18,21,55,483,378,861
15,21,55,502,315,817
1,42,54,0,42,42
4,38,50,34,152,186
1,42,54,8,42,50
20,42,54,46,840,886
27,38,50,297,1026,1323
1,42,54,2,42,44
23,42,54,226,966,1192
19,38,50,105,722,827
19,38,50,105,722,827
1,1266,2320,1008,1266,2274
1,1252,2295,997,1252,2249
1,1252,2295,722,1252,1974
1,420,769,334,420,754
1,295,540,223,295,518
1,295,540,234,295,529
1,308,565,184,308,492
1,1252,2295,997,1252,2249
1,1266,2320,636,1266,1902
1,1555,2443,717,1555,2272
1,713,1120,385,713,1098
1,713,1120,385,713,1098
1,2171,3578,1121,2171,3292
1,1555,2443,790,1555,2345
1,1083,1701,244,1083,1327
1,1083,1701,584,1083,1667
1,713,1120,340,713,1053
1,344,540,174,344,518
1,713,1120,261,713,974
15,3,9,87,45,132
10,3,9,44,30,74
26,3,9,151,78,229
7,1,4,21,7,28
12,8,21,101,96,197
5,8,21,42,40,82
27,2,5,80,54,134
2,2,5,6,4,10
14,2,5,41,28,69
29,2,5,86,58,144
9,2,5,17,18,35
2,11,30,25,22,47
1,2,5,2,2,4
10,2,5,19,20,39
19,11,30,287,209,496
30,1,2,20,30,50
16,1,2,11,16,27
1,1,2,1,1,2
5,1,2,4,5,9
16,1,2,12,16,28
20,1,2,18,20,38
24,1,2,22,24,46
4,2,5,12,8,20
19,2,5,55,38,93
5,2,5,15,10,25
1,1,2,1,1,2
13,1,2,7,13,20
7,1,2,4,7,11
6,2,5,14,12,26
17,2,5,40,34,74
2,12,33,41,24,65
6,1,4,14,6,20
9,1,4,21,9,30
15,12,33,305,180,485
3,12,33,61,36,97
12,12,33,244,144,388
13,9,25,137,117,254
11,1,2,11,11,22
24,1,2,23,24,47
1,1482,2384,592,1482,2074
1,1482,2384,807,1482,2289
1,1482,2384,592,1482,2074
1,1482,2384,521,1482,2003
15,24,64,389,360,749
2,4,10,8,8,16
2,4,10,8,8,16
16,2,5,47,32,79
19,2,5,40,38,78
25,2,5,53,50,103
27,2,5,72,54,126
21,2,5,40,42,82
14,2,5,27,28,55
19,2,5,42,38,80
18,2,5,40,36,76
6,2,5,13,12,25
17,7,9,31,119,150
25,8,22,339,200,539
9,8,22,122,72,194
24,8,22,331,192,523
11,8,22,103,88,191
14,8,22,156,112,268
2,9,24,29,18,47
21,9,24,224,189,413
12,9,24,134,108,242
13,9,24,129,117,246
27,9,24,301,243,544
9,13,35,195,117,312
20,13,35,426,260,686
9,13,35,195,117,312
26,13,35,563,338,901
29,13,35,425,377,802
12,13,35,256,156,412
8,13,35,165,104,269
19,13,35,332,247,579
7,13,35,103,91,194
24,13,35,520,312,832
14,13,35,220,182,402
11,21,55,241,231,472
20,42,54,67,840,907
7,42,54,69,294,363
1,1252,2295,951,1252,2203
1,1252,2295,538,1252,1790
1,1083,1701,550,1083,1633
1,713,1120,385,713,1098
1,1083,1701,312,1083,1395
1,344,540,83,344,427
2,26,70,82,52,134
29,26,70,1235,754,1989
28,26,70,801,728,1529
5,26,70,143,130,273
1,26,70,43,26,69
3,26,70,128,78,206
18,3,9,105,54,159
8,3,9,32,24,56
6,2,5,14,12,26
7,2,5,16,14,30
29,1,2,28,29,57
17,1,2,16,17,33
4,1,2,2,4,6
20,1,2,12,20,32
21,2,5,62,42,104
7,2,5,21,14,35
16,2,5,47,32,79
22,2,5,65,44,109
6,1,2,3,6,9
18,1,2,10,18,28
21,1,2,12,21,33
10,1,2,10,10,20
14,9,25,221,126,347
29,9,25,457,261,718
20,13,35,286,260,546
30,13,35,429,390,819
8,2,5,24,16,40
5,2,5,11,10,21
23,1,2,23,23,46
2,1,2,2,2,4
13,1,2,12,13,25
3,2,5,7,6,13
30,2,5,71,60,131
11,2,5,32,22,54
23,2,5,67,46,113
25,2,5,74,50,124
1,2,5,3,2,5
30,2,5,89,60,149
26,1,4,59,26,85
29,1,4,66,29,95
28,1,2,27,28,55
20,11,30,248,220,468
1,12,33,14,12,26
21,12,33,289,252,541
5,1,4,15,5,20
30,1,4,89,30,119
19,1,4,56,19,75
17,11,29,217,187,404
29,11,29,371,319,690
13,11,29,166,143,309
28,1,2,18,28,46
12,1,2,8,12,20
11,9,25,127,99,226
3,9,25,35,27,62
15,9,25,173,135,308
26,1,4,63,26,89
22,11,29,281,242,523
14,11,29,179,154,333
1,461,742,147,461,608
1,461,742,274,461,735
1,1482,2384,473,1482,1955
11,24,64,426,264,690
8,45,120,581,360,941
10,45,120,726,450,1176
6,45,120,421,270,691
1,59,159,79,59,138
9,2,5,26,18,44
11,2,5,32,22,54
9,2,5,27,18,45
2,4,10,12,8,20
18,4,10,106,72,178
19,2,5,53,38,91
7,2,5,13,14,27
4,2,5,8,8,16
24,2,5,67,48,115
27,2,5,59,54,113
6,2,5,13,12,25
30,4,10,132,120,252
18,4,10,79,72,151
11,7,9,18,77,95
8,7,9,13,56,69
15,7,9,27,105,132
9,7,9,16,63,79
27,7,9,37,189,226
21,7,9,12,147,159
26,3,8,115,78,193
12,3,8,58,36,94
25,8,22,279,200,479
23,8,22,312,184,496
26,8,22,353,208,561
8,8,22,105,64,169
15,8,22,207,120,327
30,8,22,314,240,554
24,13,35,494,312,806
29,13,35,628,377,1005
14,13,35,205,182,387
25,13,35,358,325,683
4,13,35,87,52,139
12,13,35,256,156,412
28,13,35,410,364,774
10,13,35,206,130,336
18,13,35,383,234,617
20,13,35,426,260,686
19,13,35,332,247,579
27,13,35,575,351,926
10,13,35,147,130,277
23,21,55,757,483,1240
2,38,50,20,76,96
28,38,50,280,1064,1344
30,38,50,330,1140,1470
2,38,50,17,76,93
9,42,54,98,378,476
1,1266,2320,1008,1266,2274
1,1252,2295,1020,1252,2272
1,420,769,334,420,754
1,1252,2295,745,1252,1997
1,1266,2320,683,1266,1949
1,308,565,234,308,542
1,295,540,126,295,421
1,2171,3578,1335,2171,3506
1,1555,2443,839,1555,2394
1,2171,3578,656,2171,2827
1,2171,3578,835,2171,3006
1,344,540,99,344,443
1,344,540,185,344,529
1,1083,1701,261,1083,1344
1,344,540,110,344,454
7,26,70,298,182,480
22,3,9,100,66,166
22,2,5,58,44,102
10,2,5,27,20,47
3,13,35,64,39,103
13,13,35,277,169,446
26,13,35,554,338,892
5,13,35,107,65,172
5,13,35,107,65,172
3,1,2,3,3,6
15,1,2,14,15,29
26,1,2,25,26,51
16,1,2,15,16,31
5,1,2,5,5,10
24,13,35,511,312,823
30,13,35,639,390,1029
5,11,30,94,55,149
25,2,5,59,50,109
25,1,2,25,25,50
14,2,5,39,28,67
19,2,5,53,38,91
14,2,5,39,28,67
23,2,5,64,46,110
8,1,4,20,8,28
2,1,2,1,2,3
17,1,2,12,17,29
6,2,5,14,12,26
4,2,5,9,8,17
25,1,4,74,25,99
17,1,4,50,17,67
19,1,2,11,19,30
1,1,2,1,1,2
27,1,2,23,27,50
9,1,2,8,9,17
10,2,5,30,20,50
24,2,5,70,48,118
11,2,5,32,22,54
25,8,21,231,200,431
24,8,21,221,192,413
23,1,2,13,23,36
18,1,2,10,18,28
22,1,4,64,22,86
18,1,4,53,18,71
20,1,4,54,20,74
19,1,4,52,19,71
2,9,25,24,18,42
5,1,2,5,5,10
21,1,2,20,21,41
29,1,4,82,29,111
17,1,4,48,17,65
27,1,4,77,27,104
10,2,5,29,20,49
14,2,5,41,28,69
27,8,21,328,216,544
1,1482,2384,854,1482,2336
1,1482,2384,401,1482,1883
25,24,64,984,600,1584
16,24,64,456,384,840
17,24,64,506,408,914
28,24,64,1084,672,1756
9,45,120,481,405,886
3,59,159,290,177,467
13,4,10,61,52,113
3,4,10,14,12,26
14,3,9,79,42,121
1,2,5,3,2,5
4,2,5,11,8,19
2,2,5,6,4,10
28,2,5,78,56,134
19,4,10,89,76,165
4,4,10,19,16,35
7,2,5,20,14,34
18,2,5,52,36,88
15,2,5,35,30,65
12,2,5,28,24,52
7,2,5,16,14,30
9,2,5,21,18,39
16,2,5,42,32,74
21,2,5,56,42,98
25,2,5,55,50,105
16,4,10,61,64,125
2,4,10,8,8,16
24,7,9,44,168,212
22,7,9,8,154,162
23,7,9,38,161,199
26,7,9,43,182,225
29,7,9,1,203,204
13,7,9,24,91,115
11,3,8,51,33,84
17,3,8,56,51,107
4,8,22,37,32,69
19,8,22,258,152,410
10,8,22,136,80,216
24,8,22,325,192,517
19,8,22,174,152,326
22,8,22,289,176,465
4,8,22,50,32,82
14,9,24,150,126,276
30,9,24,436,270,706
5,9,24,59,45,104
24,9,24,337,216,553
10,9,24,112,90,202
24,13,35,469,312,781
7,13,35,122,91,213
5,13,35,107,65,172
10,13,35,206,130,336
26,13,35,536,338,874
14,13,35,298,182,480
16,13,35,251,208,459
24,13,35,343,312,655
10,13,35,175,130,305
15,13,35,320,195,515
19,13,35,312,247,559
28,13,35,596,364,960
11,13,35,161,143,304
2,13,35,29,26,55
5,13,35,107,65,172
21,13,35,447,273,720
24,13,35,343,312,655
14,13,35,288,182,470
28,13,35,596,364,960
14,21,55,461,294,755
18,21,55,454,378,832
9,42,54,98,378,476
8,38,50,8,304,312
29,38,50,319,1102,1421
2,38,50,17,76,93
7,38,50,39,266,305
9,38,50,99,342,441
10,42,54,1,420,421
26,38,50,286,988,1274
8,38,50,88,304,392
16,38,50,176,608,784
1,1912,3400,1046,1912,2958
1,1252,2295,745,1252,1997
1,1266,2320,1008,1266,2274
1,1252,2295,882,1252,2134
1,1252,2295,951,1252,2203
1,1252,2295,997,1252,2249
1,1252,2295,538,1252,1790
1,420,769,334,420,754
1,1252,2295,676,1252,1928
1,1252,2295,538,1252,1790
1,1266,2320,1008,1266,2274
1,2171,3578,763,2171,2934
1,487,783,124,487,611
1,2171,3578,942,2171,3113
1,1083,1701,584,1083,1667
1,2171,3578,763,2171,2934
1,344,540,77,344,421
1,344,540,110,344,454
1,344,540,174,344,518
12,26,70,343,312,655
20,26,70,852,520,1372
14,26,70,596,364,960
23,26,70,996,598,1594
1,3,9,6,3,9
5,3,9,23,15,38
2,1,2,2,2,4
15,1,2,15,15,30
24,1,2,24,24,48
13,1,4,37,13,50
14,1,2,9,14,23
13,11,29,230,143,373
20,11,29,354,220,574
13,1,4,28,13,41
3,2,5,8,6,14
26,1,2,15,26,41
9,1,2,9,9,18
27,1,2,26,27,53
10,11,30,136,110,246
10,11,30,136,110,246
21,1,2,20,21,41
15,1,2,14,15,29
18,1,2,13,18,31
5,1,2,5,5,10
19,1,2,17,19,36
30,1,2,17,30,47
13,1,4,38,13,51
22,1,4,52,22,74
5,1,4,12,5,17
27,1,4,64,27,91
25,8,21,231,200,431
1,8,21,9,8,17
9,1,2,8,9,17
26,13,35,381,338,719
25,1,4,53,25,78
16,1,4,34,16,50
29,1,2,20,29,49
5,1,2,3,5,8
30,1,4,88,30,118
27,1,4,79,27,106
10,2,5,29,20,49
8,2,5,23,16,39
8,2,5,23,16,39
27,2,5,78,54,132
21,2,5,41,42,83
9,2,5,18,18,36
11,11,30,140,121,261
25,11,30,318,275,593
29,1,2,16,29,45
11,1,2,6,11,17
26,1,2,25,26,51
30,1,2,29,30,59
10,8,21,86,80,166
27,8,21,232,216,448
14,1,2,13,14,27
1,1,2,1,1,2
12,1,2,9,12,21
8,1,2,7,8,15
10,1,2,9,10,19
18,9,25,189,162,351
17,9,25,179,153,332
10,1,4,25,10,35
20,1,4,50,20,70
1,755,1215,411,755,1166
1,1482,2384,807,1482,2289
1,461,742,125,461,586
1,1482,2384,592,1482,2074
3,45,120,149,135,284
4,45,120,238,180,418
9,59,159,714,531,1245
26,3,9,107,78,185
18,3,9,74,54,128
4,2,5,8,8,16
30,2,5,59,60,119
19,2,5,37,38,75
27,4,10,151,108,259
18,4,10,101,72,173
10,2,5,24,20,44
5,2,5,15,10,25
22,2,5,62,44,106
25,2,5,70,50,120
21,2,5,49,42,91
16,2,5,38,32,70
8,7,9,15,56,71
15,7,9,27,105,132
3,7,9,4,21,25
24,7,9,46,168,214
2,7,9,2,14,16
17,3,8,80,51,131
2,8,22,19,16,35
9,8,22,122,72,194
13,8,22,162,104,266
23,8,22,312,184,496
9,8,22,124,72,196
29,8,22,323,232,555
21,9,24,249,189,438
10,9,24,100,90,190
6,9,24,60,54,114
10,9,24,145,90,235
19,9,24,267,171,438
23,9,24,334,207,541
2,13,35,41,26,67
29,13,35,628,377,1005
28,13,35,459,364,823
21,13,35,447,273,720
5,13,35,87,65,152
19,13,35,278,247,525
24,13,35,469,312,781
16,13,35,341,208,549
27,13,35,575,351,926
19,13,35,332,247,579
24,21,55,539,504,1043
21,21,55,668,441,1109
14,38,50,161,532,693
18,38,50,198,684,882
3,38,50,26,114,140
1,42,54,11,42,53
4,38,50,46,152,198
19,42,54,95,798,893
1,1898,3375,768,1898,2666
1,1252,2295,882,1252,2134
1,420,769,249,420,669
1,1252,2295,745,1252,1997
1,295,540,234,295,529
1,1266,2320,1008,1266,2274
1,713,1120,362,713,1075
1,1083,1701,601,1083,1684
1,344,540,77,344,421
1,1083,1701,397,1083,1480
1,344,540,174,344,518
1,713,1120,261,713,974
1,487,783,132,487,619
22,26,70,953,572,1525
19,26,70,823,494,1317
24,3,9,129,72,201
26,3,9,105,78,183
16,3,9,64,48,112
10,1,2,10,10,20
12,1,2,12,12,24
26,1,2,25,26,51
5,1,2,5,5,10
20,1,2,18,20,38
5,1,2,5,5,10
29,1,2,28,29,57
10,1,2,10,10,20
4,13,35,82,52,134
25,13,35,515,325,840
8,13,35,165,104,269
2,2,5,4,4,8
16,2,5,31,32,63
30,13,35,639,390,1029
19,13,35,405,247,652
26,1,2,15,26,41
11,1,2,8,11,19
23,1,2,17,23,40
1,1,4,2,1,3
6,1,2,4,6,10
20,1,4,59,20,79
16,2,5,30,32,62
19,2,5,36,38,74
4,1,4,11,4,15
3,1,4,9,3,12
7,1,2,4,7,11
6,1,2,3,6,9
14,2,5,41,28,69
11,2,5,32,22,54
1,1482,2384,401,1482,1883
1,1482,2384,735,1482,2217
1,1482,2384,854,1482,2336
1,461,742,185,461,646
27,24,64,1045,648,1693
13,3,9,57,39,96
19,3,9,83,57,140
13,3,9,73,39,112
24,3,9,135,72,207
15,3,9,89,45,134
11,2,5,31,22,53
5,2,5,14,10,24
13,2,5,25,26,51
22,2,5,43,44,87
19,2,5,45,38,83
30,2,5,71,60,131
4,7,9,2,28,30
20,7,9,33,140,173
30,7,9,55,210,265
12,7,9,5,84,89
27,7,9,52,189,241
10,3,8,36,30,66
20,8,22,271,160,431
15,8,22,203,120,323
12,8,22,157,96,253
7,8,22,64,56,120
12,8,22,165,96,261
6,9,24,89,54,143
2,9,24,24,18,42
28,13,35,596,364,960
26,13,35,454,338,792
13,13,35,268,169,437
19,13,35,411,247,658
5,13,35,79,65,144
17,13,35,297,221,518
24,13,35,511,312,823
15,13,35,246,195,441
29,13,35,628,377,1005
11,13,35,227,143,370
27,13,35,556,351,907
9,42,54,40,378,418
24,38,50,264,912,1176
21,38,50,210,798,1008
5,42,54,25,210,235
12,42,54,131,504,635
5,42,54,1,210,211
27,38,50,108,1026,1134
13,42,54,65,546,611
16,42,54,54,672,726
28,42,54,276,1176,1452
1,1252,2295,538,1252,1790
1,1266,2320,1008,1266,2274
1,1266,2320,961,1266,2227
1,2171,3578,1264,2171,3435
1,2171,3578,763,2171,2934
1,1555,2443,570,1555,2125
1,1083,1701,244,1083,1327
1,2171,3578,835,2171,3006
1,2171,3578,942,2171,3113
1,2171,3578,835,2171,3006
1,344,540,185,344,529
1,1555,2443,570,1555,2125
1,1083,1701,346,1083,1429
1,487,783,132,487,619
1,2171,3578,620,2171,2791
1,2171,3578,1335,2171,3506
28,26,70,977,728,1705
25,26,70,1083,650,1733
28,26,70,958,728,1686
4,26,70,137,104,241
6,26,70,197,156,353
21,26,70,659,546,1205
17,3,9,82,51,133
13,3,9,62,39,101
12,3,9,48,36,84
26,13,35,554,338,892
29,13,35,618,377,995
6,13,35,103,78,181
23,13,35,393,299,692
2,1,2,2,2,4
14,1,2,13,14,27
14,2,5,39,28,67
17,2,5,48,34,82
16,1,2,12,16,28
7,1,2,5,7,12
28,1,2,21,28,49
18,1,2,17,18,35
21,2,5,61,42,103
17,2,5,49,34,83
5,2,5,15,10,25
12,1,2,8,12,20
1,2,5,3,2,5
16,2,5,46,32,78
28,11,30,423,308,731
5,11,30,76,55,131
29,1,4,68,29,97
6,1,4,14,6,20
3,1,4,7,3,10
11,1,4,25,11,36
14,13,35,205,182,387
21,13,35,308,273,581
10,13,35,147,130,277
21,2,5,62,42,104
21,2,5,62,42,104
22,1,2,14,22,36
30,2,5,69,60,129
24,2,5,46,48,94
14,2,5,39,28,67
29,9,25,435,261,696
6,9,25,90,54,144
20,1,4,46,20,66
24,2,5,47,48,95
3,2,5,6,6,12
13,2,5,38,26,64
13,2,5,38,26,64
21,2,5,59,42,101
24,2,5,46,48,94
22,9,25,341,198,539
20,9,25,310,180,490
1,755,1215,411,755,1166
1,461,742,251,461,712
1,461,742,118,461,579
1,461,742,147,461,608
24,24,64,899,576,1475
15,24,64,446,360,806
2,59,159,130,118,248
11,3,9,53,33,86
20,3,9,80,60,140
2,2,5,6,4,10
19,2,5,55,38,93
18,2,5,34,36,70
14,2,5,27,28,55
5,2,5,12,10,22
14,2,5,41,28,69
23,2,5,68,46,114
7,3,9,41,21,62
13,2,5,36,26,62
21,2,5,61,42,103
11,2,5,32,22,54
25,7,9,41,175,216
8,7,9,13,56,69
1,7,9,2,7,9
15,7,9,25,105,130
6,7,9,5,42,47
21,7,9,29,147,176
25,3,8,81,75,156
15,3,8,50,45,95
23,3,8,91,69,160
4,8,22,44,32,76
7,8,22,64,56,120
2,8,22,27,16,43
9,8,22,98,72,170
11,8,22,137,88,225
11,9,24,131,99,230
23,9,24,334,207,541
13,9,24,189,117,306
8,13,35,140,104,244
16,13,35,274,208,482
11,13,35,173,143,316
13,13,35,277,169,446
1,13,35,21,13,34
16,13,35,313,208,521
1,13,35,14,13,27
24,21,55,803,504,1307
12,21,55,269,252,521
20,21,55,559,420,979
22,42,54,252,924,1176
18,38,50,198,684,882
29,38,50,247,1102,1349
1,1898,3375,768,1898,2666
1,1898,3375,1038,1898,2936
1,1266,2320,567,1266,1833
1,1266,2320,729,1266,1995
1,1898,3375,735,1898,2633
1,1252,2295,538,1252,1790
1,487,783,280,487,767
1,1555,2443,790,1555,2345
1,713,1120,250,713,963
1,2171,3578,942,2171,3113
1,2171,3578,835,2171,3006
1,1083,1701,499,1083,1582
1,344,540,83,344,427
1,2171,3578,1335,2171,3506
1,26,70,33,26,59
23,26,70,996,598,1594
21,26,70,689,546,1235
18,26,70,742,468,1210
5,3,9,27,15,42
9,3,9,41,27,68
18,1,2,17,18,35
20,1,2,19,20,39
22,13,35,469,286,755
18,13,35,383,234,617
4,1,2,4,4,8
2,1,2,2,2,4
29,1,2,28,29,57
24,1,2,23,24,47
22,1,2,21,22,43
30,2,5,87,60,147
3,1,2,3,3,6
20,1,2,20,20,40
4,1,2,3,4,7
1,1,2,1,1,2
10,1,2,6,10,16
17,2,5,33,34,67
19,2,5,55,38,93
3,2,5,6,6,12
11,2,5,23,22,45
4,2,5,8,8,16
14,2,5,27,28,55
7,1,2,5,7,12
30,1,2,20,30,50
26,1,2,18,26,44
10,9,25,115,90,205
18,9,25,207,162,369
2,2,5,4,4,8
26,2,5,61,52,113
4,1,2,4,4,8
2,1,2,2,2,4
20,12,33,275,240,515
22,12,33,302,264,566
10,12,33,203,120,323
30,12,33,610,360,970
15,1,2,8,15,23
20,1,2,11,20,31
1,1,2,1,1,2
22,1,2,12,22,34
19,1,2,16,19,35
25,1,2,22,25,47
11,1,2,8,11,19
12,1,2,9,12,21
7,8,21,72,56,128
14,8,21,144,112,256
8,2,5,23,16,39
12,2,5,35,24,59
27,11,29,314,297,611
3,11,29,35,33,68
24,11,29,279,264,543
2,2,5,5,4,9
1,1482,2384,807,1482,2289
1,461,742,274,461,735
6,24,64,179,144,323
8,59,159,775,472,1247
4,2,5,11,8,19
17,2,5,33,34,67
14,2,5,27,28,55
27,2,5,55,54,109
12,2,5,25,24,49
8,2,5,21,16,37
7,2,5,19,14,33
10,4,10,56,40,96
25,4,10,140,100,240
30,2,5,89,60,149
14,4,10,83,56,139
22,2,5,52,44,96
9,2,5,21,18,39
21,2,5,48,42,90
21,2,5,48,42,90
11,2,5,25,22,47
23,2,5,53,46,99
24,2,5,67,48,115
26,2,5,73,52,125
24,3,9,105,72,177
24,3,9,105,72,177
14,7,9,27,98,125
11,7,9,18,77,95
18,7,9,30,126,156
24,3,8,107,72,179
2,3,8,8,6,14
9,3,8,29,27,56
24,3,8,112,72,184
4,8,22,54,32,86
26,8,22,341,208,549
11,9,24,147,99,246
14,9,24,197,126,323
29,13,35,618,377,995
19,13,35,312,247,559
1,13,35,17,13,30
23,13,35,450,299,749
30,13,35,618,390,1008
8,13,35,126,104,230
5,13,35,77,65,142
3,13,35,52,39,91
24,13,35,410,312,722
10,13,35,171,130,301
17,13,35,297,221,518
21,13,35,447,273,720
5,13,35,107,65,172
29,13,35,425,377,802
6,13,35,98,78,176
20,13,35,426,260,686
23,13,35,329,299,628
21,13,35,433,273,706
13,13,35,204,169,373
15,13,35,236,195,431
6,21,55,191,126,317
1,42,54,10,42,52
21,42,54,229,882,1111
1,38,50,10,38,48
22,42,54,110,924,1034
21,42,54,105,882,987
12,38,50,132,456,588
20,38,50,60,760,820
4,38,50,44,152,196
1,1898,3375,1342,1898,3240
1,1266,2320,752,1266,2018
1,1266,2320,567,1266,1833
1,1252,2295,607,1252,1859
1,1266,2320,961,1266,2227
1,420,769,334,420,754
1,420,769,249,420,669
1,420,769,249,420,669
1,295,540,159,295,454
1,1555,2443,839,1555,2394
1,2171,3578,1157,2171,3328
1,2171,3578,835,2171,3006
1,487,783,265,487,752
1,2171,3578,942,2171,3113
1,2171,3578,835,2171,3006
1,2171,3578,1335,2171,3506
1,344,540,120,344,464
1,344,540,174,344,518
1,487,783,194,487,681
1,713,1120,205,713,918
27,26,70,1169,702,1871
9,26,70,314,234,548
26,26,70,1108,676,1784
3,26,70,128,78,206
10,3,9,58,30,88
6,1,4,18,6,24
26,1,4,77,26,103
8,13,35,170,104,274
15,12,33,251,180,431
1,12,33,15,12,27
4,11,29,64,44,108
26,1,2,24,26,50
16,1,4,47,16,63
5,2,5,15,10,25
26,2,5,75,52,127
5,1,2,5,5,10
30,11,30,381,330,711
3,2,5,9,6,15
19,2,5,55,38,93
4,2,5,12,8,20
23,8,21,236,184,420
11,8,21,113,88,201
8,2,5,21,16,37
3,2,5,8,6,14
14,2,5,41,28,69
28,2,5,81,56,137
11,2,5,32,22,54
22,2,5,42,44,86
18,2,5,34,36,70
13,1,2,12,13,25
19,1,2,18,19,37
1,8,21,13,8,21
2,8,21,25,16,41
16,1,2,15,16,31
21,1,2,20,21,41
1,1482,2384,473,1482,1955
1,461,742,147,461,608
1,1482,2384,592,1482,2074
1,461,742,118,461,579
16,24,64,599,384,983
26,4,10,151,104,255
14,4,10,81,56,137
26,4,10,151,104,255
12,2,5,35,24,59
8,2,5,23,16,39
8,2,5,24,16,40
11,2,5,32,22,54
20,2,5,42,40,82
6,2,5,13,12,25
26,2,5,69,52,121
28,2,5,74,56,130
7,2,5,20,14,34
8,2,5,22,16,38
3,2,5,9,6,15
23,7,9,9,161,170
30,7,9,41,210,251
23,7,9,42,161,203
17,7,9,28,119,147
14,7,9,25,98,123
3,7,9,6,21,27
28,7,9,11,196,207
2,7,9,4,14,18
17,3,8,82,51,133
25,8,22,235,200,435
3,8,22,41,24,65
22,8,22,202,176,378
10,8,22,138,80,218
22,8,22,303,176,479
4,8,22,45,32,77
25,13,35,515,325,840
21,13,35,433,273,706
1,13,35,16,13,29
11,13,35,161,143,304
15,13,35,293,195,488
25,13,35,533,325,858
6,13,35,105,78,183
28,13,35,606,364,970
10,13,35,171,130,301
1,13,35,16,13,29
15,13,35,320,195,515
3,13,35,65,39,104
20,13,35,293,260,553
20,13,35,426,260,686
1,13,35,20,13,33
14,13,35,298,182,480
13,13,35,268,169,437
10,13,35,157,130,287
17,42,54,2,714,716
2,38,50,23,76,99
1,38,50,5,38,43
2,38,50,11,76,87
22,38,50,242,836,1078
5,38,50,55,190,245
12,42,54,8,504,512
23,42,54,52,966,1018
1,1898,3375,768,1898,2666
1,1252,2295,951,1252,2203
1,1252,2295,538,1252,1790
1,1252,2295,882,1252,2134
1,295,540,126,295,421
1,308,565,246,308,554
1,487,783,155,487,642
1,713,1120,385,713,1098
1,487,783,155,487,642
1,1555,2443,570,1555,2125
1,1083,1701,499,1083,1582
1,487,783,194,487,681
1,1555,2443,864,1555,2419
1,713,1120,172,713,885
1,2171,3578,1335,2171,3506
9,26,70,371,234,605
13,26,70,563,338,901
26,3,9,126,78,204
27,3,9,157,81,238
6,3,9,32,18,50
14,1,2,13,14,27
17,1,2,16,17,33
16,1,2,15,16,31
28,13,35,577,364,941
20,2,5,42,40,82
12,13,35,260,156,416
28,13,35,547,364,911
14,13,35,274,182,456
10,12,33,187,120,307
12,2,5,35,24,59
13,2,5,30,26,56
3,1,2,3,3,6
2,1,2,2,2,4
8,1,2,5,8,13
6,9,25,95,54,149
21,1,4,62,21,83
6,1,2,6,6,12
24,1,2,24,24,48
29,1,2,28,29,57
7,1,2,4,7,11
23,1,2,22,23,45
25,1,2,15,25,40
18,1,2,13,18,31
13,1,2,9,13,22
3,1,2,2,3,5
22,13,35,322,286,608
18,13,35,264,234,498
13,13,35,190,169,359
21,11,29,268,231,499
17,11,29,217,187,404
5,2,5,14,10,24
19,2,5,53,38,91
23,2,5,64,46,110
3,2,5,9,6,15
18,2,5,52,36,88
25,2,5,59,50,109
13,2,5,31,26,57
24,2,5,56,48,104
19,1,4,47,19,66
15,1,4,37,15,52
1,1482,2384,592,1482,2074
1,1482,2384,807,1482,2289
1,1482,2384,807,1482,2289
1,1482,2384,378,1482,1860
1,1482,2384,854,1482,2336
1,1482,2384,473,1482,1955
10,4,10,39,40,79
13,4,10,51,52,103
14,4,10,64,56,120
9,4,10,41,36,77
24,2,5,71,48,119
3,2,5,9,6,15
23,2,5,68,46,114
13,2,5,38,26,64
22,2,5,65,44,109
11,4,10,51,44,95
8,4,10,37,32,69
2,2,5,6,4,10
29,2,5,57,58,115
10,2,5,20,20,40
10,2,5,24,20,44
1,2,5,3,2,5
12,2,5,34,24,58
24,2,5,70,48,118
23,2,5,67,46,113
14,7,9,27,98,125
11,7,9,21,77,98
27,7,9,49,189,238
12,7,9,20,84,104
12,7,9,0,84,84
10,3,8,48,30,78
19,3,8,68,57,125
24,8,22,325,192,517
20,8,22,271,160,431
2,8,22,27,16,43
10,8,22,105,80,185
19,8,22,262,152,414
18,8,22,165,144,309
19,9,24,189,171,360
13,9,24,173,117,290
12,9,24,128,108,236
11,9,24,131,99,230
9,9,24,133,81,214
13,13,35,186,169,355
24,13,35,394,312,706
15,13,35,325,195,520
13,13,35,236,169,405
24,13,35,511,312,823
18,13,35,295,234,529
29,13,35,496,377,873
8,13,35,140,104,244
22,13,35,315,286,601
13,13,35,277,169,446
9,13,35,195,117,312
29,13,35,415,377,792
19,13,35,298,247,545
8,42,54,27,336,363
11,38,50,121,418,539
16,42,54,183,672,855
27,42,54,18,1134,1152
27,42,54,120,1134,1254
14,42,54,47,588,635
21,42,54,3,882,885
1,1266,2320,1008,1266,2274
1,295,540,234,295,529
1,1266,2320,1031,1266,2297
1,2171,3578,942,2171,3113
1,1083,1701,584,1083,1667
1,2171,3578,656,2171,2827
1,2171,3578,835,2171,3006
1,1519,2443,411,1519,1930
1,344,540,185,344,529
1,344,540,185,344,529
1,1519,2443,484,1519,2003
1,1555,2443,375,1555,1930
1,1083,1701,550,1083,1633
1,487,783,171,487,658
1,344,540,174,344,518
30,26,70,1299,780,2079
6,26,70,176,156,332
11,2,5,21,22,43
23,2,5,44,46,90
8,8,21,101,64,165
28,8,21,352,224,576
13,9,25,205,117,322
25,1,2,25,25,50
30,1,2,29,30,59
29,1,2,17,29,46
15,2,5,35,30,65
19,2,5,45,38,83
24,1,4,65,24,89
3,1,4,9,3,12
3,2,5,9,6,15
10,9,25,143,90,233
6,2,5,11,12,23
13,2,5,25,26,51
6,2,5,11,12,23
22,1,2,22,22,44
8,2,5,19,16,35
16,2,5,38,32,70
15,9,25,173,135,308
8,1,4,24,8,32
28,1,4,83,28,111
4,1,2,3,4,7
14,1,2,9,14,23
13,1,2,8,13,21
29,1,2,28,29,57
20,1,2,19,20,39
30,1,2,29,30,59
28,1,2,27,28,55
24,1,2,23,24,47
22,2,5,65,44,109
6,1,4,18,6,24
26,1,4,76,26,102
14,1,4,41,14,55
28,1,4,82,28,110
9,1,2,5,9,14
25,11,29,320,275,595
1,461,742,199,461,660
1,1482,2384,378,1482,1860
1,1482,2384,854,1482,2336
12,24,64,465,288,753
4,24,64,155,96,251
1,24,64,31,24,55
12,24,64,319,288,607
7,59,159,678,413,1091
9,2,5,19,18,37
28,2,5,59,56,115
29,2,5,86,58,144
12,2,5,35,24,59
13,4,10,57,52,109
23,3,9,95,69,164
4,3,9,16,12,28
30,2,5,84,60,144
15,2,5,42,30,72
17,4,10,99,68,167
17,2,5,32,34,66
2,3,9,9,6,15
18,2,5,52,36,88
17,2,5,45,34,79
18,2,5,48,36,84
20,2,5,47,40,87
3,2,5,9,6,15
4,2,5,12,8,20
24,2,5,70,48,118
27,2,5,78,54,132
4,7,9,8,28,36
12,7,9,10,84,94
5,3,8,24,15,39
19,3,8,75,57,132
29,8,22,304,232,536
16,8,22,175,128,303
9,8,22,122,72,194
23,8,22,317,184,501
22,9,24,235,198,433
4,9,24,42,36,78
25,9,24,351,225,576
5,9,24,74,45,119
26,9,24,303,234,537
16,13,35,262,208,470
26,13,35,454,338,792
28,13,35,410,364,774
24,13,35,494,312,806
15,13,35,246,195,441
3,13,35,64,39,103
24,13,35,368,312,680
25,13,35,436,325,761
20,13,35,391,260,651
23,13,35,450,299,749
5,13,35,108,65,173
10,13,35,171,130,301
20,13,35,293,260,553
15,13,35,257,195,452
27,21,55,725,567,1292
15,42,54,10,630,640
9,42,54,21,378,399
13,38,50,33,494,527
29,38,50,290,1102,1392
12,42,54,53,504,557
1,1912,3400,774,1912,2686
1,1252,2295,1020,1252,2272
1,1266,2320,636,1266,1902
1,1266,2320,567,1266,1833
1,1266,2320,683,1266,1949
1,1252,2295,722,1252,1974
1,1252,2295,997,1252,2249
1,1252,2295,997,1252,2249
1,420,769,203,420,623
1,420,769,241,420,661
1,308,565,155,308,463
1,295,540,234,295,529
1,2171,3578,1157,2171,3328
1,1555,2443,717,1555,2272
1,1083,1701,550,1083,1633
27,26,70,848,702,1550
26,26,70,889,676,1565
5,26,70,171,130,301
20,26,70,852,520,1372
21,3,9,118,63,181
28,1,2,27,28,55
12,1,2,12,12,24
6,11,29,77,66,143
9,1,2,8,9,17
3,13,35,64,39,103
25,1,2,15,25,40
20,2,5,38,40,78
4,2,5,8,8,16
28,1,2,21,28,49
1,1,2,1,1,2
16,13,35,330,208,538
10,13,35,206,130,336
21,1,4,57,21,78
12,12,33,177,144,321
13,12,33,191,156,347
20,11,30,368,220,588
2,11,30,37,22,59
26,1,2,25,26,51
12,2,5,35,24,59
10,2,5,30,20,50
20,2,5,56,40,96
14,1,4,30,14,44
30,1,4,64,30,94
26,1,4,55,26,81
8,1,4,20,8,28
26,1,4,63,26,89
27,1,4,66,27,93
5,2,5,14,10,24
29,2,5,81,58,139
6,12,33,122,72,194
28,12,33,570,336,906
16,1,2,11,16,27
17,1,2,12,17,29
16,1,2,16,16,32
8,1,2,6,8,14
15,1,2,11,15,26
11,2,5,32,22,54
29,2,5,84,58,142
15,2,5,44,30,74
30,2,5,89,60,149
4,2,5,12,8,20
10,2,5,29,20,49
14,2,5,41,28,69
6,1,4,15,6,21
7,1,4,17,7,24
19,2,5,53,38,91
1,1482,2384,592,1482,2074
1,461,742,251,461,712
1,1482,2384,592,1482,2074
1,1482,2384,807,1482,2289
1,1482,2384,568,1482,2050
1,24,64,31,24,55
10,59,159,666,590,1256
22,2,5,65,44,109
15,2,5,44,30,74
24,2,5,46,48,94
12,2,5,23,24,47
17,2,5,49,34,83
3,2,5,6,6,12
9,2,5,19,18,37
15,2,5,44,30,74
16,2,5,46,32,78
4,2,5,12,8,20
25,2,5,73,50,123
9,3,9,41,27,68
8,3,9,36,24,60
19,2,5,37,38,75
30,2,5,59,60,119
5,4,10,19,20,39
21,4,10,80,84,164
3,2,5,9,6,15
5,2,5,15,10,25
7,2,5,16,14,30
18,2,5,42,36,78
4,3,9,16,12,28
14,3,9,56,42,98
8,3,9,43,24,67
16,3,9,86,48,134
12,4,10,71,48,119
27,2,5,63,54,117
14,2,5,33,28,61
17,7,9,32,119,151
7,7,9,0,49,49
11,7,9,0,77,77
28,7,9,51,196,247
8,7,9,0,56,56
27,7,9,15,189,204
13,7,9,25,91,116
25,7,9,21,175,196
5,7,9,10,35,45
7,3,8,34,21,55
23,3,8,111,69,180
22,3,8,106,66,172
7,3,8,34,21,55
11,3,8,37,33,70
13,8,22,119,104,223
23,8,22,312,184,496
24,8,22,262,192,454
30,8,22,407,240,647
16,8,22,217,128,345
15,8,22,207,120,327
28,8,22,386,224,610
3,9,24,44,27,71
7,9,24,68,63,131
23,9,24,339,207,546
24,9,24,239,216,455
2,13,35,43,26,69
13,13,35,186,169,355
17,13,35,249,221,470
15,13,35,325,195,520
24,13,35,520,312,832
27,13,35,585,351,936
3,13,35,43,39,82
19,13,35,278,247,525
13,13,35,190,169,359
23,13,35,377,299,676
13,13,35,277,169,446
20,13,35,433,260,693
26,13,35,563,338,901
11,13,35,238,143,381
13,13,35,277,169,446
4,13,35,63,52,115
26,13,35,554,338,892
21,13,35,455,273,728
10,13,35,171,130,301
21,13,35,447,273,720
12,13,35,172,156,328
25,21,55,823,525,1348
5,42,54,1,210,211
17,42,54,195,714,909
1,38,50,1,38,39
15,38,50,173,570,743
24,42,54,120,1008,1128
10,38,50,40,380,420
22,42,54,110,924,1034
1,1266,2320,1031,1266,2297
1,1252,2295,722,1252,1974
1,1266,2320,1008,1266,2274
1,1266,2320,1031,1266,2297
1,420,769,180,420,600
1,1266,2320,1008,1266,2274
1,1252,2295,997,1252,2249
1,1519,2443,753,1519,2272
1,1519,2443,484,1519,2003
1,2171,3578,656,2171,2827
1,2171,3578,942,2171,3113
1,1083,1701,601,1083,1684
1,2171,3578,835,2171,3006
1,2171,3578,835,2171,3006
1,2171,3578,656,2171,2827
1,2171,3578,656,2171,2827
1,2171,3578,656,2171,2827
1,1555,2443,497,1555,2052
1,1519,2443,533,1519,2052
1,713,1120,172,713,885
1,1555,2443,864,1555,2419
1,1519,2443,900,1519,2419
1,2171,3578,1335,2171,3506
1,2171,3578,620,2171,2791
1,2171,3578,620,2171,2791
17,26,70,498,442,940
14,26,70,410,364,774
15,26,70,639,390,1029
19,26,70,809,494,1303
22,26,70,953,572,1525
27,26,70,942,702,1644
17,3,9,99,51,150
10,3,9,47,30,77
3,1,2,3,3,6
9,1,2,9,9,18
22,9,25,347,198,545
7,9,25,110,63,173
8,1,2,8,8,16
28,1,2,27,28,55
11,1,2,11,11,22
8,2,5,23,16,39
24,2,5,70,48,118
21,1,2,12,21,33
28,13,35,606,364,970
22,13,35,476,286,762
28,1,2,27,28,55
26,1,2,25,26,51
29,2,5,67,58,125
1,2,5,2,2,4
11,9,25,118,99,217
2,9,25,22,18,40
29,1,2,28,29,57
29,1,2,28,29,57
22,2,5,43,44,87
17,2,5,33,34,67
7,1,2,4,7,11
19,1,2,12,19,31
22,1,2,12,22,34
24,1,2,13,24,37
10,1,2,7,10,17
26,1,2,19,26,45
23,12,33,475,276,751
30,12,33,620,360,980
29,1,4,68,29,97
21,1,4,50,21,71
29,1,2,20,29,49
22,1,2,15,22,37
14,1,2,10,14,24
6,1,2,4,6,10
23,2,5,45,46,91
9,2,5,18,18,36
16,1,2,11,16,27
8,1,2,5,8,13
11,1,2,6,11,17
12,1,2,7,12,19
1,1,2,1,1,2
5,1,2,3,5,8
4,12,33,81,48,129
23,12,33,468,276,744
5,1,2,5,5,10
19,2,5,55,38,93
25,11,29,349,275,624
9,11,29,125,99,224
20,1,2,11,20,31
15,1,2,8,15,23
10,1,4,29,10,39
1,1482,2384,521,1482,2003
1,1482,2384,401,1482,1883
1,755,1215,302,755,1057
1,1482,2384,592,1482,2074
1,1482,2384,854,1482,2336
1,1482,2384,854,1482,2336
5,24,64,133,120,253
26,24,64,1007,624,1631
25,24,64,968,600,1568
1,45,120,63,45,108
20,2,5,38,40,78
16,2,5,30,32,62
29,3,9,171,87,258
20,3,9,118,60,178
19,2,5,56,38,94
4,2,5,12,8,20
25,4,10,145,100,245
5,2,5,15,10,25
30,2,5,87,60,147
25,2,5,74,50,124
19,2,5,55,38,93
7,2,5,20,14,34
7,3,9,32,21,53
16,3,9,73,48,121
11,2,5,24,22,46
28,2,5,62,56,118
6,2,5,12,12,24
23,3,9,92,69,161
30,2,5,66,60,126
17,2,5,37,34,71
18,7,9,30,126,156
15,7,9,11,105,116
2,7,9,4,14,18
27,7,9,49,189,238
3,3,8,11,9,20
14,8,22,128,112,240
14,8,22,147,112,259
28,8,22,306,224,530
25,8,22,339,200,539
29,8,22,400,232,632
8,8,22,105,64,169
24,8,22,331,192,523
19,9,24,185,171,356
24,9,24,348,216,564
30,13,35,471,390,861
15,13,35,215,195,410
8,13,35,173,104,277
8,13,35,165,104,269
9,13,35,141,117,258
17,13,35,279,221,500
24,13,35,520,312,832
8,13,35,114,104,218
3,13,35,52,39,91
10,13,35,143,130,273
22,13,35,384,286,670
22,13,35,361,286,647
18,13,35,383,234,617
9,13,35,192,117,309
14,13,35,220,182,402
10,13,35,175,130,305
18,13,35,383,234,617
19,13,35,272,247,519
30,13,35,429,390,819
11,21,55,277,231,508
5,42,54,57,210,267
19,38,50,105,722,827
8,42,54,36,336,372
13,42,54,30,546,576
18,38,50,72,684,756
24,38,50,264,912,1176
15,38,50,15,570,585
5,38,50,50,190,240
18,38,50,198,684,882
1,1266,2320,683,1266,1949
1,1252,2295,538,1252,1790
1,295,540,132,295,427
1,420,769,341,420,761
1,295,540,126,295,421
1,2171,3578,1335,2171,3506
1,1555,2443,839,1555,2394
1,2171,3578,656,2171,2827
1,713,1120,161,713,874
1,2171,3578,835,2171,3006
1,1083,1701,312,1083,1395
1,344,540,99,344,443
4,26,70,114,104,218
26,26,70,744,676,1420
7,3,9,28,21,49
19,1,4,56,19,75
17,13,35,267,221,488
16,13,35,251,208,459
14,1,2,13,14,27
2,1,2,2,2,4
19,1,2,18,19,37
10,2,5,30,20,50
14,2,5,41,28,69
27,2,5,80,54,134
12,12,33,201,144,345
14,1,2,8,14,22
7,1,2,4,7,11
22,1,2,12,22,34
7,1,4,17,7,24
10,1,4,24,10,34
19,1,2,19,19,38
30,1,2,29,30,59
3,2,5,9,6,15
19,2,5,55,38,93
21,13,35,447,273,720
28,1,4,66,28,94
30,1,4,64,30,94
28,1,2,18,28,46
22,1,2,14,22,36
26,1,2,24,26,50
22,2,5,52,44,96
22,2,5,52,44,96
24,1,4,71,24,95
25,1,4,74,25,99
7,1,2,5,7,12
15,1,2,11,15,26
30,2,5,71,60,131
27,2,5,63,54,117
7,1,2,5,7,12
13,1,2,10,13,23
18,2,5,35,36,71
11,2,5,21,22,43
15,1,4,44,15,59
2,1,4,6,2,8
28,1,4,83,28,111
25,8,21,231,200,431
17,8,21,157,136,293
22,8,21,226,176,402
17,8,21,175,136,311
8,2,5,22,16,38
9,2,5,26,18,44
9,2,5,26,18,44
7,8,21,88,56,144
27,2,5,51,54,105
4,2,5,8,8,16
12,1,2,12,12,24
2,2,5,4,4,8
25,2,5,48,50,98
1,1482,2384,521,1482,2003
1,1482,2384,473,1482,1955
1,755,1215,411,755,1166
1,461,742,185,461,646
1,1482,2384,854,1482,2336
1,1482,2384,854,1482,2336
14,24,64,363,336,699
17,24,64,658,408,1066
7,45,120,407,315,722
7,59,159,555,413,968
30,4,10,126,120,246
22,4,10,92,88,180
22,4,10,103,88,191
18,2,5,52,36,88
24,2,5,46,48,94
18,2,5,34,36,70
24,2,5,70,48,118
20,3,9,116,60,176
29,3,9,169,87,256
2,2,5,6,4,10
21,2,5,61,42,103
19,2,5,55,38,93
19,3,9,87,57,144
3,3,9,14,9,23
3,2,5,6,6,12
24,2,5,50,48,98
29,2,5,61,58,119
22,7,9,40,154,194
29,7,9,48,203,251
16,3,8,52,48,100
13,3,8,50,39,89
21,8,22,192,168,360
14,8,22,147,112,259
20,8,22,276,160,436
18,9,24,261,162,423
22,13,35,469,286,755
27,13,35,575,351,926
22,13,35,453,286,739
9,13,35,129,117,246
6,13,35,130,78,208
7,13,35,144,91,235
16,13,35,341,208,549
12,13,35,176,156,332
21,13,35,447,273,720
14,13,35,303,182,485
27,13,35,585,351,936
17,13,35,362,221,583
16,13,35,246,208,454
16,13,35,330,208,538
26,13,35,554,338,892
18,13,35,257,234,491
7,13,35,149,91,240
5,13,35,107,65,172
12,13,35,172,156,328
2,21,55,66,42,108
12,21,55,395,252,647
12,21,55,395,252,647
16,42,54,175,672,847
12,42,54,1,504,505
3,38,50,30,114,144
12,38,50,48,456,504
3,42,54,0,126,126
5,42,54,1,210,211
21,38,50,105,798,903
1,1252,2295,538,1252,1790
1,1266,2320,1008,1266,2274
1,1266,2320,1008,1266,2274
1,420,769,334,420,754
1,420,769,295,420,715
1,420,769,341,420,761
1,1266,2320,1008,1266,2274
1,1266,2320,567,1266,1833
1,420,769,249,420,669
1,1266,2320,544,1266,1810
1,2171,3578,1335,2171,3506
1,344,540,185,344,529
1,344,540,174,344,518
1,1083,1701,346,1083,1429
1,487,783,194,487,681
1,344,540,174,344,518
1,344,540,99,344,443
13,26,70,554,338,892
12,3,9,70,36,106
16,3,9,90,48,138
9,1,2,9,9,18
10,1,2,10,10,20
15,1,2,14,15,29
1,2,5,3,2,5
8,2,5,24,16,40
3,1,2,2,3,5
9,2,5,26,18,44
11,2,5,32,22,54
1,1,4,3,1,4
24,1,4,71,24,95
26,2,5,75,52,127
27,2,5,78,54,132
28,2,5,66,56,122
29,2,5,55,58,113
24,2,5,67,48,115
16,2,5,47,32,79
14,11,30,211,154,365
22,11,30,332,242,574
23,11,30,423,253,676
11,11,30,202,121,323
1,2,5,3,2,5
22,2,5,62,44,106
25,9,25,394,225,619
10,1,2,6,10,16
30,1,2,19,30,49
12,2,5,32,24,56
8,1,4,23,8,31
29,1,4,85,29,114
10,1,2,7,10,17
14,1,2,10,14,24
23,2,5,44,46,90
6,2,5,11,12,23
9,1,2,6,9,15
18,2,5,53,36,89
3,1,2,2,3,5
8,1,4,23,8,31
14,1,4,30,14,44
25,1,4,53,25,78
15,8,21,182,120,302
1,1482,2384,378,1482,1860
1,755,1215,436,755,1191
11,24,64,348,264,612
16,24,64,630,384,1014
5,45,120,363,225,588
12,3,9,58,36,94
6,2,5,17,12,29
21,2,5,61,42,103
17,4,10,75,68,143
26,4,10,114,104,218
21,2,5,59,42,101
21,2,5,61,42,103
7,2,5,20,14,34
20,2,5,59,40,99
7,2,5,16,14,30
26,2,5,61,52,113
16,2,5,47,32,79
6,2,5,18,12,30
25,3,9,121,75,196
14,3,9,68,42,110
11,3,9,45,33,78
29,3,9,119,87,206
28,3,9,123,84,207
13,3,9,57,39,96
8,7,9,7,56,63
13,7,9,24,91,115
5,3,8,20,15,35
15,3,8,59,45,104
12,3,8,48,36,84
9,3,8,28,27,55
9,8,22,98,72,170
14,8,22,128,112,240
18,8,22,244,144,388
20,8,22,223,160,383
9,8,22,122,72,194
30,9,24,320,270,590
7,9,24,102,63,165
18,9,24,214,162,376
14,9,24,150,126,276
10,9,24,107,90,197
29,13,35,628,377,1005
30,13,35,461,390,851
27,13,35,471,351,822
30,13,35,492,390,882
11,13,35,234,143,377
23,13,35,401,299,700
12,13,35,172,156,328
8,13,35,114,104,218
12,13,35,256,156,412
16,13,35,341,208,549
8,13,35,126,104,230
25,13,35,489,325,814
5,21,55,134,105,239
28,21,55,921,588,1509
29,38,50,29,1102,1131
29,38,50,87,1102,1189
7,38,50,18,266,284
11,38,50,44,418,462
10,42,54,7,420,427
21,38,50,179,798,977
10,38,50,110,380,490
3,38,50,30,114,144
22,42,54,50,924,974
1,1898,3375,1038,1898,2936
1,1252,2295,997,1252,2249
1,1912,3400,1046,1912,2958
1,1266,2320,1031,1266,2297
1,1252,2295,1020,1252,2272
1,1252,2295,1020,1252,2272
1,344,540,126,344,470
1,713,1120,385,713,1098
1,1555,2443,448,1555,2003
1,1555,2443,570,1555,2125
1,2171,3578,835,2171,3006
1,2171,3578,835,2171,3006
1,713,1120,385,713,1098
1,2171,3578,656,2171,2827
1,344,540,110,344,454
1,344,540,174,344,518
1,344,540,174,344,518
3,26,70,94,78,172
4,26,70,173,104,277
7,26,70,298,182,480
1,26,70,29,26,55
21,26,70,733,546,1279
19,3,9,90,57,147
5,3,9,30,15,45
15,11,30,281,165,446
29,11,30,542,319,861
16,1,2,11,16,27
28,2,5,81,56,137
16,2,5,46,32,78
18,2,5,50,36,86
2,9,25,23,18,41
8,1,2,6,8,14
10,1,4,24,10,34
11,2,5,26,22,48
7,2,5,16,14,30
16,1,2,10,16,26
24,1,2,15,24,39
16,1,2,12,16,28
13,1,2,9,13,22
10,1,2,7,10,17
18,1,4,45,18,63
7,1,4,17,7,24
3,1,2,2,3,5
13,1,2,9,13,22
8,1,2,6,8,14
18,1,4,39,18,57
4,1,4,9,4,13
5,1,4,11,5,16
30,1,2,29,30,59
28,1,4,82,28,110
14,1,4,41,14,55
5,1,4,15,5,20
5,11,29,58,55,113
2,2,5,4,4,8
20,2,5,36,40,76
3,2,5,9,6,15
4,2,5,12,8,20
25,2,5,73,50,123
8,2,5,19,16,35
25,2,5,59,50,109
14,8,21,111,112,223
26,8,21,207,208,415
1,1482,2384,854,1482,2336
1,755,1215,436,755,1191
1,755,1215,436,755,1191
1,1482,2384,735,1482,2217
8,3,9,47,24,71
8,3,9,47,24,71
29,4,10,171,116,287
18,4,10,106,72,178
6,2,5,18,12,30
29,2,5,86,58,144
24,2,5,67,48,115
19,2,5,53,38,91
16,2,5,46,32,78
9,2,5,26,18,44
10,3,9,48,30,78
13,3,9,63,39,102
11,2,5,32,22,54
26,2,5,75,52,127
12,4,10,50,48,98
29,4,10,122,116,238
14,2,5,27,28,55
9,2,5,18,18,36
11,3,9,59,33,92
3,3,9,16,9,25
1,2,5,2,2,4
27,3,9,109,81,190
23,3,9,92,69,161
4,7,9,8,28,36
7,7,9,13,49,62
4,7,9,3,28,31
5,7,9,10,35,45
2,3,8,7,6,13
5,3,8,17,15,32
29,8,22,393,232,625
30,8,22,413,240,653
16,8,22,220,128,348
12,8,22,165,96,261
4,8,22,55,32,87
30,8,22,281,240,521
12,9,24,177,108,285
25,9,24,261,225,486
26,9,24,365,234,599
13,13,35,254,169,423
26,13,35,554,338,892
4,13,35,78,52,130
18,13,35,264,234,498
17,13,35,332,221,553
20,13,35,391,260,651
7,13,35,100,91,191
19,13,35,405,247,652
1,13,35,22,13,35
23,13,35,329,299,628
15,13,35,325,195,520
8,13,35,140,104,244
18,13,35,257,234,491
19,13,35,411,247,658
10,13,35,206,130,336
22,13,35,345,286,631
13,13,35,281,169,450
23,13,35,401,299,700
28,13,35,596,364,960
19,13,35,391,247,638
4,13,35,82,52,134
8,13,35,114,104,218
18,21,55,404,378,782
9,38,50,104,342,446
1,42,54,11,42,53
11,42,54,108,462,570
12,38,50,66,456,522
15,38,50,38,570,608
11,42,54,55,462,517
11,38,50,121,418,539
21,42,54,14,882,896
4,42,54,3,168,171
1,1266,2320,567,1266,1833
1,1252,2295,1020,1252,2272
1,1266,2320,729,1266,1995
1,1252,2295,745,1252,1997
1,1252,2295,997,1252,2249
1,1252,2295,561,1252,1813
1,308,565,251,308,559
1,1252,2295,630,1252,1882
1,1266,2320,961,1266,2227
1,2171,3578,1335,2171,3506
1,2171,3578,1157,2171,3328
1,1519,2443,753,1519,2272
1,2171,3578,942,2171,3113
1,2171,3578,942,2171,3113
1,2171,3578,835,2171,3006
1,713,1120,385,713,1098
1,344,540,77,344,421
1,2171,3578,1335,2171,3506
1,2171,3578,1335,2171,3506
30,26,70,1278,780,2058
3,26,70,88,78,166
29,2,5,61,58,119
18,2,5,38,36,74
1,2,5,3,2,5
24,2,5,70,48,118
16,2,5,46,32,78
1,9,25,12,9,21
15,9,25,180,135,315
29,1,2,16,29,45
24,1,2,13,24,37
7,1,2,7,7,14
12,1,2,12,12,24
11,13,35,238,143,381
10,13,35,217,130,347
27,1,2,19,27,46
13,1,2,9,13,22
9,1,2,6,9,15
22,13,35,430,286,716
14,1,2,10,14,24
30,1,2,22,30,52
5,2,5,10,10,20
14,2,5,29,28,57
23,11,30,430,253,683
10,1,2,10,10,20
25,1,2,24,25,49
18,1,2,17,18,35
10,2,5,30,20,50
26,1,2,15,26,41
1,1,2,1,1,2
18,1,2,12,18,30
7,2,5,21,14,35
24,2,5,71,48,119
23,2,5,68,46,114
19,1,2,17,19,36
29,1,4,86,29,115
27,1,4,80,27,107
12,1,2,11,12,23
1,1,2,1,1,2
27,1,2,20,27,47
30,1,4,64,30,94
11,1,4,23,11,34
23,1,2,23,23,46
8,1,4,20,8,28
4,1,4,10,4,14
27,12,33,371,324,695
26,12,33,357,312,669
21,2,5,59,42,101
12,2,5,34,24,58
25,2,5,70,50,120
23,2,5,67,46,113
7,2,5,20,14,34
22,2,5,64,44,108
27,1,4,58,27,85
13,1,4,28,13,41
10,1,4,21,10,31
5,2,5,10,10,20
12,1,4,34,12,46
7,1,4,20,7,27
20,1,2,15,20,35
30,1,2,22,30,52
7,1,2,5,7,12
24,2,5,67,48,115
13,2,5,36,26,62
1,461,742,274,461,735
1,755,1215,436,755,1191
1,755,1215,193,755,948
28,24,64,1084,672,1756
5,45,120,267,225,492
11,2,5,29,22,51
14,2,5,37,28,65
29,2,5,84,58,142
23,2,5,67,46,113
2,2,5,6,4,10
6,2,5,17,12,29
25,2,5,58,50,108
5,2,5,12,10,22
27,2,5,63,54,117
26,2,5,61,52,113
4,2,5,9,8,17
10,2,5,23,20,43
18,2,5,42,36,78
2,2,5,6,4,10
16,2,5,45,32,77
25,2,5,48,50,98
8,2,5,23,16,39
12,2,5,35,24,59
6,7,9,11,42,53
18,7,9,15,126,141
23,7,9,0,161,161
13,8,22,119,104,223
18,8,22,208,144,352
23,8,22,312,184,496
21,8,22,192,168,360
13,9,24,139,117,256
27,9,24,321,243,564
3,13,35,43,39,82
8,13,35,170,104,274
5,13,35,98,65,163
17,13,35,368,221,589
30,13,35,618,390,1008
10,13,35,213,130,343
7,13,35,144,91,235
3,13,35,51,39,90
11,13,35,238,143,381
19,13,35,332,247,579
5,13,35,87,65,152
3,13,35,64,39,103
3,13,35,64,39,103
26,13,35,372,338,710
26,13,35,536,338,874
16,21,55,509,336,845
21,42,54,229,882,1111
13,38,50,13,494,507
28,38,50,308,1064,1372
29,42,54,144,1218,1362
5,42,54,22,210,232
15,42,54,34,630,664
16,42,54,36,672,708
12,38,50,30,456,486
1,1912,3400,774,1912,2686
1,1252,2295,1020,1252,2272
1,420,769,318,420,738
1,420,769,334,420,754
1,1252,2295,791,1252,2043
1,1519,2443,387,1519,1906
1,487,783,280,487,767
1,1555,2443,448,1555,2003
1,2171,3578,942,2171,3113
1,2171,3578,942,2171,3113
1,2171,3578,656,2171,2827
1,2171,3578,1335,2171,3506
20,26,70,866,520,1386
10,26,70,314,260,574
23,26,70,996,598,1594
25,26,70,785,650,1435
27,3,9,130,81,211
17,13,35,243,221,464
29,13,35,415,377,792
23,13,35,329,299,628
30,13,35,618,390,1008
28,13,35,577,364,941
6,2,5,17,12,29
28,13,35,596,364,960
11,13,35,234,143,377
6,13,35,128,78,206
16,9,25,240,144,384
25,9,25,375,225,600
16,13,35,341,208,549
5,13,35,107,65,172
24,9,25,372,216,588
20,1,2,19,20,39
20,1,2,19,20,39
11,9,25,165,99,264
26,9,25,390,234,624
19,2,5,36,38,74
9,2,5,17,18,35
27,9,25,425,243,668
16,9,25,252,144,396
24,9,25,372,216,588
8,9,25,124,72,196
1,1,2,1,1,2
1,2,5,3,2,5
1,2,5,3,2,5
1,1482,2384,592,1482,2074
1,1482,2384,807,1482,2289
1,461,742,251,461,712
1,1482,2384,449,1482,1931
10,24,64,387,240,627
24,24,64,791,576,1367
7,45,120,407,315,722
1,59,159,94,59,153
17,3,9,100,51,151
20,3,9,118,60,178
15,2,5,44,30,74
24,2,5,71,48,119
2,2,5,6,4,10
5,2,5,15,10,25
23,2,5,68,46,114
28,2,5,53,56,109
23,2,5,44,46,90
17,2,5,33,34,67
10,2,5,20,20,40
29,3,9,137,87,224
19,3,9,90,57,147
15,2,5,35,30,65
9,2,5,17,18,35
16,2,5,30,32,62
3,2,5,9,6,15
19,2,5,45,38,83
25,2,5,59,50,109
24,2,5,67,48,115
3,2,5,8,6,14
29,7,9,55,203,258
30,7,9,49,210,259
28,7,9,46,196,242
8,7,9,15,56,71
12,7,9,-2,84,82
27,3,8,87,81,168
27,8,22,372,216,588
5,8,22,69,40,109
21,8,22,192,168,360
26,8,22,353,208,561
12,8,22,131,96,227
14,8,22,193,112,305
20,8,22,223,160,383
7,9,24,102,63,165
6,9,24,89,54,143
18,13,35,283,234,517
11,13,35,227,143,370
17,13,35,350,221,571
17,13,35,350,221,571
11,13,35,188,143,331
15,13,35,257,195,452
8,13,35,140,104,244
28,13,35,400,364,764
20,13,35,349,260,609
12,13,35,163,156,319
1,13,35,14,13,27
24,13,35,394,312,706
10,21,55,269,210,479
17,42,54,2,714,716
29,42,54,332,1218,1550
8,38,50,88,304,392
30,38,50,330,1140,1470
23,38,50,265,874,1139
2,38,50,22,76,98
28,38,50,140,1064,1204
11,38,50,94,418,512
20,38,50,20,760,780
1,1266,2320,1031,1266,2297
1,1252,2295,1020,1252,2272
1,1252,2295,745,1252,1997
1,1252,2295,1020,1252,2272
1,1266,2320,544,1266,1810
1,1266,2320,1031,1266,2297
1,1266,2320,636,1266,1902
1,2171,3578,1335,2171,3506
1,1083,1701,244,1083,1327
1,2171,3578,656,2171,2827
1,2171,3578,942,2171,3113
1,344,540,77,344,421
1,2171,3578,1335,2171,3506
1,2171,3578,1335,2171,3506
1,713,1120,261,713,974
1,2171,3578,620,2171,2791
1,1555,2443,864,1555,2419
14,26,70,596,364,960
17,3,9,81,51,132
16,3,9,95,48,143
12,3,9,68,36,104
14,1,2,14,14,28
8,1,2,8,8,16
29,1,2,28,29,57
12,2,5,34,24,58
21,2,5,59,42,101
16,2,5,45,32,77
22,2,5,46,44,90
6,2,5,13,12,25
17,2,5,36,34,70
27,1,4,64,27,91
5,1,4,12,5,17
30,1,2,29,30,59
28,1,2,27,28,55
16,1,2,16,16,32
4,2,5,11,8,19
27,9,25,425,243,668
12,9,25,189,108,297
29,1,2,28,29,57
30,1,2,29,30,59
9,1,2,9,9,18
16,2,5,46,32,78
29,1,2,28,29,57
29,1,2,28,29,57
7,1,2,4,7,11
26,1,2,15,26,41
17,1,2,10,17,27
12,11,29,213,132,345
23,11,29,407,253,660
15,11,30,186,165,351
2,1,2,2,2,4
8,2,5,22,16,38
20,1,4,42,20,62
13,2,5,38,26,64
28,2,5,81,56,137
29,2,5,84,58,142
1,1482,2384,807,1482,2289
1,755,1215,411,755,1166
1,461,742,274,461,735
1,1482,2384,807,1482,2289
1,1482,2384,807,1482,2289
1,755,1215,302,755,1057
1,755,1215,168,755,923
1,461,742,177,461,638
1,1482,2384,807,1482,2289
16,24,64,630,384,1014
10,45,120,486,450,936
4,59,159,387,236,623
3,59,159,224,177,401
20,3,9,118,60,178
9,3,9,53,27,80
28,4,10,165,112,277
22,4,10,130,88,218
8,2,5,19,16,35
27,2,5,63,54,117
10,2,5,21,20,41
2,3,9,12,6,18
21,2,5,40,42,82
3,2,5,6,6,12
28,2,5,81,56,137
13,2,5,38,26,64
13,2,5,31,26,57
18,2,5,38,36,74
27,2,5,57,54,111
30,7,9,49,210,259
10,7,9,8,70,78
3,7,9,4,21,25
25,7,9,48,175,223
2,3,8,10,6,16
28,3,8,136,84,220
30,3,8,97,90,187
3,8,22,27,24,51
23,8,22,312,184,496
3,8,22,27,24,51
6,8,22,81,48,129
14,8,22,184,112,296
15,8,22,167,120,287
4,8,22,37,32,69
12,8,22,165,96,261
11,9,24,107,99,206
7,9,24,103,63,166
27,9,24,269,243,512
1,9,24,12,9,21
22,13,35,361,286,647
15,13,35,236,195,431
21,13,35,447,273,720
10,13,35,217,130,347
15,13,35,262,195,457
4,13,35,87,52,139
23,13,35,353,299,652
1,13,35,17,13,30
21,13,35,411,273,684
27,13,35,585,351,936
10,13,35,213,130,343
30,13,35,429,390,819
17,13,35,362,221,583
10,13,35,213,130,343
13,13,35,268,169,437
27,21,55,888,567,1455
1,21,55,33,21,54
5,21,55,165,105,270
16,38,50,48,608,656
16,42,54,80,672,752
14,42,54,9,588,597
2,42,54,10,84,94
15,38,50,165,570,735
1,38,50,3,38,41
25,42,54,273,1050,1323
28,38,50,238,1064,1302
14,42,54,153,588,741
1,38,50,1,38,39
19,42,54,207,798,1005
5,38,50,58,190,248
23,42,54,189,966,1155
26,42,54,284,1092,1376
1,1266,2320,544,1266,1810
1,1252,2295,538,1252,1790
1,1266,2320,613,1266,1879
1,1252,2295,538,1252,1790
1,1252,2295,997,1252,2249
1,420,769,318,420,738
1,1266,2320,1008,1266,2274
1,1252,2295,882,1252,2134
1,1266,2320,1031,1266,2297
1,2171,3578,763,2171,2934
1,713,1120,385,713,1098
1,1555,2443,448,1555,2003
1,344,540,77,344,421
1,1083,1701,499,1083,1582
1,1083,1701,499,1083,1582
1,2171,3578,656,2171,2827
1,713,1120,385,713,1098
1,2171,3578,835,2171,3006
1,2171,3578,942,2171,3113
1,344,540,185,344,529
1,344,540,83,344,427
1,713,1120,228,713,941
27,1,2,20,27,47
8,1,2,6,8,14
17,2,5,50,34,84
7,12,33,145,84,229
19,2,5,56,38,94
22,1,2,16,22,38
16,1,2,12,16,28
6,2,5,17,12,29
22,2,5,64,44,108
6,2,5,18,12,30
23,1,4,57,23,80
10,1,4,25,10,35
11,2,5,21,22,43
24,2,5,46,48,94
6,2,5,14,12,26
3,2,5,7,6,13
29,2,5,64,58,122
2,12,33,31,24,55
21,12,33,330,252,582
24,2,5,56,48,104
14,13,35,205,182,387
25,2,5,73,50,123
26,11,30,486,286,772
9,11,30,168,99,267
18,2,5,52,36,88
15,2,5,35,30,65
16,2,5,38,32,70
26,11,30,322,286,608
19,11,30,236,209,445
19,1,2,18,19,37
7,1,2,7,7,14
29,1,4,85,29,114
4,1,4,12,4,16
14,1,4,41,14,55
27,2,5,78,54,132
24,2,5,70,48,118
27,2,5,78,54,132
4,2,5,12,8,20
15,2,5,44,30,74
30,1,2,29,30,59
7,2,5,20,14,34
15,2,5,44,30,74
7,2,5,20,14,34
1,1482,2384,521,1482,2003
1,1482,2384,592,1482,2074
1,1482,2384,807,1482,2289
1,1482,2384,854,1482,2336
1,1482,2384,592,1482,2074
28,24,64,726,672,1398
25,45,120,1845,1125,2970
8,59,159,635,472,1107
9,59,159,843,531,1374
20,2,5,38,40,78
15,2,5,29,30,59
15,2,5,35,30,65
28,2,5,66,56,122
8,3,9,45,24,69
5,7,9,4,35,39
16,7,9,0,112,112
1,7,9,0,7,7
11,3,8,49,33,82
13,8,22,119,104,223
28,8,22,306,224,530
3,8,22,27,24,51
12,8,22,165,96,261
17,9,24,165,153,318
28,13,35,459,364,823
16,13,35,274,208,482
18,13,35,257,234,491
15,13,35,325,195,520
17,13,35,350,221,571
20,13,35,349,260,609
13,13,35,281,169,450
30,13,35,650,390,1040
21,13,35,308,273,581
16,13,35,330,208,538
6,13,35,124,78,202
29,13,35,415,377,792
28,13,35,596,364,960
23,38,50,230,874,1104
26,38,50,286,988,1274
18,42,54,41,756,797
3,38,50,33,114,147
29,42,54,97,1218,1315
25,42,54,125,1050,1175
10,42,54,98,420,518
1,1266,2320,729,1266,1995
1,1252,2295,951,1252,2203
1,1252,2295,997,1252,2249
1,2171,3578,763,2171,2934
1,713,1120,396,713,1109
1,713,1120,362,713,1075
22,26,70,752,572,1324
14,26,70,400,364,764
27,26,70,923,702,1625
21,3,9,124,63,187
17,2,5,50,34,84
21,2,5,59,42,101
21,13,35,447,273,720
13,13,35,277,169,446
4,13,35,66,52,118
18,13,35,295,234,529
7,1,2,7,7,14
13,1,2,13,13,26
12,1,2,11,12,23
26,1,2,24,26,50
6,1,2,6,6,12
4,11,29,67,44,111
8,11,29,135,88,223
21,11,29,354,231,585
10,1,2,7,10,17
26,1,2,19,26,45
1,1,2,1,1,2
15,2,5,44,30,74
5,1,2,5,5,10
25,1,2,25,25,50
3,1,2,3,3,6
13,1,2,11,13,24
2,11,30,36,22,58
24,11,30,427,264,691
3,9,25,45,27,72
24,2,5,47,48,95
9,2,5,18,18,36
14,2,5,27,28,55
27,1,2,15,27,42
21,9,25,268,189,457
23,9,25,293,207,500
24,9,25,306,216,522
28,2,5,53,56,109
3,2,5,6,6,12
1,1482,2384,592,1482,2074
1,755,1215,436,755,1191
1,1482,2384,854,1482,2336
18,24,64,674,432,1106
7,59,159,555,413,968
21,2,5,56,42,98
30,3,9,123,90,213
6,3,9,25,18,43
30,4,10,117,120,237
7,4,10,27,28,55
7,3,9,32,21,53
4,3,9,18,12,30
10,2,5,30,20,50
28,2,5,83,56,139
26,2,5,55,52,107
21,2,5,44,42,86
4,2,5,12,8,20
26,2,5,75,52,127
11,2,5,31,22,53
21,2,5,59,42,101
13,7,9,25,91,116
17,7,9,32,119,151
2,3,8,10,6,16
29,3,8,136,87,223
19,3,8,75,57,132
17,3,8,82,51,133
18,8,22,244,144,388
2,8,22,21,16,37
28,8,22,380,224,604
29,8,22,323,232,555
9,8,22,84,72,156
14,9,24,136,126,262
29,9,24,310,261,571
2,13,35,29,26,55
13,13,35,227,169,396
6,13,35,86,78,164
28,13,35,606,364,970
22,13,35,476,286,762
27,13,35,471,351,822
20,13,35,426,260,686
24,13,35,511,312,823
29,13,35,597,377,974
24,13,35,419,312,731
19,13,35,371,247,618
20,13,35,391,260,651
17,13,35,362,221,583
11,13,35,227,143,370
25,13,35,533,325,858
5,13,35,86,65,151
28,13,35,410,364,774
22,13,35,453,286,739
20,21,55,636,420,1056
3,21,55,100,63,163
21,21,55,564,441,1005
21,38,50,231,798,1029
9,38,50,104,342,446
24,38,50,240,912,1152
17,42,54,186,714,900
11,42,54,55,462,517
1,1912,3400,774,1912,2686
1,420,769,334,420,754
1,1266,2320,1008,1266,2274
1,1252,2295,951,1252,2203
1,1266,2320,1008,1266,2274
1,1266,2320,683,1266,1949
1,420,769,318,420,738
1,420,769,249,420,669
1,308,565,234,308,542
1,2171,3578,763,2171,2934
1,713,1120,385,713,1098
1,1555,2443,790,1555,2345
1,713,1120,385,713,1098
1,1555,2443,839,1555,2394
1,2171,3578,942,2171,3113
1,344,540,185,344,529
1,713,1120,172,713,885
1,1555,2443,864,1555,2419
29,26,70,1235,754,1989
3,26,70,124,78,202
7,3,9,39,21,60
16,3,9,90,48,138
3,3,9,17,9,26
26,1,2,19,26,45
19,2,5,55,38,93
8,2,5,23,16,39
20,1,2,11,20,31
28,2,5,83,56,139
1,2,5,3,2,5
6,12,33,124,72,196
13,2,5,27,26,53
8,2,5,16,16,32
10,1,2,10,10,20
7,13,35,149,91,240
8,13,35,170,104,274
5,2,5,15,10,25
21,2,5,62,42,104
21,1,4,62,21,83
14,1,4,41,14,55
12,1,4,36,12,48
1,1,2,1,1,2
6,1,2,4,6,10
26,1,2,15,26,41
9,1,2,5,9,14
2,2,5,6,4,10
11,2,5,31,22,53
7,2,5,20,14,34
25,1,2,19,25,44
19,1,2,14,19,33
22,1,2,20,22,42
3,2,5,9,6,15
10,1,2,6,10,16
23,1,2,13,23,36
18,1,2,10,18,28
14,1,2,13,14,27
11,1,2,10,11,21
21,2,5,61,42,103
9,2,5,26,18,44
14,2,5,41,28,69
2,1,2,1,2,3
15,2,5,44,30,74
19,2,5,55,38,93
16,1,4,34,16,50
29,1,4,61,29,90
11,1,4,24,11,35
30,1,2,29,30,59
30,1,2,29,30,59
9,1,2,9,9,18
1,1,4,3,1,4
17,2,5,40,34,74
2,2,5,5,4,9
5,2,5,12,10,22
4,2,5,9,8,17
20,1,4,54,20,74
23,1,4,63,23,86
1,1482,2384,878,1482,2360
1,755,1215,375,755,1130
1,755,1215,375,755,1130
1,1482,2384,878,1482,2360
1,1482,2384,854,1482,2336
19,24,64,602,456,1058
9,45,120,437,405,842
6,59,159,476,354,830
7,59,159,655,413,1068
1,2,5,2,2,4
1,2,5,2,2,4
13,2,5,38,26,64
17,4,10,78,68,146
16,4,10,74,64,138
1,2,5,2,2,4
9,2,5,17,18,35
24,3,9,116,72,188
18,4,10,104,72,176
2,4,10,8,8,16
21,4,10,80,84,164
28,4,10,106,112,218
21,4,10,80,84,164
10,3,9,59,30,89
26,3,9,154,78,232
24,7,9,46,168,214
7,7,9,13,49,62
19,7,9,14,133,147
10,7,9,0,70,70
29,7,9,48,203,251
29,7,9,1,203,204
24,7,9,13,168,181
10,7,9,4,70,74
17,7,9,23,119,142
9,7,9,16,63,79
4,3,8,13,12,25
2,3,8,8,6,14
11,3,8,53,33,86
6,8,22,83,48,131
1,8,22,9,8,17
26,8,22,358,208,566
1,9,24,15,9,24
8,9,24,95,72,167
27,9,24,399,243,642
10,13,35,206,130,336
30,13,35,492,390,882
9,13,35,157,117,274
13,13,35,204,169,373
16,13,35,279,208,487
13,13,35,277,169,446
6,13,35,124,78,202
16,13,35,262,208,470
12,13,35,247,156,403
21,13,35,366,273,639
2,13,35,43,26,69
1,13,35,18,13,31
8,13,35,170,104,274
19,13,35,391,247,638
27,21,55,725,567,1292
5,21,55,110,105,215
14,21,55,307,294,601
2,38,50,23,76,99
13,38,50,13,494,507
26,42,54,17,1092,1109
1,1252,2295,630,1252,1882
1,1252,2295,630,1252,1882
1,1266,2320,752,1266,2018
1,1266,2320,729,1266,1995
1,1266,2320,1031,1266,2297
1,1252,2295,745,1252,1997
1,420,769,180,420,600
1,420,769,341,420,761
1,308,565,189,308,497
1,2171,3578,942,2171,3113
1,2171,3578,835,2171,3006
1,2171,3578,656,2171,2827
1,1555,2443,839,1555,2394
1,713,1120,261,713,974
1,344,540,185,344,529
7,26,70,200,182,382
1,26,70,41,26,67
1,26,70,41,26,67
1,3,9,6,3,9
20,1,2,18,20,38
15,1,2,14,15,29
17,1,2,16,17,33
23,1,2,21,23,44
10,13,35,157,130,287
26,13,35,408,338,746
16,13,35,251,208,459
22,1,2,14,22,36
12,13,35,256,156,412
17,13,35,362,221,583
2,8,21,24,16,40
4,8,21,49,32,81
10,2,5,29,20,49
23,2,5,45,46,91
26,2,5,51,52,103
2,1,2,2,2,4
4,1,2,4,4,8
29,1,2,16,29,45
12,1,2,7,12,19
6,1,2,6,6,12
26,1,2,25,26,51
4,1,2,4,4,8
10,12,33,207,120,327
12,2,5,23,24,47
19,1,2,17,19,36
13,1,2,9,13,22
21,1,2,14,21,35
6,2,5,13,12,25
16,2,5,35,32,67
5,2,5,11,10,21
30,2,5,66,60,126
8,1,2,7,8,15
3,1,4,9,3,12
23,1,4,65,23,88
13,1,2,13,13,26
29,2,5,86,58,144
2,8,21,18,16,34
30,1,2,29,30,59
1,2,5,3,2,5
18,1,2,17,18,35
15,1,2,14,15,29
10,2,5,22,20,42
12,9,25,126,108,234
4,9,25,42,36,78
18,1,2,18,18,36
5,1,2,5,5,10
17,1,2,17,17,34
23,11,29,267,253,520
2,11,29,23,22,45
2,11,29,23,22,45
18,1,2,18,18,36
10,1,2,10,10,20
20,2,5,38,40,78
24,2,5,46,48,94
23,2,5,61,46,107
11,2,5,29,22,51
14,2,5,29,28,57
25,2,5,53,50,103
1,755,1215,411,755,1166
1,461,742,162,461,623
1,1482,2384,878,1482,2360
1,1482,2384,378,1482,1860
1,755,1215,241,755,996
30,24,64,1181,720,1901
5,2,5,12,10,22
12,2,5,28,24,52
14,4,10,78,56,134
8,2,5,18,16,34
4,2,5,9,8,17
26,2,5,75,52,127
10,2,5,29,20,49
2,2,5,6,4,10
16,2,5,45,32,77
9,2,5,21,18,39
18,2,5,42,36,78
22,4,10,84,88,172
30,4,10,114,120,234
11,2,5,21,22,43
20,2,5,38,40,78
18,2,5,35,36,71
21,2,5,41,42,83
20,2,5,56,40,96
23,2,5,64,46,110
3,7,9,6,21,27
21,7,9,34,147,181
28,7,9,16,196,212
30,7,9,49,210,259
6,7,9,5,42,47
20,7,9,8,140,148
8,7,9,7,56,63
19,7,9,31,133,164
30,3,8,148,90,238
29,3,8,113,87,200
19,3,8,62,57,119
10,8,22,131,80,211
29,8,22,380,232,612
2,8,22,22,16,38
21,8,22,192,168,360
28,8,22,306,224,530
22,8,22,303,176,479
12,8,22,157,96,253
28,8,22,263,224,487
22,9,24,309,198,507
18,9,24,192,162,354
19,9,24,267,171,438
8,9,24,118,72,190
29,9,24,282,261,543
2,9,24,23,18,41
16,9,24,232,144,376
29,13,35,597,377,974
4,13,35,63,52,115
1,13,35,21,13,34
26,13,35,454,338,792
13,13,35,268,169,437
27,13,35,471,351,822
6,13,35,124,78,202
19,13,35,391,247,638
13,13,35,277,169,446
16,13,35,330,208,538
6,13,35,130,78,208
1,13,35,17,13,30
22,13,35,322,286,608
17,13,35,362,221,583
17,13,35,267,221,488
13,13,35,186,169,355
27,13,35,471,351,822
9,21,55,217,189,406
27,38,50,176,1026,1202
20,38,50,100,760,860
22,38,50,253,836,1089
2,42,54,20,84,104
7,42,54,84,294,378
11,38,50,110,418,528
12,42,54,60,504,564
14,38,50,140,532,672
21,42,54,48,882,930
3,42,54,2,126,128
16,42,54,80,672,752
23,38,50,115,874,989
2,38,50,6,76,82
1,1898,3375,1038,1898,2936
1,1898,3375,1038,1898,2936
1,1252,2295,722,1252,1974
1,420,769,318,420,738
1,308,565,234,308,542
1,1252,2295,951,1252,2203
1,1252,2295,722,1252,1974
1,2171,3578,763,2171,2934
1,2171,3578,942,2171,3113
1,1083,1701,618,1083,1701
1,1083,1701,244,1083,1327
1,713,1120,205,713,918
1,2171,3578,942,2171,3113
1,344,540,77,344,421
1,1555,2443,570,1555,2125
1,344,540,185,344,529
1,1083,1701,550,1083,1633
1,713,1120,205,713,918
1,713,1120,362,713,1075
1,713,1120,228,713,941
1,344,540,174,344,518
1,344,540,99,344,443
1,2171,3578,1335,2171,3506
1,26,70,36,26,62
8,26,70,346,208,554
22,26,70,629,572,1201
23,3,9,92,69,161
19,3,9,83,57,140
30,3,9,175,90,265
6,3,9,34,18,52
22,1,2,22,22,44
21,1,2,21,21,42
1,1,2,1,1,2
10,1,2,7,10,17
18,1,2,18,18,36
29,1,2,28,29,57
9,1,2,9,9,18
23,9,25,288,207,495
24,9,25,300,216,516
26,9,25,325,234,559
4,2,5,11,8,19
12,11,30,163,132,295
19,11,30,258,209,467
25,2,5,74,50,124
26,2,5,77,52,129
14,1,2,8,14,22
24,2,5,56,48,104
2,9,25,32,18,50
15,1,4,35,15,50
6,1,4,14,6,20
9,1,4,26,9,35
26,2,5,75,52,127
11,9,25,165,99,264
8,2,5,24,16,40
2,2,5,5,4,9
26,11,29,310,286,596
15,11,29,179,165,344
3,12,33,61,36,97
25,12,33,509,300,809
14,2,5,27,28,55
5,2,5,14,10,24
21,2,5,40,42,82
10,2,5,19,20,39
7,2,5,16,14,30
7,2,5,16,14,30
9,1,4,21,9,30
6,1,4,14,6,20
19,8,21,175,152,327
8,2,5,22,16,38
1,1482,2384,592,1482,2074
1,1482,2384,807,1482,2289
1,1482,2384,854,1482,2336
1,755,1215,302,755,1057
1,1482,2384,592,1482,2074
20,24,64,634,480,1114
8,24,64,315,192,507
5,45,120,363,225,588
8,59,159,775,472,1247
9,59,159,714,531,1245
4,2,5,8,8,16
19,2,5,36,38,74
20,3,9,107,60,167
24,3,9,129,72,201
19,2,5,55,38,93
5,4,10,29,20,49
14,4,10,81,56,137
2,2,5,4,4,8
25,2,5,48,50,98
22,2,5,46,44,90
10,2,5,21,20,41
9,7,9,15,63,78
16,7,9,31,112,143
13,7,9,5,91,96
25,8,22,229,200,429
20,8,22,271,160,431
7,8,22,76,56,132
20,8,22,271,160,431
3,9,24,42,27,69
15,9,24,146,135,281
8,9,24,118,72,190
8,9,24,118,72,190
26,9,24,365,234,599
3,9,24,32,27,59
16,9,24,232,144,376
30,9,24,299,270,569
14,13,35,200,182,382
10,13,35,206,130,336
4,13,35,85,52,137
12,13,35,256,156,412
14,13,35,205,182,387
12,13,35,256,156,412
9,13,35,195,117,312
19,13,35,391,247,638
14,13,35,200,182,382
6,13,35,98,78,176
3,13,35,47,39,86
22,13,35,476,286,762
10,13,35,157,130,287
16,13,35,229,208,437
6,13,35,128,78,206
9,13,35,192,117,309
8,13,35,170,104,274
16,13,35,274,208,482
26,21,55,684,546,1230
12,21,55,289,252,541
14,21,55,391,294,685
20,42,54,229,840,1069
28,38,50,28,1064,1092
10,42,54,7,420,427
6,38,50,69,228,297
28,42,54,124,1176,1300
1,38,50,10,38,48
26,42,54,256,1092,1348
30,42,54,4,1260,1264
14,38,50,154,532,686
11,38,50,33,418,451
26,42,54,59,1092,1151
1,1252,2295,722,1252,1974
1,1912,3400,774,1912,2686
1,1266,2320,729,1266,1995
1,1266,2320,1031,1266,2297
1,1252,2295,1020,1252,2272
1,420,769,241,420,661
1,1266,2320,1008,1266,2274
1,420,769,318,420,738
1,1083,1701,244,1083,1327
1,1083,1701,499,1083,1582
1,713,1120,362,713,1075
1,2171,3578,835,2171,3006
1,2171,3578,656,2171,2827
1,344,540,185,344,529
1,2171,3578,620,2171,2791
1,487,783,171,487,658
28,26,70,958,728,1686
25,26,70,1083,650,1733
27,26,70,791,702,1493
13,26,70,563,338,901
21,26,70,909,546,1455
8,3,9,47,24,71
12,3,9,49,36,85
14,2,5,27,28,55
10,2,5,19,20,39
19,2,5,36,38,74
28,1,2,16,28,44
25,1,2,25,25,50
10,13,35,213,130,343
19,2,5,55,38,93
10,2,5,29,20,49
1,1,2,1,1,2
25,1,2,25,25,50
11,1,2,7,11,18
19,2,5,50,38,88
16,13,35,341,208,549
7,13,35,149,91,240
12,13,35,256,156,412
6,1,2,6,6,12
28,1,2,27,28,55
13,9,25,205,117,322
20,9,25,315,180,495
3,9,25,47,27,74
7,2,5,14,14,28
12,2,5,23,24,47
2,2,5,6,4,10
22,2,5,65,44,109
16,2,5,34,32,66
11,2,5,23,22,45
30,1,4,85,30,115
9,1,4,26,9,35
7,2,5,16,14,30
18,2,5,42,36,78
7,2,5,16,14,30
26,1,2,15,26,41
8,1,2,5,8,13
10,12,33,157,120,277
30,12,33,472,360,832
7,2,5,15,14,29
17,2,5,36,34,70
11,2,5,31,22,53
14,9,25,217,126,343
20,9,25,310,180,490
3,9,25,47,27,74
29,1,2,28,29,57
1,1,2,1,1,2
21,1,4,61,21,82
29,1,4,85,29,114
29,11,30,542,319,861
16,11,30,299,176,475
30,2,5,74,60,134
28,1,2,27,28,55
15,1,2,14,15,29
16,1,2,15,16,31
5,2,5,15,10,25
30,2,5,89,60,149
15,2,5,44,30,74
29,2,5,86,58,144
2,8,21,25,16,41
2,1,2,1,2,3
5,2,5,11,10,21
11,1,4,32,11,43
1,1482,2384,592,1482,2074
1,1482,2384,735,1482,2217
1,461,742,251,461,712
1,755,1215,436,755,1191
1,755,1215,436,755,1191
1,461,742,147,461,608
1,1482,2384,854,1482,2336
1,1482,2384,378,1482,1860
1,461,742,147,461,608
21,2,5,44,42,86
29,2,5,61,58,119
20,2,5,42,40,82
16,2,5,34,32,66
2,4,10,12,8,20
27,4,10,157,108,265
23,2,5,44,46,90
10,2,5,19,20,39
11,3,9,53,33,86
13,3,9,63,39,102
4,3,9,18,12,30
2,3,9,9,6,15
1,2,5,3,2,5
8,2,5,22,16,38
12,7,9,10,84,94
25,7,9,46,175,221
18,7,9,0,126,126
19,3,8,89,57,146
3,8,22,37,24,61
7,8,22,70,56,126
7,8,22,95,56,151
18,8,22,201,144,345
25,8,22,279,200,479
10,9,24,145,90,235
2,9,24,22,18,40
6,9,24,64,54,118
4,9,24,58,36,94
12,13,35,176,156,332
8,13,35,140,104,244
28,13,35,596,364,960
16,13,35,346,208,554
8,13,35,140,104,244
22,13,35,384,286,670
11,13,35,192,143,335
22,13,35,469,286,755
3,13,35,43,39,82
20,13,35,412,260,672
7,13,35,110,91,201
18,13,35,390,234,624
11,13,35,234,143,377
6,13,35,86,78,164
27,13,35,556,351,907
2,13,35,35,26,61
15,13,35,262,195,457
28,21,55,752,588,1340
30,38,50,165,1140,1305
29,42,54,144,1218,1362
19,38,50,209,722,931
8,42,54,40,336,376
13,42,54,44,546,590
12,38,50,12,456,468
18,42,54,197,756,953
27,38,50,108,1026,1134
1,1898,3375,1038,1898,2936
1,1266,2320,544,1266,1810
1,1252,2295,882,1252,2134
1,1266,2320,752,1266,2018
1,1252,2295,630,1252,1882
1,420,769,249,420,669
1,1266,2320,636,1266,1902
1,1252,2295,1020,1252,2272
1,2171,3578,1335,2171,3506
1,2171,3578,1264,2171,3435
1,1555,2443,839,1555,2394
1,2171,3578,942,2171,3113
1,1555,2443,351,1555,1906
1,344,540,185,344,529
1,344,540,83,344,427
1,344,540,99,344,443
1,2171,3578,1335,2171,3506
10,26,70,328,260,588
18,26,70,779,468,1247
11,1,2,8,11,19
26,1,2,19,26,45
29,1,2,21,29,50
12,13,35,256,156,412
20,13,35,426,260,686
2,13,35,43,26,69
16,2,5,46,32,78
6,2,5,16,12,28
9,13,35,195,117,312
8,13,35,173,104,277
3,13,35,65,39,104
7,2,5,16,14,30
12,2,5,28,24,52
13,1,2,13,13,26
17,1,4,36,17,53
22,1,4,47,22,69
9,1,4,19,9,28
7,13,35,149,91,240
23,13,35,490,299,789
11,1,4,24,11,35
29,1,4,63,29,92
25,2,5,48,50,98
13,2,5,36,26,62
13,2,5,31,26,57
17,2,5,40,34,74
20,2,5,53,40,93
20,2,5,53,40,93
26,2,5,69,52,121
23,2,5,68,46,114
5,2,5,15,10,25
18,1,4,45,18,63
26,1,4,64,26,90
26,2,5,61,52,113
12,2,5,28,24,52
20,1,2,20,20,40
29,1,2,28,29,57
30,1,2,29,30,59
7,2,5,20,14,34
13,2,5,38,26,64
1,2,5,3,2,5
21,8,21,216,168,384
29,8,21,298,232,530
1,1482,2384,473,1482,1955
1,755,1215,193,755,948
1,755,1215,436,755,1191
5,24,64,194,120,314
12,45,120,886,540,1426
2,59,159,130,118,248
10,2,5,30,20,50
28,2,5,83,56,139
2,2,5,6,4,10
10,2,5,29,20,49
14,3,9,64,42,106
15,3,9,68,45,113
19,2,5,44,38,82
10,2,5,23,20,43
28,2,5,59,56,115
1,2,5,2,2,4
12,2,5,28,24,52
3,3,9,16,9,25
19,3,9,102,57,159
20,3,9,116,60,176
14,3,9,81,42,123
19,2,5,55,38,93
4,3,9,23,12,35
7,4,10,32,28,60
20,4,10,92,80,172
29,2,5,68,58,126
8,2,5,19,16,35
22,2,5,65,44,109
11,2,5,32,22,54
17,7,9,31,119,150
14,7,9,19,98,117
7,7,9,13,49,62
15,7,9,27,105,132
2,3,8,6,6,12
23,3,8,108,69,177
17,3,8,66,51,117
13,8,22,142,104,246
14,8,22,190,112,302
3,8,22,39,24,63
7,8,22,92,56,148
3,8,22,41,24,65
29,8,22,400,232,632
11,9,24,160,99,259
11,9,24,131,99,230
3,13,35,64,39,103
30,13,35,492,390,882
30,13,35,639,390,1029
17,13,35,368,221,589
1,13,35,14,13,27
5,13,35,98,65,163
14,13,35,274,182,456
22,13,35,469,286,755
13,13,35,222,169,391
6,13,35,105,78,183
1,13,35,21,13,34
18,13,35,283,234,517
28,13,35,596,364,960
11,13,35,188,143,331
17,13,35,350,221,571
4,13,35,82,52,134
12,13,35,247,156,403
14,13,35,298,182,480
29,13,35,628,377,1005
20,13,35,314,260,574
9,21,55,217,189,406
15,21,55,452,315,767
5,21,55,167,105,272
13,21,55,413,273,686
21,21,55,529,441,970
10,42,54,115,420,535
26,38,50,221,988,1209
14,38,50,161,532,693
2,38,50,17,76,93
18,38,50,198,684,882
1,1252,2295,676,1252,1928
1,1252,2295,630,1252,1882
1,1252,2295,997,1252,2249
1,1252,2295,951,1252,2203
1,1252,2295,722,1252,1974
1,308,565,234,308,542
1,308,565,251,308,559
1,713,1120,385,713,1098
1,344,540,185,344,529
1,487,783,155,487,642
1,2171,3578,942,2171,3113
1,344,540,120,344,464
1,1083,1701,312,1083,1395
1,1083,1701,499,1083,1582
1,2171,3578,1371,2171,3542
1,713,1120,362,713,1075
1,1555,2443,864,1555,2419
1,713,1120,329,713,1042
1,344,540,83,344,427
1,2171,3578,906,2171,3077
1,2171,3578,1335,2171,3506
5,26,70,217,130,347
27,3,9,160,81,241
3,3,9,18,9,27
26,3,9,154,78,232
11,3,9,62,33,95
14,3,9,81,42,123
3,1,2,3,3,6
11,2,5,32,22,54
5,2,5,15,10,25
6,2,5,18,12,30
29,2,5,86,58,144
7,2,5,21,14,35
3,2,5,9,6,15
22,13,35,469,286,755
4,1,2,2,4,6
13,2,5,38,26,64
10,2,5,30,20,50
20,1,2,19,20,39
10,2,5,27,20,47
12,2,5,32,24,56
5,2,5,13,10,23
26,2,5,61,52,113
29,11,30,516,319,835
17,11,30,303,187,490
23,2,5,53,46,99
5,2,5,12,10,22
21,12,33,392,252,644
13,12,33,243,156,399
30,1,2,20,30,50
6,11,30,74,66,140
27,9,25,405,243,648
29,9,25,435,261,696
23,11,29,294,253,547
19,9,25,285,171,456
27,9,25,405,243,648
28,2,5,81,56,137
21,2,5,61,42,103
24,2,5,70,48,118
15,1,2,9,15,24
13,1,2,8,13,21
18,1,2,17,18,35
15,1,2,14,15,29
13,9,25,202,117,319
21,1,4,51,21,72
1,1482,2384,401,1482,1883
1,755,1215,375,755,1130
1,1482,2384,878,1482,2360
1,1482,2384,854,1482,2336
1,1482,2384,592,1482,2074
1,755,1215,436,755,1191
19,24,64,748,456,1204
22,24,64,866,528,1394
8,59,159,596,472,1068
2,59,159,143,118,261
1,2,5,3,2,5
17,4,10,99,68,167
11,4,10,64,44,108
20,2,5,59,40,99
19,2,5,55,38,93
28,2,5,81,56,137
16,2,5,30,32,62
5,2,5,12,10,22
25,2,5,58,50,108
11,2,5,32,22,54
5,2,5,15,10,25
26,2,5,77,52,129
25,2,5,74,50,124
4,2,5,12,8,20
2,2,5,6,4,10
10,3,9,59,30,89
25,3,9,148,75,223
12,3,9,71,36,107
29,3,9,171,87,258
21,7,9,40,147,187
21,7,9,-3,147,144
18,7,9,34,126,160
9,7,9,3,63,66
29,7,9,53,203,256
26,7,9,50,182,232
17,7,9,31,119,150
18,7,9,33,126,159
19,7,9,31,133,164
7,7,9,11,49,60
28,3,8,136,84,220
15,3,8,74,45,119
25,8,22,339,200,539
1,8,22,14,8,22
7,8,22,96,56,152
7,8,22,96,56,152
10,8,22,138,80,218
4,8,22,45,32,77
27,9,24,262,243,505
26,9,24,259,234,493
5,9,24,74,45,119
13,13,35,277,169,446
15,13,35,262,195,457
30,13,35,440,390,830
17,13,35,368,221,589
17,13,35,368,221,589
12,13,35,218,156,374
18,13,35,308,234,542
23,13,35,393,299,692
5,13,35,108,65,173
19,13,35,391,247,638
16,13,35,341,208,549
18,13,35,390,234,624
4,13,35,85,52,137
12,13,35,256,156,412
5,13,35,79,65,144
10,13,35,178,130,308
11,13,35,161,143,304
23,13,35,329,299,628
18,13,35,390,234,624
1,13,35,15,13,28
1,21,55,32,21,53
28,38,50,0,1064,1064
24,38,50,276,912,1188
29,38,50,29,1102,1131
13,38,50,85,494,579
9,42,54,89,378,467
11,38,50,121,418,539
25,38,50,275,950,1225
2,42,54,1,84,85
4,42,54,44,168,212
24,38,50,264,912,1176
1,1266,2320,961,1266,2227
1,1252,2295,745,1252,1997
1,420,769,334,420,754
1,1252,2295,791,1252,2043
1,1266,2320,1008,1266,2274
1,308,565,251,308,559
1,420,769,249,420,669
1,295,540,234,295,529
1,1252,2295,1020,1252,2272
1,308,565,251,308,559
1,1266,2320,1008,1266,2274
1,2171,3578,978,2171,3149
1,2171,3578,1264,2171,3435
1,2171,3578,1264,2171,3435
1,344,540,120,344,464
1,1083,1701,550,1083,1633
1,2171,3578,1335,2171,3506
12,26,70,511,312,823
20,1,2,11,20,31
9,2,5,22,18,40
1,2,5,2,2,4
14,2,5,39,28,67
26,2,5,61,52,113
28,2,5,66,56,122
20,2,5,47,40,87
30,2,5,71,60,131
9,1,2,9,9,18
15,1,4,44,15,59
8,1,4,24,8,32
27,11,29,455,297,752
22,11,29,370,242,612
26,11,30,486,286,772
5,9,25,54,45,99
4,9,25,43,36,79
27,1,2,26,27,53
22,1,2,22,22,44
2,1,2,2,2,4
14,9,25,200,126,326
9,9,25,128,81,209
2,2,5,6,4,10
25,2,5,74,50,124
27,2,5,80,54,134
25,2,5,74,50,124
20,2,5,59,40,99
14,2,5,33,28,61
16,2,5,42,32,74
29,2,5,86,58,144
25,2,5,74,50,124
21,1,4,62,21,83
14,2,5,41,28,69
20,2,5,58,40,98
18,2,5,53,36,89
17,8,21,214,136,350
10,8,21,126,80,206
12,9,25,153,108,261
11,9,25,140,99,239
24,1,4,70,24,94
13,1,4,38,13,51
23,1,2,23,23,46
4,1,2,4,4,8
11,1,2,11,11,22
1,2,5,2,2,4
28,2,5,64,56,120
24,1,4,55,24,79
4,1,4,9,4,13
13,1,4,31,13,44
7,1,4,17,7,24
22,2,5,62,44,106
3,2,5,8,6,14
17,1,2,13,17,30
24,1,4,52,24,76
22,1,4,48,22,70
19,1,2,11,19,30
11,1,2,6,11,17
24,1,4,68,24,92
10,1,4,28,10,38
26,1,4,74,26,100
8,2,5,22,16,38
11,1,2,6,11,17
27,1,2,15,27,42
14,1,4,32,14,46
25,11,29,320,275,595
28,11,29,358,308,666
1,1482,2384,401,1482,1883
1,1482,2384,473,1482,1955
1,461,742,229,461,690
1,461,742,274,461,735
1,1482,2384,854,1482,2336
1,461,742,251,461,712
19,24,64,602,456,1058
12,24,64,380,288,668
10,45,120,594,450,1044
2,45,120,145,90,235
7,59,159,678,413,1091
20,2,5,59,40,99
26,2,5,77,52,129
1,2,5,3,2,5
27,2,5,76,54,130
12,2,5,35,24,59
8,3,9,33,24,57
9,2,5,26,18,44
3,2,5,6,6,12
2,2,5,6,4,10
8,4,10,46,32,78
2,3,9,8,6,14
20,3,9,82,60,142
26,4,10,109,104,213
11,4,10,46,44,90
3,4,10,11,12,23
11,4,10,42,44,86
6,2,5,17,12,29
15,2,5,42,30,72
7,4,10,32,28,60
4,4,10,16,16,32
15,4,10,59,60,119
4,7,9,8,28,36
7,7,9,3,49,52
12,7,9,9,84,93
26,7,9,1,182,183
6,7,9,-1,42,41
30,7,9,3,210,213
26,3,8,122,78,200
13,3,8,42,39,81
18,8,22,197,144,341
13,8,22,176,104,280
16,8,22,161,128,289
18,8,22,189,144,333
8,8,22,80,64,144
9,8,22,84,72,156
3,9,24,44,27,71
15,9,24,178,135,313
3,9,24,42,27,69
3,9,24,44,27,71
10,9,24,145,90,235
7,9,24,68,63,131
10,13,35,213,130,343
24,13,35,419,312,731
12,13,35,247,156,403
8,13,35,126,104,230
13,13,35,213,169,382
3,13,35,43,39,82
27,13,35,386,351,737
3,13,35,52,39,91
14,13,35,303,182,485
20,13,35,314,260,574
29,13,35,628,377,1005
17,13,35,368,221,589
9,13,35,192,117,309
17,13,35,279,221,500
21,13,35,344,273,617
21,13,35,359,273,632
2,13,35,41,26,67
14,13,35,288,182,470
4,13,35,54,52,106
24,13,35,377,312,689
7,13,35,149,91,240
19,21,55,510,399,909
7,21,55,157,147,304
28,21,55,752,588,1340
21,38,50,84,798,882
9,42,54,89,378,467
17,42,54,186,714,900
23,38,50,265,874,1139
1,1912,3400,1352,1912,3264
1,1912,3400,774,1912,2686
1,1912,3400,1046,1912,2958
1,1266,2320,961,1266,2227
1,1252,2295,745,1252,1997
1,1266,2320,1008,1266,2274
1,1252,2295,951,1252,2203
1,420,769,249,420,669
1,420,769,188,420,608
1,1252,2295,630,1252,1882
1,2171,3578,620,2171,2791
1,713,1120,385,713,1098
1,2171,3578,656,2171,2827
1,2171,3578,942,2171,3113
1,1555,2443,497,1555,2052
1,1083,1701,312,1083,1395
1,2171,3578,1371,2171,3542
1,487,783,132,487,619
14,26,70,596,364,960
26,26,70,816,676,1492
18,26,70,779,468,1247
1,3,9,5,3,8
1,3,9,5,3,8
3,3,9,13,9,22
23,3,9,136,69,205
30,13,35,429,390,819
16,13,35,341,208,549
14,13,35,298,182,480
12,13,35,256,156,412
3,9,25,36,27,63
15,9,25,180,135,315
1,2,5,3,2,5
5,2,5,14,10,24
10,1,2,7,10,17
15,1,2,11,15,26
11,1,2,8,11,19
15,1,4,44,15,59
20,1,4,59,20,79
22,1,2,16,22,38
19,1,2,14,19,33
15,2,5,35,30,65
6,2,5,14,12,26
6,1,2,4,6,10
15,1,2,11,15,26
8,11,29,135,88,223
15,11,29,253,165,418
25,13,35,358,325,683
26,13,35,372,338,710
22,13,35,315,286,601
19,1,2,11,19,30
1,1,2,1,1,2
18,1,2,10,18,28
4,9,25,60,36,96
17,9,25,255,153,408
7,2,5,20,14,34
9,2,5,26,18,44
16,2,5,46,32,78
19,1,2,11,19,30
17,1,2,16,17,33
17,1,2,16,17,33
27,1,2,26,27,53
19,1,2,18,19,37
20,2,5,59,40,99
28,2,5,83,56,139
29,2,5,86,58,144
2,2,5,6,4,10
27,1,4,66,27,93
4,1,4,10,4,14
11,1,4,25,11,36
17,1,4,39,17,56
26,2,5,61,52,113
12,9,25,126,108,234
21,2,5,62,42,104
18,2,5,53,36,89
20,1,2,20,20,40
30,1,2,29,30,59
30,1,4,73,30,103
10,1,4,24,10,34
16,1,4,39,16,55
26,1,2,14,26,40
25,1,2,13,25,38
14,8,21,144,112,256
27,1,2,20,27,47
17,1,2,13,17,30
1,1482,2384,878,1482,2360
1,461,742,147,461,608
5,4,10,30,20,50
6,4,10,35,24,59
21,4,10,124,84,208
8,4,10,47,32,79
30,2,5,89,60,149
21,2,5,62,42,104
26,2,5,77,52,129
4,2,5,12,8,20
6,2,5,18,12,30
21,2,5,49,42,91
20,2,5,47,40,87
9,2,5,21,18,39
16,2,5,30,32,62
14,2,5,27,28,55
14,2,5,27,28,55
5,2,5,10,10,20
13,2,5,38,26,64
16,2,5,46,32,78
26,7,9,47,182,229
24,7,9,39,168,207
19,7,9,35,133,168
27,3,8,90,81,171
22,9,24,325,198,523
12,9,24,168,108,276
3,9,24,36,27,63
1,13,35,22,13,35
19,13,35,405,247,652
29,13,35,628,377,1005
25,13,35,436,325,761
7,13,35,100,91,191
19,21,55,458,399,857
15,21,55,337,315,652
1,21,55,22,21,43
5,38,50,55,190,245
13,42,54,149,546,695
13,38,50,20,494,514
2,42,54,16,84,100
8,38,50,92,304,396
10,38,50,110,380,490
10,38,50,100,380,480
16,42,54,36,672,708
1,1252,2295,905,1252,2157
1,1252,2295,630,1252,1882
1,420,769,188,420,608
1,1252,2295,768,1252,2020
1,1266,2320,544,1266,1810
1,1083,1701,601,1083,1684
1,1519,2443,753,1519,2272
1,713,1120,396,713,1109
1,344,540,185,344,529
1,713,1120,396,713,1109
1,344,540,77,344,421
1,344,540,185,344,529
1,344,540,174,344,518
1,487,783,194,487,681
1,344,540,174,344,518
1,2171,3578,1335,2171,3506
23,26,70,948,598,1546
4,26,70,170,104,274
11,26,70,469,286,755
14,3,9,81,42,123
4,3,9,16,12,28
24,1,2,23,24,47
15,1,2,14,15,29
15,2,5,29,30,59
16,1,2,15,16,31
17,2,5,32,34,66
13,1,4,32,13,45
15,13,35,309,195,504
28,13,35,577,364,941
29,8,21,243,232,475
4,2,5,12,8,20
11,2,5,32,22,54
6,1,2,6,6,12
25,1,2,25,25,50
1,1,2,1,1,2
11,1,2,11,11,22
17,2,5,48,34,82
30,11,30,552,330,882
1,1,4,2,1,3
29,1,4,66,29,95
13,1,2,12,13,25
11,1,2,10,11,21
26,1,2,24,26,50
1,1482,2384,807,1482,2289
1,1482,2384,378,1482,1860
5,24,64,197,120,317
7,24,64,181,168,349
9,24,64,354,216,570
8,45,120,562,360,922
5,59,159,492,295,787
23,2,5,54,46,100
17,4,10,100,68,168
7,4,10,41,28,69
14,4,10,83,56,139
27,2,5,80,54,134
22,2,5,65,44,109
4,2,5,11,8,19
12,3,9,55,36,91
23,3,9,105,69,174
24,2,5,64,48,112
12,2,5,32,24,56
4,2,5,12,8,20
29,2,5,84,58,142
23,3,9,124,69,193
4,3,9,21,12,33
10,2,5,24,20,44
8,2,5,19,16,35
14,7,9,8,98,106
26,7,9,15,182,197
10,7,9,18,70,88
7,7,9,4,49,53
6,7,9,5,42,47
5,7,9,0,35,35
11,8,22,152,88,240
11,8,22,149,88,237
14,8,22,193,112,305
17,8,22,231,136,367
9,8,22,98,72,170
4,8,22,54,32,86
14,8,22,193,112,305
1,8,22,10,8,18
11,8,22,152,88,240
30,9,24,436,270,706
17,9,24,202,153,355
28,9,24,272,252,524
3,9,24,44,27,71
12,13,35,260,156,416
9,13,35,129,117,246
28,13,35,400,364,764
26,13,35,554,338,892
7,13,35,144,91,235
28,13,35,489,364,853
11,13,35,238,143,381
8,13,35,131,104,235
9,13,35,195,117,312
29,13,35,618,377,995
24,13,35,419,312,731
22,13,35,315,286,601
5,13,35,82,65,147
8,13,35,114,104,218
29,13,35,476,377,853
3,13,35,65,39,104
6,13,35,124,78,202
15,13,35,293,195,488
24,13,35,520,312,832
6,13,35,130,78,208
10,13,35,206,130,336
3,13,35,46,39,85
4,13,35,85,52,137
7,21,55,230,147,377
24,42,54,120,1008,1128
4,38,50,16,152,168
11,42,54,55,462,517
22,38,50,22,836,858
23,42,54,102,966,1068
1,1252,2295,561,1252,1813
1,1252,2295,997,1252,2249
1,1266,2320,1031,1266,2297
1,1252,2295,745,1252,1997
1,1266,2320,1008,1266,2274
1,1252,2295,538,1252,1790
1,1266,2320,544,1266,1810
1,1266,2320,961,1266,2227
1,420,769,249,420,669
1,1252,2295,1020,1252,2272
1,2171,3578,620,2171,2791
1,2171,3578,835,2171,3006
1,2171,3578,942,2171,3113
1,1083,1701,244,1083,1327
1,487,783,265,487,752
1,344,540,185,344,529
1,1083,1701,346,1083,1429
1,344,540,174,344,518
1,344,540,174,344,518
14,26,70,606,364,970
21,26,70,689,546,1235
4,3,9,18,12,30
6,1,2,3,6,9
8,1,2,4,8,12
22,1,2,12,22,34
3,1,2,2,3,5
3,1,2,2,3,5
14,1,2,10,14,24
30,13,35,639,390,1029
12,13,35,256,156,412
2,2,5,6,4,10
26,2,5,77,52,129
11,2,5,23,22,45
21,2,5,44,42,86
5,2,5,11,10,21
26,1,4,77,26,103
28,1,4,83,28,111
5,1,4,15,5,20
7,1,4,20,7,27
6,1,4,17,6,23
2,1,2,1,2,3
23,1,2,12,23,35
27,1,2,14,27,41
3,2,5,8,6,14
1,2,5,3,2,5
17,13,35,368,221,589
5,2,5,10,10,20
25,2,5,48,50,98
25,2,5,48,50,98
21,2,5,40,42,82
6,2,5,11,12,23
24,2,5,46,48,94
29,2,5,52,58,110
8,2,5,14,16,30
23,2,5,54,46,100
18,2,5,42,36,78
24,1,2,14,24,38
13,1,2,8,13,21
27,8,21,277,216,493
2,8,21,21,16,37
11,8,21,113,88,201
16,1,4,38,16,54
5,1,4,12,5,17
24,1,2,23,24,47
16,2,5,46,32,78
27,2,5,78,54,132
29,1,2,28,29,57
4,1,2,4,4,8
11,2,5,32,22,54
9,8,21,113,72,185
7,8,21,88,56,144
18,8,21,226,144,370
16,2,5,38,32,70
12,2,5,26,24,50
17,2,5,37,34,71
29,2,5,59,58,117
19,2,5,39,38,77
1,1,4,2,1,3
1,755,1215,448,755,1203
1,1482,2384,735,1482,2217
1,1482,2384,854,1482,2336
1,461,742,185,461,646
26,24,64,674,624,1298
3,24,64,118,72,190
9,45,120,632,405,1037
22,2,5,65,44,109
22,2,5,65,44,109
23,2,5,68,46,114
22,2,5,65,44,109
12,3,9,55,36,91
1,3,9,5,3,8
5,2,5,15,10,25
9,2,5,26,18,44
1,2,5,3,2,5
3,4,10,17,12,29
11,3,9,48,33,81
14,3,9,61,42,103
30,4,10,141,120,261
21,4,10,99,84,183
2,3,9,11,6,17
13,3,9,73,39,112
22,3,9,118,66,184
5,3,9,27,15,42
30,2,5,84,60,144
26,4,10,151,104,255
3,4,10,17,12,29
21,2,5,59,42,101
22,2,5,52,44,96
8,2,5,19,16,35
30,2,5,87,60,147
18,2,5,52,36,88
9,7,9,12,63,75
17,7,9,0,119,119
25,7,9,10,175,185
23,7,9,38,161,199
26,3,8,126,78,204
23,3,8,113,69,182
27,3,8,87,81,168
20,3,8,94,60,154
2,3,8,6,6,12
11,8,22,149,88,237
13,8,22,136,104,240
10,8,22,92,80,172
30,8,22,275,240,515
9,8,22,124,72,196
28,8,22,380,224,604
9,8,22,118,72,190
13,8,22,145,104,249
3,9,24,44,27,71
26,9,24,384,234,618
3,9,24,44,27,71
5,9,24,70,45,115
22,13,35,322,286,608
1,13,35,21,13,34
2,13,35,43,26,69
29,13,35,628,377,1005
2,13,35,39,26,65
5,13,35,108,65,173
8,13,35,170,104,274
30,13,35,639,390,1029
26,13,35,508,338,846
15,13,35,309,195,504
2,13,35,35,26,61
12,13,35,172,156,328
5,13,35,103,65,168
17,13,35,350,221,571
11,13,35,238,143,381
12,13,35,235,156,391
30,13,35,618,390,1008
27,13,35,575,351,926
8,13,35,173,104,277
19,13,35,298,247,545
9,13,35,157,117,274
19,13,35,391,247,638
2,13,35,35,26,61
7,13,35,144,91,235
1,21,55,27,21,48
11,21,55,362,231,593
22,42,54,216,924,1140
14,42,54,70,588,658
24,42,54,81,1008,1089
10,38,50,0,380,380
5,42,54,1,210,211
29,38,50,247,1102,1349
7,38,50,7,266,273
30,38,50,300,1140,1440
1,42,54,2,42,44
1,1266,2320,497,1266,1763
1,1252,2295,538,1252,1790
1,1252,2295,997,1252,2249
1,1252,2295,882,1252,2134
1,1266,2320,683,1266,1949
1,1252,2295,676,1252,1928
1,1266,2320,1008,1266,2274
1,1252,2295,951,1252,2203
1,1266,2320,752,1266,2018
1,1252,2295,745,1252,1997
1,308,565,234,308,542
1,295,540,234,295,529
1,1266,2320,544,1266,1810
1,713,1120,385,713,1098
1,487,783,280,487,767
1,1083,1701,601,1083,1684
1,1519,2443,826,1519,2345
1,1083,1701,499,1083,1582
1,1083,1701,499,1083,1582
1,2171,3578,942,2171,3113
1,713,1120,362,713,1075
1,713,1120,161,713,874
1,1519,2443,606,1519,2125
1,1519,2443,411,1519,1930
1,344,540,158,344,502
1,1083,1701,312,1083,1395
1,344,540,174,344,518
1,487,783,194,487,681
1,344,540,83,344,427
1,344,540,174,344,518
16,26,70,458,416,874
12,26,70,511,312,823
12,26,70,352,312,664
4,3,9,19,12,31
4,3,9,16,12,28
17,3,9,91,51,142
22,3,9,106,66,172
29,3,9,171,87,258
6,1,2,6,6,12
28,1,2,27,28,55
20,13,35,286,260,546
20,1,2,20,20,40
24,2,5,46,48,94
14,2,5,27,28,55
12,2,5,23,24,47
21,1,2,21,21,42
10,1,2,10,10,20
26,1,2,25,26,51
5,1,2,5,5,10
18,12,33,354,216,570
7,13,35,152,91,243
29,13,35,628,377,1005
14,13,35,303,182,485
25,13,35,541,325,866
30,13,35,650,390,1040
26,13,35,445,338,783
5,13,35,86,65,151
21,1,2,21,21,42
14,1,2,13,14,27
19,1,2,18,19,37
22,2,5,62,44,106
14,2,5,39,28,67
18,2,5,50,36,86
18,2,5,50,36,86
10,1,2,10,10,20
21,1,2,20,21,41
12,9,25,153,108,261
11,9,25,140,99,239
9,9,25,128,81,209
11,2,5,32,22,54
4,2,5,12,8,20
4,2,5,9,8,17
22,2,5,51,44,95
17,1,2,10,17,27
13,1,2,7,13,20
24,1,2,13,24,37
14,2,5,27,28,55
2,2,5,4,4,8
14,1,2,10,14,24
16,1,2,15,16,31
6,1,2,6,6,12
23,1,2,22,23,45
10,2,5,19,20,39
1,9,25,16,9,25
1,755,1215,302,755,1057
1,461,742,125,461,586
1,1482,2384,378,1482,1860
1,1482,2384,473,1482,1955
29,24,64,1030,696,1726
16,24,64,415,384,799
15,2,5,42,30,72
13,2,5,36,26,62
11,2,5,31,22,53
9,2,5,18,18,36
4,2,5,8,8,16
29,2,5,84,58,142
20,2,5,58,40,98
24,4,10,110,96,206
17,4,10,78,68,146
1,2,5,3,2,5
25,4,10,95,100,195
2,4,10,8,8,16
16,4,10,61,64,125
27,3,9,111,81,192
26,3,9,107,78,185
29,4,10,110,116,226
14,4,10,53,56,109
7,3,9,41,21,62
26,3,9,151,78,229
3,3,9,13,9,22
20,3,9,88,60,148
10,2,5,19,20,39
24,2,5,46,48,94
28,7,9,1,196,197
19,7,9,7,133,140
11,3,8,43,33,76
11,3,8,54,33,87
10,3,8,49,30,79
8,8,22,84,64,148
7,8,22,78,56,134
8,8,22,110,64,174
28,8,22,281,224,505
15,9,24,221,135,356
26,9,24,259,234,493
24,13,35,511,312,823
18,13,35,383,234,617
5,13,35,87,65,152
4,13,35,82,52,134
22,13,35,345,286,631
4,13,35,70,52,122
26,13,35,381,338,719
24,13,35,494,312,806
30,13,35,650,390,1040
11,13,35,234,143,377
24,21,55,763,504,1267
18,21,55,434,378,812
4,21,55,96,84,180
22,21,55,579,462,1041
19,42,54,187,798,985
26,42,54,256,1092,1348
29,42,54,129,1218,1347
4,38,50,6,152,158
21,42,54,229,882,1111
21,38,50,116,798,914
26,38,50,286,988,1274
1,1266,2320,961,1266,2227
1,1252,2295,951,1252,2203
1,1266,2320,683,1266,1949
1,1266,2320,752,1266,2018
1,1266,2320,683,1266,1949
1,1266,2320,1031,1266,2297
1,1252,2295,997,1252,2249
1,420,769,249,420,669
1,2171,3578,1335,2171,3506
1,713,1120,250,713,963
1,344,540,126,344,470
1,344,540,77,344,421
1,1083,1701,550,1083,1633
1,487,783,132,487,619
26,26,70,1126,676,1802
23,26,70,803,598,1401
7,26,70,298,182,480
7,3,9,39,21,60
20,3,9,116,60,176
5,1,2,3,5,8
21,1,2,21,21,42
8,1,2,8,8,16
8,1,2,8,8,16
28,1,2,27,28,55
27,2,5,78,54,132
24,1,4,71,24,95
5,1,2,3,5,8
13,12,33,196,156,352
26,1,2,19,26,45
7,1,2,5,7,12
7,2,5,16,14,30
26,1,4,59,26,85
14,11,29,236,154,390
25,11,29,421,275,696
9,9,25,104,81,185
9,9,25,104,81,185
29,1,2,17,29,46
15,1,2,9,15,24
27,1,2,25,27,52
5,1,2,5,5,10
27,1,2,16,27,43
30,2,5,89,60,149
27,2,5,80,54,134
1,12,33,14,12,26
17,12,33,234,204,438
17,12,33,234,204,438
2,1,4,6,2,8
26,1,4,76,26,102
7,2,5,16,14,30
15,2,5,35,30,65
14,2,5,33,28,61
29,1,4,85,29,114
22,1,4,64,22,86
27,1,4,79,27,106
17,1,4,50,17,67
14,1,2,13,14,27
22,1,2,21,22,43
1,461,742,251,461,712
1,1482,2384,592,1482,2074
1,1482,2384,473,1482,1955
1,1482,2384,854,1482,2336
1,755,1215,193,755,948
1,755,1215,436,755,1191
1,461,742,147,461,608
9,24,64,256,216,472
6,24,64,156,144,300
6,45,120,443,270,713
10,45,120,594,450,1044
2,45,120,145,90,235
10,59,159,968,590,1558
3,59,159,290,177,467
12,2,5,25,24,49
27,2,5,57,54,111
7,2,5,20,14,34
25,2,5,70,50,120
19,2,5,36,38,74
8,2,5,15,16,31
13,2,5,27,26,53
12,2,5,25,24,49
20,4,10,118,80,198
2,4,10,12,8,20
17,2,5,49,34,83
18,2,5,52,36,88
4,2,5,8,8,16
8,2,5,22,16,38
17,2,5,32,34,66
11,2,5,21,22,43
21,7,9,2,147,149
11,7,9,21,77,98
23,7,9,13,161,174
6,7,9,10,42,52
3,7,9,2,21,23
7,7,9,0,49,49
19,7,9,7,133,140
8,7,9,3,56,59
30,7,9,57,210,267
21,3,8,102,63,165
5,3,8,25,15,40
29,3,8,108,87,195
12,8,22,105,96,201
25,8,22,339,200,539
14,8,22,193,112,305
20,8,22,249,160,409
20,8,22,271,160,431
12,8,22,157,96,253
27,8,22,247,216,463
15,8,22,151,120,271
12,8,22,163,96,259
24,8,22,331,192,523
16,9,24,156,144,300
20,9,24,281,180,461
19,9,24,185,171,356
16,9,24,186,144,330
7,9,24,68,63,131
20,13,35,293,260,553
15,13,35,309,195,504
2,13,35,31,26,57
4,13,35,78,52,130
2,13,35,31,26,57
26,13,35,372,338,710
25,13,35,358,325,683
4,13,35,85,52,137
3,13,35,44,39,83
3,13,35,64,39,103
26,13,35,554,338,892
30,13,35,429,390,819
23,13,35,498,299,797
8,13,35,170,104,274
17,13,35,291,221,512
9,13,35,129,117,246
25,13,35,358,325,683
15,13,35,309,195,504
17,13,35,249,221,470
4,21,55,90,84,174
25,42,54,17,1050,1067
17,42,54,195,714,909
29,42,54,317,1218,1535
5,38,50,50,190,240
19,38,50,190,722,912
9,42,54,1,378,379
13,38,50,150,494,644
20,38,50,110,760,870
10,38,50,115,380,495
9,42,54,45,378,423
9,42,54,21,378,399
1,1912,3400,774,1912,2686
1,1912,3400,1352,1912,3264
1,1252,2295,997,1252,2249
1,1266,2320,497,1266,1763
1,1266,2320,892,1266,2158
1,1252,2295,951,1252,2203
1,1252,2295,997,1252,2249
1,1266,2320,544,1266,1810
1,420,769,341,420,761
1,420,769,211,420,631
1,1252,2295,722,1252,1974
1,1266,2320,1008,1266,2274
1,1266,2320,1031,1266,2297
1,1252,2295,951,1252,2203
1,1266,2320,544,1266,1810
1,1252,2295,997,1252,2249
1,1266,2320,1008,1266,2274
1,2171,3578,763,2171,2934
1,1555,2443,864,1555,2419
1,2171,3578,620,2171,2791
1,2171,3578,620,2171,2791
1,2171,3578,835,2171,3006
1,1083,1701,550,1083,1633
1,1555,2443,570,1555,2125
1,344,540,158,344,502
1,487,783,132,487,619
1,2171,3578,1335,2171,3506
1,344,540,174,344,518
18,26,70,515,468,983
1,3,9,5,3,8
25,1,2,24,25,49
27,1,2,26,27,53
28,1,2,27,28,55
8,9,25,126,72,198
23,1,2,23,23,46
24,13,35,511,312,823
28,13,35,596,364,960
10,2,5,21,20,41
5,2,5,11,10,21
14,1,2,9,14,23
11,1,2,7,11,18
19,11,29,303,209,512
7,11,29,112,77,189
1,9,25,13,9,22
16,2,5,47,32,79
13,2,5,38,26,64
29,2,5,86,58,144
10,1,2,6,10,16
17,9,25,183,153,336
30,9,25,323,270,593
29,9,25,334,261,595
25,1,2,25,25,50
21,1,2,21,21,42
19,1,2,19,19,38
5,1,2,5,5,10
26,1,2,25,26,51
6,1,2,6,6,12
19,2,5,53,38,91
29,2,5,81,58,139
27,12,33,558,324,882
11,12,33,227,132,359
17,1,2,16,17,33
16,1,2,15,16,31
25,1,2,24,25,49
14,2,5,41,28,69
25,11,30,460,275,735
12,11,30,221,132,353
5,11,30,64,55,119
30,11,30,381,330,711
19,1,2,13,19,32
1,1,2,1,1,2
15,2,5,35,30,65
7,2,5,16,14,30
30,2,5,71,60,131
20,2,5,58,40,98
28,2,5,81,56,137
15,1,2,14,15,29
9,1,2,9,9,18
9,1,2,9,9,18
6,1,2,6,6,12
11,2,5,29,22,51
10,2,5,27,20,47
11,2,5,29,22,51
10,2,5,19,20,39
18,2,5,34,36,70
22,2,5,46,44,90
13,2,5,27,26,53
12,1,2,7,12,19
19,1,2,11,19,30
2,8,21,19,16,35
18,2,5,34,36,70
5,9,25,63,45,108
7,9,25,88,63,151
28,2,5,81,56,137
4,2,5,12,8,20
25,1,4,71,25,96
20,1,4,57,20,77
19,1,4,54,19,73
20,1,4,57,20,77
1,8,21,12,8,20
1,1482,2384,401,1482,1883
1,755,1215,266,755,1021
1,1482,2384,568,1482,2050
1,461,742,229,461,690
22,24,64,570,528,1098
30,24,64,1162,720,1882
5,45,120,297,225,522
5,59,159,492,295,787
3,2,5,7,6,13
27,2,5,66,54,120
25,2,5,53,50,103
26,2,5,55,52,107
17,2,5,39,34,73
18,2,5,41,36,77
19,2,5,56,38,94
17,2,5,40,34,74
22,2,5,52,44,96
24,3,9,109,72,181
12,3,9,55,36,91
24,3,9,135,72,207
1,3,9,6,3,9
13,7,9,11,91,102
19,7,9,16,133,149
8,3,8,39,24,63
23,3,8,86,69,155
5,8,22,68,40,108
30,9,24,443,270,713
21,9,24,255,189,444
27,13,35,585,351,936
22,13,35,476,286,762
27,13,35,424,351,775
28,13,35,400,364,764
23,13,35,393,299,692
4,13,35,78,52,130
12,13,35,176,156,332
15,13,35,267,195,462
29,13,35,506,377,883
21,13,35,433,273,706
6,21,55,201,126,327
26,21,55,855,546,1401
19,21,55,479,399,878
27,21,55,725,567,1292
24,38,50,36,912,948
26,38,50,299,988,1287
15,42,54,2,630,632
15,38,50,23,570,593
11,38,50,121,418,539
4,42,54,20,168,188
20,38,50,60,760,820
6,38,50,33,228,261
29,38,50,145,1102,1247
1,1898,3375,937,1898,2835
1,1266,2320,961,1266,2227
1,1252,2295,722,1252,1974
1,1266,2320,683,1266,1949
1,1252,2295,951,1252,2203
1,1252,2295,997,1252,2249
1,1252,2295,997,1252,2249
1,1555,2443,619,1555,2174
1,2171,3578,763,2171,2934
1,344,540,185,344,529
1,1519,2443,826,1519,2345
1,2171,3578,942,2171,3113
1,1555,2443,717,1555,2272
1,2171,3578,656,2171,2827
1,1555,2443,570,1555,2125
1,713,1120,205,713,918
1,713,1120,261,713,974
9,26,70,390,234,624
25,1,2,25,25,50
3,1,2,3,3,6
4,1,2,4,4,8
19,1,2,19,19,38
18,1,2,18,18,36
22,1,2,22,22,44
17,1,2,17,17,34
1,2,5,3,2,5
27,2,5,76,54,130
17,8,21,146,136,282
15,8,21,129,120,249
24,2,5,56,48,104
9,2,5,21,18,39
12,2,5,35,24,59
24,2,5,71,48,119
21,1,4,62,21,83
28,1,2,27,28,55
14,1,2,13,14,27
5,1,4,11,5,16
9,1,4,19,9,28
30,13,35,440,390,830
8,13,35,117,104,221
5,1,2,5,5,10
30,1,2,29,30,59
20,1,4,57,20,77
23,1,4,65,23,88
7,1,4,17,7,24
25,2,5,59,50,109
19,2,5,45,38,83
16,2,5,38,32,70
13,1,2,7,13,20
10,1,4,29,10,39
25,2,5,60,50,110
30,2,5,84,60,144
27,2,5,76,54,130
25,2,5,59,50,109
20,2,5,59,40,99
18,2,5,53,36,89
13,1,4,38,13,51
28,1,4,82,28,110
5,1,4,12,5,17
17,1,4,36,17,53
1,1482,2384,401,1482,1883
1,1482,2384,854,1482,2336
1,1482,2384,807,1482,2289
8,45,120,590,360,950
7,45,120,517,315,832
27,2,5,53,54,107
11,2,5,21,22,43
15,4,10,84,60,144
17,4,10,95,68,163
6,2,5,11,12,23
21,2,5,40,42,82
12,2,5,35,24,59
8,2,5,23,16,39
14,2,5,33,28,61
10,2,5,22,20,42
23,2,5,51,46,97
3,2,5,6,6,12
29,2,5,61,58,119
11,3,9,65,33,98
23,2,5,64,46,110
3,2,5,8,6,14
17,2,5,48,34,82
12,2,5,26,24,50
26,2,5,57,52,109
28,7,9,46,196,242
7,7,9,1,49,50
28,7,9,23,196,219
17,7,9,28,119,147
25,7,9,46,175,221
22,7,9,0,154,154
4,3,8,20,12,32
6,3,8,29,18,47
16,3,8,63,48,111
6,8,22,68,48,116
28,8,22,256,224,480
12,8,22,120,96,216
12,8,22,165,96,261
9,9,24,109,81,190
17,9,24,202,153,355
28,9,24,413,252,665
17,9,24,210,153,363
16,13,35,330,208,538
4,13,35,57,52,109
14,13,35,205,182,387
19,13,35,338,247,585
29,13,35,455,377,832
18,13,35,371,234,605
25,13,35,533,325,858
24,13,35,494,312,806
23,13,35,377,299,676
21,13,35,344,273,617
27,13,35,443,351,794
25,13,35,541,325,866
2,13,35,34,26,60
24,13,35,494,312,806
18,42,54,197,756,953
15,38,50,165,570,735
8,38,50,80,304,384
6,42,54,14,252,266
6,38,50,6,228,234
27,38,50,297,1026,1323
6,38,50,33,228,261
1,38,50,4,38,42
4,38,50,20,152,172
17,42,54,167,714,881
18,38,50,180,684,864
27,42,54,295,1134,1429
26,42,54,87,1092,1179
1,1912,3400,774,1912,2686
1,1898,3375,937,1898,2835
1,1252,2295,882,1252,2134
1,1266,2320,567,1266,1833
1,1252,2295,538,1252,1790
1,295,540,148,295,443
1,1252,2295,951,1252,2203
1,1252,2295,745,1252,1997
1,420,769,318,420,738
1,308,565,234,308,542
1,2171,3578,1264,2171,3435
1,1555,2443,839,1555,2394
1,713,1120,205,713,918
12,26,70,494,312,806
24,26,70,1039,624,1663
30,26,70,1278,780,2058
30,26,70,1047,780,1827
10,3,9,56,30,86
10,3,9,48,30,78
19,2,5,55,38,93
5,2,5,15,10,25
16,1,2,9,16,25
13,1,2,7,13,20
19,1,2,11,19,30
17,1,2,10,17,27
12,1,2,7,12,19
2,1,2,1,2,3
13,1,2,12,13,25
20,1,2,18,20,38
2,1,2,2,2,4
20,2,5,46,40,86
21,1,2,19,21,40
25,1,2,23,25,48
29,1,2,27,29,56
20,1,2,17,20,37
26,1,2,22,26,48
17,1,2,15,17,32
28,2,5,53,56,109
22,2,5,42,44,86
13,2,5,36,26,62
7,2,5,20,14,34
21,2,5,59,42,101
8,2,5,22,16,38
6,11,30,107,66,173
30,2,5,66,60,126
9,2,5,20,18,38
17,1,2,17,17,34
27,1,2,26,27,53
14,8,21,144,112,256
12,8,21,123,96,219
22,8,21,226,176,402
6,9,25,72,54,126
23,1,2,23,23,46
15,1,2,15,15,30
15,2,5,44,30,74
18,2,5,53,36,89
23,1,4,59,23,82
2,1,4,5,2,7
6,2,5,13,12,25
20,2,5,42,40,82
7,9,25,109,63,172
1,1482,2384,807,1482,2289
1,1482,2384,807,1482,2289
1,1482,2384,473,1482,1955
1,461,742,199,461,660
1,1482,2384,807,1482,2289
1,1482,2384,592,1482,2074
1,461,742,185,461,646
1,1482,2384,854,1482,2336
1,1482,2384,521,1482,2003
24,24,64,929,576,1505
26,24,64,1023,624,1647
10,45,120,726,450,1176
8,3,9,31,24,55
22,4,10,92,88,180
24,4,10,101,96,197
18,2,5,42,36,78
20,2,5,47,40,87
30,2,5,84,60,144
23,2,5,64,46,110
20,2,5,56,40,96
11,2,5,29,22,51
27,2,5,72,54,126
21,2,5,62,42,104
8,2,5,24,16,40
26,2,5,60,52,112
26,2,5,60,52,112
17,2,5,49,34,83
5,2,5,15,10,25
10,3,9,46,30,76
29,3,9,132,87,219
7,2,5,20,14,34
6,2,5,17,12,29
30,3,9,169,90,259
11,2,5,31,22,53
15,2,5,42,30,72
14,2,5,27,28,55
6,2,5,17,12,29
7,2,5,20,14,34
13,3,9,77,39,116
16,7,9,13,112,125
27,7,9,44,189,233
29,7,9,3,203,206
21,7,9,38,147,185
17,7,9,31,119,150
21,7,9,12,147,159
12,7,9,20,84,104
13,7,9,5,91,96
20,7,9,17,140,157
16,3,8,79,48,127
16,8,22,217,128,345
27,8,22,366,216,582
14,8,22,193,112,305
15,9,24,218,135,353
15,9,24,178,135,313
16,9,24,225,144,369
29,9,24,428,261,689
12,9,24,117,108,225
14,9,24,207,126,333
9,13,35,129,117,246
19,13,35,391,247,638
10,13,35,157,130,287
9,13,35,195,117,312
2,13,35,43,26,69
27,13,35,471,351,822
21,13,35,447,273,720
10,13,35,213,130,343
28,13,35,440,364,804
2,13,35,43,26,69
4,13,35,85,52,137
19,13,35,272,247,519
1,13,35,21,13,34
28,38,50,112,1064,1176
27,42,54,309,1134,1443
1,42,54,11,42,53
3,42,54,2,126,128
25,42,54,125,1050,1175
24,42,54,236,1008,1244
19,38,50,190,722,912
18,42,54,197,756,953
1,308,565,121,308,429
1,1898,3375,937,1898,2835
1,1252,2295,951,1252,2203
1,1252,2295,722,1252,1974
1,1266,2320,1008,1266,2274
1,1252,2295,538,1252,1790
1,1266,2320,683,1266,1949
1,1266,2320,961,1266,2227
1,1266,2320,1031,1266,2297
1,1266,2320,752,1266,2018
1,1252,2295,745,1252,1997
1,2171,3578,1264,2171,3435
1,2171,3578,1264,2171,3435
1,2171,3578,763,2171,2934
1,1519,2443,900,1519,2419
1,1083,1701,584,1083,1667
1,1555,2443,717,1555,2272
1,2171,3578,656,2171,2827
1,713,1120,161,713,874
1,713,1120,396,713,1109
1,1555,2443,570,1555,2125
1,344,540,185,344,529
1,2171,3578,1335,2171,3506
1,344,540,126,344,470
18,26,70,767,468,1235
30,26,70,1299,780,2079
2,26,70,59,52,111
14,3,9,81,42,123
28,2,5,81,56,137
11,2,5,32,22,54
23,1,2,13,23,36
30,1,2,17,30,47
28,11,30,524,308,832
15,11,30,281,165,446
11,11,30,206,121,327
5,13,35,107,65,172
27,13,35,575,351,926
3,1,2,3,3,6
3,2,5,9,6,15
3,2,5,9,6,15
21,2,5,40,42,82
12,2,5,23,24,47
22,2,5,42,44,86
14,1,2,14,14,28
15,1,2,15,15,30
28,1,4,69,28,97
3,1,2,3,3,6
22,1,2,21,22,43
15,1,2,14,15,29
22,2,5,58,44,102
22,1,4,52,22,74
25,2,5,73,50,123
24,2,5,70,48,118
18,1,2,12,18,30
14,1,2,10,14,24
20,11,30,374,220,594
16,2,5,47,32,79
21,2,5,62,42,104
14,2,5,41,28,69
22,2,5,51,44,95
29,2,5,67,58,125
23,11,30,292,253,545
16,11,30,203,176,379
26,11,30,330,286,616
3,2,5,9,6,15
23,2,5,68,46,114
30,2,5,63,60,123
24,11,29,418,264,682
30,1,4,71,30,101
19,1,4,45,19,64
3,1,4,7,3,10
25,2,5,48,50,98
9,2,5,26,18,44
27,2,5,78,54,132
10,1,4,21,10,31
5,2,5,15,10,25
11,2,5,32,22,54
15,2,5,35,30,65
8,1,4,23,8,31
1,1,4,3,1,4
4,8,21,41,32,73
5,8,21,51,40,91
17,2,5,49,34,83
17,2,5,49,34,83
1,1482,2384,521,1482,2003
1,1482,2384,592,1482,2074
1,1482,2384,735,1482,2217
1,461,742,118,461,579
1,755,1215,241,755,996
22,24,64,852,528,1380
12,45,120,698,540,1238
9,45,120,437,405,842
10,45,120,486,450,936
9,59,159,585,531,1116
30,3,9,131,90,221
26,2,5,61,52,113
10,2,5,24,20,44
6,2,5,17,12,29
1,2,5,3,2,5
28,2,5,81,56,137
18,2,5,41,36,77
14,4,10,81,56,137
1,4,10,6,4,10
3,3,9,12,9,21
5,3,9,20,15,35
23,4,10,133,92,225
9,4,10,52,36,88
18,2,5,38,36,74
11,2,5,32,22,54
22,2,5,51,44,95
21,2,5,48,42,90
25,2,5,70,50,120
17,2,5,48,34,82
10,2,5,24,20,44
17,2,5,40,34,74
4,2,5,9,8,17
26,2,5,61,52,113
30,7,9,55,210,265
4,7,9,2,28,30
28,7,9,51,196,247
3,7,9,2,21,23
6,7,9,10,42,52
28,7,9,26,196,222
15,7,9,25,105,130
4,3,8,20,12,32
19,3,8,93,57,150
25,3,8,81,75,156
27,8,22,301,216,517
24,8,22,325,192,517
4,8,22,54,32,86
28,8,22,306,224,530
12,8,22,157,96,253
20,8,22,276,160,436
7,8,22,78,56,134
14,8,22,193,112,305
19,8,22,262,152,414
5,9,24,58,45,103
6,9,24,89,54,143
14,9,24,166,126,292
2,9,24,19,18,37
4,9,24,39,36,75
23,13,35,401,299,700
7,13,35,144,91,235
17,13,35,350,221,571
11,13,35,234,143,377
6,13,35,124,78,202
13,13,35,227,169,396
6,13,35,105,78,183
2,13,35,43,26,69
3,13,35,47,39,86
10,13,35,175,130,305
30,13,35,650,390,1040
20,13,35,426,260,686
1,13,35,21,13,34
29,13,35,516,377,893
4,13,35,78,52,130
25,13,35,533,325,858
11,13,35,180,143,323
9,13,35,141,117,258
1,13,35,14,13,27
30,13,35,618,390,1008
16,13,35,341,208,549
3,13,35,49,39,88
25,21,55,671,525,1196
26,38,50,39,988,1027
1,38,50,5,38,43
16,42,54,175,672,847
1,42,54,11,42,53
19,38,50,190,722,912
9,42,54,45,378,423
1,1252,2295,951,1252,2203
1,1252,2295,997,1252,2249
1,1252,2295,538,1252,1790
1,1266,2320,636,1266,1902
1,1252,2295,745,1252,1997
1,1252,2295,951,1252,2203
1,1252,2295,951,1252,2203
1,295,540,169,295,464
1,1266,2320,1008,1266,2274
1,1555,2443,351,1555,1906
1,713,1120,385,713,1098
1,2171,3578,942,2171,3113
1,1083,1701,550,1083,1633
1,2171,3578,942,2171,3113
1,2171,3578,835,2171,3006
1,1083,1701,244,1083,1327
1,713,1120,385,713,1098
1,713,1120,161,713,874
1,344,540,120,344,464
1,713,1120,194,713,907
1,487,783,171,487,658
4,26,70,173,104,277
19,26,70,557,494,1051
18,3,9,105,54,159
23,1,2,22,23,45
12,2,5,34,24,58
25,2,5,73,50,123
12,1,2,12,12,24
2,1,2,2,2,4
25,11,29,443,275,718
29,11,29,371,319,690
26,12,33,434,312,746
26,1,2,17,26,43
22,2,5,62,44,106
14,2,5,39,28,67
10,1,2,10,10,20
6,1,2,6,6,12
7,1,2,5,7,12
7,2,5,20,14,34
24,2,5,70,48,118
26,1,2,18,26,44
30,9,25,390,270,660
13,1,2,11,13,24
22,1,2,19,22,41
15,1,2,11,15,26
29,1,2,21,29,50
28,1,2,21,28,49
10,1,2,7,10,17
8,8,21,101,64,165
23,8,21,289,184,473
27,8,21,340,216,556
23,8,21,193,184,377
2,2,5,5,4,9
13,2,5,31,26,57
10,1,2,7,10,17
25,1,2,18,25,43
2,2,5,4,4,8
3,2,5,9,6,15
5,1,4,14,5,19
6,1,4,13,6,19
16,12,33,220,192,412
30,12,33,412,360,772
22,12,33,302,264,566
5,2,5,12,10,22
4,1,4,11,4,15
7,1,4,20,7,27
8,1,4,17,8,25
27,1,4,57,27,84
13,1,4,28,13,41
23,2,5,64,46,110
25,2,5,70,50,120
1,1482,2384,521,1482,2003
1,1482,2384,807,1482,2289
1,461,742,185,461,646
1,1482,2384,473,1482,1955
1,1482,2384,807,1482,2289
1,1482,2384,854,1482,2336
1,461,742,251,461,712
1,1482,2384,592,1482,2074
21,24,64,813,504,1317
16,2,5,47,32,79
1,2,5,3,2,5
23,4,10,129,92,221
8,4,10,45,32,77
30,2,5,59,60,119
13,2,5,25,26,51
9,2,5,25,18,43
4,2,5,11,8,19
2,2,5,6,4,10
21,2,5,61,42,103
11,2,5,25,22,47
9,2,5,21,18,39
8,2,5,18,16,34
6,2,5,14,12,26
28,3,9,133,84,217
17,3,9,81,51,132
13,2,5,38,26,64
20,2,5,58,40,98
8,2,5,23,16,39
16,2,5,42,32,74
20,2,5,53,40,93
29,2,5,81,58,139
16,2,5,45,32,77
30,2,5,71,60,131
12,2,5,35,24,59
29,2,5,81,58,139
29,7,9,55,203,258
5,7,9,4,35,39
29,7,9,21,203,224
14,7,9,25,98,123
26,7,9,10,182,192
19,7,9,11,133,144
25,7,9,34,175,209
15,3,8,73,45,118
22,3,8,106,66,172
9,3,8,36,27,63
25,3,8,121,75,196
1,8,22,9,8,17
24,8,22,325,192,517
7,8,22,95,56,151
18,8,22,197,144,341
13,8,22,179,104,283
19,8,22,262,152,414
26,8,22,358,208,566
7,9,24,70,63,133
7,9,24,98,63,161
28,9,24,407,252,659
19,9,24,189,171,360
5,13,35,73,65,138
26,13,35,554,338,892
20,13,35,286,260,546
24,13,35,520,312,832
15,13,35,320,195,515
16,13,35,341,208,549
23,13,35,361,299,660
4,13,35,85,52,137
22,13,35,469,286,755
27,13,35,528,351,879
8,13,35,117,104,221
24,21,55,803,504,1307
5,21,55,151,105,256
5,38,50,55,190,245
25,38,50,38,950,988
2,42,54,1,84,85
6,42,54,27,252,279
23,42,54,102,966,1068
5,42,54,55,210,265
11,38,50,110,418,528
1,1266,2320,544,1266,1810
1,1252,2295,997,1252,2249
1,420,769,188,420,608
1,1252,2295,997,1252,2249
1,344,540,185,344,529
1,2171,3578,763,2171,2934
1,713,1120,385,713,1098
1,487,783,124,487,611
1,2171,3578,1157,2171,3328
1,2171,3578,1264,2171,3435
1,487,783,186,487,673
1,344,540,185,344,529
1,2171,3578,835,2171,3006
1,2171,3578,942,2171,3113
1,2171,3578,656,2171,2827
1,344,540,185,344,529
1,344,540,158,344,502
1,344,540,185,344,529
1,344,540,185,344,529
1,2171,3578,1371,2171,3542
1,344,540,126,344,470
1,344,540,110,344,454
1,1555,2443,864,1555,2419
1,1083,1701,550,1083,1633
1,344,540,174,344,518
1,1555,2443,717,1555,2272
1,344,540,174,344,518
1,2171,3578,1335,2171,3506
3,11,29,52,33,85
18,11,29,314,198,512
4,8,21,34,32,66
17,13,35,249,221,470
25,13,35,366,325,691
9,1,2,5,9,14
26,13,35,554,338,892
21,13,35,447,273,720
9,13,35,192,117,309
27,1,2,25,27,52
4,1,2,4,4,8
6,1,2,6,6,12
15,2,5,31,30,61
30,9,25,360,270,630
13,9,25,156,117,273
30,1,2,29,30,59
16,13,35,341,208,549
3,13,35,64,39,103
14,11,30,262,154,416
5,1,2,5,5,10
8,1,2,8,8,16
2,1,2,2,2,4
24,1,2,23,24,47
9,1,2,9,9,18
5,2,5,13,10,23
1,9,25,11,9,20
14,9,25,151,126,277
19,9,25,204,171,375
18,9,25,194,162,356
25,1,2,25,25,50
25,1,2,25,25,50
29,2,5,55,58,113
5,2,5,10,10,20
10,13,35,196,130,326
22,13,35,430,286,716
1,1,4,2,1,3
29,2,5,81,58,139
13,2,5,36,26,62
9,2,5,21,18,39
23,2,5,54,46,100
29,1,4,68,29,97
24,1,4,57,24,81
13,1,2,10,13,23
17,1,2,12,17,29
12,1,2,8,12,20
19,1,2,13,19,32
27,1,2,17,27,44
4,1,2,3,4,7
23,8,21,193,184,377
8,9,25,114,72,186
8,9,25,114,72,186
1,9,25,14,9,23
30,11,30,552,330,882
17,12,33,346,204,550
21,1,2,12,21,33
9,1,2,5,9,14
13,2,5,38,26,64
22,2,5,64,44,108
1,461,742,162,461,623
1,1482,2384,878,1482,2360
1,1482,2384,807,1482,2289
1,755,1215,266,755,1021
1,1482,2384,854,1482,2336
1,461,742,147,461,608
14,2,5,29,28,57
22,2,5,46,44,90
20,4,10,118,80,198
25,2,5,74,50,124
23,2,5,68,46,114
24,2,5,70,48,118
29,2,5,61,58,119
5,2,5,11,10,21
26,2,5,75,52,127
13,2,5,38,26,64
15,3,9,62,45,107
8,2,5,19,16,35
19,2,5,45,38,83
6,2,5,17,12,29
2,2,5,6,4,10
11,3,9,59,33,92
2,3,9,11,6,17
17,2,5,49,34,83
21,2,5,61,42,103
20,7,9,33,140,173
21,7,9,0,147,147
7,7,9,13,49,62
28,7,9,46,196,242
27,7,9,49,189,238
5,7,9,0,35,35
26,3,8,126,78,204
17,8,22,234,136,370
10,8,22,138,80,218
19,8,22,258,152,410
2,9,24,30,18,48
13,9,24,173,117,290
11,13,35,161,143,304
1,13,35,21,13,34
6,13,35,130,78,208
13,13,35,281,169,450
9,13,35,195,117,312
27,13,35,585,351,936
5,13,35,107,65,172
1,13,35,17,13,30
28,13,35,606,364,970
8,13,35,137,104,241
11,13,35,234,143,377
12,13,35,256,156,412
16,13,35,341,208,549
10,13,35,217,130,347
14,13,35,288,182,470
16,13,35,229,208,437
27,13,35,575,351,926
28,13,35,400,364,764
18,13,35,283,234,517
17,13,35,350,221,571
19,13,35,391,247,638
15,13,35,225,195,420
2,42,54,22,84,106
22,38,50,242,836,1078
1,42,54,0,42,42
10,42,54,115,420,535
18,38,50,198,684,882
15,38,50,165,570,735
20,42,54,218,840,1058
1,38,50,9,38,47
28,42,54,3,1176,1179
8,42,54,1,336,337
17,38,50,187,646,833
2,42,54,22,84,106
1,1912,3400,774,1912,2686
1,1252,2295,951,1252,2203
1,1252,2295,951,1252,2203
1,1252,2295,745,1252,1997
1,1252,2295,538,1252,1790
1,295,540,234,295,529
1,295,540,207,295,502
1,1266,2320,544,1266,1810
1,1266,2320,1008,1266,2274
1,713,1120,261,713,974
1,487,783,280,487,767
1,2171,3578,942,2171,3113
1,1083,1701,499,1083,1582
1,1555,2443,448,1555,2003
1,344,540,120,344,464
1,487,783,288,487,775
17,26,70,724,442,1166
17,26,70,486,442,928
14,26,70,596,364,960
13,26,70,372,338,710
8,26,70,251,208,459
16,3,9,93,48,141
26,8,21,223,208,431
7,1,2,7,7,14
1,1,2,1,1,2
13,1,2,10,13,23
26,1,2,19,26,45
28,13,35,596,364,960
21,13,35,447,273,720
22,1,4,62,22,84
4,1,4,11,4,15
21,1,2,20,21,41
10,1,2,10,10,20
9,2,5,17,18,35
23,1,4,54,23,77
6,1,4,14,6,20
13,1,4,31,13,44
21,1,2,21,21,42
11,1,2,11,11,22
16,12,33,331,192,523
14,12,33,289,168,457
27,1,2,25,27,52
1,1,2,1,1,2
5,1,2,5,5,10
15,1,2,14,15,29
11,1,2,11,11,22
15,1,2,10,15,25
27,1,4,62,27,89
21,2,5,61,42,103
8,2,5,23,16,39
19,2,5,55,38,93
18,2,5,52,36,88
24,2,5,70,48,118
13,2,5,38,26,64
22,8,21,231,176,407
29,8,21,304,232,536
11,1,2,11,11,22
13,1,2,13,13,26
13,1,2,7,13,20
6,1,2,3,6,9
16,11,30,242,176,418
16,12,33,220,192,412
6,12,33,82,72,154
25,12,33,344,300,644
7,9,25,100,63,163
27,11,30,497,297,794
23,11,30,423,253,676
25,2,5,70,50,120
1,2,5,3,2,5
7,8,21,88,56,144
21,8,21,264,168,432
22,2,5,64,44,108
20,2,5,58,40,98
1,1,2,1,1,2
24,1,4,68,24,92
28,1,4,80,28,108
1,755,1215,375,755,1130
1,1482,2384,735,1482,2217
1,1482,2384,378,1482,1860
1,1482,2384,854,1482,2336
1,755,1215,436,755,1191
1,1482,2384,854,1482,2336
1,461,742,133,461,594
28,24,64,726,672,1398
19,24,64,541,456,997
23,24,64,891,552,1443
20,24,64,710,480,1190
6,45,120,421,270,691
4,59,159,387,236,623
2,2,5,5,4,9
21,2,5,56,42,98
11,2,5,26,22,48
1,2,5,2,2,4
25,4,10,118,100,218
13,4,10,61,52,113
6,2,5,17,12,29
26,4,10,109,104,213
25,4,10,105,100,205
12,4,10,50,48,98
17,4,10,71,68,139
8,2,5,22,16,38
23,2,5,64,46,110
24,2,5,50,48,98
5,2,5,11,10,21
30,2,5,87,60,147
9,2,5,26,18,44
25,3,9,146,75,221
16,3,9,93,48,141
19,3,9,76,57,133
7,3,9,29,21,50
30,3,9,123,90,213
23,2,5,48,46,94
2,2,5,5,4,9
1,2,5,3,2,5
24,2,5,64,48,112
26,7,9,43,182,225
28,7,9,38,196,234
2,7,9,0,14,14
21,7,9,8,147,155
13,7,9,1,91,92
22,7,9,-4,154,150
6,7,9,8,42,50
12,7,9,20,84,104
22,3,8,106,66,172
3,8,22,41,24,65
7,8,22,95,56,151
12,8,22,163,96,259
21,8,22,192,168,360
5,8,22,56,40,96
12,8,22,163,96,259
28,8,22,386,224,610
20,8,22,276,160,436
12,9,24,174,108,282
19,9,24,280,171,451
15,9,24,218,135,353
19,13,35,278,247,525
4,13,35,87,52,139
23,13,35,450,299,749
4,13,35,70,52,122
28,13,35,606,364,970
13,13,35,177,169,346
20,13,35,412,260,672
12,13,35,176,156,332
22,13,35,453,286,739
27,13,35,585,351,936
17,13,35,362,221,583
10,13,35,196,130,326
4,13,35,85,52,137
8,13,35,117,104,221
19,13,35,298,247,545
23,13,35,474,299,773
10,13,35,164,130,294
15,13,35,215,195,410
8,13,35,140,104,244
26,13,35,554,338,892
13,13,35,277,169,446
7,13,35,110,91,201
7,13,35,110,91,201
7,13,35,152,91,243
20,13,35,391,260,651
20,21,55,636,420,1056
14,21,55,461,294,755
11,42,54,108,462,570
18,42,54,2,756,758
10,42,54,98,420,518
10,38,50,15,380,395
30,42,54,328,1260,1588
30,38,50,330,1140,1470
23,38,50,253,874,1127
28,38,50,308,1064,1372
21,42,54,105,882,987
1,1266,2320,961,1266,2227
1,1266,2320,544,1266,1810
1,420,769,318,420,738
1,1266,2320,961,1266,2227
1,1266,2320,1008,1266,2274
1,420,769,211,420,631
1,1266,2320,1008,1266,2274
1,1266,2320,1031,1266,2297
1,1252,2295,951,1252,2203
1,1252,2295,997,1252,2249
1,1555,2443,717,1555,2272
1,487,783,124,487,611
1,2171,3578,763,2171,2934
1,1083,1701,584,1083,1667
1,1083,1701,550,1083,1633
1,713,1120,205,713,918
1,713,1120,385,713,1098
1,713,1120,385,713,1098
1,2171,3578,656,2171,2827
1,487,783,241,487,728
1,2171,3578,763,2171,2934
1,344,540,185,344,529
1,1083,1701,261,1083,1344
1,344,540,158,344,502
1,487,783,132,487,619
1,713,1120,228,713,941
1,713,1120,172,713,885
1,344,540,158,344,502
28,26,70,801,728,1529
7,3,9,41,21,62
29,3,9,164,87,251
11,11,30,169,121,290
5,11,30,77,55,132
19,2,5,53,38,91
10,2,5,28,20,48
10,9,25,108,90,198
4,9,25,43,36,79
11,1,4,33,11,44
15,1,2,8,15,23
12,2,5,25,24,49
3,2,5,6,6,12
24,12,33,472,288,760
9,12,33,177,108,285
5,1,2,5,5,10
20,1,2,19,20,39
18,1,2,18,18,36
11,1,2,11,11,22
23,9,25,345,207,552
9,9,25,135,81,216
5,9,25,75,45,120
12,11,30,221,132,353
2,11,30,37,22,59
19,1,4,52,19,71
15,1,4,41,15,56
26,1,2,17,26,43
5,1,2,3,5,8
15,11,29,192,165,357
16,11,29,204,176,380
21,1,4,61,21,82
16,1,4,47,16,63
19,1,4,55,19,74
28,2,5,55,56,111
6,2,5,12,12,24
27,8,21,232,216,448
20,8,21,172,160,332
25,2,5,73,50,123
30,2,5,87,60,147
27,1,2,26,27,53
16,1,2,16,16,32
8,1,4,17,8,25
2,11,29,35,22,57
4,9,25,62,36,98
30,9,25,465,270,735
22,1,2,16,22,38
1,1482,2384,807,1482,2289
1,461,742,251,461,712
1,461,742,251,461,712
1,1482,2384,592,1482,2074
1,1482,2384,378,1482,1860
1,755,1215,241,755,996
1,755,1215,436,755,1191
1,461,742,147,461,608
1,1482,2384,807,1482,2289
1,461,742,125,461,586
14,24,64,551,336,887
3,24,64,118,72,190
6,59,159,533,354,887
29,2,5,68,58,126
19,2,5,45,38,83
29,2,5,81,58,139
24,2,5,67,48,115
25,2,5,73,50,123
25,2,5,74,50,124
7,2,5,21,14,35
16,2,5,46,32,78
8,2,5,23,16,39
10,2,5,29,20,49
29,2,5,84,58,142
10,2,5,27,20,47
17,2,5,45,34,79
27,4,10,159,108,267
12,4,10,71,48,119
28,2,5,62,56,118
18,2,5,40,36,76
6,2,5,17,12,29
21,2,5,61,42,103
21,2,5,61,42,103
30,2,5,87,60,147
19,4,10,112,76,188
27,4,10,159,108,267
1,2,5,3,2,5
25,3,9,114,75,189
27,3,9,123,81,204
11,7,9,6,77,83
21,7,9,2,147,149
4,7,9,7,28,35
15,7,9,21,105,126
5,7,9,4,35,39
7,7,9,4,49,53
29,7,9,55,203,258
20,7,9,33,140,173
7,7,9,13,49,62
27,7,9,15,189,204
19,3,8,74,57,131
10,3,8,32,30,62
12,3,8,43,36,79
11,8,22,149,88,237
28,8,22,380,224,604
30,8,22,407,240,647
17,8,22,234,136,370
20,8,22,276,160,436
16,8,22,150,128,278
26,9,24,378,234,612
18,13,35,257,234,491
11,13,35,173,143,316
10,13,35,213,130,343
18,13,35,383,234,617
10,13,35,157,130,287
5,13,35,98,65,163
22,13,35,453,286,739
13,13,35,227,169,396
3,13,35,47,39,86
20,13,35,293,260,553
5,13,35,86,65,151
21,13,35,344,273,617
26,13,35,508,338,846
1,13,35,21,13,34
9,13,35,157,117,274
22,13,35,469,286,755
6,13,35,103,78,181
24,13,35,419,312,731
9,21,55,286,189,475
15,21,55,494,315,809
22,42,54,15,924,939
18,38,50,198,684,882
1,38,50,12,38,50
27,38,50,297,1026,1323
1,38,50,11,38,49
14,38,50,140,532,672
4,38,50,44,152,196
1,42,54,11,42,53
7,42,54,1,294,295
4,38,50,44,152,196
13,38,50,130,494,624
4,38,50,44,152,196
1,1266,2320,1008,1266,2274
1,1252,2295,951,1252,2203
1,420,769,334,420,754
1,1266,2320,1008,1266,2274
1,1266,2320,1008,1266,2274
1,2171,3578,1264,2171,3435
1,2171,3578,1157,2171,3328
1,713,1120,138,713,851
1,1555,2443,790,1555,2345
1,1083,1701,244,1083,1327
1,1555,2443,717,1555,2272
1,2171,3578,835,2171,3006
1,344,540,77,344,421
1,344,540,99,344,443
1,1519,2443,460,1519,1979
1,344,540,191,344,535
1,2171,3578,1371,2171,3542
1,1083,1701,346,1083,1429
1,713,1120,228,713,941
1,2171,3578,1335,2171,3506
1,2171,3578,1335,2171,3506
30,26,70,1299,780,2079
29,26,70,1195,754,1949
24,26,70,989,624,1613
16,26,70,693,416,1109
20,26,70,572,520,1092
19,26,70,809,494,1303
4,3,9,16,12,28
16,3,9,93,48,141
3,1,2,3,3,6
30,1,2,29,30,59
27,1,2,19,27,46
18,1,2,13,18,31
19,9,25,228,171,399
13,9,25,156,117,273
19,13,35,325,247,572
18,13,35,308,234,542
29,13,35,496,377,873
10,1,2,10,10,20
18,1,2,17,18,35
6,1,2,4,6,10
25,1,2,25,25,50
28,1,2,27,28,55
16,1,2,14,16,30
11,11,30,206,121,327
25,1,2,16,25,41
7,1,2,4,7,11
19,1,2,19,19,38
8,1,2,8,8,16
12,1,2,12,12,24
17,1,2,13,17,30
8,1,2,6,8,14
1,1,2,1,1,2
5,1,2,4,5,9
20,1,2,17,20,37
19,2,5,36,38,74
18,2,5,34,36,70
16,2,5,46,32,78
17,2,5,49,34,83
18,2,5,52,36,88
16,1,4,36,16,52
9,1,4,21,9,30
12,11,30,203,132,335
14,11,30,237,154,391
22,8,21,203,176,379
30,8,21,277,240,517
13,1,2,13,13,26
24,2,5,70,48,118
11,2,5,32,22,54
13,2,5,38,26,64
5,1,4,15,5,20
24,1,4,70,24,94
17,1,2,12,17,29
9,1,2,6,9,15
30,1,2,22,30,52
15,1,2,10,15,25
7,1,2,4,7,11
1,8,21,12,8,20
19,8,21,231,152,383
29,8,21,353,232,585
5,1,2,5,5,10
1,1,2,1,1,2
24,8,21,302,192,494
2,2,5,6,4,10
12,2,5,34,24,58
1,1482,2384,592,1482,2074
1,1482,2384,473,1482,1955
1,1482,2384,521,1482,2003
1,1482,2384,592,1482,2074
1,1482,2384,401,1482,1883
1,1482,2384,521,1482,2003
1,1482,2384,854,1482,2336
1,1482,2384,854,1482,2336
1,755,1215,290,755,1045
1,461,742,162,461,623
1,45,120,56,45,101
7,59,159,522,413,935
5,2,5,15,10,25
16,2,5,46,32,78
29,2,5,81,58,139
25,2,5,70,50,120
24,2,5,70,48,118
10,2,5,29,20,49
25,2,5,70,50,120
27,2,5,76,54,130
7,4,10,41,28,69
1,2,5,3,2,5
29,2,5,81,58,139
23,3,9,130,69,199
24,4,10,127,96,223
18,2,5,52,36,88
18,2,5,52,36,88
15,2,5,40,30,70
21,2,5,56,42,98
10,4,10,53,40,93
19,4,10,101,76,177
16,2,5,46,32,78
26,2,5,75,52,127
16,2,5,46,32,78
8,2,5,23,16,39
15,2,5,44,30,74
11,2,5,32,22,54
20,2,5,58,40,98
4,2,5,8,8,16
13,2,5,27,26,53
24,2,5,70,48,118
13,2,5,38,26,64
7,3,9,41,21,62
22,3,9,128,66,194
12,4,10,46,48,94
3,4,10,11,12,23
27,2,5,78,54,132
30,2,5,87,60,147
23,4,10,133,92,225
30,4,10,174,120,294
10,2,5,29,20,49
1,2,5,3,2,5
19,3,9,76,57,133
5,3,9,20,15,35
22,3,9,100,66,166
6,3,9,27,18,45
9,2,5,21,18,39
19,2,5,45,38,83
11,7,9,18,77,95
6,7,9,10,42,52
2,7,9,3,14,17
24,7,9,20,168,188
25,7,9,46,175,221
15,8,22,137,120,257
23,8,22,211,184,395
22,8,22,221,176,397
13,8,22,176,104,280
22,8,22,274,176,450
15,9,24,211,135,346
6,9,24,87,54,141
13,9,24,192,117,309
24,9,24,320,216,536
21,9,24,249,189,438
7,13,35,100,91,191
12,13,35,172,156,328
24,13,35,511,312,823
19,13,35,272,247,519
3,13,35,62,39,101
16,13,35,251,208,459
18,13,35,283,234,517
9,13,35,192,117,309
1,13,35,20,13,33
13,13,35,277,169,446
29,13,35,597,377,974
25,13,35,533,325,858
29,13,35,618,377,995
10,13,35,217,130,347
6,13,35,128,78,206
9,13,35,192,117,309
11,13,35,234,143,377
12,13,35,260,156,416
15,13,35,309,195,504
12,21,55,322,252,574
8,21,55,193,168,361
27,42,54,266,1134,1400
29,42,54,285,1218,1503
18,42,54,90,756,846
23,38,50,69,874,943
7,38,50,70,266,336
25,38,50,275,950,1225
30,42,54,247,1260,1507
4,38,50,16,152,168
19,42,54,95,798,893
25,38,50,138,950,1088
1,1266,2320,1008,1266,2274
1,1252,2295,882,1252,2134
1,1266,2320,961,1266,2227
1,1266,2320,752,1266,2018
1,1252,2295,1020,1252,2272
1,420,769,334,420,754
1,295,540,234,295,529
1,420,769,318,420,738
1,420,769,334,420,754
1,308,565,234,308,542
1,1252,2295,1020,1252,2272
1,308,565,234,308,542
1,1912,3400,740,1912,2652
1,1252,2295,997,1252,2249
1,1252,2295,997,1252,2249
1,1252,2295,538,1252,1790
1,1252,2295,997,1252,2249
1,2171,3578,620,2171,2791
1,487,783,280,487,767
1,1519,2443,753,1519,2272
1,1519,2443,826,1519,2345
1,2171,3578,656,2171,2827
1,713,1120,205,713,918
1,713,1120,385,713,1098
1,713,1120,385,713,1098
1,1519,2443,606,1519,2125
1,1555,2443,570,1555,2125
1,1555,2443,497,1555,2052
1,1555,2443,864,1555,2419
1,2171,3578,1335,2171,3506
12,26,70,511,312,823
22,3,9,90,66,156
19,3,9,111,57,168
1,1,2,1,1,2
8,1,2,4,8,12
28,1,2,16,28,44
7,13,35,149,91,240
21,13,35,455,273,728
24,13,35,520,312,832
3,13,35,65,39,104
14,13,35,303,182,485
27,11,30,367,297,664
17,11,30,231,187,418
7,2,5,21,14,35
16,2,5,47,32,79
16,1,2,9,16,25
29,1,4,86,29,115
19,1,4,56,19,75
23,1,4,67,23,90
2,1,4,6,2,8
4,1,2,2,4,6
26,1,2,15,26,41
9,1,2,5,9,14
15,2,5,44,30,74
8,1,2,8,8,16
9,2,5,17,18,35
7,2,5,13,14,27
4,1,4,11,4,15
19,1,4,54,19,73
28,1,4,80,28,108
9,2,5,26,18,44
18,2,5,52,36,88
12,8,21,151,96,247
17,8,21,214,136,350
1,2,5,2,2,4
4,2,5,9,8,17
10,1,4,28,10,38
24,1,4,70,24,94
9,1,4,26,9,35
22,1,4,64,22,86
1,1482,2384,878,1482,2360
1,755,1215,266,755,1021
1,1482,2384,735,1482,2217
1,1482,2384,854,1482,2336
1,1482,2384,854,1482,2336
1,755,1215,436,755,1191
1,755,1215,302,755,1057
1,461,742,266,461,727
1,1482,2384,854,1482,2336
1,461,742,266,461,727
21,24,64,813,504,1317
26,24,64,824,624,1448
3,24,64,116,72,188
5,24,64,130,120,250
18,3,9,79,54,133
5,2,5,13,10,23
5,2,5,13,10,23
4,2,5,8,8,16
17,4,10,90,68,158
30,4,10,174,120,294
16,4,10,93,64,157
1,2,5,3,2,5
1,2,5,3,2,5
23,2,5,53,46,99
6,2,5,14,12,26
18,4,10,85,72,157
17,4,10,80,68,148
24,2,5,58,48,106
22,2,5,53,44,97
21,3,9,124,63,187
19,2,5,50,38,88
29,3,9,124,87,211
8,3,9,34,24,58
25,2,5,59,50,109
16,2,5,38,32,70
8,2,5,24,16,40
26,2,5,77,52,129
19,2,5,53,38,91
27,2,5,76,54,130
30,2,5,89,60,149
21,2,5,62,42,104
19,7,9,7,133,140
16,7,9,6,112,118
21,7,9,40,147,187
27,7,9,37,189,226
3,7,9,5,21,26
3,7,9,4,21,25
29,7,9,11,203,214
15,7,9,12,105,117
6,7,9,2,42,44
14,7,9,12,98,110
12,7,9,23,84,107
21,7,9,17,147,164
4,3,8,16,12,28
18,3,8,80,54,134
16,3,8,75,48,123
9,8,22,100,72,172
21,8,22,192,168,360
2,8,22,20,16,36
26,8,22,324,208,532
20,9,24,194,180,374
25,9,24,363,225,588
25,13,35,358,325,683
22,13,35,384,286,670
7,13,35,115,91,206
23,13,35,450,299,749
19,13,35,371,247,618
4,13,35,82,52,134
24,13,35,469,312,781
8,13,35,156,104,260
11,13,35,173,143,316
1,13,35,20,13,33
1,13,35,16,13,29
12,13,35,176,156,332
4,13,35,63,52,115
1,13,35,22,13,35
7,13,35,152,91,243
29,13,35,597,377,974
28,13,35,489,364,853
17,13,35,267,221,488
4,13,35,85,52,137
1,13,35,21,13,34
5,13,35,79,65,144
19,13,35,391,247,638
9,21,55,301,189,490
29,21,55,954,609,1563
1,21,55,33,21,54
29,21,55,763,609,1372
1,42,54,2,42,44
12,38,50,78,456,534
12,42,54,40,504,544
17,42,54,186,714,900
11,38,50,11,418,429
8,42,54,40,336,376
24,38,50,216,912,1128
12,42,54,138,504,642
2,38,50,20,76,96
25,42,54,3,1050,1053
6,38,50,33,228,261
12,38,50,138,456,594
1,1252,2295,997,1252,2249
1,1252,2295,630,1252,1882
1,1252,2295,882,1252,2134
1,420,769,295,420,715
1,420,769,264,420,684
1,420,769,295,420,715
1,1252,2295,951,1252,2203
1,1266,2320,636,1266,1902
1,295,540,207,295,502
1,295,540,207,295,502
1,308,565,133,308,441
1,1266,2320,1008,1266,2274
1,1266,2320,1008,1266,2274
1,1266,2320,892,1266,2158
1,1266,2320,544,1266,1810
1,487,783,280,487,767
1,1083,1701,397,1083,1480
1,713,1120,205,713,918
1,713,1120,161,713,874
1,2171,3578,942,2171,3113
1,487,783,265,487,752
1,713,1120,161,713,874
1,1555,2443,570,1555,2125
1,2171,3578,1371,2171,3542
1,1083,1701,414,1083,1497
1,713,1120,205,713,918
1,713,1120,194,713,907
1,487,783,194,487,681
18,26,70,767,468,1235
25,26,70,1065,650,1715
13,26,70,554,338,892
6,26,70,256,156,412
25,3,9,146,75,221
16,3,9,95,48,143
18,3,9,105,54,159
4,1,2,2,4,6
24,1,2,13,24,37
9,9,25,142,81,223
12,9,25,189,108,297
27,9,25,425,243,668
16,1,2,14,16,30
10,9,25,143,90,233
14,1,2,9,14,23
19,1,4,47,19,66
21,9,25,331,189,520
5,12,33,75,60,135
10,12,33,151,120,271
10,1,2,10,10,20
24,1,2,23,24,47
21,1,2,19,21,40
22,1,2,20,22,42
17,1,2,9,17,26
23,2,5,44,46,90
14,2,5,27,28,55
2,13,35,29,26,55
26,13,35,372,338,710
5,13,35,72,65,137
2,1,2,2,2,4
18,1,2,16,18,34
10,2,5,19,20,39
9,2,5,17,18,35
8,8,21,69,64,133
6,8,21,52,48,100
21,2,5,56,42,98
30,1,2,19,30,49
9,1,2,6,9,15
8,1,4,18,8,26
10,1,4,23,10,33
20,2,5,58,40,98
3,2,5,9,6,15
12,2,5,35,24,59
20,2,5,38,40,78
8,1,2,8,8,16
13,2,5,38,26,64
25,8,21,315,200,515
25,8,21,315,200,515
3,1,2,3,3,6
25,1,2,25,25,50
30,1,2,28,30,58
4,2,5,9,8,17
6,1,2,3,6,9
1,1482,2384,592,1482,2074
1,1482,2384,401,1482,1883
1,461,742,251,461,712
1,1482,2384,854,1482,2336
1,755,1215,436,755,1191
1,1482,2384,592,1482,2074
1,1482,2384,854,1482,2336
1,1482,2384,807,1482,2289
10,45,120,486,450,936
8,59,159,775,472,1247
2,2,5,6,4,10
6,2,5,17,12,29
10,2,5,28,20,48
3,2,5,8,6,14
6,2,5,13,12,25
9,2,5,27,18,45
13,2,5,38,26,64
7,2,5,14,14,28
20,2,5,39,40,79
5,2,5,15,10,25
3,2,5,9,6,15
8,2,5,15,16,31
1,2,5,2,2,4
15,2,5,35,30,65
8,2,5,24,16,40
11,2,5,32,22,54
16,3,9,93,48,141
20,3,9,116,60,176
5,2,5,14,10,24
25,2,5,70,50,120
27,2,5,59,54,113
3,2,5,7,6,13
11,7,9,21,77,98
13,7,9,0,91,91
2,7,9,1,14,15
26,7,9,3,182,185
26,7,9,50,182,232
22,7,9,40,154,194
29,7,9,24,203,227
18,7,9,30,126,156
16,3,8,53,48,101
3,3,8,14,9,23
29,3,8,103,87,190
22,8,22,298,176,474
29,8,22,393,232,625
23,8,22,312,184,496
1,8,22,12,8,20
30,8,22,275,240,515
27,8,22,372,216,588
2,8,22,28,16,44
30,8,22,413,240,653
12,8,22,157,96,253
30,9,24,400,270,670
16,13,35,346,208,554
30,13,35,639,390,1029
26,13,35,508,338,846
21,13,35,447,273,720
16,13,35,341,208,549
21,13,35,300,273,573
7,13,35,144,91,235
4,13,35,73,52,125
25,13,35,515,325,840
7,13,35,144,91,235
5,13,35,79,65,144
28,13,35,596,364,960
12,13,35,172,156,328
3,13,35,62,39,101
11,13,35,238,143,381
27,13,35,556,351,907
22,13,35,476,286,762
25,13,35,515,325,840
24,13,35,436,312,748
11,13,35,192,143,335
20,13,35,433,260,693
25,21,55,836,525,1361
11,21,55,362,231,593
12,38,50,132,456,588
16,38,50,184,608,792
26,38,50,221,988,1209
7,38,50,77,266,343
23,38,50,230,874,1104
1,42,54,3,42,45
16,38,50,176,608,784
1,1898,3375,1038,1898,2936
1,1266,2320,1008,1266,2274
1,1252,2295,538,1252,1790
1,1266,2320,1008,1266,2274
1,1252,2295,997,1252,2249
1,1266,2320,1008,1266,2274
1,420,769,295,420,715
1,1266,2320,544,1266,1810
1,420,769,334,420,754
1,1266,2320,1031,1266,2297
1,1252,2295,1020,1252,2272
1,1252,2295,997,1252,2249
1,295,540,240,295,535
1,1266,2320,1008,1266,2274
1,487,783,132,487,619
1,1519,2443,900,1519,2419
1,2171,3578,835,2171,3006
1,1083,1701,397,1083,1480
1,2171,3578,656,2171,2827
1,2171,3578,942,2171,3113
1,487,783,265,487,752
1,1083,1701,550,1083,1633
1,1555,2443,570,1555,2125
1,713,1120,205,713,918
1,487,783,194,487,681
1,2171,3578,1371,2171,3542
1,2171,3578,1335,2171,3506
24,26,70,1022,624,1646
11,26,70,469,286,755
24,26,70,1022,624,1646
18,26,70,628,468,1096
14,3,9,81,42,123
8,3,9,32,24,56
15,1,2,15,15,30
18,1,2,18,18,36
11,1,2,11,11,22
27,1,2,26,27,53
12,1,2,8,12,20
27,1,2,18,27,45
4,12,33,79,48,127
6,12,33,118,72,190
21,2,5,62,42,104
30,2,5,89,60,149
21,2,5,51,42,93
27,11,30,367,297,664
7,11,30,95,77,172
7,13,35,149,91,240
30,2,5,63,60,123
13,2,5,27,26,53
21,1,2,13,21,34
28,1,2,17,28,45
4,1,2,2,4,6
5,2,5,15,10,25
29,2,5,84,58,142
26,2,5,77,52,129
16,2,5,47,32,79
4,2,5,8,8,16
17,2,5,32,34,66
16,2,5,30,32,62
5,1,4,11,5,16
7,1,4,16,7,23
2,1,4,5,2,7
5,8,21,61,40,101
27,8,21,328,216,544
14,2,5,34,28,62
3,1,2,2,3,5
7,2,5,16,14,30
11,2,5,25,22,47
16,2,5,37,32,69
2,2,5,6,4,10
9,2,5,26,18,44
9,8,21,115,72,187
22,8,21,281,176,457
1,2,5,2,2,4
3,2,5,7,6,13
28,1,4,59,28,87
5,1,4,11,5,16
3,1,4,6,3,9
15,9,25,233,135,368
20,9,25,310,180,490
11,1,4,23,11,34
18,1,4,38,18,56
15,2,5,44,30,74
24,2,5,70,48,118
1,461,742,185,461,646
1,461,742,118,461,579
1,1482,2384,735,1482,2217
1,1482,2384,807,1482,2289
1,1482,2384,807,1482,2289
1,1482,2384,378,1482,1860
1,755,1215,193,755,948
1,1482,2384,807,1482,2289
10,45,120,486,450,936
3,2,5,8,6,14
24,2,5,67,48,115
24,2,5,46,48,94
21,2,5,40,42,82
3,2,5,8,6,14
1,4,10,4,4,8
17,4,10,65,68,133
6,2,5,17,12,29
5,2,5,13,10,23
10,2,5,27,20,47
15,2,5,33,30,63
24,2,5,53,48,101
24,2,5,70,48,118
28,2,5,81,56,137
7,2,5,21,14,35
11,4,10,46,44,90
5,4,10,21,20,41
2,2,5,5,4,9
20,2,5,53,40,93
25,2,5,73,50,123
6,2,5,17,12,29
25,2,5,70,50,120
21,2,5,61,42,103
13,2,5,38,26,64
26,2,5,77,52,129
11,2,5,31,22,53
27,2,5,76,54,130
29,7,9,55,203,258
24,7,9,39,168,207
1,7,9,1,7,8
1,7,9,1,7,8
13,7,9,21,91,112
30,7,9,55,210,265
20,7,9,33,140,173
2,7,9,0,14,14
5,3,8,17,15,32
21,3,8,81,63,144
22,3,8,103,66,169
20,3,8,94,60,154
29,8,22,323,232,555
25,8,22,339,200,539
14,8,22,128,112,240
25,8,22,229,200,429
17,8,22,234,136,370
26,8,22,341,208,549
17,8,22,234,136,370
4,8,22,55,32,87
22,9,24,319,198,517
23,9,24,323,207,530
4,9,24,43,36,79
9,9,24,131,81,212
12,13,35,256,156,412
15,13,35,236,195,431
29,13,35,628,377,1005
29,13,35,476,377,853
21,13,35,433,273,706
27,13,35,424,351,775
16,13,35,346,208,554
18,13,35,295,234,529
23,13,35,490,299,789
11,13,35,234,143,377
23,13,35,474,299,773
13,13,35,227,169,396
5,13,35,98,65,163
24,13,35,377,312,689
24,13,35,377,312,689
13,13,35,277,169,446
13,13,35,281,169,450
7,13,35,110,91,201
22,13,35,469,286,755
20,13,35,286,260,546
24,13,35,511,312,823
13,13,35,268,169,437
16,21,55,430,336,766
29,21,55,922,609,1531
29,21,55,970,609,1579
4,42,54,9,168,177
2,38,50,3,76,79
7,38,50,18,266,284
28,42,54,18,1176,1194
7,42,54,24,294,318
24,42,54,81,1008,1089
7,38,50,70,266,336
11,42,54,7,462,469
16,38,50,80,608,688
1,1898,3375,1038,1898,2936
1,1252,2295,997,1252,2249
1,1252,2295,538,1252,1790
1,420,769,318,420,738
1,1252,2295,538,1252,1790
1,295,540,240,295,535
1,1266,2320,892,1266,2158
1,308,565,246,308,554
1,1252,2295,630,1252,1882
1,1252,2295,1020,1252,2272
1,2171,3578,763,2171,2934
1,344,540,185,344,529
1,2171,3578,763,2171,2934
1,2171,3578,835,2171,3006
1,2171,3578,942,2171,3113
1,344,540,158,344,502
1,1555,2443,570,1555,2125
1,713,1120,228,713,941
1,1083,1701,550,1083,1633
1,1083,1701,261,1083,1344
1,487,783,132,487,619
1,487,783,132,487,619
1,344,540,174,344,518
1,344,540,174,344,518
1,344,540,174,344,518
26,26,70,907,676,1583
29,26,70,1235,754,1989
8,26,70,279,208,487
19,3,9,102,57,159
5,3,9,25,15,40
29,2,5,64,58,122
18,2,5,40,36,76
21,8,21,269,168,437
22,8,21,281,176,457
13,8,21,166,104,270
30,2,5,87,60,147
2,2,5,6,4,10
16,1,2,16,16,32
26,1,2,15,26,41
27,13,35,462,351,813
27,13,35,462,351,813
21,13,35,359,273,632
17,13,35,291,221,512
1,13,35,21,13,34
30,13,35,639,390,1029
16,13,35,341,208,549
8,2,5,22,16,38
21,2,5,59,42,101
7,2,5,20,14,34
28,2,5,81,56,137
11,1,2,7,11,18
7,1,2,4,7,11
1,13,35,22,13,35
18,13,35,390,234,624
13,1,2,8,13,21
13,11,30,243,143,386
8,11,30,150,88,238
14,11,30,262,154,416
25,1,4,74,25,99
28,1,4,83,28,111
28,1,4,83,28,111
18,2,5,50,36,86
26,2,5,73,52,125
22,2,5,62,44,106
27,2,5,76,54,130
27,2,5,76,54,130
25,1,2,24,25,49
1,1,2,1,1,2
5,2,5,15,10,25
22,11,30,279,242,521
11,11,30,140,121,261
17,1,2,17,17,34
24,1,2,22,24,46
14,1,2,13,14,27
11,9,25,140,99,239
18,9,25,230,162,392
22,1,2,16,22,38
18,1,2,13,18,31
17,8,21,175,136,311
12,8,21,123,96,219
21,8,21,216,168,384
12,1,2,7,12,19
15,1,2,8,15,23
25,2,5,53,50,103
18,2,5,38,36,74
29,1,2,28,29,57
17,1,2,16,17,33
2,1,2,2,2,4
5,1,2,5,5,10
8,1,2,7,8,15
19,2,5,55,38,93
28,2,5,81,56,137
4,1,4,12,4,16
2,1,4,6,2,8
1,1482,2384,473,1482,1955
1,1482,2384,807,1482,2289
1,1482,2384,521,1482,2003
1,461,742,162,461,623
1,1482,2384,807,1482,2289
1,1482,2384,592,1482,2074
1,461,742,274,461,735
1,1482,2384,878,1482,2360
1,461,742,274,461,735
1,1482,2384,568,1482,2050
1,1482,2384,854,1482,2336
1,755,1215,436,755,1191
1,755,1215,436,755,1191
1,1482,2384,473,1482,1955
1,1482,2384,854,1482,2336
1,755,1215,314,755,1069
1,755,1215,375,755,1130
1,1482,2384,378,1482,1860
1,1482,2384,568,1482,2050
6,24,64,190,144,334
6,24,64,236,144,380
21,45,120,1121,945,2066
5,59,159,389,295,684
3,59,159,195,177,372
3,2,5,7,6,13
28,2,5,66,56,122
3,2,5,9,6,15
12,2,5,28,24,52
16,2,5,38,32,70
24,3,9,142,72,214
1,4,10,6,4,10
16,2,5,30,32,62
19,2,5,36,38,74
28,4,10,106,112,218
30,4,10,114,120,234
14,2,5,41,28,69
23,2,5,68,46,114
6,2,5,17,12,29
14,2,5,39,28,67
26,2,5,73,52,125
28,2,5,78,56,134
2,4,10,12,8,20
27,4,10,157,108,265
3,2,5,9,6,15
26,2,5,75,52,127
12,2,5,35,24,59
9,2,5,27,18,45
15,2,5,32,30,62
21,2,5,44,42,86
14,3,9,75,42,117
30,3,9,161,90,251
18,2,5,42,36,78
17,2,5,50,34,84
22,2,5,64,44,108
25,2,5,73,50,123
24,7,9,44,168,212
27,7,9,22,189,211
2,7,9,3,14,17
27,7,9,10,189,199
2,7,9,0,14,14
19,7,9,31,133,164
15,7,9,8,105,113
21,7,9,29,147,176
25,7,9,46,175,221
1,3,8,5,3,8
23,3,8,75,69,144
9,3,8,30,27,57
18,3,8,71,54,125
25,3,8,121,75,196
14,3,8,55,42,97
2,8,22,20,16,36
9,8,22,122,72,194
7,8,22,64,56,120
13,8,22,162,104,266
2,8,22,22,16,38
30,8,22,334,240,574
9,8,22,118,72,190
25,8,22,218,200,418
19,9,24,280,171,451
10,9,24,145,90,235
21,9,24,310,189,499
1,9,24,10,9,19
27,9,24,321,243,564
6,9,24,55,54,109
20,9,24,295,180,475
30,9,24,356,270,626
11,9,24,123,99,222
20,9,24,290,180,470
4,9,24,58,36,94
28,13,35,489,364,853
11,13,35,238,143,381
5,13,35,87,65,152
1,13,35,14,13,27
17,13,35,297,221,518
9,13,35,185,117,302
25,13,35,515,325,840
15,13,35,325,195,520
18,13,35,257,234,491
15,13,35,262,195,457
14,13,35,230,182,412
14,13,35,298,182,480
9,13,35,157,117,274
22,13,35,469,286,755
1,13,35,16,13,29
2,13,35,41,26,67
11,13,35,192,143,335
20,13,35,391,260,651
30,13,35,513,390,903
6,13,35,128,78,206
22,13,35,469,286,755
4,13,35,85,52,137
19,13,35,272,247,519
5,13,35,107,65,172
21,13,35,344,273,617
24,13,35,419,312,731
30,13,35,429,390,819
29,21,55,970,609,1579
26,21,55,827,546,1373
6,38,50,18,228,246
8,38,50,44,304,348
23,38,50,230,874,1104
10,38,50,110,380,490
15,42,54,172,630,802
15,38,50,75,570,645
22,38,50,88,836,924
1,38,50,3,38,41
6,42,54,30,252,282
13,38,50,130,494,624
7,42,54,69,294,363
9,38,50,0,342,342
11,42,54,7,462,469
14,38,50,154,532,686
15,38,50,83,570,653
20,42,54,164,840,1004
17,38,50,145,646,791
17,42,54,85,714,799
15,42,54,2,630,632
1,1252,2295,722,1252,1974
1,1266,2320,1008,1266,2274
1,1252,2295,745,1252,1997
1,1252,2295,882,1252,2134
1,1252,2295,538,1252,1790
1,1252,2295,1020,1252,2272
1,420,769,334,420,754
1,295,540,126,295,421
1,420,769,318,420,738
1,420,769,318,420,738
1,1252,2295,951,1252,2203
1,295,540,148,295,443
1,295,540,169,295,464
1,1252,2295,630,1252,1882
1,1555,2443,717,1555,2272
1,487,783,124,487,611
1,1555,2443,839,1555,2394
1,2171,3578,835,2171,3006
1,487,783,155,487,642
1,2171,3578,835,2171,3006
1,2171,3578,763,2171,2934
1,1083,1701,499,1083,1582
1,344,540,174,344,518
1,344,540,77,344,421
1,344,540,185,344,529
1,1083,1701,346,1083,1429
1,344,540,77,344,421
1,344,540,126,344,470
1,344,540,83,344,427
1,1083,1701,499,1083,1582
1,713,1120,205,713,918
1,1555,2443,864,1555,2419
1,713,1120,261,713,974
1,487,783,194,487,681
1,1083,1701,550,1083,1633
1,487,783,194,487,681
1,487,783,132,487,619
1,713,1120,172,713,885
1,344,540,174,344,518
1,2171,3578,620,2171,2791
1,26,70,43,26,69
8,26,70,346,208,554
22,26,70,937,572,1509
23,26,70,803,598,1401
18,26,70,628,468,1096
16,26,70,469,416,885
7,26,70,303,182,485
18,3,9,72,54,126
7,3,9,39,21,60
24,3,9,105,72,177
19,3,9,107,57,164
26,3,9,126,78,204
17,13,35,291,221,512
27,13,35,462,351,813
18,2,5,52,36,88
5,2,5,15,10,25
30,1,2,22,30,52
14,1,2,10,14,24
30,1,2,29,30,59
25,1,2,25,25,50
18,1,2,18,18,36
20,1,2,18,20,38
7,13,35,152,91,243
18,13,35,390,234,624
22,1,2,21,22,43
5,1,2,5,5,10
17,1,2,11,17,28
23,1,2,15,23,38
8,1,2,5,8,13
29,1,2,16,29,45
8,1,2,4,8,12
3,2,5,9,6,15
24,8,21,277,192,469
21,8,21,242,168,410
23,1,2,16,23,39
8,1,2,5,8,13
21,1,2,18,21,39
26,1,2,22,26,48
29,12,33,485,348,833
8,12,33,134,96,230
25,2,5,55,50,105
1,2,5,2,2,4
11,1,4,31,11,42
28,1,4,80,28,108
29,1,2,21,29,50
20,1,2,15,20,35
6,8,21,55,48,103
7,8,21,65,56,121
17,2,5,32,34,66
14,2,5,27,28,55
28,2,5,53,56,109
26,2,5,49,52,101
3,2,5,8,6,14
21,2,5,59,42,101
2,12,33,27,24,51
11,12,33,151,132,283
9,1,4,26,9,35
8,1,4,23,8,31
19,1,4,43,19,62
20,1,4,58,20,78
14,1,4,41,14,55
7,1,2,4,7,11
8,11,29,114,88,202
13,11,29,185,143,328
28,1,4,69,28,97
23,1,4,57,23,80
21,1,4,52,21,73
28,1,4,82,28,110
10,1,4,29,10,39
22,9,25,341,198,539
13,1,4,32,13,45
19,1,4,43,19,62
1,1482,2384,592,1482,2074
1,1482,2384,592,1482,2074
1,1482,2384,473,1482,1955
1,461,742,185,461,646
1,1482,2384,854,1482,2336
1,461,742,266,461,727
1,1482,2384,854,1482,2336
1,1482,2384,854,1482,2336
1,1482,2384,378,1482,1860
1,1482,2384,807,1482,2289
21,24,64,665,504,1169
19,24,64,748,456,1204
23,24,64,817,552,1369
4,45,120,238,180,418
1,59,159,65,59,124
1,59,159,94,59,153
17,2,5,49,34,83
3,2,5,9,6,15
29,2,5,84,58,142
8,3,9,45,24,69
21,2,5,59,42,101
19,4,10,110,76,186
12,4,10,70,48,118
8,4,10,46,32,78
18,4,10,104,72,176
29,2,5,68,58,126
21,2,5,49,42,91
29,3,9,169,87,256
16,3,9,93,48,141
16,3,9,86,48,134
13,3,9,70,39,109
27,3,9,111,81,192
21,3,9,86,63,149
23,2,5,54,46,100
16,2,5,38,32,70
4,7,9,8,28,36
3,7,9,5,21,26
6,7,9,2,42,44
11,7,9,8,77,85
19,7,9,31,133,164
21,7,9,17,147,164
19,3,8,62,57,119
28,8,22,256,224,480
25,8,22,273,200,473
13,8,22,176,104,280
28,8,22,380,224,604
25,8,22,345,200,545
9,8,22,118,72,190
15,8,22,137,120,257
22,8,22,303,176,479
9,9,24,100,81,181
11,9,24,160,99,259
13,9,24,183,117,300
8,9,24,116,72,188
23,9,24,334,207,541
7,13,35,100,91,191
4,13,35,85,52,137
18,13,35,383,234,617
21,13,35,330,273,603
19,13,35,391,247,638
5,13,35,79,65,144
3,13,35,65,39,104
27,13,35,556,351,907
8,13,35,131,104,235
8,13,35,140,104,244
19,13,35,411,247,658
13,13,35,277,169,446
27,13,35,575,351,926
21,13,35,300,273,573
20,13,35,426,260,686
8,13,35,173,104,277
5,13,35,73,65,138
10,13,35,213,130,343
21,13,35,366,273,639
2,13,35,43,26,69
13,13,35,190,169,359
12,21,55,382,252,634
20,21,55,658,420,1078
28,21,55,890,588,1478
1,42,54,1,42,43
24,38,50,24,912,936
8,38,50,88,304,392
15,42,54,67,630,697
7,42,54,69,294,363
17,42,54,85,714,799
3,42,54,33,126,159
27,38,50,297,1026,1323
26,38,50,260,988,1248
29,42,54,144,1218,1362
1,1266,2320,892,1266,2158
1,1252,2295,951,1252,2203
1,420,769,318,420,738
1,1252,2295,745,1252,1997
1,1266,2320,544,1266,1810
1,420,769,334,420,754
1,295,540,234,295,529
1,1266,2320,729,1266,1995
1,1252,2295,538,1252,1790
1,344,540,66,344,410
1,2171,3578,763,2171,2934
1,1555,2443,790,1555,2345
1,2171,3578,835,2171,3006
1,2171,3578,942,2171,3113
1,1555,2443,839,1555,2394
1,2171,3578,656,2171,2827
1,2171,3578,835,2171,3006
1,344,540,185,344,529
1,1555,2443,570,1555,2125
1,344,540,185,344,529
1,2171,3578,620,2171,2791
1,1555,2443,570,1555,2125
22,26,70,953,572,1525
19,26,70,809,494,1303
10,26,70,426,260,686
24,3,9,96,72,168
5,3,9,28,15,43
5,2,5,10,10,20
1,2,5,2,2,4
30,13,35,513,390,903
23,2,5,68,46,114
28,2,5,83,56,139
23,2,5,64,46,110
6,2,5,17,12,29
5,1,4,15,5,20
26,1,4,77,26,103
28,1,4,80,28,108
21,1,4,60,21,81
10,9,25,115,90,205
19,11,30,236,209,445
16,11,30,198,176,374
19,1,2,18,19,37
23,1,2,22,23,45
7,1,2,7,7,14
1,2,5,2,2,4
23,2,5,53,46,99
18,2,5,41,36,77
19,2,5,44,38,82
28,2,5,66,56,122
3,1,2,2,3,5
17,1,2,10,17,27
20,2,5,59,40,99
9,2,5,27,18,45
18,1,2,18,18,36
4,1,2,4,4,8
18,1,2,18,18,36
12,1,2,8,12,20
4,1,2,3,4,7
5,1,2,3,5,8
17,13,35,350,221,571
23,1,2,17,23,40
9,1,2,7,9,16
29,13,35,476,377,853
23,11,30,409,253,662
20,1,2,15,20,35
9,12,33,127,108,235
2,12,33,28,24,52
26,8,21,316,208,524
15,1,2,15,15,30
28,11,30,515,308,823
1,11,30,19,11,30
3,1,4,9,3,12
27,12,33,371,324,695
19,12,33,261,228,489
2,1,4,5,2,7
2,1,4,5,2,7
16,1,2,16,16,32
30,2,5,71,60,131
17,1,4,50,17,67
26,1,4,76,26,102
1,755,1215,411,755,1166
1,461,742,185,461,646
1,755,1215,241,755,996
1,461,742,251,461,712
1,1482,2384,807,1482,2289
1,1482,2384,854,1482,2336
1,1482,2384,854,1482,2336
1,755,1215,436,755,1191
2,45,120,119,90,209
1,59,159,75,59,134
10,2,5,22,20,42
18,2,5,40,36,76
19,2,5,34,38,72
19,2,5,34,38,72
8,3,9,36,24,60
30,2,5,59,60,119
25,2,5,59,50,109
16,2,5,38,32,70
10,2,5,28,20,48
30,2,5,84,60,144
27,2,5,51,54,105
2,2,5,4,4,8
7,2,5,15,14,29
19,2,5,40,38,78
23,3,9,111,69,180
3,3,9,14,9,23
22,4,10,128,88,216
28,4,10,162,112,274
11,2,5,21,22,43
6,2,5,17,12,29
13,2,5,38,26,64
14,2,5,25,28,53
6,3,9,32,18,50
21,3,9,113,63,176
15,2,5,35,30,65
7,2,5,16,14,30
7,2,5,16,14,30
17,2,5,40,34,74
24,2,5,71,48,119
27,2,5,59,54,113
10,2,5,19,20,39
21,7,9,-3,147,144
11,7,9,20,77,97
12,7,9,1,84,85
6,7,9,11,42,53
27,3,8,107,81,188
28,3,8,111,84,195
3,3,8,10,9,19
28,3,8,136,84,220
23,9,24,257,207,464
24,9,24,354,216,570
28,9,24,279,252,531
27,13,35,396,351,747
16,13,35,218,208,426
4,13,35,78,52,130
20,13,35,342,260,602
28,13,35,489,364,853
22,13,35,345,286,631
11,13,35,234,143,377
5,13,35,103,65,168
10,13,35,175,130,305
6,13,35,82,78,160
12,13,35,247,156,403
3,13,35,64,39,103
20,13,35,433,260,693
10,13,35,196,130,326
19,13,35,312,247,559
16,13,35,229,208,437
30,13,35,650,390,1040
9,13,35,157,117,274
1,13,35,15,13,28
6,21,55,197,126,323
11,21,55,362,231,593
19,21,55,573,399,972
15,42,54,123,630,753
3,38,50,33,114,147
24,42,54,145,1008,1153
15,42,54,67,630,697
14,38,50,0,532,532
6,42,54,59,252,311
1,1266,2320,497,1266,1763
1,1252,2295,882,1252,2134
1,1252,2295,722,1252,1974
1,1252,2295,538,1252,1790
1,1252,2295,538,1252,1790
1,1252,2295,630,1252,1882
1,1252,2295,882,1252,2134
1,295,540,234,295,529
1,1266,2320,961,1266,2227
1,2171,3578,1335,2171,3506
1,1555,2443,864,1555,2419
1,1519,2443,753,1519,2272
1,1083,1701,431,1083,1514
1,2171,3578,656,2171,2827
1,2171,3578,942,2171,3113
1,2171,3578,942,2171,3113
1,2171,3578,942,2171,3113
1,344,540,191,344,535
1,713,1120,261,713,974
1,1555,2443,864,1555,2419
1,344,540,110,344,454
1,2171,3578,1335,2171,3506
22,26,70,629,572,1201
20,26,70,852,520,1372
24,26,70,1022,624,1646
15,26,70,650,390,1040
15,3,9,87,45,132
22,8,21,189,176,365
5,8,21,43,40,83
27,1,2,23,27,50
29,1,2,25,29,54
17,1,2,17,17,34
19,1,2,19,19,38
16,2,5,46,32,78
16,13,35,341,208,549
7,1,4,17,7,24
21,1,4,50,21,71
25,1,2,19,25,44
4,1,2,3,4,7
2,2,5,5,4,9
13,2,5,31,26,57
4,2,5,9,8,17
27,1,2,18,27,45
29,1,2,20,29,49
22,1,2,15,22,37
28,1,2,19,28,47
14,1,2,10,14,24
7,2,5,20,14,34
23,2,5,68,46,114
28,11,30,473,308,781
8,12,33,163,96,259
18,12,33,366,216,582
21,12,33,427,252,679
20,1,4,54,20,74
25,1,4,68,25,93
13,12,33,179,156,335
3,12,33,41,36,77
29,2,5,86,58,144
27,2,5,80,54,134
14,1,4,40,14,54
26,1,2,19,26,45
7,1,4,20,7,27
20,1,4,58,20,78
19,2,5,55,38,93
21,2,5,61,42,103
17,1,2,15,17,32
8,1,4,23,8,31
24,1,4,68,24,92
1,1482,2384,521,1482,2003
1,755,1215,266,755,1021
1,461,742,185,461,646
1,1482,2384,854,1482,2336
1,1482,2384,592,1482,2074
1,1482,2384,568,1482,2050
1,461,742,125,461,586
15,24,64,590,360,950
8,2,5,24,16,40
2,4,10,12,8,20
1,2,5,3,2,5
4,2,5,12,8,20
4,4,10,15,16,31
13,2,5,29,26,55
11,2,5,24,22,46
17,3,9,99,51,150
27,4,10,124,108,232
27,4,10,124,108,232
24,2,5,55,48,103
30,2,5,69,60,129
2,4,10,9,8,17
28,4,10,129,112,241
2,4,10,9,8,17
11,4,10,48,44,92
27,7,9,1,189,190
26,7,9,19,182,201
21,3,8,81,63,144
18,8,22,165,144,309
22,8,22,206,176,382
6,8,22,81,48,129
27,8,22,247,216,463
14,8,22,190,112,302
29,8,22,272,232,504
19,8,22,249,152,401
25,8,22,339,200,539
21,9,24,305,189,494
8,9,24,80,72,152
5,9,24,74,45,119
22,9,24,319,198,517
4,13,35,87,52,139
16,13,35,251,208,459
17,13,35,350,221,571
13,13,35,281,169,450
29,13,35,628,377,1005
9,13,35,185,117,302
24,13,35,469,312,781
19,13,35,371,247,618
22,13,35,345,286,631
13,13,35,281,169,450
9,13,35,148,117,265
27,13,35,471,351,822
4,13,35,85,52,137
30,13,35,618,390,1008
16,21,55,509,336,845
3,21,55,79,63,142
30,38,50,345,1140,1485
10,38,50,115,380,495
22,38,50,66,836,902
16,38,50,160,608,768
5,38,50,8,190,198
4,42,54,20,168,188
14,42,54,32,588,620
16,42,54,71,672,743
15,38,50,15,570,585
1,1898,3375,768,1898,2666
1,1252,2295,1020,1252,2272
1,1266,2320,636,1266,1902
1,420,769,334,420,754
1,295,540,234,295,529
1,1266,2320,961,1266,2227
1,1252,2295,538,1252,1790
1,713,1120,362,713,1075
1,344,540,185,344,529
1,344,540,120,344,464
18,26,70,779,468,1247
9,26,70,383,234,617
11,26,70,453,286,739
2,26,70,57,52,109
27,3,9,157,81,238
6,1,2,6,6,12
26,1,2,22,26,48
16,1,2,14,16,30
11,1,2,11,11,22
22,1,2,22,22,44
22,13,35,476,286,762
10,13,35,217,130,347
11,13,35,238,143,381
19,1,4,56,19,75
1,2,5,3,2,5
13,1,4,38,13,51
30,9,25,323,270,593
27,12,33,407,324,731
26,12,33,392,312,704
6,2,5,11,12,23
17,1,2,17,17,34
9,1,2,9,9,18
28,2,5,83,56,139
1,2,5,3,2,5
7,1,2,7,7,14
3,2,5,8,6,14
4,2,5,11,8,19
8,2,5,23,16,39
4,2,5,12,8,20
6,1,4,18,6,24
29,1,4,86,29,115
16,1,2,10,16,26
21,9,25,331,189,520
9,9,25,142,81,223
10,2,5,28,20,48
24,2,5,67,48,115
26,12,33,529,312,841
19,12,33,386,228,614
11,1,4,26,11,37
25,1,4,59,25,84
11,1,2,6,11,17
9,1,2,5,9,14
9,1,2,5,9,14
12,2,5,34,24,58
17,2,5,48,34,82
9,2,5,25,18,43
26,1,2,15,26,41
1,1482,2384,592,1482,2074
1,461,742,251,461,712
1,755,1215,205,755,960
1,1482,2384,854,1482,2336
1,461,742,229,461,690
1,1482,2384,473,1482,1955
1,461,742,125,461,586
27,24,64,838,648,1486
8,24,64,207,192,399
10,45,120,618,450,1068
25,2,5,74,50,124
15,2,5,44,30,74
16,2,5,47,32,79
4,2,5,12,8,20
8,2,5,23,16,39
10,4,10,58,40,98
5,4,10,29,20,49
15,2,5,42,30,72
18,2,5,50,36,86
29,2,5,55,58,113
30,2,5,57,60,117
8,2,5,15,16,31
16,2,5,45,32,77
16,2,5,45,32,77
2,2,5,6,4,10
20,2,5,58,40,98
9,2,5,25,18,43
21,2,5,59,42,101
9,3,9,52,27,79
21,2,5,61,42,103
24,2,5,70,48,118
6,3,9,28,18,46
10,3,9,47,30,77
22,2,5,62,44,106
12,2,5,34,24,58
15,2,5,31,30,61
16,2,5,33,32,65
27,2,5,78,54,132
8,2,5,23,16,39
24,3,9,109,72,181
10,7,9,14,70,84
3,7,9,6,21,27
30,7,9,3,210,213
4,7,9,0,28,28
11,7,9,15,77,92
13,7,9,0,91,91
27,7,9,15,189,204
20,7,9,17,140,157
17,3,8,55,51,106
8,3,8,37,24,61
15,3,8,59,45,104
23,3,8,75,69,144
2,3,8,8,6,14
20,3,8,74,60,134
8,8,22,73,64,137
6,8,22,81,48,129
28,8,22,256,224,480
23,8,22,287,184,471
18,8,22,165,144,309
16,8,22,210,128,338
17,8,22,234,136,370
5,8,22,69,40,109
18,9,24,175,162,337
12,9,24,174,108,282
21,9,24,249,189,438
18,13,35,371,234,605
8,13,35,165,104,269
12,13,35,256,156,412
12,13,35,256,156,412
25,13,35,428,325,753
28,13,35,400,364,764
23,13,35,474,299,773
26,13,35,454,338,792
17,13,35,368,221,589
4,13,35,57,52,109
14,13,35,288,182,470
5,13,35,73,65,138
25,13,35,541,325,866
10,13,35,213,130,343
7,13,35,144,91,235
8,13,35,173,104,277
15,13,35,293,195,488
24,13,35,511,312,823
28,13,35,596,364,960
13,13,35,268,169,437
2,13,35,31,26,57
2,13,35,41,26,67
3,21,55,99,63,162
13,42,54,9,546,555
20,42,54,229,840,1069
29,38,50,247,1102,1349
10,42,54,98,420,518
13,38,50,150,494,644
25,38,50,275,950,1225
15,38,50,165,570,735
27,42,54,3,1134,1137
1,42,54,0,42,42
24,42,54,3,1008,1011
21,42,54,48,882,930
30,38,50,330,1140,1470
28,42,54,276,1176,1452
23,38,50,23,874,897
10,38,50,55,380,435
1,1252,2295,1020,1252,2272
1,1266,2320,544,1266,1810
1,1266,2320,544,1266,1810
1,1252,2295,722,1252,1974
1,1252,2295,745,1252,1997
1,1266,2320,1008,1266,2274
1,1252,2295,722,1252,1974
1,1266,2320,799,1266,2065
1,1252,2295,538,1252,1790
1,1266,2320,961,1266,2227
1,1252,2295,722,1252,1974
1,344,540,174,344,518
1,1555,2443,864,1555,2419
1,2171,3578,1264,2171,3435
1,487,783,280,487,767
1,2171,3578,942,2171,3113
1,344,540,120,344,464
1,1083,1701,346,1083,1429
1,2171,3578,1371,2171,3542
1,1083,1701,295,1083,1378
1,1083,1701,397,1083,1480
1,713,1120,261,713,974
1,487,783,194,487,681
1,344,540,174,344,518
1,487,783,132,487,619
1,344,540,110,344,454
1,2171,3578,1371,2171,3542
30,26,70,1047,780,1827
18,26,70,742,468,1210
24,26,70,821,624,1445
18,26,70,767,468,1235
6,3,9,35,18,53
25,3,9,101,75,176
4,1,2,4,4,8
29,1,2,28,29,57
7,1,2,7,7,14
29,2,5,67,58,125
13,2,5,30,26,56
5,11,30,94,55,149
5,1,2,4,5,9
30,2,5,89,60,149
30,2,5,89,60,149
7,13,35,149,91,240
9,12,33,177,108,285
15,11,30,222,165,387
6,1,2,6,6,12
17,1,2,16,17,33
18,1,2,17,18,35
20,2,5,38,40,78
21,2,5,40,42,82
29,2,5,55,58,113
10,2,5,28,20,48
30,2,5,84,60,144
5,9,25,54,45,99
11,1,2,10,11,21
3,1,4,7,3,10
6,1,4,15,6,21
3,1,2,2,3,5
29,1,2,19,29,48
22,1,2,14,22,36
17,1,4,46,17,63
12,8,21,111,96,207
1,1,2,1,1,2
24,1,2,18,24,42
16,1,2,15,16,31
12,2,5,23,24,47
12,8,21,151,96,247
17,1,2,12,17,29
22,1,4,47,22,69
13,1,2,12,13,25
10,1,2,10,10,20
25,1,4,71,25,96
22,1,4,62,22,84
1,461,742,251,461,712
1,1482,2384,807,1482,2289
1,1482,2384,854,1482,2336
1,1482,2384,378,1482,1860
1,1482,2384,854,1482,2336
1,1482,2384,854,1482,2336
1,1482,2384,568,1482,2050
1,1482,2384,854,1482,2336
1,461,742,185,461,646
13,24,64,487,312,799
16,24,64,497,384,881
19,2,5,40,38,78
19,2,5,40,38,78
26,2,5,77,52,129
12,4,10,56,48,104
3,2,5,8,6,14
11,2,5,31,22,53
3,4,10,17,12,29
1,4,10,6,4,10
20,4,10,118,80,198
6,4,10,35,24,59
4,2,5,9,8,17
28,2,5,64,56,120
13,4,10,77,52,129
28,4,10,165,112,277
2,4,10,12,8,20
13,2,5,38,26,64
3,2,5,9,6,15
18,2,5,52,36,88
27,2,5,80,54,134
27,2,5,80,54,134
9,4,10,42,36,78
19,2,5,44,38,82
4,2,5,9,8,17
30,2,5,87,60,147
5,2,5,12,10,22
8,2,5,18,16,34
20,2,5,58,40,98
3,3,9,17,9,26
30,3,9,175,90,265
17,3,9,78,51,129
7,3,9,32,21,53
19,2,5,45,38,83
26,7,9,47,182,229
8,7,9,15,56,71
30,7,9,55,210,265
5,7,9,2,35,37
20,7,9,15,140,155
20,3,8,98,60,158
16,3,8,77,48,125
9,8,22,124,72,196
24,8,22,325,192,517
2,8,22,18,16,34
14,8,22,190,112,302
17,8,22,186,136,322
16,8,22,147,128,275
12,8,22,157,96,253
12,8,22,163,96,259
15,8,22,197,120,317
30,8,22,413,240,653
27,9,24,269,243,512
27,9,24,262,243,505
23,9,24,334,207,541
13,9,24,189,117,306
27,13,35,396,351,747
17,13,35,362,221,583
28,13,35,489,364,853
4,13,35,63,52,115
24,13,35,410,312,722
3,13,35,62,39,101
24,13,35,520,312,832
26,13,35,563,338,901
3,13,35,65,39,104
3,13,35,64,39,103
18,13,35,257,234,491
28,13,35,400,364,764
29,13,35,425,377,802
14,13,35,298,182,480
21,13,35,411,273,684
17,13,35,368,221,589
11,13,35,238,143,381
21,13,35,381,273,654
4,13,35,85,52,137
26,13,35,554,338,892
8,13,35,173,104,277
5,13,35,73,65,138
17,13,35,267,221,488
16,13,35,346,208,554
30,13,35,639,390,1029
5,13,35,108,65,173
11,13,35,192,143,335
28,13,35,596,364,960
21,21,55,668,441,1109
29,21,55,731,609,1340
15,21,55,494,315,809
25,38,50,138,950,1088
29,38,50,29,1102,1131
9,42,54,21,378,399
28,42,54,321,1176,1497
3,42,54,18,126,144
7,42,54,80,294,374
6,38,50,18,228,246
20,38,50,200,760,960
1,1266,2320,636,1266,1902
1,420,769,180,420,600
1,1266,2320,752,1266,2018
1,1266,2320,752,1266,2018
1,1252,2295,1020,1252,2272
1,1252,2295,951,1252,2203
1,1252,2295,951,1252,2203
1,1252,2295,722,1252,1974
1,1266,2320,1031,1266,2297
1,1266,2320,892,1266,2158
1,420,769,334,420,754
1,1266,2320,544,1266,1810
1,1266,2320,1008,1266,2274
1,420,769,188,420,608
1,1266,2320,1008,1266,2274
1,308,565,178,308,486
1,308,565,246,308,554
1,1266,2320,961,1266,2227
1,420,769,249,420,669
1,2171,3578,1157,2171,3328
1,487,783,280,487,767
1,1083,1701,346,1083,1429
1,1555,2443,839,1555,2394
1,2171,3578,656,2171,2827
1,1083,1701,244,1083,1327
1,2171,3578,942,2171,3113
1,1083,1701,550,1083,1633
1,2171,3578,942,2171,3113
1,1555,2443,375,1555,1930
1,344,540,185,344,529
1,487,783,132,487,619
1,487,783,132,487,619
1,2171,3578,1335,2171,3506
1,2171,3578,1335,2171,3506
1,2171,3578,620,2171,2791
24,26,70,1039,624,1663
30,26,70,879,780,1659
27,1,2,15,27,42
10,1,2,6,10,16
28,1,2,16,28,44
9,8,21,77,72,149
23,8,21,198,184,382
6,8,21,52,48,100
28,11,29,374,308,682
24,11,29,321,264,585
15,11,29,192,165,357
20,11,29,256,220,476
22,13,35,476,286,762
6,13,35,130,78,208
8,2,5,19,16,35
30,2,5,71,60,131
13,2,5,38,26,64
22,9,25,237,198,435
26,9,25,280,234,514
29,9,25,312,261,573
24,11,30,326,264,590
8,1,2,4,8,12
22,1,4,60,22,82
11,1,4,30,11,41
6,1,4,16,6,22
24,9,25,360,216,576
13,9,25,195,117,312
5,1,2,3,5,8
9,1,2,5,9,14
11,1,2,6,11,17
2,9,25,29,18,47
20,9,25,285,180,465
30,1,2,28,30,58
1,1,2,1,1,2
14,1,2,11,14,25
5,1,2,4,5,9
22,9,25,253,198,451
27,9,25,311,243,554
29,9,25,450,261,711
12,9,25,186,108,294
14,11,30,262,154,416
24,11,30,449,264,713
18,11,30,337,198,535
11,2,5,32,22,54
6,2,5,18,12,30
6,1,4,14,6,20
10,1,4,23,10,33
22,2,5,43,44,87
16,2,5,31,32,63
19,1,4,54,19,73
9,1,4,26,9,35
19,1,4,55,19,74
14,9,25,217,126,343
6,9,25,93,54,147
9,9,25,140,81,221
1,1482,2384,401,1482,1883
1,755,1215,448,755,1203
1,461,742,177,461,638
1,1482,2384,854,1482,2336
1,755,1215,193,755,948
1,1482,2384,854,1482,2336
9,24,64,337,216,553
10,59,159,666,590,1256
25,2,5,74,50,124
27,2,5,80,54,134
10,2,5,23,20,43
13,3,9,70,39,109
14,3,9,75,42,117
5,4,10,30,20,50
11,4,10,65,44,109
26,2,5,77,52,129
20,2,5,59,40,99
29,2,5,81,58,139
3,2,5,8,6,14
6,2,5,17,12,29
15,2,5,42,30,72
12,2,5,35,24,59
17,2,5,49,34,83
28,2,5,59,56,115
12,3,9,68,36,104
2,3,9,11,6,17
8,3,9,38,24,62
20,3,9,95,60,155
17,2,5,33,34,67
6,2,5,17,12,29
11,2,5,32,22,54
1,2,5,2,2,4
2,3,9,11,6,17
4,3,9,23,12,35
2,7,9,3,14,17
28,7,9,53,196,249
15,7,9,21,105,126
11,7,9,4,77,81
5,7,9,4,35,39
25,7,9,41,175,216
16,3,8,79,48,127
15,3,8,73,45,118
21,3,8,98,63,161
17,3,8,67,51,118
30,8,22,407,240,647
4,8,22,44,32,76
23,8,22,211,184,395
25,8,22,312,200,512
14,8,22,184,112,296
23,8,22,256,184,440
27,8,22,372,216,588
30,9,24,400,270,670
7,9,24,102,63,165
20,9,24,194,180,374
10,9,24,100,90,190
18,9,24,261,162,423
5,9,24,49,45,94
1,13,35,20,13,33
12,13,35,209,156,365
16,13,35,341,208,549
29,13,35,628,377,1005
14,13,35,239,182,421
3,13,35,44,39,83
14,13,35,200,182,382
24,13,35,494,312,806
2,13,35,43,26,69
15,13,35,309,195,504
24,13,35,352,312,664
21,13,35,455,273,728
2,13,35,43,26,69
4,13,35,70,52,122
20,13,35,272,260,532
12,13,35,188,156,344
27,13,35,585,351,936
9,13,35,132,117,249
6,13,35,128,78,206
18,13,35,390,234,624
18,13,35,371,234,605
12,13,35,256,156,412
17,13,35,297,221,518
4,13,35,57,52,109
12,13,35,205,156,361
8,13,35,170,104,274
3,13,35,52,39,91
3,13,35,47,39,86
18,13,35,314,234,548
2,13,35,35,26,61
5,13,35,82,65,147
11,13,35,192,143,335
20,21,55,438,420,858
13,21,55,428,273,701
19,42,54,218,798,1016
29,38,50,73,1102,1175
22,42,54,110,924,1034
9,38,50,50,342,392
8,38,50,44,304,348
30,38,50,300,1140,1440
1,1266,2320,544,1266,1810
1,1898,3375,870,1898,2768
1,1252,2295,997,1252,2249
1,1252,2295,538,1252,1790
1,420,769,188,420,608
1,1252,2295,882,1252,2134
1,420,769,180,420,600
1,420,769,334,420,754
1,420,769,318,420,738
1,420,769,295,420,715
1,1266,2320,1008,1266,2274
1,420,769,318,420,738
1,1912,3400,740,1912,2652
1,1252,2295,997,1252,2249
1,2171,3578,1264,2171,3435
1,713,1120,138,713,851
1,2171,3578,942,2171,3113
1,1083,1701,550,1083,1633
1,1083,1701,312,1083,1395
1,1519,2443,606,1519,2125
1,344,540,174,344,518
1,713,1120,362,713,1075
1,344,540,120,344,464
1,1083,1701,550,1083,1633
1,344,540,83,344,427
1,487,783,194,487,681
1,1083,1701,550,1083,1633
1,344,540,83,344,427
1,344,540,191,344,535
1,2171,3578,1335,2171,3506
1,344,540,126,344,470
3,26,70,88,78,166
20,3,9,82,60,142
7,3,9,34,21,55
7,2,5,20,14,34
16,2,5,42,32,74
26,2,5,69,52,121
30,8,21,308,240,548
15,8,21,154,120,274
1,1,2,1,1,2
21,1,2,20,21,41
25,1,2,24,25,49
28,13,35,606,364,970
10,13,35,217,130,347
8,1,2,5,8,13
2,1,4,6,2,8
9,1,4,26,9,35
27,1,4,77,27,104
12,2,5,35,24,59
14,2,5,41,28,69
14,2,5,41,28,69
25,2,5,73,50,123
28,1,4,69,28,97
8,2,5,24,16,40
10,2,5,30,20,50
15,2,5,44,30,74
22,11,30,299,242,541
21,1,4,52,21,73
16,1,4,40,16,56
21,1,4,52,21,73
7,1,4,17,7,24
20,1,2,19,20,39
30,1,2,29,30,59
29,8,21,292,232,524
24,8,21,241,192,433
10,9,25,158,90,248
6,9,25,95,54,149
9,1,2,6,9,15
26,1,2,17,26,43
10,1,2,6,10,16
21,2,5,49,42,91
23,1,2,20,23,43
17,1,2,15,17,32
23,2,5,54,46,100
8,9,25,124,72,196
6,9,25,93,54,147
2,9,25,31,18,49
23,1,4,57,23,80
6,2,5,18,12,30
12,1,4,28,12,40
18,2,5,52,36,88
30,2,5,87,60,147
11,8,21,101,88,189
4,2,5,12,8,20
13,2,5,38,26,64
13,1,2,8,13,21
16,1,2,10,16,26
29,2,5,55,58,113
13,2,5,31,26,57
11,2,5,26,22,48
9,1,2,7,9,16
27,1,2,20,27,47
10,1,4,25,10,35
24,1,4,60,24,84
1,461,742,140,461,601
1,461,742,274,461,735
1,461,742,274,461,735
1,461,742,185,461,646
1,461,742,266,461,727
1,1482,2384,807,1482,2289
1,461,742,266,461,727
11,24,64,426,264,690
30,45,120,1458,1350,2808
1,59,159,67,59,126
6,2,5,17,12,29
12,2,5,34,24,58
7,2,5,20,14,34
3,2,5,9,6,15
1,2,5,3,2,5
20,2,5,53,40,93
10,2,5,21,20,41
19,2,5,40,38,78
10,3,9,59,30,89
23,3,9,136,69,205
14,2,5,29,28,57
9,2,5,19,18,37
24,2,5,71,48,119
2,2,5,6,4,10
16,2,5,45,32,77
8,2,5,15,16,31
29,3,9,137,87,224
23,3,9,109,69,178
20,3,9,116,60,176
26,4,10,151,104,255
25,4,10,145,100,245
7,2,5,21,14,35
27,2,5,76,54,130
5,2,5,14,10,24
1,3,9,6,3,9
6,3,9,34,18,52
17,2,5,37,34,71
25,2,5,55,50,105
19,2,5,55,38,93
16,2,5,46,32,78
26,7,9,15,182,197
24,7,9,39,168,207
19,7,9,36,133,169
9,7,9,3,63,66
15,7,9,6,105,111
25,7,9,41,175,216
14,7,9,10,98,108
24,7,9,33,168,201
26,3,8,128,78,206
16,3,8,77,48,125
13,8,22,119,104,223
29,8,22,393,232,625
24,8,22,325,192,517
4,8,22,54,32,86
19,8,22,262,152,414
28,8,22,263,224,487
21,9,24,305,189,494
13,9,24,154,117,271
6,9,24,87,54,141
7,13,35,144,91,235
24,13,35,520,312,832
24,13,35,469,312,781
16,13,35,274,208,482
9,13,35,157,117,274
20,13,35,293,260,553
22,13,35,376,286,662
12,13,35,188,156,344
15,13,35,325,195,520
15,13,35,220,195,415
10,13,35,213,130,343
2,13,35,31,26,57
23,13,35,401,299,700
13,13,35,277,169,446
28,13,35,596,364,960
19,13,35,411,247,658
3,13,35,49,39,88
2,13,35,29,26,55
4,13,35,57,52,109
13,13,35,268,169,437
29,13,35,455,377,832
24,21,55,539,504,1043
10,21,55,329,210,539
11,38,50,94,418,512
1,38,50,3,38,41
20,38,50,230,760,990
27,42,54,120,1134,1254
22,38,50,253,836,1089
14,42,54,138,588,726
29,42,54,19,1218,1237
1,1266,2320,961,1266,2227
1,1252,2295,997,1252,2249
1,1266,2320,1008,1266,2274
1,1252,2295,882,1252,2134
1,1266,2320,683,1266,1949
1,1266,2320,776,1266,2042
1,1252,2295,1020,1252,2272
1,1252,2295,997,1252,2249
1,1252,2295,630,1252,1882
1,1912,3400,1012,1912,2924
1,487,783,194,487,681
1,1083,1701,584,1083,1667
1,487,783,155,487,642
1,2171,3578,727,2171,2898
1,713,1120,250,713,963
1,713,1120,329,713,1042
1,344,540,174,344,518
1,2171,3578,1371,2171,3542
1,2171,3578,1371,2171,3542
1,344,540,126,344,470
1,1555,2443,864,1555,2419
1,1555,2443,717,1555,2272
1,713,1120,228,713,941
1,344,540,174,344,518
1,2171,3578,906,2171,3077
1,344,540,174,344,518
1,2171,3578,620,2171,2791
1,2171,3578,1335,2171,3506
24,26,70,821,624,1445
26,3,9,126,78,204
24,1,2,23,24,47
25,13,35,533,325,858
27,13,35,575,351,926
5,2,5,15,10,25
30,2,5,89,60,149
15,2,5,35,30,65
20,2,5,47,40,87
10,2,5,24,20,44
7,2,5,14,14,28
25,2,5,49,50,99
1,1,2,1,1,2
26,2,5,77,52,129
15,2,5,44,30,74
11,9,25,173,99,272
23,9,25,362,207,569
18,2,5,50,36,86
19,2,5,53,38,91
15,2,5,32,30,62
10,2,5,21,20,41
12,2,5,35,24,59
18,2,5,52,36,88
10,2,5,29,20,49
22,1,4,64,22,86
17,1,4,50,17,67
19,2,5,36,38,74
30,2,5,57,60,117
2,12,33,33,24,57
27,12,33,442,324,766
5,1,2,3,5,8
25,1,2,14,25,39
10,2,5,19,20,39
16,2,5,30,32,62
26,2,5,77,52,129
5,2,5,15,10,25
16,2,5,42,32,74
2,1,2,1,2,3
1,461,742,185,461,646
1,1482,2384,854,1482,2336
1,755,1215,193,755,948
1,461,742,147,461,608
1,1482,2384,401,1482,1883
1,1482,2384,878,1482,2360
1,1482,2384,521,1482,2003
2,24,64,77,48,125
7,45,120,508,315,823
5,45,120,243,225,468
18,2,5,53,36,89
3,2,5,9,6,15
9,2,5,26,18,44
10,2,5,29,20,49
22,2,5,62,44,106
18,2,5,50,36,86
6,2,5,11,12,23
25,3,9,121,75,196
6,4,10,28,24,52
1,4,10,4,4,8
22,4,10,84,88,172
4,2,5,8,8,16
10,2,5,19,20,39
29,3,9,140,87,227
29,2,5,55,58,113
8,2,5,15,16,31
13,2,5,31,26,57
11,2,5,26,22,48
2,2,5,6,4,10
18,2,5,53,36,89
17,3,9,96,51,147
8,2,5,22,16,38
10,3,9,40,30,70
2,3,9,8,6,14
16,7,9,26,112,138
28,7,9,21,196,217
2,7,9,4,14,18
11,7,9,4,77,81
8,7,9,0,56,56
7,3,8,34,21,55
17,3,8,55,51,106
13,3,8,61,39,100
9,3,8,36,27,63
19,3,8,75,57,132
12,3,8,58,36,94
11,3,8,36,33,69
9,8,22,82,72,154
8,8,22,73,64,137
27,8,22,247,216,463
1,8,22,13,8,21
23,8,22,312,184,496
27,8,22,265,216,481
19,9,24,276,171,447
5,9,24,59,45,104
16,13,35,229,208,437
5,13,35,72,65,137
13,13,35,268,169,437
18,13,35,308,234,542
22,13,35,315,286,601
9,13,35,157,117,274
10,13,35,206,130,336
8,13,35,170,104,274
21,13,35,330,273,603
7,13,35,110,91,201
27,13,35,424,351,775
25,13,35,384,325,709
7,13,35,110,91,201
6,13,35,124,78,202
12,13,35,260,156,416
7,13,35,152,91,243
30,13,35,429,390,819
26,13,35,554,338,892
11,13,35,180,143,323
16,38,50,16,608,624
19,38,50,19,722,741
2,42,54,10,84,94
7,38,50,60,266,326
28,42,54,276,1176,1452
26,42,54,129,1092,1221
28,42,54,139,1176,1315
18,42,54,197,756,953
4,42,54,39,168,207
4,42,54,44,168,212
1,1252,2295,538,1252,1790
1,1266,2320,1008,1266,2274
1,1266,2320,729,1266,1995
1,1266,2320,1031,1266,2297
1,420,769,334,420,754
1,1252,2295,538,1252,1790
1,1252,2295,745,1252,1997
1,1252,2295,951,1252,2203
1,1266,2320,544,1266,1810
1,1266,2320,961,1266,2227
1,1266,2320,544,1266,1810
1,2171,3578,906,2171,3077
1,487,783,124,487,611
1,2171,3578,835,2171,3006
1,1083,1701,550,1083,1633
1,713,1120,205,713,918
1,1555,2443,570,1555,2125
1,1555,2443,448,1555,2003
1,2171,3578,942,2171,3113
1,2171,3578,620,2171,2791
1,1083,1701,550,1083,1633
1,344,540,99,344,443
1,344,540,185,344,529
1,344,540,185,344,529
1,713,1120,261,713,974
1,713,1120,205,713,918
1,1083,1701,397,1083,1480
1,487,783,132,487,619
1,487,783,194,487,681
1,2171,3578,620,2171,2791
1,2171,3578,1335,2171,3506
1,2171,3578,1335,2171,3506
9,26,70,352,234,586
14,26,70,596,364,960
28,3,9,163,84,247
7,3,9,38,21,59
29,8,21,365,232,597
15,8,21,189,120,309
9,8,21,113,72,185
22,8,21,277,176,453
30,8,21,377,240,617
23,1,2,23,23,46
17,1,2,17,17,34
26,1,2,25,26,51
8,2,5,23,16,39
27,2,5,78,54,132
11,13,35,161,143,304
6,13,35,88,78,166
16,1,2,9,16,25
23,1,2,13,23,36
23,1,2,17,23,40
27,1,2,20,27,47
1,2,5,3,2,5
17,2,5,48,34,82
29,2,5,81,58,139
15,12,33,295,180,475
3,12,33,59,36,95
18,12,33,354,216,570
30,2,5,71,60,131
22,2,5,52,44,96
10,13,35,213,130,343
6,12,33,100,72,172
11,12,33,184,132,316
28,9,25,322,252,574
30,9,25,345,270,615
27,1,2,26,27,53
7,1,4,15,7,22
29,1,4,61,29,90
23,1,4,57,23,80
20,1,4,50,20,70
22,1,4,47,22,69
7,1,4,15,7,22
14,9,25,221,126,347
21,11,30,386,231,617
6,11,30,110,66,176
9,1,2,6,9,15
15,1,2,10,15,25
20,1,4,47,20,67
3,1,4,7,3,10
21,2,5,49,42,91
17,2,5,40,34,74
1,2,5,2,2,4
2,1,4,6,2,8
10,1,4,30,10,40
21,1,2,20,21,41
12,8,21,111,96,207
22,8,21,203,176,379
15,11,30,276,165,441
10,11,30,184,110,294
9,2,5,27,18,45
27,1,2,25,27,52
12,8,21,123,96,219
4,8,21,41,32,73
24,1,2,18,24,42
1,1,2,1,1,2
16,12,33,220,192,412
25,11,29,320,275,595
1,8,21,12,8,20
11,8,21,99,88,187
12,8,21,108,96,204
29,8,21,298,232,530
21,1,2,21,21,42
12,1,2,12,12,24
11,1,2,11,11,22
28,1,4,80,28,108
27,1,4,77,27,104
27,11,29,345,297,642
9,2,5,19,18,37
3,2,5,6,6,12
4,1,2,3,4,7
30,1,2,22,30,52
18,8,21,185,144,329
27,9,25,419,243,662
1,1482,2384,878,1482,2360
1,755,1215,411,755,1166
1,755,1215,375,755,1130
1,461,742,162,461,623
18,24,64,674,432,1106
30,24,64,1162,720,1882
5,2,5,15,10,25
2,2,5,6,4,10
19,2,5,56,38,94
9,2,5,27,18,45
10,3,9,58,30,88
19,4,10,72,76,148
22,4,10,84,88,172
9,2,5,21,18,39
14,2,5,33,28,61
24,7,9,46,168,214
16,7,9,31,112,143
10,7,9,19,70,89
29,3,8,143,87,230
30,3,8,140,90,230
26,8,22,272,208,480
13,8,22,162,104,266
21,8,22,285,168,453
21,8,22,285,168,453
28,8,22,281,224,505
30,8,22,374,240,614
7,8,22,96,56,152
14,8,22,193,112,305
2,8,22,28,16,44
10,8,22,138,80,218
30,9,24,436,270,706
12,13,35,172,156,328
1,13,35,16,13,29
5,13,35,98,65,163
30,13,35,513,390,903
18,13,35,257,234,491
14,13,35,220,182,402
17,13,35,362,221,583
2,13,35,41,26,67
14,13,35,220,182,402
6,13,35,128,78,206
14,13,35,205,182,387
1,13,35,22,13,35
1,13,35,14,13,27
4,13,35,87,52,139
25,13,35,541,325,866
15,13,35,325,195,520
18,13,35,308,234,542
1,13,35,16,13,29
28,42,54,94,1176,1270
5,38,50,58,190,248
24,42,54,275,1008,1283
22,38,50,22,836,858
24,42,54,120,1008,1128
29,38,50,87,1102,1189
11,38,50,127,418,545
29,38,50,160,1102,1262
21,42,54,3,882,885
1,1898,3375,937,1898,2835
1,1266,2320,892,1266,2158
1,1266,2320,636,1266,1902
1,420,769,341,420,761
1,1252,2295,951,1252,2203
1,1252,2295,997,1252,2249
1,295,540,240,295,535
1,1898,3375,870,1898,2768
1,713,1120,385,713,1098
1,487,783,280,487,767
1,2171,3578,942,2171,3113
1,2171,3578,942,2171,3113
1,2171,3578,656,2171,2827
1,713,1120,161,713,874
1,2171,3578,1371,2171,3542
1,344,540,77,344,421
1,2171,3578,835,2171,3006
1,2171,3578,1371,2171,3542
21,26,70,909,546,1455
22,26,70,953,572,1525
23,26,70,706,598,1304
9,3,9,39,27,66
18,2,5,34,36,70
1,2,5,2,2,4
22,1,2,21,22,43
1,1,2,1,1,2
1,1,2,1,1,2
8,1,2,8,8,16
17,12,33,335,204,539
30,2,5,89,60,149
16,2,5,47,32,79
7,1,2,7,7,14
30,1,2,29,30,59
23,1,2,22,23,45
24,1,2,23,24,47
12,1,2,12,12,24
28,2,5,74,56,130
1,2,5,3,2,5
1,1,2,1,1,2
28,1,2,18,28,46
7,1,2,4,7,11
22,9,25,281,198,479
29,9,25,370,261,631
9,9,25,115,81,196
1,1,4,2,1,3
16,2,5,37,32,69
21,8,21,242,168,410
21,8,21,242,168,410
7,8,21,81,56,137
11,2,5,31,22,53
29,2,5,81,58,139
19,1,2,14,19,33
15,1,2,11,15,26
17,9,25,213,153,366
23,9,25,288,207,495
1,9,25,13,9,22
29,2,5,55,58,113
26,1,2,25,26,51
2,1,2,2,2,4
11,2,5,32,22,54
2,2,5,6,4,10
11,2,5,32,22,54
3,1,2,3,3,6
8,1,2,8,8,16
12,1,2,12,12,24
16,1,2,15,16,31
26,1,2,17,26,43
12,1,2,7,12,19
2,1,2,1,2,3
1,1482,2384,521,1482,2003
1,1482,2384,807,1482,2289
1,1482,2384,878,1482,2360
1,755,1215,193,755,948
1,1482,2384,568,1482,2050
1,461,742,185,461,646
6,24,64,236,144,380
1,24,64,27,24,51
28,24,64,1102,672,1774
4,45,120,300,180,480
7,59,159,455,413,868
26,3,9,147,78,225
18,3,9,102,54,156
1,2,5,2,2,4
2,2,5,4,4,8
16,2,5,46,32,78
21,4,10,99,84,183
18,4,10,85,72,157
11,4,10,42,44,86
21,4,10,122,84,206
13,4,10,75,52,127
2,2,5,4,4,8
29,2,5,57,58,115
23,2,5,67,46,113
23,2,5,67,46,113
20,2,5,39,40,79
1,2,5,2,2,4
24,2,5,53,48,101
30,2,5,69,60,129
27,2,5,62,54,116
16,3,9,64,48,112
15,2,5,42,30,72
26,2,5,73,52,125
17,4,10,66,68,134
22,4,10,86,88,174
20,7,9,0,140,140
16,7,9,32,112,144
18,7,9,33,126,159
24,7,9,0,168,168
19,7,9,0,133,133
11,7,9,4,77,81
3,3,8,11,9,20
19,3,8,62,57,119
29,8,22,266,232,498
1,8,22,9,8,17
22,8,22,245,176,421
13,8,22,176,104,280
26,8,22,341,208,549
12,8,22,113,96,209
25,9,24,369,225,594
22,9,24,214,198,412
19,9,24,253,171,424
30,9,24,320,270,590
5,13,35,107,65,172
22,13,35,315,286,601
17,13,35,243,221,464
6,13,35,124,78,202
16,13,35,330,208,538
23,13,35,401,299,700
13,13,35,227,169,396
8,13,35,170,104,274
13,13,35,281,169,450
22,13,35,469,286,755
11,13,35,161,143,304
17,13,35,267,221,488
22,13,35,384,286,670
11,21,55,362,231,593
14,21,55,307,294,601
19,42,54,64,798,862
7,38,50,7,266,273
13,38,50,150,494,644
14,38,50,42,532,574
17,42,54,186,714,900
13,42,54,142,546,688
10,38,50,60,380,440
5,38,50,55,190,245
12,38,50,12,456,468
12,42,54,27,504,531
16,42,54,2,672,674
3,38,50,33,114,147
6,38,50,6,228,234
30,42,54,-29,1260,1231
3,42,54,0,126,126
20,38,50,20,760,780
1,1266,2320,1008,1266,2274
1,420,769,318,420,738
1,1266,2320,544,1266,1810
1,1252,2295,538,1252,1790
1,1252,2295,630,1252,1882
1,1266,2320,1054,1266,2320
1,420,769,318,420,738
1,1266,2320,961,1266,2227
1,1898,3375,1410,1898,3308
1,1266,2320,1008,1266,2274
1,2171,3578,1335,2171,3506
1,2171,3578,1264,2171,3435
1,2171,3578,1264,2171,3435
1,1083,1701,244,1083,1327
1,713,1120,205,713,918
1,1519,2443,631,1519,2150
1,1083,1701,550,1083,1633
1,1519,2443,411,1519,1930
1,713,1120,385,713,1098
1,487,783,194,487,681
1,344,540,110,344,454
1,344,540,191,344,535
21,26,70,895,546,1441
18,26,70,515,468,983
19,26,70,809,494,1303
3,26,70,86,78,164
26,26,70,744,676,1420
12,3,9,70,36,106
9,3,9,37,27,64
1,1,2,1,1,2
20,1,2,11,20,31
26,1,2,15,26,41
4,13,35,57,52,109
17,13,35,243,221,464
20,13,35,286,260,546
2,1,2,2,2,4
3,1,2,3,3,6
28,9,25,301,252,553
12,1,4,36,12,48
9,1,4,27,9,36
4,1,2,4,4,8
8,1,2,8,8,16
29,1,2,29,29,58
23,1,2,22,23,45
26,1,2,25,26,51
8,11,30,121,88,209
3,1,2,3,3,6
5,9,25,79,45,124
20,9,25,315,180,495
27,9,25,385,243,628
17,2,5,50,34,84
11,2,5,32,22,54
29,2,5,68,58,126
1,1,2,1,1,2
22,1,2,14,22,36
12,1,2,8,12,20
7,1,2,4,7,11
30,2,5,59,60,119
29,8,21,267,232,499
12,8,21,111,96,207
30,8,21,277,240,517
7,1,4,20,7,27
22,11,29,383,242,625
14,11,29,244,154,398
12,1,4,35,12,47
21,1,4,61,21,82
6,1,4,18,6,24
7,2,5,19,14,33
2,2,5,5,4,9
21,2,5,56,42,98
27,2,5,63,54,117
6,2,5,14,12,26
28,1,2,27,28,55
9,2,5,21,18,39
1,2,5,2,2,4
22,1,4,54,22,76
20,1,4,49,20,69
29,1,4,71,29,100
21,2,5,40,42,82
3,2,5,6,6,12
1,2,5,3,2,5
27,2,5,76,54,130
22,11,29,243,242,485
22,11,29,243,242,485
5,2,5,14,10,24
17,2,5,48,34,82
1,1482,2384,401,1482,1883
1,1482,2384,592,1482,2074
1,1482,2384,521,1482,2003
1,461,742,147,461,608
1,461,742,147,461,608
1,1482,2384,568,1482,2050
3,45,120,146,135,281
26,2,5,49,52,101
10,2,5,19,20,39
23,4,10,129,92,221
6,4,10,34,24,58
15,4,10,71,60,131
11,4,10,52,44,96
25,2,5,74,50,124
16,2,5,47,32,79
3,2,5,9,6,15
10,2,5,29,20,49
1,4,10,6,4,10
5,3,9,29,15,44
3,3,9,17,9,26
20,3,9,80,60,140
19,2,5,45,38,83
24,2,5,55,48,103
7,2,5,16,14,30
19,2,5,36,38,74
21,2,5,40,42,82
20,2,5,53,40,93
17,3,9,81,51,132
22,4,10,86,88,174
24,3,9,140,72,212
8,2,5,24,16,40
16,2,5,47,32,79
28,2,5,83,56,139
21,2,5,62,42,104
17,2,5,48,34,82
29,2,5,81,58,139
2,2,5,4,4,8
23,2,5,51,46,97
9,2,5,25,18,43
7,2,5,20,14,34
5,2,5,15,10,25
6,2,5,17,12,29
25,7,9,14,175,189
14,7,9,23,98,121
11,7,9,18,77,95
1,7,9,2,7,9
23,7,9,38,161,199
10,7,9,18,70,88
28,7,9,53,196,249
12,7,9,20,84,104
2,7,9,1,14,15
29,8,22,266,232,498
1,8,22,14,8,22
30,8,22,301,240,541
29,8,22,380,232,612
18,8,22,236,144,380
20,8,22,276,160,436
10,8,22,105,80,185
26,9,24,309,234,543
16,9,24,232,144,376
16,9,24,156,144,300
23,9,24,334,207,541
21,13,35,411,273,684
4,13,35,57,52,109
10,13,35,213,130,343
23,13,35,474,299,773
2,13,35,41,26,67
14,13,35,200,182,382
15,13,35,309,195,504
24,13,35,352,312,664
29,13,35,618,377,995
27,13,35,585,351,936
24,13,35,419,312,731
29,13,35,415,377,792
5,13,35,72,65,137
7,13,35,100,91,191
9,13,35,157,117,274
10,13,35,196,130,326
9,13,35,192,117,309
1,13,35,22,13,35
28,13,35,489,364,853
18,13,35,371,234,605
22,13,35,469,286,755
21,13,35,433,273,706
7,13,35,100,91,191
12,13,35,209,156,365
28,13,35,596,364,960
12,13,35,260,156,416
5,13,35,79,65,144
6,13,35,130,78,208
15,42,54,164,630,794
18,38,50,180,684,864
14,38,50,161,532,693
3,38,50,30,114,144
2,38,50,23,76,99
27,38,50,297,1026,1323
5,38,50,55,190,245
8,42,54,1,336,337
9,38,50,36,342,378
28,42,54,276,1176,1452
3,42,54,30,126,156
19,42,54,207,798,1005
1,1252,2295,538,1252,1790
1,1266,2320,961,1266,2227
1,1252,2295,561,1252,1813
1,1252,2295,745,1252,1997
1,1266,2320,1008,1266,2274
1,420,769,318,420,738
1,1266,2320,1031,1266,2297
1,295,540,148,295,443
1,1266,2320,1008,1266,2274
1,1252,2295,882,1252,2134
1,1266,2320,961,1266,2227
1,295,540,175,295,470
1,295,540,234,295,529
1,295,540,240,295,535
1,1266,2320,1008,1266,2274
1,1266,2320,1008,1266,2274
1,1252,2295,538,1252,1790
1,713,1120,362,713,1075
1,344,540,185,344,529
1,713,1120,385,713,1098
1,2171,3578,942,2171,3113
1,1083,1701,244,1083,1327
1,713,1120,250,713,963
1,1083,1701,550,1083,1633
1,344,540,185,344,529
1,344,540,191,344,535
1,1555,2443,570,1555,2125
1,1083,1701,584,1083,1667
1,1555,2443,790,1555,2345
1,1083,1701,550,1083,1633
1,2171,3578,1335,2171,3506
1,344,540,126,344,470
3,26,70,130,78,208
17,26,70,724,442,1166
21,26,70,601,546,1147
27,3,9,109,81,190
9,3,9,43,27,70
19,3,9,107,57,164
27,3,9,160,81,241
12,1,2,7,12,19
25,1,2,14,25,39
20,2,5,58,40,98
22,2,5,64,44,108
10,2,5,29,20,49
26,9,25,410,234,644
4,1,2,4,4,8
19,2,5,56,38,94
18,1,2,10,18,28
19,1,2,11,19,30
28,1,2,16,28,44
25,1,2,24,25,49
7,13,35,149,91,240
3,13,35,64,39,103
17,1,2,12,17,29
20,1,2,14,20,34
7,2,5,21,14,35
19,2,5,56,38,94
25,2,5,48,50,98
21,2,5,40,42,82
9,2,5,17,18,35
15,2,5,29,30,59
30,11,30,561,330,891
19,11,30,355,209,564
28,13,35,577,364,941
23,1,2,13,23,36
22,8,21,277,176,453
7,8,21,88,56,144
4,1,2,4,4,8
6,1,2,3,6,9
5,1,2,3,5,8
30,1,2,17,30,47
20,1,2,12,20,32
18,1,2,18,18,36
10,1,4,21,10,31
26,1,4,55,26,81
15,1,4,44,15,59
20,1,4,58,20,78
1,1482,2384,807,1482,2289
1,1482,2384,401,1482,1883
1,1482,2384,735,1482,2217
1,461,742,251,461,712
1,1482,2384,878,1482,2360
1,755,1215,448,755,1203
1,1482,2384,378,1482,1860
1,755,1215,436,755,1191
1,461,742,266,461,727
1,1482,2384,592,1482,2074
1,1482,2384,473,1482,1955
1,461,742,266,461,727
30,24,64,854,720,1574
21,45,120,1121,945,2066
10,59,159,984,590,1574
2,59,159,133,118,251
9,59,159,843,531,1374
5,59,159,397,295,692
9,59,159,714,531,1245
9,59,159,714,531,1245
27,3,9,145,81,226
17,3,9,91,51,142
9,4,10,50,36,86
13,4,10,73,52,125
29,3,9,164,87,251
12,2,5,25,24,49
29,2,5,55,58,113
3,2,5,6,6,12
3,2,5,9,6,15
12,3,9,64,36,100
19,3,9,102,57,159
29,3,9,119,87,206
8,3,9,33,24,57
20,2,5,59,40,99
30,2,5,89,60,149
13,7,9,21,91,112
1,7,9,2,7,9
14,7,9,23,98,121
9,7,9,12,63,75
27,7,9,49,189,238
5,7,9,2,35,37
16,7,9,13,112,125
24,3,8,95,72,167
20,3,8,79,60,139
10,8,22,136,80,216
27,8,22,265,216,481
22,8,22,289,176,465
5,8,22,68,40,108
14,8,22,174,112,286
10,8,22,136,80,216
19,8,22,258,152,410
25,8,22,345,200,545
7,8,22,73,56,129
17,9,24,247,153,400
24,9,24,348,216,564
25,9,24,351,225,576
12,9,24,177,108,285
4,9,24,45,36,81
25,9,24,351,225,576
19,13,35,272,247,519
17,13,35,350,221,571
9,13,35,195,117,312
4,13,35,78,52,130
10,13,35,171,130,301
2,13,35,43,26,69
10,13,35,213,130,343
14,13,35,288,182,470
12,13,35,172,156,328
16,13,35,341,208,549
24,13,35,377,312,689
22,13,35,476,286,762
24,13,35,419,312,731
3,13,35,64,39,103
26,13,35,408,338,746
15,13,35,236,195,431
18,13,35,383,234,617
28,13,35,489,364,853
16,21,55,359,336,695
14,21,55,445,294,739
8,38,50,88,304,392
16,38,50,176,608,784
8,38,50,20,304,324
14,38,50,140,532,672
22,42,54,216,924,1140
8,42,54,79,336,415
16,38,50,88,608,696
5,42,54,25,210,235
15,38,50,173,570,743
9,38,50,77,342,419
6,42,54,30,252,282
1,1266,2320,636,1266,1902
1,1252,2295,951,1252,2203
1,1266,2320,961,1266,2227
1,1252,2295,1020,1252,2272
1,420,769,318,420,738
1,1252,2295,882,1252,2134
1,420,769,241,420,661
1,420,769,318,420,738
1,1266,2320,892,1266,2158
1,1252,2295,745,1252,1997
1,1266,2320,1008,1266,2274
1,295,540,234,295,529
1,1252,2295,997,1252,2249
1,1252,2295,997,1252,2249
1,295,540,234,295,529
1,1898,3375,870,1898,2768
1,2171,3578,1157,2171,3328
1,713,1120,385,713,1098
1,1555,2443,790,1555,2345
1,2171,3578,942,2171,3113
1,2171,3578,942,2171,3113
1,2171,3578,942,2171,3113
1,1083,1701,550,1083,1633
1,713,1120,385,713,1098
1,1555,2443,570,1555,2125
1,713,1120,385,713,1098
1,344,540,174,344,518
1,344,540,83,344,427
13,26,70,554,338,892
5,3,9,22,15,37
7,3,9,41,21,62
9,8,21,113,72,185
12,1,2,12,12,24
7,1,2,7,7,14
19,1,2,18,19,37
24,1,2,23,24,47
8,1,2,5,8,13
6,1,2,4,6,10
29,1,4,86,29,115
19,1,2,11,19,30
3,1,2,2,3,5
23,13,35,490,299,789
10,13,35,213,130,343
23,2,5,64,46,110
19,2,5,53,38,91
26,2,5,73,52,125
17,2,5,48,34,82
2,1,2,1,2,3
22,1,2,16,22,38
12,2,5,35,24,59
1,1,2,1,1,2
29,1,2,21,29,50
4,1,2,3,4,7
2,2,5,4,4,8
16,2,5,30,32,62
30,1,2,28,30,58
3,1,2,3,3,6
22,1,2,20,22,42
29,1,2,27,29,56
3,1,2,3,3,6
25,2,5,74,50,124
5,2,5,15,10,25
5,2,5,11,10,21
5,2,5,11,10,21
13,2,5,31,26,57
11,2,5,26,22,48
14,8,21,120,112,232
5,1,4,14,5,19
22,1,4,62,22,84
13,9,25,166,117,283
10,9,25,128,90,218
5,9,25,64,45,109
14,1,2,14,14,28
13,1,2,13,13,26
28,13,35,459,364,823
12,13,35,197,156,353
30,1,2,17,30,47
24,1,2,14,24,38
9,8,21,92,72,164
2,8,21,21,16,37
29,1,4,72,29,101
28,2,5,66,56,122
29,2,5,68,58,126
22,9,25,281,198,479
24,2,5,56,48,104
30,2,5,71,60,131
20,2,5,47,40,87
4,8,21,50,32,82
21,8,21,264,168,432
2,8,21,24,16,40
10,8,21,122,80,202
1,1482,2384,473,1482,1955
1,755,1215,302,755,1057
1,755,1215,436,755,1191
1,755,1215,241,755,996
1,755,1215,205,755,960
1,461,742,125,461,586
29,24,64,1086,696,1782
8,59,159,775,472,1247
1,4,10,6,4,10
8,2,5,15,16,31
6,2,5,17,12,29
6,2,5,17,12,29
29,4,10,122,116,238
8,4,10,34,32,66
13,2,5,27,26,53
14,2,5,29,28,57
2,2,5,6,4,10
10,2,5,29,20,49
23,2,5,54,46,100
12,2,5,28,24,52
29,2,5,52,58,110
27,2,5,80,54,134
22,7,9,18,154,172
26,7,9,43,182,225
6,7,9,2,42,44
11,7,9,20,77,97
14,7,9,5,98,103
10,7,9,16,70,86
4,3,8,16,12,28
24,3,8,85,72,157
10,3,8,49,30,79
18,3,8,87,54,141
10,3,8,48,30,78
13,8,22,176,104,280
16,8,22,178,128,306
16,8,22,220,128,348
27,8,22,372,216,588
19,8,22,249,152,401
21,8,22,234,168,402
20,8,22,276,160,436
26,9,24,365,234,599
23,9,24,224,207,431
15,9,24,167,135,302
24,9,24,256,216,472
13,9,24,126,117,243
9,9,24,100,81,181
30,13,35,440,390,830
18,13,35,257,234,491
29,13,35,425,377,802
13,13,35,227,169,396
23,13,35,329,299,628
18,13,35,283,234,517
3,13,35,62,39,101
8,13,35,117,104,221
7,13,35,149,91,240
1,13,35,17,13,30
15,13,35,257,195,452
22,13,35,453,286,739
3,13,35,43,39,82
10,13,35,157,130,287
5,13,35,98,65,163
15,13,35,236,195,431
9,13,35,141,117,258
2,13,35,43,26,69
21,13,35,330,273,603
16,13,35,262,208,470
24,13,35,343,312,655
11,13,35,227,143,370
1,13,35,16,13,29
8,21,55,193,168,361
4,38,50,46,152,198
20,42,54,46,840,886
23,38,50,230,874,1104
18,42,54,90,756,846
10,42,54,23,420,443
1,1266,2320,1008,1266,2274
1,1912,3400,1046,1912,2958
1,420,769,334,420,754
1,1252,2295,1020,1252,2272
1,420,769,249,420,669
1,295,540,234,295,529
1,1252,2295,1020,1252,2272
1,1252,2295,538,1252,1790
1,1252,2295,538,1252,1790
1,2171,3578,620,2171,2791
1,1555,2443,448,1555,2003
1,713,1120,396,713,1109
1,1519,2443,826,1519,2345
1,1555,2443,302,1555,1857
1,1083,1701,380,1083,1463
1,1083,1701,312,1083,1395
1,1083,1701,550,1083,1633
1,2171,3578,763,2171,2934
1,2171,3578,763,2171,2934
1,1083,1701,244,1083,1327
1,713,1120,385,713,1098
1,1519,2443,606,1519,2125
1,344,540,191,344,535
1,1555,2443,448,1555,2003
1,344,540,99,344,443
1,1555,2443,570,1555,2125
1,344,540,126,344,470
1,344,540,126,344,470
1,487,783,288,487,775
1,344,540,110,344,454
1,2171,3578,1335,2171,3506
16,26,70,558,416,974
1,26,70,41,26,67
5,26,70,175,130,305
28,3,9,135,84,219
26,3,9,112,78,190
19,2,5,36,38,74
24,2,5,46,48,94
20,2,5,58,40,98
18,2,5,52,36,88
27,2,5,76,54,130
3,2,5,8,6,14
30,1,2,29,30,59
16,1,2,15,16,31
15,1,2,11,15,26
22,1,2,16,22,38
28,1,2,16,28,44
23,1,2,13,23,36
18,1,2,10,18,28
4,2,5,8,8,16
28,1,4,66,28,94
19,1,4,45,19,64
22,2,5,46,44,90
15,2,5,32,30,62
22,2,5,45,44,89
19,12,33,393,228,621
12,1,2,9,12,21
1,1,2,1,1,2
9,11,30,136,99,235
20,1,2,19,20,39
3,1,2,3,3,6
17,1,2,16,17,33
19,2,5,45,38,83
26,2,5,61,52,113
19,9,25,271,171,442
26,2,5,61,52,113
27,2,5,63,54,117
29,2,5,61,58,119
26,1,4,76,26,102
11,1,4,32,11,43
2,2,5,4,4,8
20,12,33,275,240,515
7,1,4,17,7,24
12,2,5,34,24,58
10,2,5,30,20,50
7,11,29,81,77,158
26,11,29,302,286,588
16,1,4,34,16,50
4,1,4,8,4,12
21,1,2,15,21,36
1,1,2,1,1,2
27,9,25,344,243,587
9,9,25,115,81,196
7,8,21,85,56,141
1,1482,2384,401,1482,1883
1,1482,2384,401,1482,1883
1,1482,2384,592,1482,2074
1,755,1215,411,755,1166
1,755,1215,448,755,1203
1,1482,2384,854,1482,2336
1,461,742,147,461,608
1,461,742,147,461,608
1,461,742,147,461,608
1,461,742,118,461,579
1,461,742,266,461,727
30,24,64,950,720,1670
27,24,64,1045,648,1693
18,3,9,106,54,160
24,2,5,59,48,107
19,4,10,89,76,165
28,4,10,132,112,244
6,2,5,17,12,29
10,2,5,28,20,48
6,4,10,25,24,49
9,4,10,38,36,74
21,4,10,122,84,206
15,4,10,87,60,147
30,4,10,114,120,234
10,4,10,38,40,78
19,4,10,106,76,182
16,4,10,90,64,154
18,3,9,82,54,136
29,3,9,132,87,219
16,2,5,46,32,78
25,2,5,73,50,123
18,2,5,52,36,88
11,2,5,32,22,54
1,4,10,4,4,8
14,4,10,53,56,109
19,3,9,90,57,147
27,3,9,128,81,209
19,3,9,83,57,140
30,3,9,131,90,221
26,2,5,77,52,129
8,2,5,24,16,40
24,7,9,39,168,207
10,7,9,18,70,88
29,7,9,53,203,256
19,7,9,36,133,169
7,7,9,1,49,50
20,7,9,36,140,176
22,3,8,106,66,172
4,8,22,54,32,86
25,8,22,262,200,462
18,8,22,197,144,341
5,8,22,50,40,90
13,8,22,179,104,283
10,9,24,145,90,235
30,9,24,320,270,590
28,9,24,299,252,551
11,9,24,117,99,216
2,13,35,31,26,57
3,13,35,64,39,103
22,13,35,322,286,608
7,13,35,149,91,240
29,13,35,597,377,974
11,13,35,227,143,370
5,13,35,73,65,138
25,13,35,358,325,683
23,13,35,474,299,773
12,13,35,209,156,365
15,13,35,257,195,452
9,13,35,195,117,312
23,13,35,361,299,660
29,13,35,455,377,832
17,13,35,297,221,518
28,13,35,459,364,823
23,13,35,329,299,628
16,13,35,313,208,521
12,13,35,247,156,403
16,13,35,341,208,549
18,13,35,295,234,529
11,21,55,241,231,472
4,21,55,88,84,172
3,42,54,0,126,126
18,42,54,177,756,933
7,38,50,39,266,305
15,38,50,83,570,653
8,42,54,79,336,415
20,42,54,89,840,929
30,38,50,30,1140,1170
14,38,50,140,532,672
10,42,54,44,420,464
3,42,54,0,126,126
12,38,50,120,456,576
17,42,54,186,714,900
26,42,54,59,1092,1151
29,42,54,66,1218,1284
18,42,54,80,756,836
1,1266,2320,1008,1266,2274
1,1252,2295,791,1252,2043
1,1266,2320,636,1266,1902
1,1252,2295,951,1252,2203
1,1252,2295,676,1252,1928
1,1266,2320,729,1266,1995
1,420,769,318,420,738
1,420,769,318,420,738
1,1252,2295,1020,1252,2272
1,295,540,234,295,529
1,1252,2295,538,1252,1790
1,420,769,188,420,608
1,1266,2320,1008,1266,2274
1,1266,2320,961,1266,2227
1,295,540,234,295,529
1,1266,2320,961,1266,2227
1,2171,3578,1335,2171,3506
1,2171,3578,942,2171,3113
1,2171,3578,942,2171,3113
1,1083,1701,244,1083,1327
1,713,1120,385,713,1098
1,713,1120,161,713,874
1,713,1120,161,713,874
1,344,540,191,344,535
1,713,1120,261,713,974
1,344,540,99,344,443
1,1083,1701,550,1083,1633
1,713,1120,205,713,918
1,713,1120,228,713,941
1,2171,3578,835,2171,3006
1,2171,3578,906,2171,3077
6,26,70,260,156,416
25,26,70,855,650,1505
18,26,70,515,468,983
15,26,70,440,390,830
21,3,9,118,63,181
23,1,2,22,23,45
6,1,2,6,6,12
8,2,5,23,16,39
23,2,5,68,46,114
11,2,5,32,22,54
2,2,5,4,4,8
30,9,25,323,270,593
2,9,25,22,18,40
6,1,2,3,6,9
29,1,2,17,29,46
22,1,4,65,22,87
26,2,5,75,52,127
5,2,5,15,10,25
18,2,5,52,36,88
7,2,5,13,14,27
8,2,5,15,16,31
25,2,5,48,50,98
7,2,5,21,14,35
1,11,29,17,11,28
15,11,29,253,165,418
11,11,29,185,121,306
4,1,2,3,4,7
14,1,4,40,14,54
5,1,4,14,5,19
19,1,2,12,19,31
5,1,2,5,5,10
3,11,30,53,33,86
27,2,5,63,54,117
15,2,5,35,30,65
20,1,2,20,20,40
12,1,4,27,12,39
5,8,21,43,40,83
24,8,21,206,192,398
1,2,5,3,2,5
30,1,4,88,30,118
25,1,4,73,25,98
7,2,5,20,14,34
3,2,5,9,6,15
16,1,2,9,16,25
23,2,5,44,46,90
25,1,4,61,25,86
5,1,4,12,5,17
4,2,5,11,8,19
9,2,5,25,18,43
15,2,5,42,30,72
1,1482,2384,449,1482,1931
1,1482,2384,878,1482,2360
1,461,742,185,461,646
1,755,1215,436,755,1191
1,755,1215,375,755,1130
6,24,64,232,144,376
3,45,120,146,135,281
8,4,10,47,32,79
30,2,5,84,60,144
30,2,5,84,60,144
5,2,5,14,10,24
12,2,5,28,24,52
24,2,5,71,48,119
22,2,5,65,44,109
22,2,5,65,44,109
1,2,5,3,2,5
3,2,5,9,6,15
27,2,5,78,54,132
6,2,5,17,12,29
27,3,9,152,81,233
3,3,9,17,9,26
14,2,5,39,28,67
28,2,5,78,56,134
15,7,9,4,105,109
21,7,9,8,147,155
16,7,9,31,112,143
21,7,9,38,147,185
8,7,9,7,56,63
25,7,9,1,175,176
28,7,9,3,196,199
19,3,8,93,57,150
18,3,8,71,54,125
10,3,8,40,30,70
19,8,22,174,152,326
9,8,22,100,72,172
9,8,22,124,72,196
19,8,22,262,152,414
12,9,24,143,108,251
3,9,24,29,27,56
14,9,24,203,126,329
12,9,24,140,108,248
29,13,35,506,377,883
27,13,35,462,351,813
16,13,35,218,208,426
7,13,35,149,91,240
2,13,35,35,26,61
9,13,35,195,117,312
24,13,35,494,312,806
20,13,35,314,260,574
27,13,35,424,351,775
8,13,35,170,104,274
29,13,35,597,377,974
5,13,35,79,65,144
18,13,35,371,234,605
26,21,55,684,546,1230
3,21,55,100,63,163
25,21,55,836,525,1361
4,38,50,40,152,192
26,38,50,65,988,1053
16,42,54,183,672,855
29,42,54,3,1218,1221
18,38,50,207,684,891
2,42,54,23,84,107
29,38,50,319,1102,1421
6,42,54,59,252,311
27,38,50,230,1026,1256
1,1266,2320,1031,1266,2297
1,1252,2295,538,1252,1790
1,1252,2295,951,1252,2203
1,1252,2295,630,1252,1882
1,1252,2295,882,1252,2134
1,1266,2320,1008,1266,2274
1,1252,2295,1020,1252,2272
1,1266,2320,752,1266,2018
1,1266,2320,752,1266,2018
1,1252,2295,951,1252,2203
1,487,783,280,487,767
1,487,783,124,487,611
1,487,783,124,487,611
1,1083,1701,244,1083,1327
1,713,1120,362,713,1075
1,713,1120,205,713,918
1,1083,1701,499,1083,1582
1,713,1120,362,713,1075
9,26,70,257,234,491
7,3,9,28,21,49
4,3,9,18,12,30
10,13,35,171,130,301
3,1,2,2,3,5
16,2,5,45,32,77
29,11,30,542,319,861
3,1,4,6,3,9
24,2,5,71,48,119
26,2,5,77,52,129
14,2,5,39,28,67
15,1,2,11,15,26
27,1,2,20,27,47
29,1,4,86,29,115
6,1,4,18,6,24
20,1,2,12,20,32
20,1,2,12,20,32
14,8,21,176,112,288
15,8,21,189,120,309
29,8,21,298,232,530
8,2,5,15,16,31
8,8,21,72,64,136
4,8,21,36,32,68
11,11,29,157,121,278
3,1,4,9,3,12
1,1482,2384,330,1482,1812
1,1482,2384,473,1482,1955
6,45,120,299,270,569
2,59,159,197,118,315
21,2,5,40,42,82
18,2,5,34,36,70
18,2,5,38,36,74
9,2,5,19,18,37
30,4,10,177,120,297
26,2,5,73,52,125
19,2,5,53,38,91
9,2,5,26,18,44
21,2,5,56,42,98
3,2,5,8,6,14
8,2,5,22,16,38
17,2,5,48,34,82
8,2,5,23,16,39
15,2,5,44,30,74
25,2,5,73,50,123
14,2,5,41,28,69
28,2,5,81,56,137
2,2,5,6,4,10
17,2,5,37,34,71
5,4,10,20,20,40
22,4,10,86,88,174
1,4,10,4,4,8
24,4,10,91,96,187
29,3,9,156,87,243
9,3,9,48,27,75
11,2,5,26,22,48
18,2,5,42,36,78
13,2,5,36,26,62
27,2,5,76,54,130
1,7,9,1,7,8
30,7,9,55,210,265
28,7,9,51,196,247
29,7,9,53,203,256
3,7,9,5,21,26
22,7,9,36,154,190
2,7,9,4,14,18
15,7,9,12,105,117
14,3,8,54,42,96
2,3,8,8,6,14
1,3,8,5,3,8
22,3,8,106,66,172
19,8,22,174,152,326
22,8,22,298,176,474
6,8,22,81,48,129
16,8,22,220,128,348
21,8,22,234,168,402
1,8,22,9,8,17
16,8,22,178,128,306
7,9,24,103,63,166
3,9,24,44,27,71
9,9,24,126,81,207
16,9,24,159,144,303
7,13,35,144,91,235
17,13,35,362,221,583
25,13,35,515,325,840
20,13,35,342,260,602
1,13,35,17,13,30
6,13,35,128,78,206
19,13,35,298,247,545
28,13,35,606,364,970
23,13,35,361,299,660
24,13,35,419,312,731
23,13,35,498,299,797
8,13,35,140,104,244
13,13,35,227,169,396
9,13,35,141,117,258
5,13,35,107,65,172
9,13,35,192,117,309
18,13,35,264,234,498
14,21,55,291,294,585
25,21,55,630,525,1155
27,38,50,135,1026,1161
27,38,50,311,1026,1337
2,38,50,22,76,98
24,38,50,276,912,1188
27,38,50,230,1026,1256
15,38,50,165,570,735
27,38,50,297,1026,1323
8,42,54,92,336,428
12,38,50,132,456,588
29,42,54,19,1218,1237
2,42,54,10,84,94
20,38,50,20,760,780
1,1266,2320,683,1266,1949
1,1252,2295,745,1252,1997
1,1252,2295,538,1252,1790
1,1252,2295,722,1252,1974
1,1252,2295,630,1252,1882
1,308,565,246,308,554
1,1252,2295,630,1252,1882
1,2171,3578,1264,2171,3435
1,487,783,124,487,611
1,2171,3578,656,2171,2827
1,1519,2443,826,1519,2345
1,1555,2443,790,1555,2345
1,1555,2443,717,1555,2272
1,344,540,185,344,529
1,1083,1701,550,1083,1633
1,1555,2443,424,1555,1979
1,344,540,185,344,529
1,1083,1701,346,1083,1429
1,344,540,158,344,502
1,1083,1701,550,1083,1633
1,487,783,194,487,681
1,487,783,194,487,681
1,2171,3578,1335,2171,3506
24,26,70,1039,624,1663
28,26,70,1193,728,1921
17,26,70,724,442,1166
27,26,70,772,702,1474
24,26,70,838,624,1462
7,1,2,7,7,14
24,1,2,18,24,42
25,1,2,19,25,44
2,1,2,1,2,3
21,2,5,62,42,104
29,2,5,86,58,144
15,2,5,32,30,62
14,2,5,29,28,57
10,11,30,151,110,261
11,11,30,166,121,287
9,2,5,21,18,39
28,2,5,53,56,109
29,1,4,79,29,108
28,1,4,76,28,104
1,1,4,3,1,4
16,1,2,15,16,31
30,1,2,28,30,58
1,8,21,9,8,17
8,1,2,8,8,16
17,1,2,17,17,34
30,12,33,412,360,772
15,12,33,206,180,386
14,2,5,39,28,67
2,1,4,4,2,6
28,8,21,352,224,576
3,8,21,38,24,62
16,2,5,47,32,79
17,2,5,50,34,84
8,2,5,24,16,40
11,1,4,32,11,43
6,1,4,18,6,24
15,1,2,8,15,23
18,1,2,10,18,28
27,9,25,311,243,554
15,9,25,173,135,308
5,9,25,58,45,103
1,1482,2384,592,1482,2074
1,1482,2384,401,1482,1883
1,755,1215,411,755,1166
1,755,1215,302,755,1057
1,1482,2384,592,1482,2074
1,461,742,229,461,690
1,1482,2384,807,1482,2289
1,1482,2384,473,1482,1955
1,755,1215,266,755,1021
1,461,742,266,461,727
1,461,742,125,461,586
9,24,64,348,216,564
7,59,159,455,413,868
3,2,5,9,6,15
8,2,5,24,16,40
29,2,5,68,58,126
16,3,9,70,48,118
24,2,5,46,48,94
3,2,5,6,6,12
22,2,5,62,44,106
20,2,5,56,40,96
7,4,10,31,28,59
29,4,10,128,116,244
4,2,5,8,8,16
6,2,5,13,12,25
22,2,5,43,44,87
25,2,5,49,50,99
17,2,5,48,34,82
24,2,5,67,48,115
27,2,5,78,54,132
8,2,5,23,16,39
15,2,5,44,30,74
17,2,5,49,34,83
12,4,10,70,48,118
6,4,10,35,24,59
20,3,9,116,60,176
28,3,9,163,84,247
12,3,9,70,36,106
27,3,9,157,81,238
16,7,9,29,112,141
29,7,9,3,203,206
19,7,9,14,133,147
5,7,9,8,35,43
16,7,9,0,112,112
22,7,9,42,154,196
4,3,8,20,12,32
18,3,8,64,54,118
25,3,8,121,75,196
15,3,8,74,45,119
2,8,22,27,16,43
29,8,22,400,232,632
6,8,22,66,48,114
24,8,22,220,192,412
10,8,22,100,80,180
22,8,22,289,176,465
19,8,22,212,152,364
19,8,22,262,152,414
6,8,22,83,48,131
9,9,24,133,81,214
4,9,24,59,36,95
9,9,24,107,81,188
28,9,24,299,252,551
5,9,24,70,45,115
4,9,24,39,36,75
18,9,24,261,162,423
9,13,35,195,117,312
18,13,35,283,234,517
2,13,35,43,26,69
17,13,35,362,221,583
27,13,35,556,351,907
17,13,35,267,221,488
25,13,35,541,325,866
29,13,35,415,377,792
15,13,35,309,195,504
18,13,35,283,234,517
17,13,35,362,221,583
26,13,35,563,338,901
22,13,35,469,286,755
14,13,35,190,182,372
10,13,35,217,130,347
28,13,35,596,364,960
28,13,35,400,364,764
29,13,35,496,377,873
23,21,55,554,483,1037
21,21,55,471,441,912
18,42,54,197,756,953
21,38,50,231,798,1029
4,38,50,46,152,198
1,42,54,5,42,47
8,38,50,68,304,372
23,42,54,102,966,1068
16,42,54,36,672,708
21,42,54,207,882,1089
1,1252,2295,630,1252,1882
1,1252,2295,538,1252,1790
1,420,769,334,420,754
1,1266,2320,961,1266,2227
1,295,540,234,295,529
1,295,540,223,295,518
1,295,540,223,295,518
1,420,769,211,420,631
1,1266,2320,752,1266,2018
1,1252,2295,538,1252,1790
1,1555,2443,351,1555,1906
1,2171,3578,656,2171,2827
1,2171,3578,942,2171,3113
1,2171,3578,835,2171,3006
1,713,1120,385,713,1098
1,1083,1701,601,1083,1684
1,344,540,120,344,464
1,1083,1701,397,1083,1480
1,713,1120,205,713,918
1,487,783,288,487,775
1,2171,3578,1335,2171,3506
19,26,70,557,494,1051
6,3,9,35,18,53
7,9,25,110,63,173
15,1,2,15,15,30
4,1,2,3,4,7
20,1,2,15,20,35
4,13,35,66,52,118
2,13,35,33,26,59
27,13,35,575,351,926
12,2,5,23,24,47
25,1,4,74,25,99
28,2,5,78,56,134
3,2,5,9,6,15
25,2,5,74,50,124
27,2,5,80,54,134
3,1,2,3,3,6
9,1,2,8,9,17
6,13,35,124,78,202
12,13,35,247,156,403
22,13,35,453,286,739
22,1,2,13,22,35
3,1,2,2,3,5
23,1,2,13,23,36
18,2,5,35,36,71
12,2,5,23,24,47
20,13,35,426,260,686
11,13,35,234,143,377
4,2,5,12,8,20
13,2,5,38,26,64
29,2,5,61,58,119
3,2,5,9,6,15
8,2,5,23,16,39
30,1,4,74,30,104
7,2,5,13,14,27
25,2,5,48,50,98
21,9,25,331,189,520
10,9,25,158,90,248
3,2,5,9,6,15
7,2,5,21,14,35
28,1,4,64,28,92
7,1,2,4,7,11
22,2,5,65,44,109
28,8,21,352,224,576
21,8,21,264,168,432
10,8,21,84,80,164
26,8,21,218,208,426
22,8,21,221,176,397
15,1,2,15,15,30
9,2,5,17,18,35
4,2,5,8,8,16
26,2,5,49,52,101
16,2,5,30,32,62
5,12,33,65,60,125
12,12,33,157,144,301
29,2,5,86,58,144
3,2,5,6,6,12
5,2,5,10,10,20
2,2,5,4,4,8
23,8,21,212,184,396
6,8,21,55,48,103
23,2,5,67,46,113
15,2,5,35,30,65
7,2,5,16,14,30
16,1,2,11,16,27
17,1,2,12,17,29
1,461,742,266,461,727
1,755,1215,193,755,948
1,755,1215,436,755,1191
1,461,742,266,461,727
15,2,5,44,30,74
28,2,5,78,56,134
26,2,5,73,52,125
20,2,5,46,40,86
7,2,5,16,14,30
10,2,5,29,20,49
18,3,9,106,54,160
18,3,9,106,54,160
6,2,5,14,12,26
3,3,9,18,9,27
18,3,9,106,54,160
25,2,5,58,50,108
19,2,5,44,38,82
1,2,5,3,2,5
26,2,5,75,52,127
5,2,5,12,10,22
24,2,5,56,48,104
6,7,9,4,42,46
11,7,9,21,77,98
19,7,9,16,133,149
21,7,9,0,147,147
22,7,9,36,154,190
21,7,9,34,147,181
28,7,9,51,196,247
11,7,9,0,77,77
19,7,9,31,133,164
20,3,8,65,60,125
30,3,8,116,90,206
26,8,22,353,208,561
17,8,22,156,136,292
24,8,22,262,192,454
8,8,22,73,64,137
2,8,22,28,16,44
29,9,24,428,261,689
24,9,24,348,216,564
17,9,24,182,153,335
20,13,35,412,260,672
20,13,35,412,260,672
23,13,35,474,299,773
11,13,35,180,143,323
18,13,35,264,234,498
26,13,35,445,338,783
17,13,35,231,221,452
3,13,35,43,39,82
13,13,35,227,169,396
11,13,35,161,143,304
13,13,35,186,169,355
20,13,35,412,260,672
6,13,35,128,78,206
22,13,35,469,286,755
6,13,35,128,78,206
12,13,35,172,156,328
25,13,35,533,325,858
2,13,35,43,26,69
8,13,35,140,104,244
4,13,35,70,52,122
8,13,35,126,104,230
20,21,55,669,420,1089
27,42,54,62,1134,1196
13,42,54,142,546,688
20,38,50,200,760,960
17,38,50,17,646,663
10,38,50,115,380,495
3,38,50,33,114,147
1,42,54,4,42,46
2,42,54,20,84,104
9,42,54,74,378,452
18,42,54,41,756,797
18,42,54,41,756,797
6,38,50,66,228,294
12,38,50,120,456,576
1,1912,3400,944,1912,2856
1,1266,2320,729,1266,1995
1,1912,3400,876,1912,2788
1,1266,2320,961,1266,2227
1,1266,2320,1008,1266,2274
1,1266,2320,497,1266,1763
1,1252,2295,538,1252,1790
1,1252,2295,538,1252,1790
1,420,769,334,420,754
1,295,540,126,295,421
1,1266,2320,961,1266,2227
1,1252,2295,997,1252,2249
1,1252,2295,722,1252,1974
1,487,783,280,487,767
1,1083,1701,550,1083,1633
1,2171,3578,942,2171,3113
1,713,1120,250,713,963
1,2171,3578,835,2171,3006
1,1519,2443,606,1519,2125
1,344,540,174,344,518
1,713,1120,329,713,1042
1,344,540,185,344,529
1,1083,1701,397,1083,1480
1,487,783,132,487,619
1,2171,3578,1335,2171,3506
29,26,70,1235,754,1989
16,26,70,682,416,1098
30,26,70,1278,780,2058
17,26,70,558,442,1000
11,26,70,453,286,739
13,2,5,25,26,51
29,2,5,55,58,113
14,2,5,27,28,55
12,1,2,12,12,24
28,1,2,27,28,55
27,1,2,26,27,53
3,1,2,3,3,6
13,1,2,13,13,26
18,1,2,17,18,35
20,2,5,56,40,96
27,2,5,76,54,130
6,1,2,4,6,10
24,1,2,13,24,37
23,2,5,67,46,113
6,11,30,74,66,140
13,13,35,254,169,423
6,13,35,117,78,195
27,2,5,76,54,130
7,1,2,4,7,11
15,1,2,9,15,24
26,8,21,223,208,431
9,8,21,77,72,149
11,2,5,31,22,53
14,2,5,39,28,67
3,8,21,38,24,62
24,8,21,302,192,494
3,1,4,9,3,12
1,1,4,3,1,4
13,11,30,220,143,363
24,1,2,17,24,41
18,1,2,13,18,31
30,2,5,84,60,144
9,2,5,25,18,43
18,2,5,50,36,86
28,2,5,78,56,134
13,2,5,25,26,51
11,2,5,21,22,43
11,1,2,6,11,17
7,1,2,4,7,11
9,1,4,26,9,35
12,1,4,34,12,46
30,2,5,57,60,117
5,1,4,15,5,20
25,1,4,73,25,98
7,8,21,88,56,144
17,8,21,214,136,350
7,8,21,88,56,144
15,1,4,37,15,52
1,1482,2384,473,1482,1955
1,1482,2384,592,1482,2074
1,1482,2384,401,1482,1883
1,755,1215,411,755,1166
1,1482,2384,592,1482,2074
1,461,742,251,461,712
1,1482,2384,878,1482,2360
1,1482,2384,735,1482,2217
1,461,742,185,461,646
1,1482,2384,378,1482,1860
1,461,742,118,461,579
1,1482,2384,854,1482,2336
1,1482,2384,568,1482,2050
1,461,742,162,461,623
1,461,742,266,461,727
15,24,64,398,360,758
20,24,64,710,480,1190
6,45,120,443,270,713
10,59,159,968,590,1558
24,2,5,50,48,98
13,2,5,31,26,57
5,2,5,12,10,22
15,4,10,57,60,117
3,4,10,11,12,23
11,2,5,31,22,53
18,2,5,50,36,86
21,2,5,41,42,83
22,4,10,103,88,191
12,4,10,56,48,104
29,2,5,84,58,142
26,4,10,151,104,255
29,4,10,168,116,284
30,4,10,126,120,246
4,4,10,17,16,33
21,2,5,41,42,83
4,2,5,8,8,16
13,2,5,38,26,64
17,3,9,100,51,151
26,3,9,151,78,229
7,3,9,41,21,62
20,3,9,116,60,176
17,2,5,36,34,70
16,2,5,47,32,79
3,2,5,9,6,15
24,2,5,67,48,115
29,4,10,128,116,244
7,4,10,31,28,59
9,2,5,21,18,39
29,2,5,67,58,125
14,2,5,37,28,65
8,2,5,21,16,37
19,2,5,53,38,91
11,2,5,31,22,53
23,3,9,95,69,164
21,3,9,86,63,149
12,2,5,35,24,59
12,2,5,35,24,59
15,7,9,2,105,107
30,7,9,55,210,265
6,7,9,1,42,43
26,7,9,10,182,192
17,7,9,31,119,150
26,7,9,22,182,204
16,7,9,29,112,141
29,7,9,53,203,256
7,7,9,13,49,62
15,7,9,29,105,134
22,7,9,8,154,162
13,7,9,0,91,91
4,3,8,16,12,28
1,3,8,3,3,6
1,3,8,4,3,7
19,3,8,92,57,149
4,3,8,20,12,32
24,8,22,262,192,454
10,8,22,136,80,216
7,8,22,95,56,151
16,8,22,217,128,345
26,9,24,303,234,537
15,9,24,221,135,356
11,9,24,107,99,206
4,13,35,85,52,137
15,13,35,320,195,515
4,13,35,87,52,139
15,13,35,215,195,410
11,13,35,192,143,335
16,13,35,341,208,549
11,13,35,169,143,312
28,13,35,400,364,764
27,13,35,471,351,822
25,13,35,393,325,718
5,13,35,107,65,172
25,13,35,541,325,866
17,13,35,243,221,464
2,13,35,43,26,69
11,13,35,192,143,335
7,13,35,100,91,191
16,13,35,229,208,437
25,13,35,515,325,840
16,13,35,341,208,549
23,21,55,516,483,999
9,21,55,237,189,426
21,42,54,14,882,896
6,38,50,18,228,246
17,38,50,94,646,740
7,38,50,77,266,343
10,42,54,23,420,443
4,38,50,12,152,164
7,38,50,70,266,336
16,42,54,2,672,674
12,42,54,60,504,564
1,1266,2320,636,1266,1902
1,1266,2320,1008,1266,2274
1,1252,2295,722,1252,1974
1,420,769,341,420,761
1,1266,2320,961,1266,2227
1,1266,2320,961,1266,2227
1,420,769,318,420,738
1,1266,2320,636,1266,1902
1,1252,2295,538,1252,1790
1,2171,3578,763,2171,2934
1,2171,3578,1264,2171,3435
1,2171,3578,727,2171,2898
1,1083,1701,380,1083,1463
1,1083,1701,584,1083,1667
1,713,1120,205,713,918
1,344,540,185,344,529
1,2171,3578,1371,2171,3542
1,1083,1701,601,1083,1684
1,1519,2443,606,1519,2125
1,487,783,171,487,658
1,344,540,174,344,518
1,2171,3578,620,2171,2791
25,26,70,715,650,1365
23,3,9,130,69,199
26,1,2,15,26,41
28,1,2,16,28,44
9,1,2,8,9,17
12,1,2,11,12,23
18,13,35,383,234,617
7,13,35,149,91,240
24,2,5,50,48,98
14,2,5,29,28,57
20,1,2,20,20,40
6,1,2,6,6,12
7,13,35,149,91,240
2,13,35,43,26,69
18,11,30,337,198,535
21,11,30,393,231,624
9,1,2,6,9,15
25,1,2,16,25,41
11,2,5,21,22,43
22,2,5,42,44,86
19,1,4,47,19,66
1,1,2,1,1,2
22,1,4,62,22,84
25,1,4,71,25,96
29,2,5,86,58,144
24,2,5,71,48,119
19,2,5,56,38,94
7,2,5,21,14,35
2,2,5,6,4,10
20,1,2,17,20,37
19,1,2,16,19,35
15,1,4,44,15,59
17,1,4,50,17,67
30,1,4,88,30,118
22,1,2,14,22,36
9,1,2,6,9,15
16,9,25,168,144,312
24,9,25,252,216,468
9,9,25,113,81,194
6,2,5,17,12,29
23,2,5,67,46,113
8,2,5,23,16,39
20,1,2,11,20,31
29,1,2,16,29,45
9,1,4,27,9,36
2,1,4,6,2,8
30,2,5,57,60,117
29,2,5,55,58,113
8,2,5,23,16,39
1,1482,2384,401,1482,1883
1,1482,2384,592,1482,2074
1,1482,2384,401,1482,1883
1,1482,2384,592,1482,2074
1,1482,2384,592,1482,2074
1,1482,2384,854,1482,2336
1,755,1215,436,755,1191
1,1482,2384,735,1482,2217
1,461,742,185,461,646
1,1482,2384,378,1482,1860
1,755,1215,205,755,960
1,1482,2384,401,1482,1883
1,1482,2384,568,1482,2050
3,45,120,175,135,310
4,45,120,290,180,470
12,2,5,25,24,49
20,2,5,42,40,82
17,4,10,80,68,148
23,4,10,108,92,200
1,3,9,4,3,7
3,3,9,12,9,21
25,2,5,58,50,108
15,2,5,44,30,74
21,2,5,62,42,104
4,3,9,21,12,33
5,3,9,27,15,42
25,3,9,146,75,221
2,3,9,12,6,18
11,2,5,32,22,54
20,2,5,59,40,99
22,2,5,42,44,86
18,2,5,50,36,86
7,7,9,11,49,60
17,7,9,5,119,124
23,7,9,9,161,170
5,7,9,4,35,39
4,7,9,8,28,36
27,3,8,120,81,201
19,3,8,68,57,125
10,3,8,40,30,70
8,3,8,39,24,63
22,8,22,303,176,479
26,9,24,384,234,618
20,9,24,194,180,374
5,9,24,56,45,101
1,9,24,9,9,18
17,13,35,297,221,518
22,13,35,315,286,601
1,13,35,22,13,35
8,13,35,140,104,244
27,13,35,396,351,747
23,13,35,498,299,797
12,13,35,260,156,416
28,13,35,440,364,804
17,13,35,279,221,500
26,13,35,472,338,810
8,13,35,170,104,274
22,13,35,469,286,755
13,13,35,281,169,450
25,13,35,489,325,814
12,13,35,209,156,365
10,13,35,171,130,301
2,13,35,29,26,55
2,13,35,41,26,67
19,42,54,95,798,893
16,42,54,71,672,743
30,38,50,345,1140,1485
19,42,54,95,798,893
16,38,50,40,608,648
1,420,769,241,420,661
1,420,769,341,420,761
1,1252,2295,630,1252,1882
1,295,540,234,295,529
1,1266,2320,752,1266,2018
1,1252,2295,997,1252,2249
1,1555,2443,864,1555,2419
1,2171,3578,620,2171,2791
1,713,1120,284,713,997
1,2171,3578,942,2171,3113
1,487,783,155,487,642
1,2171,3578,835,2171,3006
1,487,783,288,487,775
1,344,540,158,344,502
1,713,1120,261,713,974
1,487,783,132,487,619
1,344,540,174,344,518
1,2171,3578,620,2171,2791
17,26,70,558,442,1000
23,3,9,136,69,205
11,9,25,173,99,272
30,9,25,473,270,743
11,9,25,173,99,272
10,13,35,213,130,343
29,13,35,618,377,995
22,1,2,21,22,43
18,2,5,34,36,70
3,2,5,6,6,12
24,1,2,15,24,39
29,1,2,19,29,48
3,2,5,9,6,15
15,2,5,44,30,74
19,2,5,56,38,94
8,1,2,8,8,16
24,1,2,23,24,47
9,1,4,27,9,36
25,1,4,74,25,99
22,2,5,51,44,95
9,9,25,119,81,200
6,9,25,80,54,134
18,9,25,239,162,401
24,2,5,50,48,98
5,2,5,11,10,21
1,1,2,1,1,2
27,1,2,25,27,52
18,1,2,17,18,35
24,1,2,24,24,48
21,1,2,21,21,42
5,8,21,43,40,83
7,8,21,60,56,116
23,8,21,198,184,382
3,1,2,2,3,5
25,2,5,45,50,95
27,1,2,26,27,53
27,1,2,26,27,53
5,9,25,63,45,108
19,9,25,238,171,409
11,8,21,94,88,182
27,8,21,232,216,448
27,8,21,232,216,448
20,8,21,252,160,412
17,2,5,48,34,82
10,2,5,28,20,48
18,2,5,50,36,86
10,2,5,19,20,39
27,2,5,51,54,105
21,8,21,255,168,423
21,8,21,255,168,423
5,8,21,61,40,101
27,9,25,419,243,662
1,1482,2384,592,1482,2074
1,1482,2384,878,1482,2360
1,755,1215,205,755,960
1,461,742,185,461,646
1,461,742,199,461,660
1,1482,2384,473,1482,1955
1,1482,2384,592,1482,2074
1,1482,2384,735,1482,2217
7,59,159,678,413,1091
2,59,159,194,118,312
27,2,5,80,54,134
10,2,5,28,20,48
23,2,5,64,46,110
23,2,5,54,46,100
6,2,5,14,12,26
16,2,5,30,32,62
28,2,5,53,56,109
20,2,5,58,40,98
23,4,10,133,92,225
11,4,10,64,44,108
16,2,5,45,32,77
25,2,5,70,50,120
22,4,10,128,88,216
26,4,10,151,104,255
13,3,9,59,39,98
29,3,9,132,87,219
7,2,5,13,14,27
14,2,5,27,28,55
7,2,5,19,14,33
2,2,5,5,4,9
5,3,9,27,15,42
13,2,5,30,26,56
25,2,5,58,50,108
9,2,5,27,18,45
18,2,5,34,36,70
12,2,5,23,24,47
26,7,9,1,182,183
2,7,9,1,14,15
19,7,9,7,133,140
23,7,9,42,161,203
3,8,22,27,24,51
3,8,22,41,24,65
21,8,22,289,168,457
18,8,22,165,144,309
26,8,22,358,208,566
11,9,24,162,99,261
10,9,24,112,90,202
25,9,24,243,225,468
10,9,24,145,90,235
19,9,24,276,171,447
2,13,35,39,26,65
8,13,35,173,104,277
19,13,35,332,247,579
19,13,35,405,247,652
14,13,35,303,182,485
7,13,35,149,91,240
3,13,35,65,39,104
14,13,35,239,182,421
24,13,35,419,312,731
6,13,35,124,78,202
16,13,35,341,208,549
18,13,35,383,234,617
19,13,35,278,247,525
22,13,35,322,286,608
13,13,35,254,169,423
14,13,35,230,182,412
25,13,35,410,325,735
15,13,35,325,195,520
10,13,35,213,130,343
16,13,35,229,208,437
23,13,35,450,299,749
14,13,35,200,182,382
5,13,35,87,65,152
11,21,55,332,231,563
6,21,55,197,126,323
5,21,55,167,105,272
25,42,54,3,1050,1053
16,38,50,184,608,792
27,38,50,81,1026,1107
19,38,50,219,722,941
20,38,50,30,760,790
16,42,54,2,672,674
10,38,50,10,380,390
4,38,50,40,152,192
25,42,54,111,1050,1161
30,42,54,4,1260,1264
7,38,50,70,266,336
23,38,50,69,874,943
1,38,50,6,38,44
11,38,50,110,418,528
1,1252,2295,538,1252,1790
1,1252,2295,882,1252,2134
1,1266,2320,752,1266,2018
1,420,769,241,420,661
1,1252,2295,1020,1252,2272
1,1252,2295,1020,1252,2272
1,295,540,126,295,421
1,420,769,318,420,738
1,295,540,234,295,529
1,295,540,234,295,529
1,308,565,246,308,554
1,1898,3375,870,1898,2768
1,344,540,158,344,502
1,1519,2443,582,1519,2101
1,2171,3578,942,2171,3113
1,487,783,132,487,619
1,487,783,280,487,767
1,2171,3578,835,2171,3006
1,2171,3578,656,2171,2827
1,2171,3578,835,2171,3006
1,1555,2443,839,1555,2394
1,487,783,241,487,728
1,487,783,265,487,752
1,1555,2443,497,1555,2052
1,344,540,185,344,529
1,344,540,77,344,421
1,344,540,158,344,502
1,713,1120,362,713,1075
16,26,70,693,416,1109
28,3,9,165,84,249
14,9,25,151,126,277
28,9,25,301,252,553
15,9,25,161,135,296
28,2,5,81,56,137
1,2,5,3,2,5
19,13,35,405,247,652
19,13,35,405,247,652
22,1,2,16,22,38
19,1,2,14,19,33
12,13,35,260,156,416
8,1,2,6,8,14
4,2,5,11,8,19
22,1,2,21,22,43
19,1,2,18,19,37
13,2,5,38,26,64
23,2,5,68,46,114
15,1,2,8,15,23
18,11,29,303,198,501
13,11,29,219,143,362
29,11,29,488,319,807
30,8,21,258,240,498
18,1,2,17,18,35
11,1,2,10,11,21
28,11,30,498,308,806
6,11,30,107,66,173
8,8,21,97,64,161
8,8,21,97,64,161
5,1,2,5,5,10
12,1,2,12,12,24
12,8,21,146,96,242
26,8,21,316,208,524
19,1,2,18,19,37
4,1,2,4,4,8
8,1,2,8,8,16
30,1,2,26,30,56
9,1,2,8,9,17
27,2,5,57,54,111
5,2,5,11,10,21
8,2,5,17,16,33
7,2,5,21,14,35
1,2,5,3,2,5
4,1,4,12,4,16
29,8,21,365,232,597
3,8,21,38,24,62
20,9,25,310,180,490
20,9,25,310,180,490
29,9,25,450,261,711
1,1482,2384,401,1482,1883
1,755,1215,411,755,1166
1,1482,2384,854,1482,2336
1,1482,2384,378,1482,1860
1,1482,2384,568,1482,2050
1,755,1215,193,755,948
1,755,1215,241,755,996
1,1482,2384,378,1482,1860
2,24,64,62,48,110
25,24,64,744,600,1344
2,24,64,75,48,123
5,45,120,243,225,468
7,45,120,517,315,832
5,59,159,357,295,652
23,3,9,130,69,199
13,3,9,73,39,112
11,3,9,59,33,92
21,2,5,62,42,104
2,2,5,6,4,10
21,2,5,62,42,104
12,2,5,34,24,58
27,2,5,78,54,132
30,2,5,57,60,117
18,2,5,34,36,70
13,2,5,25,26,51
29,2,5,86,58,144
15,2,5,32,30,62
1,2,5,2,2,4
4,2,5,11,8,19
27,2,5,76,54,130
11,2,5,32,22,54
6,2,5,18,12,30
16,2,5,47,32,79
13,2,5,36,26,62
30,2,5,84,60,144
15,3,9,66,45,111
10,2,5,28,20,48
10,2,5,28,20,48
30,2,5,84,60,144
5,2,5,14,10,24
17,7,9,14,119,133
11,7,9,18,77,95
8,7,9,15,56,71
9,7,9,7,63,70
30,7,9,55,210,265
4,7,9,3,28,31
29,7,9,24,203,227
16,3,8,52,48,100
30,3,8,119,90,209
17,3,8,84,51,135
17,3,8,66,51,117
9,8,22,82,72,154
9,8,22,122,72,194
26,8,22,358,208,566
29,8,22,323,232,555
14,8,22,184,112,296
16,8,22,168,128,296
8,8,22,110,64,174
17,8,22,189,136,325
16,9,24,232,144,376
30,9,24,299,270,569
14,13,35,200,182,382
19,13,35,332,247,579
21,13,35,330,273,603
27,13,35,386,351,737
16,13,35,341,208,549
16,13,35,346,208,554
18,13,35,383,234,617
17,13,35,249,221,470
25,13,35,366,325,691
21,13,35,330,273,603
24,13,35,520,312,832
9,13,35,192,117,309
25,13,35,541,325,866
19,13,35,332,247,579
27,13,35,443,351,794
28,13,35,577,364,941
7,13,35,144,91,235
17,13,35,332,221,553
9,13,35,192,117,309
26,13,35,536,338,874
3,13,35,64,39,103
29,21,55,954,609,1563
25,21,55,823,525,1348
3,42,54,15,126,141
13,42,54,149,546,695
24,42,54,120,1008,1128
4,42,54,20,168,188
29,38,50,290,1102,1392
22,42,54,3,924,927
14,42,54,70,588,658
30,38,50,90,1140,1230
1,1266,2320,1008,1266,2274
1,420,769,180,420,600
1,1252,2295,538,1252,1790
1,1266,2320,544,1266,1810
1,1252,2295,951,1252,2203
1,1252,2295,1020,1252,2272
1,420,769,334,420,754
1,295,540,234,295,529
1,295,540,126,295,421
1,308,565,251,308,559
1,1266,2320,1031,1266,2297
1,308,565,234,308,542
1,1266,2320,961,1266,2227
1,1252,2295,1020,1252,2272
1,1266,2320,636,1266,1902
1,1266,2320,1008,1266,2274
1,1252,2295,538,1252,1790
1,2171,3578,906,2171,3077
1,2171,3578,1264,2171,3435
1,487,783,280,487,767
1,1555,2443,351,1555,1906
1,1555,2443,790,1555,2345
1,344,540,120,344,464
1,1555,2443,864,1555,2419
1,344,540,158,344,502
1,344,540,158,344,502
1,2171,3578,1335,2171,3506
1,2171,3578,1335,2171,3506
27,26,70,942,702,1644
7,26,70,244,182,426
13,26,70,563,338,901
10,3,9,40,30,70
13,3,9,57,39,96
22,2,5,42,44,86
18,13,35,308,234,542
26,13,35,445,338,783
10,13,35,171,130,301
18,1,2,17,18,35
22,2,5,58,44,102
2,2,5,5,4,9
28,2,5,74,56,130
13,2,5,25,26,51
7,11,30,131,77,208
25,11,30,468,275,743
25,1,2,24,25,49
30,11,29,531,330,861
30,11,29,531,330,861
23,13,35,337,299,636
16,13,35,234,208,442
26,2,5,51,52,103
27,2,5,80,54,134
2,2,5,6,4,10
8,2,5,23,16,39
4,2,5,12,8,20
25,11,30,340,275,615
3,11,30,41,33,74
15,1,2,13,15,28
3,1,2,3,3,6
24,13,35,494,312,806
17,13,35,350,221,571
11,1,4,27,11,38
26,1,4,64,26,90
20,1,4,50,20,70
8,9,25,126,72,198
4,1,4,9,4,13
23,1,4,52,23,75
6,1,2,3,6,9
10,1,2,6,10,16
5,11,29,89,55,144
8,11,29,142,88,230
9,1,2,9,9,18
23,1,2,23,23,46
9,2,5,17,18,35
13,1,2,9,13,22
26,1,2,18,26,44
16,1,2,15,16,31
9,8,21,83,72,155
28,8,21,258,224,482
5,1,2,4,5,9
14,1,2,10,14,24
30,2,5,87,60,147
12,2,5,35,24,59
1,1,4,3,1,4
14,1,4,41,14,55
2,1,4,4,2,6
13,2,5,36,26,62
30,2,5,84,60,144
10,2,5,28,20,48
19,2,5,50,38,88
3,2,5,8,6,14
21,1,4,51,21,72
14,1,4,34,14,48
2,8,21,25,16,41
13,8,21,164,104,268
1,8,21,13,8,21
14,8,21,176,112,288
1,755,1215,411,755,1166
1,461,742,229,461,690
1,755,1215,302,755,1057
1,755,1215,302,755,1057
1,755,1215,205,755,960
1,755,1215,411,755,1166
18,24,64,674,432,1106
6,24,64,156,144,300
24,24,64,622,576,1198
23,24,64,905,552,1457
7,45,120,340,315,655
18,2,5,52,36,88
3,2,5,9,6,15
22,2,5,65,44,109
1,2,5,3,2,5
6,3,9,34,18,52
27,3,9,152,81,233
27,4,10,159,108,267
17,4,10,100,68,168
4,4,10,19,16,35
7,2,5,15,14,29
16,2,5,34,32,66
20,3,9,113,60,173
2,3,9,11,6,17
29,2,5,86,58,144
9,2,5,27,18,45
29,2,5,81,58,139
16,2,5,45,32,77
12,3,9,71,36,107
1,3,9,4,3,7
23,3,9,92,69,161
12,2,5,35,24,59
20,2,5,59,40,99
9,2,5,21,18,39
2,2,5,4,4,8
6,2,5,13,12,25
3,2,5,9,6,15
14,2,5,41,28,69
25,7,9,41,175,216
18,7,9,30,126,156
21,7,9,38,147,185
18,7,9,7,126,133
2,7,9,3,14,17
9,7,9,3,63,66
23,7,9,44,161,205
19,3,8,92,57,149
26,8,22,358,208,566
18,8,22,248,144,392
28,8,22,380,224,604
6,8,22,63,48,111
19,8,22,249,152,401
27,9,24,399,243,642
5,9,24,58,45,103
9,9,24,133,81,214
5,9,24,73,45,118
5,9,24,49,45,94
23,13,35,361,299,660
6,13,35,124,78,202
20,13,35,433,260,693
11,13,35,238,143,381
26,13,35,563,338,901
13,13,35,268,169,437
18,13,35,390,234,624
12,13,35,247,156,403
15,13,35,309,195,504
20,13,35,412,260,672
26,13,35,372,338,710
12,13,35,209,156,365
5,13,35,86,65,151
14,13,35,298,182,480
24,13,35,343,312,655
15,13,35,257,195,452
9,13,35,154,117,271
29,21,55,763,609,1372
19,21,55,604,399,1003
24,21,55,803,504,1307
20,21,55,658,420,1078
17,21,55,569,357,926
17,38,50,17,646,663
12,38,50,36,456,492
16,42,54,54,672,726
23,38,50,230,874,1104
1,38,50,3,38,41
14,38,50,42,532,574
7,38,50,81,266,347
10,38,50,110,380,490
30,42,54,20,1260,1280
1,1252,2295,951,1252,2203
1,1266,2320,729,1266,1995
1,1912,3400,1046,1912,2958
1,1266,2320,961,1266,2227
1,420,769,334,420,754
1,1252,2295,1020,1252,2272
1,420,769,211,420,631
1,1252,2295,882,1252,2134
1,1252,2295,951,1252,2203
1,420,769,318,420,738
1,308,565,246,308,554
1,295,540,240,295,535
1,1266,2320,636,1266,1902
1,2171,3578,1264,2171,3435
1,1555,2443,448,1555,2003
1,713,1120,205,713,918
1,713,1120,205,713,918
1,1555,2443,351,1555,1906
1,344,540,191,344,535
1,1555,2443,570,1555,2125
1,2171,3578,1371,2171,3542
1,713,1120,172,713,885
1,2171,3578,1335,2171,3506
11,26,70,476,286,762
10,26,70,349,260,609
28,26,70,1212,728,1940
22,26,70,937,572,1509
30,3,9,145,90,235
23,3,9,136,69,205
14,13,35,303,182,485
1,12,33,20,12,32
19,12,33,374,228,602
22,1,4,65,22,87
3,1,4,9,3,12
5,1,4,15,5,20
26,2,5,77,52,129
9,2,5,27,18,45
22,1,4,65,22,87
8,1,4,24,8,32
13,2,5,36,26,62
26,2,5,73,52,125
19,11,30,258,209,467
4,1,2,4,4,8
9,1,2,8,9,17
17,1,2,16,17,33
24,1,2,18,24,42
10,1,2,7,10,17
14,1,2,8,14,22
16,1,2,9,16,25
14,1,2,8,14,22
19,1,2,11,19,30
13,11,30,239,143,382
25,2,5,58,50,108
29,2,5,68,58,126
24,2,5,56,48,104
4,8,21,34,32,66
25,9,25,263,225,488
17,1,4,48,17,65
30,1,4,85,30,115
30,1,4,85,30,115
24,1,4,70,24,94
21,1,4,61,21,82
1,8,21,9,8,17
14,1,2,14,14,28
7,1,2,7,7,14
10,1,2,6,10,16
7,1,2,4,7,11
30,1,2,17,30,47
30,1,4,73,30,103
15,1,4,37,15,52
18,1,4,44,18,62
5,1,4,12,5,17
27,11,29,345,297,642
1,1482,2384,807,1482,2289
1,1482,2384,592,1482,2074
1,1482,2384,878,1482,2360
1,1482,2384,878,1482,2360
1,1482,2384,378,1482,1860
1,1482,2384,854,1482,2336
1,755,1215,436,755,1191
1,755,1215,436,755,1191
6,45,120,436,270,706
5,45,120,291,225,516
12,45,120,713,540,1253
15,45,120,729,675,1404
10,59,159,889,590,1479
5,2,5,11,10,21
10,2,5,21,20,41
20,2,5,56,40,96
27,2,5,76,54,130
22,2,5,62,44,106
4,2,5,11,8,19
15,4,10,84,60,144
5,4,10,28,20,48
6,2,5,17,12,29
3,2,5,8,6,14
27,2,5,78,54,132
28,2,5,81,56,137
20,2,5,58,40,98
4,2,5,12,8,20
15,3,9,87,45,132
12,4,10,67,48,115
8,2,5,18,16,34
19,2,5,44,38,82
8,2,5,23,16,39
17,2,5,49,34,83
20,2,5,47,40,87
12,2,5,28,24,52
10,4,10,38,40,78
3,2,5,6,6,12
10,2,5,20,20,40
16,2,5,47,32,79
25,2,5,74,50,124
11,2,5,26,22,48
16,2,5,38,32,70
27,3,9,152,81,233
2,3,9,11,6,17
15,2,5,33,30,63
26,2,5,57,52,109
27,2,5,63,54,117
30,7,9,55,210,265
26,7,9,1,182,183
1,7,9,2,7,9
28,7,9,51,196,247
15,7,9,27,105,132
6,7,9,5,42,47
11,3,8,49,33,82
6,8,22,81,48,129
16,8,22,217,128,345
20,8,22,249,160,409
26,8,22,341,208,549
30,8,22,301,240,541
27,8,22,253,216,469
21,8,22,276,168,444
10,8,22,105,80,185
21,8,22,289,168,457
23,9,24,339,207,546
26,9,24,378,234,612
29,9,24,428,261,689
17,9,24,247,153,400
24,9,24,279,216,495
14,9,24,139,126,265
22,9,24,325,198,523
4,13,35,85,52,137
22,13,35,469,286,755
11,13,35,238,143,381
3,13,35,65,39,104
16,13,35,274,208,482
3,13,35,65,39,104
25,13,35,515,325,840
1,13,35,16,13,29
14,13,35,220,182,402
7,13,35,144,91,235
2,13,35,43,26,69
30,13,35,513,390,903
15,13,35,320,195,515
17,13,35,368,221,589
8,13,35,140,104,244
12,21,55,322,252,574
24,21,55,644,504,1148
4,42,54,9,168,177
24,42,54,275,1008,1283
24,42,54,236,1008,1244
29,38,50,334,1102,1436
11,42,54,55,462,517
3,38,50,12,114,126
13,42,54,142,546,688
3,42,54,33,126,159
18,42,54,197,756,953
29,38,50,290,1102,1392
1,308,565,155,308,463
1,1252,2295,791,1252,2043
1,1252,2295,951,1252,2203
1,420,769,334,420,754
1,420,769,249,420,669
1,1266,2320,752,1266,2018
1,420,769,318,420,738
1,308,565,234,308,542
1,1266,2320,961,1266,2227
1,1266,2320,1008,1266,2274
1,1252,2295,538,1252,1790
1,1252,2295,997,1252,2249
1,1252,2295,997,1252,2249
1,2171,3578,763,2171,2934
1,2171,3578,1264,2171,3435
1,713,1120,385,713,1098
1,1555,2443,790,1555,2345
1,2171,3578,656,2171,2827
1,2171,3578,942,2171,3113
1,1555,2443,570,1555,2125
1,1555,2443,497,1555,2052
1,1083,1701,261,1083,1344
1,1083,1701,397,1083,1480
1,1555,2443,864,1555,2419
1,1555,2443,864,1555,2419
1,487,783,194,487,681
1,487,783,194,487,681
1,713,1120,362,713,1075
1,2171,3578,1335,2171,3506
28,26,70,977,728,1705
3,26,70,130,78,208
26,26,70,889,676,1565
30,26,70,942,780,1722
12,3,9,57,36,93
6,8,21,77,48,125
16,8,21,205,128,333
24,8,21,307,192,499
18,8,21,230,144,374
7,13,35,149,91,240
18,13,35,383,234,617
26,13,35,554,338,892
13,13,35,277,169,446
29,1,2,28,29,57
29,1,2,28,29,57
4,2,5,8,8,16
3,2,5,6,6,12
27,13,35,575,351,926
25,13,35,533,325,858
19,2,5,44,38,82
29,2,5,67,58,125
10,13,35,217,130,347
13,13,35,281,169,450
2,2,5,6,4,10
13,2,5,38,26,64
25,2,5,74,50,124
15,12,33,251,180,431
29,2,5,86,58,144
27,11,29,345,297,642
24,11,29,307,264,571
26,9,25,390,234,624
17,9,25,255,153,408
9,2,5,24,18,42
11,2,5,21,22,43
10,2,5,20,20,40
20,1,4,50,20,70
17,1,4,42,17,59
27,2,5,49,54,103
5,11,30,64,55,119
13,11,30,165,143,308
23,1,2,17,23,40
17,1,2,13,17,30
13,1,2,13,13,26
6,9,25,86,54,140
18,9,25,257,162,419
15,1,2,14,15,29
9,1,2,8,9,17
13,2,5,38,26,64
10,2,5,29,20,49
28,1,2,16,28,44
23,9,25,293,207,500
5,9,25,64,45,109
7,1,4,17,7,24
11,1,4,26,11,37
12,1,4,28,12,40
6,1,2,4,6,10
25,1,4,73,25,98
21,1,4,61,21,82
28,13,35,440,364,804
10,13,35,157,130,287
17,1,4,46,17,63
24,1,4,65,24,89
30,2,5,84,60,144
18,2,5,53,36,89
29,2,5,84,58,142
6,1,4,17,6,23
10,1,4,28,10,38
26,1,4,56,26,82
29,1,4,61,29,90
11,1,4,23,11,34
9,2,5,25,18,43
13,2,5,36,26,62
29,1,2,16,29,45
26,1,2,15,26,41
3,9,25,47,27,74
11,9,25,171,99,270
1,1482,2384,401,1482,1883
1,1482,2384,854,1482,2336
1,461,742,185,461,646
1,461,742,251,461,712
29,24,64,770,696,1466
13,24,64,512,312,824
8,45,120,475,360,835
30,3,9,169,90,259
28,3,9,158,84,242
15,3,9,68,45,113
7,3,9,32,21,53
1,3,9,5,3,8
19,2,5,53,38,91
4,2,5,11,8,19
25,2,5,74,50,124
10,2,5,30,20,50
15,2,5,44,30,74
10,2,5,29,20,49
22,2,5,64,44,108
9,2,5,26,18,44
2,2,5,4,4,8
11,2,5,32,22,54
18,3,9,105,54,159
29,2,5,61,58,119
19,2,5,42,38,80
5,2,5,11,10,21
17,4,10,99,68,167
2,2,5,6,4,10
2,2,5,6,4,10
7,7,9,6,49,55
22,7,9,2,154,156
19,7,9,31,133,164
24,7,9,13,168,181
5,3,8,24,15,39
8,8,22,100,64,164
25,8,22,328,200,528
18,8,22,169,144,313
17,13,35,350,221,571
6,13,35,128,78,206
20,13,35,412,260,672
22,13,35,315,286,601
23,13,35,474,299,773
21,13,35,300,273,573
25,13,35,358,325,683
30,13,35,492,390,882
12,13,35,260,156,416
15,13,35,257,195,452
22,13,35,384,286,670
4,42,54,39,168,207
21,38,50,210,798,1008
15,38,50,15,570,585
28,42,54,139,1176,1315
3,38,50,33,114,147
1,1252,2295,951,1252,2203
1,420,769,334,420,754
1,1266,2320,752,1266,2018
1,2171,3578,763,2171,2934
1,2171,3578,1264,2171,3435
1,2171,3578,942,2171,3113
1,2171,3578,835,2171,3006
1,2171,3578,656,2171,2827
1,1083,1701,346,1083,1429
27,26,70,886,702,1588
29,1,2,28,29,57
9,11,30,168,99,267
8,11,30,150,88,238
28,2,5,53,56,109
23,2,5,44,46,90
7,1,2,7,7,14
27,1,2,26,27,53
13,2,5,25,26,51
29,2,5,55,58,113
3,1,2,2,3,5
16,1,2,11,16,27
2,2,5,6,4,10
12,2,5,34,24,58
5,1,2,3,5,8
2,1,2,1,2,3
19,11,30,281,209,490
12,11,30,178,132,310
17,2,5,39,34,73
7,2,5,16,14,30
16,1,2,9,16,25
23,1,2,13,23,36
6,2,5,17,12,29
3,1,4,9,3,12
6,1,4,18,6,24
4,2,5,9,8,17
12,1,4,35,12,47
1,461,742,251,461,712
1,1482,2384,807,1482,2289
1,461,742,185,461,646
3,24,64,116,72,188
4,45,120,295,180,475
5,45,120,297,225,522
15,4,10,84,60,144
21,4,10,118,84,202
9,2,5,25,18,43
8,4,10,38,32,70
21,4,10,99,84,183
23,4,10,133,92,225
29,4,10,168,116,284
15,2,5,44,30,74
17,3,9,99,51,150
22,3,9,128,66,194
27,2,5,59,54,113
4,2,5,9,8,17
26,2,5,55,52,107
9,2,5,25,18,43
23,7,9,9,161,170
21,7,9,8,147,155
10,7,9,8,70,78
3,7,9,5,21,26
26,7,9,47,182,229
4,3,8,14,12,26
13,8,22,176,104,280
21,8,22,285,168,453
28,8,22,380,224,604
8,8,22,73,64,137
16,8,22,210,128,338
30,8,22,314,240,554
14,8,22,156,112,268
20,9,24,199,180,379
29,9,24,310,261,571
25,9,24,351,225,576
14,9,24,197,126,323
26,9,24,309,234,543
30,9,24,349,270,619
23,13,35,329,299,628
12,13,35,247,156,403
16,13,35,262,208,470
16,13,35,251,208,459
6,13,35,105,78,183
29,13,35,567,377,944
4,13,35,59,52,111
3,13,35,52,39,91
16,13,35,251,208,459
2,13,35,31,26,57
24,13,35,520,312,832
11,13,35,234,143,377
7,13,35,100,91,191
20,13,35,342,260,602
8,13,35,170,104,274
12,21,55,382,252,634
6,38,50,60,228,288
3,38,50,5,114,119
16,38,50,160,608,768
1,42,54,5,42,47
4,38,50,4,152,156
26,42,54,59,1092,1151
24,38,50,132,912,1044
7,38,50,70,266,336
1,420,769,334,420,754
1,1252,2295,630,1252,1882
1,1266,2320,544,1266,1810
1,1898,3375,1005,1898,2903
1,1252,2295,538,1252,1790
1,1555,2443,790,1555,2345
1,2171,3578,942,2171,3113
1,1083,1701,499,1083,1582
1,2171,3578,942,2171,3113
1,487,783,155,487,642
1,1083,1701,312,1083,1395
1,1555,2443,448,1555,2003
18,26,70,616,468,1084
19,26,70,809,494,1303
23,3,9,134,69,203
18,1,2,10,18,28
19,1,2,11,19,30
26,13,35,554,338,892
1,13,35,21,13,34
22,1,2,12,22,34
2,1,2,1,2,3
25,2,5,73,50,123
22,2,5,62,44,106
10,2,5,28,20,48
7,1,2,4,7,11
21,1,2,12,21,33
6,1,2,3,6,9
2,11,30,37,22,59
25,11,30,468,275,743
24,2,5,71,48,119
29,2,5,86,58,144
15,2,5,44,30,74
20,1,2,19,20,39
22,2,5,52,44,96
14,2,5,29,28,57
30,2,5,63,60,123
28,2,5,59,56,115
18,1,2,13,18,31
15,1,2,10,15,25
14,1,2,9,14,23
8,1,2,5,8,13
8,1,2,5,8,13
28,1,2,27,28,55
6,1,4,18,6,24
28,1,4,82,28,110
4,2,5,12,8,20
10,2,5,23,20,43
8,2,5,18,16,34
17,1,2,16,17,33
13,1,2,12,13,25
13,2,5,31,26,57
6,2,5,14,12,26
11,1,4,32,11,43
21,1,4,61,21,82
23,2,5,54,46,100
22,2,5,52,44,96
6,1,2,6,6,12
19,1,2,19,19,38
1,755,1215,302,755,1057
1,1482,2384,807,1482,2289
1,1482,2384,854,1482,2336
1,461,742,162,461,623
1,461,742,266,461,727
10,24,64,259,240,499
16,24,64,620,384,1004
4,45,120,214,180,394
15,3,9,89,45,134
6,2,5,18,12,30
29,2,5,86,58,144
26,2,5,77,52,129
6,2,5,14,12,26
10,4,10,59,40,99
3,2,5,9,6,15
16,2,5,46,32,78
5,4,10,29,20,49
3,4,10,17,12,29
16,2,5,37,32,69
7,2,5,16,14,30
29,4,10,122,116,238
18,4,10,76,72,148
12,3,9,49,36,85
5,3,9,21,15,36
11,3,9,53,33,86
3,7,9,5,21,26
17,7,9,2,119,121
16,7,9,31,112,143
29,7,9,55,203,258
21,7,9,38,147,185
9,7,9,7,63,70
17,7,9,14,119,133
26,7,9,50,182,232
18,3,8,58,54,112
29,3,8,143,87,230
2,3,8,10,6,16
12,3,8,53,36,89
13,3,8,50,39,89
30,3,8,119,90,209
15,8,22,203,120,323
12,8,22,165,96,261
21,8,22,285,168,453
3,8,22,39,24,63
3,8,22,41,24,65
28,8,22,380,224,604
21,8,22,285,168,453
11,8,22,144,88,232
2,8,22,28,16,44
26,8,22,244,208,452
6,9,24,87,54,141
9,13,35,129,117,246
18,13,35,390,234,624
23,13,35,377,299,676
20,13,35,349,260,609
10,13,35,143,130,273
4,13,35,70,52,122
5,13,35,107,65,172
19,13,35,405,247,652
17,13,35,362,221,583
18,13,35,352,234,586
15,13,35,236,195,431
6,13,35,88,78,166
9,13,35,141,117,258
17,13,35,267,221,488
20,13,35,433,260,693
11,13,35,238,143,381
22,13,35,322,286,608
10,21,55,225,210,435
15,21,55,477,315,792
28,21,55,890,588,1478
17,42,54,186,714,900
15,38,50,150,570,720
30,38,50,345,1140,1485
23,38,50,69,874,943
22,42,54,252,924,1176
7,42,54,76,294,370
1,1266,2320,1008,1266,2274
1,1252,2295,1020,1252,2272
1,1252,2295,538,1252,1790
1,420,769,334,420,754
1,1252,2295,1020,1252,2272
1,1266,2320,636,1266,1902
1,420,769,188,420,608
1,1252,2295,997,1252,2249
1,1266,2320,1008,1266,2274
1,1266,2320,961,1266,2227
1,1252,2295,951,1252,2203
1,1519,2443,606,1519,2125
1,2171,3578,656,2171,2827
1,487,783,241,487,728
1,2171,3578,656,2171,2827
1,1555,2443,448,1555,2003
1,344,540,191,344,535
1,344,540,126,344,470
22,3,9,128,66,194
22,1,2,16,22,38
9,8,21,75,72,147
14,1,2,13,14,27
1,2,5,2,2,4
19,2,5,55,38,93
26,13,35,563,338,901
8,13,35,173,104,277
5,2,5,15,10,25
21,2,5,62,42,104
1,1,2,1,1,2
22,1,2,16,22,38
13,1,2,10,13,23
29,2,5,57,58,115
25,2,5,49,50,99
26,2,5,75,52,127
6,2,5,17,12,29
6,9,25,93,54,147
2,2,5,6,4,10
13,2,5,38,26,64
18,2,5,48,36,84
3,2,5,8,6,14
30,1,4,89,30,119
2,1,4,6,2,8
22,11,30,405,242,647
25,11,30,460,275,735
9,11,30,166,99,265
22,1,2,14,22,36
21,1,2,13,21,34
2,2,5,4,4,8
23,2,5,48,46,94
13,11,30,177,143,320
25,11,30,340,275,615
7,1,2,6,7,13
23,1,2,23,23,46
22,11,29,383,242,625
30,11,29,523,330,853
6,1,2,5,6,11
19,1,2,16,19,35
1,9,25,11,9,20
1,1,2,1,1,2
1,755,1215,448,755,1203
1,755,1215,241,755,996
1,1482,2384,473,1482,1955
1,461,742,274,461,735
3,4,10,12,12,24
15,4,10,59,60,119
30,3,9,137,90,227
10,2,5,21,20,41
9,2,5,19,18,37
9,2,5,21,18,39
2,2,5,6,4,10
30,2,5,89,60,149
25,2,5,74,50,124
5,2,5,15,10,25
7,3,9,41,21,62
5,4,10,28,20,48
5,4,10,28,20,48
2,2,5,5,4,9
1,7,9,1,7,8
1,7,9,2,7,9
28,7,9,3,196,199
17,7,9,31,119,150
17,7,9,31,119,150
23,3,8,86,69,155
13,3,8,58,39,97
16,8,22,217,128,345
10,8,22,109,80,189
4,8,22,52,32,84
6,9,24,89,54,143
26,9,24,278,234,512
28,9,24,393,252,645
17,9,24,251,153,404
24,9,24,354,216,570
16,13,35,346,208,554
13,13,35,281,169,450
17,13,35,368,221,589
3,13,35,65,39,104
23,13,35,361,299,660
18,13,35,383,234,617
3,13,35,62,39,101
13,21,55,435,273,708
2,42,54,5,84,89
29,38,50,160,1102,1262
1,38,50,12,38,50
16,38,50,160,608,768
18,42,54,197,756,953
4,38,50,46,152,198
1,1252,2295,745,1252,1997
1,1252,2295,745,1252,1997
1,420,769,249,420,669
1,1266,2320,636,1266,1902
1,295,540,234,295,529
1,1252,2295,951,1252,2203
1,1898,3375,1410,1898,3308
1,1266,2320,636,1266,1902
1,2171,3578,1371,2171,3542
1,487,783,155,487,642
1,1555,2443,839,1555,2394
1,713,1120,362,713,1075
1,344,540,77,344,421
22,26,70,953,572,1525
20,3,9,118,60,178
5,3,9,20,15,35
14,9,25,221,126,347
4,1,2,4,4,8
7,2,5,20,14,34
17,2,5,49,34,83
12,2,5,35,24,59
24,13,35,511,312,823
9,13,35,192,117,309
26,9,25,332,234,566
30,9,25,383,270,653
29,9,25,370,261,631
1,11,30,19,11,30
1,11,30,19,11,30
3,1,2,3,3,6
8,1,2,8,8,16
17,2,5,40,34,74
21,2,5,49,42,91
16,12,33,315,192,507
6,12,33,118,72,190
22,11,29,358,242,600
23,2,5,68,46,114
27,2,5,80,54,134
30,1,2,29,30,59
29,1,2,28,29,57
23,1,2,23,23,46
2,2,5,6,4,10
18,2,5,53,36,89
2,2,5,4,4,8
11,2,5,26,22,48
27,1,2,26,27,53
28,1,2,27,28,55
12,1,2,8,12,20
23,1,2,13,23,36
21,1,2,12,21,33
3,1,2,2,3,5
29,1,2,21,29,50
11,1,2,8,11,19
1,1,2,1,1,2
11,11,30,140,121,261
20,11,30,254,220,474
6,11,30,76,66,142
22,11,30,405,242,647
24,11,30,442,264,706
24,1,2,14,24,38
19,1,2,11,19,30
14,1,4,33,14,47
9,1,4,21,9,30
17,1,4,40,17,57
27,2,5,63,54,117
2,2,5,5,4,9
18,2,5,52,36,88
24,2,5,70,48,118
7,2,5,20,14,34
15,1,2,9,15,24
1,1482,2384,878,1482,2360
1,755,1215,241,755,996
1,461,742,229,461,690
1,1482,2384,473,1482,1955
1,1482,2384,854,1482,2336
1,461,742,251,461,712
29,24,64,919,696,1615
11,24,64,398,264,662
22,24,64,683,528,1211
1,45,120,58,45,103
30,2,5,87,60,147
5,2,5,12,10,22
4,2,5,9,8,17
27,2,5,51,54,105
8,2,5,15,16,31
7,2,5,20,14,34
19,2,5,53,38,91
19,4,10,72,76,148
6,2,5,17,12,29
5,2,5,15,10,25
5,2,5,15,10,25
8,2,5,23,16,39
5,2,5,15,10,25
6,2,5,18,12,30
28,4,10,106,112,218
10,4,10,38,40,78
5,2,5,11,10,21
14,2,5,31,28,59
6,2,5,13,12,25
26,7,9,22,182,204
23,7,9,42,161,203
21,7,9,34,147,181
8,3,8,26,24,50
8,3,8,37,24,61
16,3,8,52,48,100
8,3,8,39,24,63
18,8,22,165,144,309
9,8,22,98,72,170
16,8,22,210,128,338
17,8,22,234,136,370
7,9,24,103,63,166
25,9,24,297,225,522
30,9,24,443,270,713
5,13,35,108,65,173
19,13,35,325,247,572
10,13,35,171,130,301
26,13,35,536,338,874
10,13,35,157,130,287
4,13,35,85,52,137
25,13,35,436,325,761
27,13,35,386,351,737
2,13,35,43,26,69
12,13,35,260,156,416
13,13,35,277,169,446
12,13,35,247,156,403
16,13,35,346,208,554
5,13,35,72,65,137
26,13,35,408,338,746
20,21,55,504,420,924
19,21,55,416,399,815
23,38,50,69,874,943
11,38,50,127,418,545
14,38,50,154,532,686
21,42,54,71,882,953
22,42,54,74,924,998
29,42,54,144,1218,1362
1,1252,2295,538,1252,1790
1,1266,2320,729,1266,1995
1,1252,2295,951,1252,2203
1,1252,2295,630,1252,1882
1,1252,2295,951,1252,2203
1,420,769,334,420,754
1,1266,2320,961,1266,2227
1,487,783,124,487,611
1,487,783,280,487,767
1,344,540,77,344,421
1,713,1120,362,713,1075
1,2171,3578,1371,2171,3542
1,713,1120,205,713,918
26,26,70,1108,676,1784
11,26,70,469,286,755
4,26,70,165,104,269
24,26,70,838,624,1462
19,3,9,76,57,133
26,3,9,151,78,229
18,3,9,106,54,160
7,1,4,15,7,22
22,9,25,347,198,545
27,8,21,226,216,442
27,13,35,462,351,813
30,13,35,513,390,903
7,1,2,6,7,13
12,1,2,9,12,21
3,1,2,2,3,5
20,1,2,20,20,40
17,2,5,48,34,82
23,2,5,64,46,110
21,2,5,59,42,101
13,2,5,27,26,53
26,2,5,55,52,107
27,2,5,76,54,130
26,1,2,25,26,51
30,1,2,29,30,59
8,1,2,8,8,16
30,1,4,74,30,104
14,1,4,35,14,49
23,1,4,57,23,80
16,2,5,45,32,77
20,2,5,56,40,96
16,2,5,45,32,77
19,1,2,12,19,31
30,1,2,19,30,49
14,11,30,178,154,332
28,11,30,356,308,664
29,11,30,368,319,687
20,1,2,20,20,40
30,1,2,29,30,59
24,11,30,427,264,691
22,11,30,392,242,634
30,2,5,80,60,140
9,2,5,26,18,44
10,2,5,29,20,49
24,1,2,24,24,48
30,1,2,29,30,59
10,1,2,6,10,16
12,1,2,7,12,19
19,11,29,243,209,452
9,1,2,7,9,16
1,1,2,1,1,2
14,12,33,192,168,360
19,12,33,261,228,489
26,1,4,59,26,85
11,1,4,25,11,36
20,2,5,56,40,96
4,2,5,11,8,19
16,2,5,45,32,77
1,461,742,266,461,727
1,1482,2384,878,1482,2360
1,1482,2384,878,1482,2360
29,24,64,1086,696,1782
15,24,64,581,360,941
6,59,159,495,354,849
1,2,5,3,2,5
9,2,5,27,18,45
4,2,5,9,8,17
10,2,5,24,20,44
17,2,5,48,34,82
13,2,5,36,26,62
2,2,5,4,4,8
1,2,5,2,2,4
15,3,9,87,45,132
22,3,9,128,66,194
26,2,5,60,52,112
25,2,5,49,50,99
10,2,5,20,20,40
7,2,5,20,14,34
21,7,9,40,147,187
23,7,9,23,161,184
18,7,9,33,126,159
7,7,9,6,49,55
11,7,9,1,77,78
8,7,9,11,56,67
28,7,9,11,196,207
2,3,8,10,6,16
30,3,8,116,90,206
9,8,22,124,72,196
21,8,22,285,168,453
19,8,22,258,152,410
1,8,22,14,8,22
9,8,22,122,72,194
18,8,22,201,144,345
27,8,22,372,216,588
18,8,22,201,144,345
11,9,24,160,99,259
3,9,24,44,27,71
29,13,35,618,377,995
11,13,35,238,143,381
10,13,35,157,130,287
22,13,35,453,286,739
24,13,35,494,312,806
25,13,35,541,325,866
28,13,35,596,364,960
10,13,35,217,130,347
10,13,35,206,130,336
30,13,35,650,390,1040
15,13,35,325,195,520
1,13,35,21,13,34
25,13,35,533,325,858
17,13,35,249,221,470
18,13,35,383,234,617
21,13,35,411,273,684
16,21,55,430,336,766
30,21,55,987,630,1617
27,38,50,297,1026,1323
5,42,54,57,210,267
20,38,50,200,760,960
28,38,50,308,1064,1372
10,42,54,109,420,529
11,42,54,126,462,588
28,42,54,18,1176,1194
15,42,54,148,630,778
16,38,50,40,608,648
11,42,54,108,462,570
1,1252,2295,1020,1252,2272
1,1266,2320,567,1266,1833
1,1252,2295,951,1252,2203
1,1266,2320,1008,1266,2274
1,1266,2320,961,1266,2227
1,1252,2295,745,1252,1997
1,420,769,249,420,669
1,2171,3578,656,2171,2827
1,2171,3578,656,2171,2827
1,1083,1701,312,1083,1395
1,1083,1701,550,1083,1633
1,344,540,174,344,518
1,344,540,83,344,427
1,344,540,185,344,529
1,713,1120,205,713,918
1,344,540,158,344,502
30,26,70,984,780,1764
6,3,9,34,18,52
30,3,9,169,90,259
7,1,2,7,7,14
14,1,2,14,14,28
16,1,2,16,16,32
3,1,2,2,3,5
5,12,33,98,60,158
12,12,33,236,144,380
9,2,5,26,18,44
7,2,5,20,14,34
17,2,5,50,34,84
11,2,5,32,22,54
28,2,5,83,56,139
13,2,5,36,26,62
17,2,5,48,34,82
6,1,4,14,6,20
2,2,5,6,4,10
12,1,2,10,12,22
9,1,2,8,9,17
15,1,2,13,15,28
9,9,25,104,81,185
17,1,2,16,17,33
14,1,2,13,14,27
14,1,4,35,14,49
14,1,4,35,14,49
15,1,4,37,15,52
20,2,5,49,40,89
1,2,5,2,2,4
22,2,5,54,44,98
11,9,25,171,99,270
20,9,25,310,180,490
13,9,25,202,117,319
20,1,2,15,20,35
17,1,2,13,17,30
16,1,2,16,16,32
29,1,2,28,29,57
16,1,2,12,16,28
17,1,2,13,17,30
28,2,5,66,56,122
12,2,5,28,24,52
1,2,5,2,2,4
12,2,5,28,24,52
24,12,33,338,288,626
11,12,33,155,132,287
15,2,5,42,30,72
25,2,5,70,50,120
6,1,4,14,6,20
22,1,4,50,22,72
13,1,2,12,13,25
21,1,2,19,21,40
30,13,35,440,390,830
18,9,25,270,162,432
5,9,25,75,45,120
7,9,25,105,63,168
15,2,5,44,30,74
18,1,4,53,18,71
13,1,4,38,13,51
30,1,4,67,30,97
16,9,25,204,144,348
17,8,21,207,136,343
11,8,21,134,88,222
1,1482,2384,807,1482,2289
1,1482,2384,473,1482,1955
1,1482,2384,854,1482,2336
1,461,742,266,461,727
29,24,64,919,696,1615
29,45,120,2140,1305,3445
13,4,10,73,52,125
17,4,10,95,68,163
2,3,9,12,6,18
20,3,9,118,60,178
5,2,5,15,10,25
1,2,5,2,2,4
12,2,5,23,24,47
15,4,10,57,60,117
1,4,10,4,4,8
13,4,10,49,52,101
9,4,10,34,36,70
7,2,5,21,14,35
27,2,5,80,54,134
11,2,5,26,22,48
22,2,5,52,44,96
29,2,5,86,58,144
19,2,5,56,38,94
3,2,5,8,6,14
16,3,9,66,48,114
7,3,9,29,21,50
24,2,5,46,48,94
15,2,5,29,30,59
17,7,9,13,119,132
24,7,9,13,168,181
20,7,9,38,140,178
18,7,9,30,126,156
20,7,9,29,140,169
24,7,9,44,168,212
10,3,8,40,30,70
23,8,22,302,184,486
23,8,22,251,184,435
30,8,22,407,240,647
25,8,22,345,200,545
17,9,24,247,153,400
29,9,24,282,261,543
26,9,24,365,234,599
1,9,24,12,9,21
6,9,24,87,54,141
9,9,24,131,81,212
15,13,35,215,195,410
6,13,35,130,78,208
5,13,35,107,65,172
29,13,35,425,377,802
27,13,35,585,351,936
22,13,35,345,286,631
11,13,35,192,143,335
8,13,35,173,104,277
11,13,35,234,143,377
26,13,35,536,338,874
16,13,35,318,208,526
11,13,35,238,143,381
12,13,35,260,156,416
22,13,35,315,286,601
18,13,35,308,234,542
25,21,55,603,525,1128
24,38,50,276,912,1188
10,38,50,110,380,490
30,38,50,30,1140,1170
24,38,50,204,912,1116
9,38,50,99,342,441
21,42,54,71,882,953
22,42,54,110,924,1034
17,38,50,187,646,833
15,38,50,150,570,720
10,42,54,23,420,443
28,38,50,28,1064,1092
11,38,50,121,418,539
21,42,54,48,882,930
1,1252,2295,951,1252,2203
1,295,540,169,295,464
1,1266,2320,1008,1266,2274
1,2171,3578,620,2171,2791
1,1519,2443,875,1519,2394
1,487,783,124,487,611
1,1555,2443,448,1555,2003
1,1555,2443,570,1555,2125
1,1083,1701,397,1083,1480
1,1555,2443,839,1555,2394
1,713,1120,385,713,1098
1,2171,3578,1371,2171,3542
1,1083,1701,516,1083,1599
1,344,540,191,344,535
1,2171,3578,1371,2171,3542
1,2171,3578,1335,2171,3506
7,26,70,298,182,480
2,3,9,12,6,18
10,2,5,27,20,47
23,13,35,498,299,797
2,13,35,43,26,69
10,2,5,20,20,40
28,2,5,55,56,111
29,2,5,57,58,115
27,1,4,80,27,107
15,1,4,44,15,59
27,1,4,80,27,107
8,1,4,24,8,32
15,1,4,44,15,59
16,2,5,47,32,79
7,2,5,21,14,35
29,2,5,55,58,113
12,1,2,10,12,22
30,1,2,29,30,59
25,1,2,17,25,42
24,2,5,71,48,119
27,2,5,80,54,134
17,2,5,50,34,84
21,1,2,16,21,37
11,1,2,8,11,19
25,1,2,25,25,50
30,1,2,29,30,59
25,1,2,24,25,49
23,1,2,22,23,45
18,11,30,337,198,535
15,11,30,281,165,446
4,11,30,75,44,119
7,1,2,6,7,13
28,12,33,412,336,748
26,1,2,17,26,43
10,1,2,6,10,16
13,1,2,9,13,22
20,1,2,14,20,34
21,11,29,354,231,585
20,11,29,337,220,557
24,11,29,404,264,668
19,1,4,55,19,74
19,1,4,55,19,74
21,1,2,21,21,42
19,1,2,19,19,38
9,2,5,21,18,39
5,2,5,11,10,21
19,1,4,55,19,74
26,1,4,76,26,102
1,461,742,251,461,712
1,1482,2384,378,1482,1860
1,1482,2384,854,1482,2336
1,755,1215,193,755,948
1,755,1215,193,755,948
13,24,64,337,312,649
14,24,64,363,336,699
29,2,5,78,58,136
12,2,5,32,24,56
11,4,10,46,44,90
9,4,10,38,36,74
2,2,5,5,4,9
3,2,5,7,6,13
17,2,5,49,34,83
25,2,5,73,50,123
19,4,10,110,76,186
23,2,5,48,46,94
24,2,5,50,48,98
9,2,5,19,18,37
9,3,9,37,27,64
27,2,5,76,54,130
17,2,5,48,34,82
25,2,5,70,50,120
23,2,5,68,46,114
15,2,5,44,30,74
28,2,5,66,56,122
10,2,5,24,20,44
15,7,9,6,105,111
1,7,9,0,7,7
20,7,9,17,140,157
18,7,9,10,126,136
12,7,9,5,84,89
8,7,9,7,56,63
2,7,9,1,14,15
15,3,8,53,45,98
1,3,8,4,3,7
8,8,22,87,64,151
20,8,22,271,160,431
8,8,22,110,64,174
7,8,22,92,56,148
20,8,22,183,160,343
23,8,22,317,184,501
23,8,22,216,184,400
13,8,22,131,104,235
26,9,24,278,234,512
20,9,24,295,180,475
6,9,24,60,54,114
8,9,24,116,72,188
3,9,24,35,27,62
20,13,35,314,260,574
5,13,35,108,65,173
14,13,35,298,182,480
24,13,35,520,312,832
5,13,35,73,65,138
23,13,35,329,299,628
26,13,35,508,338,846
21,13,35,447,273,720
7,13,35,144,91,235
9,13,35,157,117,274
7,21,55,234,147,381
28,21,55,752,588,1340
20,38,50,110,760,870
24,38,50,276,912,1188
30,42,54,4,1260,1264
29,38,50,334,1102,1436
15,38,50,83,570,653
6,38,50,66,228,294
2,42,54,10,84,94
2,38,50,22,76,98
10,42,54,1,420,421
13,38,50,150,494,644
13,38,50,39,494,533
1,1252,2295,492,1252,1744
1,1266,2320,497,1266,1763
1,1252,2295,951,1252,2203
1,1266,2320,1008,1266,2274
1,1266,2320,752,1266,2018
1,1252,2295,951,1252,2203
1,1266,2320,544,1266,1810
1,308,565,251,308,559
1,1266,2320,636,1266,1902
1,1083,1701,499,1083,1582
1,1083,1701,584,1083,1667
1,1083,1701,550,1083,1633
1,1083,1701,499,1083,1582
1,344,540,83,344,427
15,26,70,429,390,819
21,26,70,689,546,1235
10,26,70,433,260,693
22,3,9,106,66,172
6,3,9,35,18,53
20,3,9,118,60,178
13,3,9,73,39,112
5,2,5,10,10,20
17,2,5,32,34,66
19,1,4,54,19,73
24,1,4,68,24,92
26,2,5,73,52,125
19,2,5,53,38,91
11,1,2,6,11,17
3,1,2,2,3,5
8,1,2,5,8,13
3,2,5,7,6,13
25,2,5,59,50,109
18,2,5,42,36,78
3,1,4,9,3,12
7,2,5,20,14,34
14,2,5,41,28,69
1,1,2,1,1,2
18,1,2,17,18,35
19,13,35,405,247,652
15,13,35,320,195,515
28,13,35,596,364,960
6,13,35,128,78,206
2,1,2,2,2,4
25,1,2,24,25,49
13,2,5,30,26,56
13,2,5,30,26,56
23,2,5,53,46,99
8,2,5,24,16,40
24,2,5,71,48,119
25,1,4,62,25,87
24,1,4,60,24,84
13,11,30,177,143,320
3,11,30,41,33,74
1,1,2,1,1,2
30,1,2,29,30,59
10,13,35,143,130,273
14,13,35,200,182,382
1,1,4,3,1,4
7,1,2,4,7,11
24,1,2,13,24,37
2,1,2,1,2,3
16,2,5,38,32,70
10,1,4,29,10,39
7,1,4,20,7,27
14,1,2,9,14,23
5,1,2,3,5,8
25,2,5,74,50,124
23,2,5,68,46,114
3,2,5,6,6,12
11,2,5,23,22,45
26,11,29,453,286,739
1,11,29,17,11,28
1,1,4,2,1,3
21,1,4,60,21,81
9,1,4,26,9,35
21,1,2,13,21,34
30,1,2,19,30,49
3,1,2,2,3,5
4,8,21,34,32,66
2,8,21,17,16,33
5,2,5,15,10,25
4,8,21,46,32,78
28,8,21,323,224,547
22,8,21,254,176,430
25,11,29,291,275,566
17,2,5,50,34,84
28,2,5,83,56,139
8,2,5,24,16,40
1,461,742,266,461,727
1,461,742,274,461,735
1,461,742,274,461,735
1,755,1215,436,755,1191
1,1482,2384,473,1482,1955
1,755,1215,302,755,1057
1,755,1215,241,755,996
1,461,742,274,461,735
1,461,742,118,461,579
30,2,5,89,60,149
25,2,5,74,50,124
14,2,5,33,28,61
5,2,5,12,10,22
13,4,10,77,52,129
27,2,5,78,54,132
30,2,5,87,60,147
16,2,5,46,32,78
25,2,5,73,50,123
29,2,5,77,58,135
8,2,5,21,16,37
10,3,9,58,30,88
23,2,5,53,46,99
6,2,5,11,12,23
22,2,5,64,44,108
28,2,5,81,56,137
21,4,10,122,84,206
14,4,10,81,56,137
10,2,5,23,20,43
6,2,5,14,12,26
26,2,5,61,52,113
4,2,5,9,8,17
3,2,5,7,6,13
3,2,5,7,6,13
18,2,5,52,36,88
24,7,9,39,168,207
1,7,9,2,7,9
15,7,9,27,105,132
29,7,9,21,203,224
19,7,9,26,133,159
22,7,9,18,154,172
27,7,9,-4,189,185
20,7,9,17,140,157
22,3,8,71,66,137
18,3,8,71,54,125
22,8,22,202,176,378
28,8,22,256,224,480
12,8,22,110,96,206
24,8,22,325,192,517
1,8,22,12,8,20
6,9,24,87,54,141
9,9,24,100,81,181
22,9,24,214,198,412
28,13,35,577,364,941
11,13,35,161,143,304
13,13,35,186,169,355
17,13,35,350,221,571
24,13,35,520,312,832
2,13,35,43,26,69
2,13,35,43,26,69
2,13,35,43,26,69
26,13,35,454,338,792
6,13,35,107,78,185
11,13,35,157,143,300
13,13,35,186,169,355
2,13,35,29,26,55
5,42,54,41,210,251
6,42,54,59,252,311
29,42,54,3,1218,1221
1,42,54,11,42,53
13,38,50,13,494,507
12,42,54,1,504,505
1,1266,2320,729,1266,1995
1,1252,2295,745,1252,1997
1,1266,2320,544,1266,1810
1,295,540,126,295,421
1,420,769,295,420,715
1,308,565,189,308,497
1,1912,3400,740,1912,2652
1,1519,2443,875,1519,2394
1,1555,2443,839,1555,2394
1,2171,3578,942,2171,3113
1,2171,3578,1371,2171,3542
1,1083,1701,550,1083,1633
1,344,540,126,344,470
29,26,70,1195,754,1949
11,26,70,476,286,762
8,26,70,229,208,437
22,26,70,629,572,1201
24,26,70,1022,624,1646
14,1,2,14,14,28
6,2,5,18,12,30
26,1,2,24,26,50
26,1,2,24,26,50
1,1,2,1,1,2
14,2,5,41,28,69
12,2,5,35,24,59
21,2,5,62,42,104
30,1,4,85,30,115
22,2,5,40,44,84
25,2,5,45,50,95
16,1,2,15,16,31
1,2,5,2,2,4
2,1,2,1,2,3
21,1,2,16,21,37
17,2,5,50,34,84
13,2,5,38,26,64
23,1,4,68,23,91
23,11,30,389,253,642
1,11,30,19,11,30
7,1,2,4,7,11
15,1,2,10,15,25
23,1,2,15,23,38
25,12,33,418,300,718
24,12,33,401,288,689
12,12,33,201,144,345
18,1,2,10,18,28
5,9,25,53,45,98
25,9,25,263,225,488
1,755,1215,193,755,948
1,755,1215,193,755,948
20,24,64,518,480,998
15,24,64,581,360,941
9,45,120,502,405,907
28,2,5,66,56,122
16,2,5,38,32,70
22,2,5,46,44,90
14,2,5,41,28,69
14,2,5,41,28,69
11,2,5,25,22,47
30,4,10,114,120,234
28,2,5,81,56,137
8,4,10,46,32,78
26,4,10,151,104,255
13,4,10,75,52,127
26,2,5,77,52,129
27,2,5,80,54,134
23,2,5,51,46,97
14,2,5,31,28,59
25,4,10,115,100,215
28,4,10,129,112,241
29,3,9,164,87,251
18,3,9,105,54,159
23,3,9,134,69,203
30,2,5,57,60,117
28,2,5,78,56,134
2,7,9,1,14,15
5,7,9,9,35,44
12,7,9,0,84,84
24,7,9,39,168,207
18,7,9,33,126,159
10,7,9,8,70,78
18,7,9,18,126,144
5,7,9,5,35,40
3,7,9,6,21,27
2,3,8,6,6,12
28,3,8,136,84,220
21,3,8,83,63,146
15,8,22,164,120,284
2,8,22,21,16,37
3,8,22,37,24,61
10,8,22,92,80,172
24,9,24,279,216,495
6,9,24,80,54,134
28,9,24,413,252,665
10,9,24,145,90,235
2,13,35,43,26,69
7,13,35,100,91,191
17,13,35,297,221,518
8,13,35,126,104,230
19,13,35,405,247,652
25,13,35,436,325,761
10,13,35,196,130,326
7,13,35,144,91,235
15,13,35,309,195,504
26,13,35,372,338,710
23,13,35,474,299,773
29,13,35,628,377,1005
9,13,35,163,117,280
11,13,35,234,143,377
19,13,35,405,247,652
25,13,35,428,325,753
19,13,35,391,247,638
6,13,35,86,78,164
11,13,35,238,143,381
10,13,35,164,130,294
10,13,35,196,130,326
10,21,55,252,210,462
27,21,55,888,567,1455
2,21,55,44,42,86
12,42,54,138,504,642
17,42,54,39,714,753
21,38,50,242,798,1040
5,38,50,55,190,245
20,38,50,220,760,980
23,38,50,127,874,1001
14,42,54,47,588,635
10,38,50,110,380,490
2,42,54,12,84,96
26,38,50,26,988,1014
9,38,50,50,342,392
30,38,50,300,1140,1440
12,38,50,120,456,576
12,42,54,118,504,622
26,42,54,284,1092,1376
1,1266,2320,752,1266,2018
1,1252,2295,722,1252,1974
1,1266,2320,1008,1266,2274
1,1252,2295,882,1252,2134
1,1266,2320,1008,1266,2274
1,1266,2320,1008,1266,2274
1,1266,2320,892,1266,2158
1,1266,2320,961,1266,2227
1,2171,3578,620,2171,2791
1,2171,3578,1157,2171,3328
1,2171,3578,835,2171,3006
1,1555,2443,619,1555,2174
1,344,540,191,344,535
1,2171,3578,1335,2171,3506
23,26,70,980,598,1578
14,26,70,479,364,843
8,26,70,341,208,549
13,26,70,563,338,901
29,3,9,117,87,204
24,1,2,17,24,41
7,1,2,5,7,12
14,1,2,14,14,28
15,1,2,15,15,30
15,9,25,236,135,371
26,9,25,410,234,644
13,1,2,12,13,25
26,1,2,25,26,51
14,9,25,168,126,294
11,2,5,21,22,43
18,13,35,352,234,586
14,2,5,33,28,61
15,1,2,13,15,28
24,1,2,21,24,45
28,2,5,64,56,120
9,2,5,21,18,39
30,11,30,561,330,891
5,11,30,94,55,149
25,13,35,533,325,858
23,13,35,490,299,789
10,13,35,213,130,343
16,12,33,315,192,507
21,13,35,447,273,720
10,13,35,213,130,343
20,11,30,254,220,474
16,11,30,203,176,379
11,1,2,7,11,18
21,1,2,14,21,35
3,1,2,3,3,6
3,1,2,3,3,6
8,9,25,106,72,178
20,13,35,412,260,672
24,13,35,494,312,806
1,9,25,16,9,25
4,1,2,3,4,7
27,1,2,20,27,47
7,1,4,20,7,27
28,1,4,80,28,108
3,1,4,9,3,12
3,1,4,9,3,12
8,2,5,19,16,35
6,2,5,14,12,26
7,2,5,16,14,30
28,2,5,83,56,139
29,2,5,86,58,144
7,1,4,20,7,27
11,1,4,23,11,34
2,1,4,4,2,6
18,1,2,17,18,35
26,1,4,56,26,82
12,1,4,26,12,38
12,1,2,8,12,20
9,1,2,6,9,15
2,2,5,6,4,10
27,2,5,80,54,134
27,2,5,80,54,134
17,2,5,50,34,84
1,2,5,3,2,5
18,8,21,192,144,336
22,1,2,22,22,44
23,1,2,23,23,46
5,1,2,5,5,10
14,1,2,14,14,28
6,1,2,5,6,11
24,1,2,21,24,45
16,2,5,42,32,74
18,2,5,48,36,84
15,2,5,40,30,70
9,9,25,140,81,221
1,1482,2384,878,1482,2360
1,461,742,251,461,712
1,461,742,199,461,660
1,1482,2384,568,1482,2050
1,755,1215,436,755,1191
1,1482,2384,378,1482,1860
1,1482,2384,378,1482,1860
1,1482,2384,854,1482,2336
1,461,742,229,461,690
13,24,64,512,312,824
7,59,159,622,413,1035
16,3,9,95,48,143
5,3,9,30,15,45
3,4,10,16,12,28
10,4,10,53,40,93
13,3,9,53,39,92
3,3,9,12,9,21
9,2,5,27,18,45
4,2,5,12,8,20
16,4,10,62,64,126
29,4,10,113,116,229
1,2,5,3,2,5
14,2,5,39,28,67
20,2,5,38,40,78
25,2,5,48,50,98
14,2,5,41,28,69
10,4,10,56,40,96
3,2,5,7,6,13
23,2,5,53,46,99
17,4,10,65,68,133
17,4,10,65,68,133
8,2,5,18,16,34
12,2,5,26,24,50
24,2,5,67,48,115
7,2,5,20,14,34
2,2,5,5,4,9
17,2,5,40,34,74
13,2,5,36,26,62
17,7,9,28,119,147
4,7,9,7,28,35
28,7,9,3,196,199
14,7,9,25,98,123
11,7,9,18,77,95
26,7,9,43,182,225
17,7,9,10,119,129
18,3,8,58,54,112
5,3,8,25,15,40
28,3,8,111,84,195
8,3,8,26,24,50
1,8,22,11,8,19
17,8,22,178,136,314
18,8,22,244,144,388
5,8,22,69,40,109
30,8,22,394,240,634
6,8,22,83,48,131
18,8,22,248,144,392
3,9,24,29,27,56
1,9,24,12,9,21
27,9,24,379,243,622
20,9,24,290,180,470
11,13,35,150,143,293
14,13,35,274,182,456
29,13,35,618,377,995
7,13,35,115,91,206
22,13,35,469,286,755
7,13,35,107,91,198
16,13,35,330,208,538
20,13,35,314,260,574
17,13,35,243,221,464
27,13,35,575,351,926
18,13,35,390,234,624
8,13,35,170,104,274
29,13,35,618,377,995
26,13,35,554,338,892
19,21,55,510,399,909
14,21,55,307,294,601
17,21,55,428,357,785
4,42,54,46,168,214
6,38,50,66,228,294
4,38,50,4,152,156
7,38,50,11,266,277
30,38,50,30,1140,1170
11,42,54,55,462,517
21,42,54,229,882,1111
1,42,54,11,42,53
21,38,50,105,798,903
10,42,54,98,420,518
6,38,50,24,228,252
1,1266,2320,729,1266,1995
1,1252,2295,561,1252,1813
1,1252,2295,745,1252,1997
1,1266,2320,752,1266,2018
1,1252,2295,1020,1252,2272
1,295,540,126,295,421
1,1252,2295,997,1252,2249
1,344,540,66,344,410
1,2171,3578,1264,2171,3435
1,713,1120,261,713,974
1,2171,3578,835,2171,3006
1,2171,3578,656,2171,2827
1,344,540,120,344,464
1,713,1120,385,713,1098
1,1555,2443,570,1555,2125
1,344,540,174,344,518
22,26,70,629,572,1201
18,26,70,616,468,1084
10,26,70,349,260,609
9,26,70,390,234,624
1,26,70,43,26,69
22,3,9,130,66,196
8,3,9,39,24,63
24,3,9,96,72,168
20,1,2,19,20,39
29,1,2,28,29,57
26,1,2,25,26,51
16,1,2,15,16,31
26,2,5,77,52,129
25,2,5,59,50,109
5,2,5,12,10,22
28,2,5,66,56,122
17,11,30,211,187,398
8,11,30,99,88,187
1,2,5,3,2,5
26,2,5,69,52,121
17,2,5,45,34,79
9,2,5,25,18,43
16,1,2,12,16,28
5,2,5,15,10,25
25,2,5,73,50,123
19,1,2,11,19,30
27,2,5,51,54,105
2,2,5,4,4,8
17,1,2,16,17,33
22,1,2,20,22,42
28,2,5,83,56,139
15,2,5,44,30,74
25,11,30,310,275,585
4,11,30,50,44,94
1,2,5,3,2,5
18,2,5,52,36,88
24,2,5,70,48,118
21,1,2,15,21,36
30,1,4,68,30,98
26,1,4,59,26,85
29,12,33,590,348,938
7,12,33,142,84,226
7,2,5,20,14,34
19,2,5,55,38,93
24,1,4,60,24,84
16,1,4,40,16,56
21,1,4,52,21,73
9,2,5,17,18,35
1,1482,2384,401,1482,1883
1,1482,2384,807,1482,2289
1,461,742,266,461,727
1,1482,2384,854,1482,2336
1,461,742,162,461,623
5,24,64,158,120,278
29,24,64,1086,696,1782
2,2,5,6,4,10
14,2,5,41,28,69
5,2,5,15,10,25
17,2,5,40,34,74
30,2,5,71,60,131
27,2,5,76,54,130
11,2,5,25,22,47
24,2,5,56,48,104
15,2,5,44,30,74
13,2,5,38,26,64
21,2,5,61,42,103
6,2,5,14,12,26
2,2,5,5,4,9
21,2,5,49,42,91
6,2,5,14,12,26
11,2,5,21,22,43
10,2,5,20,20,40
22,7,9,16,154,170
24,7,9,20,168,188
28,7,9,23,196,219
3,7,9,2,21,23
24,7,9,44,168,212
13,7,9,18,91,109
18,3,8,84,54,138
1,3,8,3,3,6
1,3,8,5,3,8
22,3,8,87,66,153
26,8,22,353,208,561
14,8,22,190,112,302
26,8,22,353,208,561
28,8,22,386,224,610
8,8,22,110,64,174
7,8,22,78,56,134
8,8,22,89,64,153
19,9,24,280,171,451
2,9,24,24,18,42
11,13,35,234,143,377
1,13,35,21,13,34
14,13,35,303,182,485
27,13,35,556,351,907
1,13,35,14,13,27
27,13,35,396,351,747
15,13,35,262,195,457
27,13,35,471,351,822
30,13,35,587,390,977
24,13,35,511,312,823
3,13,35,62,39,101
9,21,55,242,189,431
16,42,54,183,672,855
8,42,54,79,336,415
15,38,50,173,570,743
9,38,50,104,342,446
10,38,50,100,380,480
22,42,54,110,924,1034
8,42,54,18,336,354
17,38,50,170,646,816
9,42,54,45,378,423
27,38,50,135,1026,1161
1,1266,2320,1008,1266,2274
1,295,540,240,295,535
1,1252,2295,997,1252,2249
1,420,769,211,420,631
1,2171,3578,942,2171,3113
1,2171,3578,656,2171,2827
1,713,1120,362,713,1075
1,713,1120,362,713,1075
1,2171,3578,620,2171,2791
1,1083,1701,397,1083,1480
1,713,1120,261,713,974
28,26,70,1212,728,1940
12,26,70,410,312,722
6,8,21,77,48,125
19,2,5,56,38,94
2,2,5,6,4,10
19,2,5,56,38,94
1,2,5,3,2,5
24,2,5,71,48,119
23,2,5,64,46,110
7,2,5,20,14,34
7,2,5,20,14,34
29,2,5,84,58,142
8,12,33,157,96,253
19,1,2,18,19,37
24,1,2,23,24,47
25,1,2,24,25,49
5,1,2,5,5,10
1,1,2,1,1,2
22,1,2,21,22,43
29,2,5,84,58,142
2,12,33,28,24,52
9,12,33,127,108,235
23,13,35,337,299,636
20,13,35,293,260,553
4,1,2,2,4,6
25,1,2,14,25,39
19,1,2,19,19,38
18,11,30,212,198,410
27,1,2,16,27,43
1,1,2,1,1,2
9,1,2,9,9,18
10,1,2,10,10,20
1,755,1215,436,755,1191
1,1482,2384,735,1482,2217
1,755,1215,290,755,1045
1,1482,2384,854,1482,2336
1,1482,2384,807,1482,2289
7,24,64,186,168,354
12,24,64,380,288,668
2,24,64,79,48,127
7,59,159,689,413,1102
15,2,5,34,30,64
16,2,5,36,32,68
18,4,10,106,72,178
25,2,5,74,50,124
5,2,5,15,10,25
18,2,5,50,36,86
20,2,5,56,40,96
12,2,5,35,24,59
18,2,5,52,36,88
7,2,5,20,14,34
28,2,5,81,56,137
27,2,5,51,54,105
20,2,5,38,40,78
17,3,9,99,51,150
17,3,9,99,51,150
15,2,5,44,30,74
1,2,5,2,2,4
19,2,5,45,38,83
24,3,9,140,72,212
20,3,9,116,60,176
18,3,9,102,54,156
22,3,9,124,66,190
8,7,9,-1,56,55
6,3,8,19,18,37
30,8,22,407,240,647
7,8,22,95,56,151
14,8,22,193,112,305
26,8,22,238,208,446
14,8,22,193,112,305
24,8,22,315,192,507
15,8,22,203,120,323
17,9,24,190,153,343
8,9,24,95,72,167
3,13,35,64,39,103
22,13,35,369,286,655
13,13,35,213,169,382
26,13,35,454,338,792
29,13,35,597,377,974
11,13,35,192,143,335
13,13,35,177,169,346
8,13,35,140,104,244
1,13,35,17,13,30
10,13,35,136,130,266
30,13,35,524,390,914
14,13,35,288,182,470
1,13,35,21,13,34
10,13,35,206,130,336
14,21,55,307,294,601
6,42,54,66,252,318
1,420,769,334,420,754
1,295,540,240,295,535
1,1252,2295,951,1252,2203
1,1252,2295,997,1252,2249
1,1266,2320,961,1266,2227
1,2171,3578,835,2171,3006
1,713,1120,138,713,851
1,1083,1701,312,1083,1395
1,713,1120,205,713,918
1,1555,2443,790,1555,2345
25,3,9,146,75,221
21,3,9,124,63,187
5,2,5,12,10,22
2,2,5,5,4,9
25,2,5,59,50,109
23,1,2,17,23,40
22,1,4,62,22,84
13,13,35,213,169,382
15,2,5,44,30,74
26,2,5,77,52,129
24,2,5,71,48,119
5,2,5,11,10,21
3,2,5,7,6,13
21,2,5,40,42,82
23,2,5,44,46,90
21,13,35,366,273,639
18,2,5,42,36,78
19,2,5,45,38,83
17,2,5,50,34,84
20,2,5,59,40,99
8,1,4,18,8,26
2,1,4,5,2,7
24,11,30,283,264,547
30,11,30,354,330,684
23,2,5,67,46,113
14,1,2,10,14,24
6,1,2,4,6,10
3,1,2,2,3,5
11,1,2,7,11,18
30,2,5,87,60,147
3,1,2,3,3,6
19,2,5,44,38,82
2,2,5,5,4,9
30,8,21,377,240,617
5,9,25,78,45,123
21,9,25,326,189,515
4,9,25,62,36,98
1,1482,2384,521,1482,2003
1,1482,2384,330,1482,1812
1,1482,2384,568,1482,2050
25,24,64,792,600,1392
14,3,9,64,42,106
17,2,5,50,34,84
2,4,10,8,8,16
26,2,5,75,52,127
5,2,5,15,10,25
11,2,5,32,22,54
17,2,5,32,34,66
2,2,5,4,4,8
3,4,10,13,12,25
13,2,5,38,26,64
9,2,5,27,18,45
20,3,9,118,60,178
29,3,9,171,87,258
20,4,10,76,80,156
10,4,10,38,40,78
19,3,9,76,57,133
13,3,9,52,39,91
10,3,9,58,30,88
20,3,9,97,60,157
13,3,9,63,39,102
7,7,9,11,49,60
2,7,9,3,14,17
9,7,9,3,63,66
28,7,9,38,196,234
27,7,9,49,189,238
9,3,8,44,27,71
22,3,8,82,66,148
4,8,22,37,32,69
12,8,22,110,96,206
9,8,22,118,72,190
3,8,22,41,24,65
4,8,22,55,32,87
14,8,22,122,112,234
18,8,22,201,144,345
29,9,24,310,261,571
18,9,24,192,162,354
22,9,24,246,198,444
6,13,35,117,78,195
13,13,35,254,169,423
15,13,35,236,195,431
1,13,35,16,13,29
11,13,35,234,143,377
13,13,35,254,169,423
29,13,35,597,377,974
9,13,35,157,117,274
1,13,35,14,13,27
19,13,35,411,247,658
10,13,35,175,130,305
23,13,35,490,299,789
8,13,35,165,104,269
8,13,35,126,104,230
24,13,35,520,312,832
4,13,35,63,52,115
13,13,35,213,169,382
2,13,35,29,26,55
1,13,35,21,13,34
21,13,35,455,273,728
17,21,55,541,357,898
29,42,54,66,1218,1284
3,38,50,3,114,117
26,38,50,26,988,1014
4,42,54,44,168,212
7,42,54,1,294,295
22,38,50,121,836,957
16,38,50,160,608,768
21,38,50,210,798,1008
2,38,50,8,76,84
2,38,50,22,76,98
14,38,50,161,532,693
20,38,50,60,760,820
2,42,54,7,84,91
5,38,50,50,190,240
18,42,54,12,756,768
4,42,54,20,168,188
9,38,50,99,342,441
1,1898,3375,768,1898,2666
1,1912,3400,944,1912,2856
1,1266,2320,1008,1266,2274
1,1252,2295,538,1252,1790
1,1266,2320,1008,1266,2274
1,1266,2320,892,1266,2158
1,1266,2320,961,1266,2227
1,308,565,133,308,441
1,1266,2320,636,1266,1902
1,1266,2320,544,1266,1810
1,1266,2320,544,1266,1810
1,1555,2443,839,1555,2394
1,1555,2443,790,1555,2345
1,2171,3578,835,2171,3006
1,487,783,155,487,642
1,344,540,77,344,421
1,1555,2443,497,1555,2052
1,2171,3578,1335,2171,3506
30,26,70,1278,780,2058
12,26,70,494,312,806
26,26,70,1126,676,1802
6,26,70,256,156,412
10,1,2,6,10,16
26,1,2,15,26,41
26,1,2,25,26,51
10,1,2,10,10,20
2,1,2,2,2,4
12,13,35,256,156,412
7,2,5,15,14,29
29,2,5,81,58,139
26,2,5,75,52,127
1,1,4,2,1,3
27,2,5,80,54,134
26,2,5,47,52,99
18,2,5,32,36,68
28,1,2,24,28,52
21,9,25,326,189,515
23,9,25,357,207,564
28,9,25,434,252,686
26,1,2,24,26,50
29,1,2,27,29,56
28,1,2,19,28,47
10,1,2,7,10,17
29,2,5,86,58,144
30,1,2,19,30,49
25,1,2,16,25,41
17,1,2,12,17,29
18,1,2,12,18,30
15,1,2,15,15,30
18,1,2,18,18,36
29,2,5,57,58,115
21,1,2,20,21,41
15,2,5,44,30,74
27,2,5,78,54,132
6,2,5,17,12,29
17,1,2,17,17,34
24,1,2,24,24,48
24,2,5,70,48,118
16,2,5,46,32,78
13,2,5,38,26,64
16,1,2,9,16,25
1,755,1215,375,755,1130
1,461,742,185,461,646
15,2,5,32,30,62
14,2,5,29,28,57
16,2,5,46,32,78
29,2,5,61,58,119
6,2,5,13,12,25
26,4,10,146,104,250
19,2,5,36,38,74
4,2,5,12,8,20
5,2,5,15,10,25
27,3,9,128,81,209
13,3,9,62,39,101
25,2,5,73,50,123
12,2,5,35,24,59
18,3,9,72,54,126
7,3,9,38,21,59
27,3,9,145,81,226
30,2,5,89,60,149
6,2,5,18,12,30
5,2,5,15,10,25
29,2,5,86,58,144
8,3,9,47,24,71
1,3,9,6,3,9
2,4,10,9,8,17
28,4,10,129,112,241
29,2,5,68,58,126
30,2,5,71,60,131
10,2,5,30,20,50
22,7,9,8,154,162
19,7,9,35,133,168
14,7,9,25,98,123
23,7,9,17,161,178
1,7,9,2,7,9
11,3,8,54,33,87
14,3,8,58,42,100
14,3,8,46,42,88
16,3,8,53,48,101
21,8,22,285,168,453
2,8,22,28,16,44
29,8,22,361,232,593
25,8,22,339,200,539
5,8,22,52,40,92
28,9,24,299,252,551
3,9,24,31,27,58
16,9,24,159,144,303
28,9,24,407,252,659
28,13,35,606,364,970
18,13,35,390,234,624
22,13,35,345,286,631
3,13,35,64,39,103
20,13,35,426,260,686
27,13,35,443,351,794
5,13,35,77,65,142
1,13,35,21,13,34
27,13,35,424,351,775
14,13,35,205,182,387
14,13,35,244,182,426
26,13,35,426,338,764
27,13,35,575,351,926
8,13,35,170,104,274
26,13,35,372,338,710
30,13,35,429,390,819
4,13,35,82,52,134
2,13,35,34,26,60
3,13,35,62,39,101
29,13,35,496,377,873
23,21,55,504,483,987
6,38,50,66,228,294
19,38,50,219,722,941
24,42,54,120,1008,1128
1,38,50,5,38,43
2,42,54,10,84,94
13,38,50,143,494,637
19,38,50,209,722,931
1,1266,2320,961,1266,2227
1,1252,2295,997,1252,2249
1,1266,2320,1008,1266,2274
1,1252,2295,745,1252,1997
1,1252,2295,997,1252,2249
1,1252,2295,997,1252,2249
1,295,540,169,295,464
1,295,540,240,295,535
1,713,1120,385,713,1098
1,2171,3578,656,2171,2827
1,2171,3578,656,2171,2827
1,2171,3578,835,2171,3006
1,2171,3578,942,2171,3113
1,713,1120,385,713,1098
1,344,540,174,344,518
1,344,540,120,344,464
1,344,540,126,344,470
1,713,1120,362,713,1075
1,344,540,126,344,470
16,26,70,682,416,1098
16,26,70,682,416,1098
16,1,4,47,16,63
21,1,4,62,21,83
1,13,35,17,13,30
20,13,35,342,260,602
10,1,2,10,10,20
18,1,2,18,18,36
24,1,2,24,24,48
25,1,2,17,25,42
1,1,2,1,1,2
2,1,2,1,2,3
27,1,2,16,27,43
15,2,5,44,30,74
30,2,5,89,60,149
24,1,2,22,24,46
16,1,2,15,16,31
20,1,2,18,20,38
29,1,2,28,29,57
26,1,2,25,26,51
25,2,5,48,50,98
25,1,4,64,25,89
17,1,4,44,17,61
16,1,2,15,16,31
10,1,2,10,10,20
29,9,25,312,261,573
21,9,25,226,189,415
30,8,21,302,240,542
27,8,21,272,216,488
14,2,5,27,28,55
17,2,5,32,34,66
21,13,35,300,273,573
3,13,35,43,39,82
12,1,2,8,12,20
5,1,2,3,5,8
11,1,2,7,11,18
27,1,4,64,27,91
2,1,4,5,2,7
19,1,2,14,19,33
20,11,30,374,220,594
21,2,5,48,42,90
14,2,5,32,28,60
29,8,21,249,232,481
1,8,21,9,8,17
6,8,21,52,48,100
16,1,4,36,16,52
29,1,4,66,29,95
21,1,4,48,21,69
23,1,2,23,23,46
15,1,2,15,15,30
3,8,21,28,24,52
7,8,21,65,56,121
1,461,742,251,461,712
1,461,742,147,461,608
1,461,742,185,461,646
1,1482,2384,807,1482,2289
1,755,1215,241,755,996
1,755,1215,290,755,1045
1,1482,2384,854,1482,2336
11,24,64,348,264,612
29,24,64,1141,696,1837
21,24,64,544,504,1048
10,45,120,738,450,1188
14,2,5,41,28,69
3,2,5,9,6,15
10,4,10,47,40,87
30,4,10,141,120,261
2,2,5,6,4,10
30,4,10,177,120,297
10,4,10,59,40,99
20,2,5,59,40,99
6,2,5,18,12,30
29,2,5,57,58,115
14,2,5,41,28,69
18,2,5,52,36,88
27,4,10,157,108,265
30,2,5,57,60,117
24,2,5,46,48,94
25,2,5,73,50,123
8,2,5,23,16,39
21,2,5,41,42,83
1,2,5,2,2,4
15,3,9,68,45,113
29,2,5,67,58,125
1,2,5,2,2,4
17,3,9,99,51,150
23,2,5,61,46,107
6,2,5,16,12,28
4,3,9,23,12,35
10,3,9,56,30,86
2,2,5,6,4,10
1,2,5,3,2,5
22,3,9,106,66,172
22,7,9,2,154,156
14,7,9,27,98,125
14,7,9,12,98,110
3,7,9,2,21,23
4,7,9,0,28,28
3,7,9,5,21,26
10,7,9,8,70,78
7,7,9,13,49,62
26,7,9,50,182,232
23,7,9,44,161,205
21,3,8,102,63,165
12,3,8,58,36,94
13,8,22,176,104,280
24,8,22,331,192,523
8,8,22,110,64,174
12,8,22,165,96,261
8,8,22,73,64,137
16,9,24,179,144,323
2,9,24,30,18,48
5,9,24,70,45,115
7,13,35,149,91,240
11,13,35,173,143,316
27,13,35,556,351,907
22,13,35,384,286,670
6,13,35,86,78,164
25,13,35,489,325,814
29,13,35,506,377,883
4,13,35,66,52,118
16,13,35,274,208,482
1,13,35,14,13,27
9,21,55,296,189,485
7,21,55,230,147,377
30,38,50,345,1140,1485
26,42,54,214,1092,1306
12,38,50,66,456,522
15,38,50,150,570,720
12,42,54,131,504,635
15,42,54,26,630,656
6,38,50,18,228,246
22,42,54,110,924,1034
27,42,54,295,1134,1429
25,38,50,275,950,1225
1,1912,3400,1046,1912,2958
1,1266,2320,636,1266,1902
1,1266,2320,752,1266,2018
1,1252,2295,997,1252,2249
1,1252,2295,745,1252,1997
1,420,769,249,420,669
1,420,769,334,420,754
1,1252,2295,997,1252,2249
1,1266,2320,567,1266,1833
1,420,769,249,420,669
1,1266,2320,961,1266,2227
1,295,540,126,295,421
1,295,540,234,295,529
1,2171,3578,763,2171,2934
1,1555,2443,790,1555,2345
1,1083,1701,499,1083,1582
1,2171,3578,942,2171,3113
1,1555,2443,448,1555,2003
1,1083,1701,397,1083,1480
1,713,1120,194,713,907
1,487,783,132,487,619
17,26,70,665,442,1107
12,26,70,494,312,806
19,26,70,823,494,1317
15,26,70,639,390,1029
25,3,9,148,75,223
5,3,9,30,15,45
26,1,2,19,26,45
9,1,2,9,9,18
4,13,35,57,52,109
9,13,35,195,117,312
30,13,35,650,390,1040
26,1,4,74,26,100
30,1,4,85,30,115
3,1,4,9,3,12
22,2,5,64,44,108
21,2,5,61,42,103
22,8,21,203,176,379
19,1,2,14,19,33
10,1,2,6,10,16
1,1,2,1,1,2
6,1,2,6,6,12
22,13,35,384,286,670
16,2,5,45,32,77
19,2,5,53,38,91
24,2,5,67,48,115
19,1,4,47,19,66
1,1,4,2,1,3
3,1,4,7,3,10
25,2,5,48,50,98
2,2,5,4,4,8
13,2,5,25,26,51
9,2,5,25,18,43
29,1,2,20,29,49
28,9,25,441,252,693
20,9,25,315,180,495
10,2,5,24,20,44
21,2,5,49,42,91
6,2,5,17,12,29
28,2,5,81,56,137
1,2,5,3,2,5
28,11,30,347,308,655
15,11,30,186,165,351
2,1,2,1,2,3
13,1,2,8,13,21
1,1,2,1,1,2
29,1,2,28,29,57
23,8,21,193,184,377
18,8,21,151,144,295
23,1,2,21,23,44
17,1,2,16,17,33
13,1,4,32,13,45
5,8,21,63,40,103
19,8,21,239,152,391
21,8,21,264,168,432
3,8,21,38,24,62
18,1,2,10,18,28
1,1482,2384,807,1482,2289
1,755,1215,436,755,1191
1,1482,2384,854,1482,2336
1,755,1215,448,755,1203
26,24,64,691,624,1315
30,45,120,2178,1350,3528
28,4,10,165,112,277
21,4,10,124,84,208
5,4,10,24,20,44
3,4,10,14,12,26
9,2,5,26,18,44
2,2,5,6,4,10
11,2,5,32,22,54
30,2,5,57,60,117
8,2,5,15,16,31
30,2,5,74,60,134
14,2,5,34,28,62
7,2,5,21,14,35
18,3,9,74,54,128
13,3,9,53,39,92
23,3,9,134,69,203
29,3,9,169,87,256
5,2,5,13,10,23
19,3,9,102,57,159
19,3,9,102,57,159
10,7,9,19,70,89
2,7,9,0,14,14
26,3,8,126,78,204
15,3,8,74,45,119
6,3,8,27,18,45
15,3,8,49,45,94
9,3,8,36,27,63
27,8,22,295,216,511
15,8,22,207,120,327
24,9,24,348,216,564
13,9,24,154,117,271
6,9,24,89,54,143
20,13,35,349,260,609
18,13,35,383,234,617
26,13,35,454,338,792
5,13,35,108,65,173
14,13,35,303,182,485
18,13,35,264,234,498
1,13,35,21,13,34
15,13,35,325,195,520
11,13,35,238,143,381
2,13,35,35,26,61
12,13,35,239,156,395
27,13,35,396,351,747
18,13,35,352,234,586
8,13,35,131,104,235
2,38,50,11,76,87
11,42,54,49,462,511
3,42,54,34,126,160
6,42,54,20,252,272
1,1252,2295,722,1252,1974
1,1266,2320,892,1266,2158
1,420,769,295,420,715
1,420,769,249,420,669
1,420,769,341,420,761
1,295,540,240,295,535
1,1266,2320,892,1266,2158
1,2171,3578,942,2171,3113
1,487,783,194,487,681
1,2171,3578,942,2171,3113
1,1555,2443,570,1555,2125
1,344,540,191,344,535
1,1555,2443,497,1555,2052
11,26,70,361,286,647
1,26,70,43,26,69
14,26,70,606,364,970
8,8,21,102,64,166
16,9,25,252,144,396
5,1,2,5,5,10
27,13,35,585,351,936
14,13,35,303,182,485
22,9,25,281,198,479
5,9,25,64,45,109
20,9,25,255,180,435
7,2,5,20,14,34
23,2,5,64,46,110
12,2,5,34,24,58
13,1,2,12,13,25
9,1,2,7,9,16
29,1,2,21,29,50
4,9,25,45,36,81
2,9,25,23,18,41
11,2,5,21,22,43
4,11,29,64,44,108
11,11,29,176,121,297
5,11,29,80,55,135
7,11,30,106,77,183
24,1,2,22,24,46
11,1,2,10,11,21
9,1,2,9,9,18
30,1,2,29,30,59
6,1,2,6,6,12
3,1,2,3,3,6
5,1,2,3,5,8
27,12,33,380,324,704
15,1,2,15,15,30
14,1,2,14,14,28
24,2,5,70,48,118
26,1,2,25,26,51
20,11,30,248,220,468
10,11,30,124,110,234
21,11,30,260,231,491
2,9,25,29,18,47
11,2,5,31,22,53
3,2,5,8,6,14
1,1482,2384,854,1482,2336
1,1482,2384,378,1482,1860
23,3,9,88,69,157
28,3,9,108,84,192
4,2,5,8,8,16
2,2,5,4,4,8
6,2,5,11,12,23
26,2,5,73,52,125
28,2,5,81,56,137
8,4,10,30,32,62
13,4,10,49,52,101
1,2,5,2,2,4
7,2,5,14,14,28
25,4,10,95,100,195
4,4,10,15,16,31
10,2,5,29,20,49
20,3,9,113,60,173
12,3,9,68,36,104
3,3,9,16,9,25
30,3,9,161,90,251
12,3,9,49,36,85
30,3,9,123,90,213
6,2,5,17,12,29
16,2,5,45,32,77
17,7,9,0,119,119
20,7,9,33,140,173
30,7,9,49,210,259
26,7,9,3,182,185
14,7,9,23,98,121
15,7,9,11,105,116
11,3,8,53,33,86
27,3,8,90,81,171
16,3,8,52,48,100
11,8,22,101,88,189
9,8,22,82,72,154
28,9,24,373,252,625
21,9,24,305,189,494
12,9,24,143,108,251
15,13,35,320,195,515
27,13,35,367,351,718
26,13,35,508,338,846
1,13,35,22,13,35
4,13,35,57,52,109
1,13,35,21,13,34
15,13,35,309,195,504
21,13,35,433,273,706
12,13,35,247,156,403
7,13,35,144,91,235
11,13,35,188,143,331
29,13,35,455,377,832
12,13,35,247,156,403
30,13,35,639,390,1029
16,13,35,279,208,487
29,13,35,567,377,944
12,13,35,260,156,416
19,13,35,298,247,545
3,13,35,51,39,90
25,13,35,366,325,691
24,21,55,790,504,1294
2,21,55,44,42,86
17,42,54,2,714,716
24,42,54,236,1008,1244
19,42,54,207,798,1005
28,38,50,28,1064,1092
11,42,54,108,462,570
19,42,54,207,798,1005
17,38,50,145,646,791
1,42,54,4,42,46
28,38,50,84,1064,1148
6,38,50,15,228,243
1,308,565,121,308,429
1,1266,2320,1008,1266,2274
1,295,540,223,295,518
1,295,540,234,295,529
1,1555,2443,839,1555,2394
1,2171,3578,942,2171,3113
1,713,1120,161,713,874
1,1519,2443,411,1519,1930
1,1519,2443,411,1519,1930
1,487,783,265,487,752
1,344,540,120,344,464
1,2171,3578,1371,2171,3542
1,713,1120,172,713,885
1,344,540,174,344,518
1,713,1120,329,713,1042
1,713,1120,194,713,907
1,344,540,174,344,518
1,344,540,83,344,427
8,26,70,346,208,554
5,26,70,213,130,343
5,26,70,154,130,284
22,26,70,953,572,1525
14,3,9,83,42,125
5,3,9,20,15,35
14,3,9,60,42,102
27,3,9,160,81,241
6,1,2,6,6,12
15,13,35,220,195,415
2,13,35,29,26,55
29,2,5,81,58,139
30,2,5,84,60,144
21,2,5,59,42,101
6,1,2,6,6,12
2,1,2,2,2,4
15,1,2,8,15,23
11,2,5,23,22,45
11,1,2,10,11,21
2,1,2,2,2,4
7,2,5,20,14,34
19,2,5,55,38,93
26,1,4,55,26,81
24,1,4,51,24,75
30,9,25,300,270,570
19,9,25,190,171,361
23,9,25,230,207,437
23,2,5,44,46,90
2,9,25,30,18,48
19,2,5,45,38,83
4,2,5,9,8,17
8,1,4,24,8,32
7,1,2,6,7,13
29,2,5,86,58,144
26,12,33,392,312,704
19,12,33,286,228,514
13,2,5,38,26,64
11,2,5,21,22,43
3,2,5,6,6,12
28,2,5,53,56,109
4,1,4,10,4,14
22,1,4,54,22,76
26,8,21,267,208,475
2,8,21,21,16,37
13,8,21,134,104,238
20,1,2,19,20,39
15,1,2,14,15,29
12,1,2,12,12,24
1,1,4,3,1,4
23,1,4,63,23,86
11,8,21,101,88,189
30,8,21,277,240,517
29,1,2,28,29,57
3,1,2,3,3,6
10,2,5,29,20,49
28,1,2,18,28,46
16,1,2,10,16,26
16,1,2,16,16,32
26,1,2,25,26,51
15,1,2,13,15,28
7,1,2,4,7,11
16,1,2,9,16,25
10,1,4,24,10,34
17,1,4,41,17,58
1,461,742,147,461,608
1,1482,2384,807,1482,2289
17,24,64,669,408,1077
28,24,64,744,672,1416
6,45,120,436,270,706
2,4,10,12,8,20
5,2,5,14,10,24
18,2,5,34,36,70
10,2,5,19,20,39
6,2,5,13,12,25
21,2,5,46,42,88
29,2,5,84,58,142
14,2,5,41,28,69
25,2,5,74,50,124
9,3,9,43,27,70
26,3,9,126,78,204
22,3,9,128,66,194
15,3,9,87,45,132
4,2,5,12,8,20
13,2,5,38,26,64
28,3,9,135,84,219
4,3,9,19,12,31
15,2,5,29,30,59
18,2,5,34,36,70
28,2,5,78,56,134
22,2,5,62,44,106
22,2,5,43,44,87
29,2,5,57,58,115
7,7,9,5,49,54
6,7,9,11,42,53
18,7,9,33,126,159
13,7,9,21,91,112
5,7,9,10,35,45
30,7,9,25,210,235
10,7,9,19,70,89
2,3,8,6,6,12
4,3,8,15,12,27
21,3,8,102,63,165
21,8,22,192,168,360
8,8,22,75,64,139
26,8,22,284,208,492
19,8,22,258,152,410
3,8,22,41,24,65
10,8,22,136,80,216
22,9,24,261,198,459
15,9,24,149,135,284
12,9,24,143,108,251
6,9,24,71,54,125
14,13,35,205,182,387
22,13,35,430,286,716
7,13,35,149,91,240
4,13,35,66,52,118
18,13,35,295,234,529
20,13,35,349,260,609
24,13,35,352,312,664
11,13,35,227,143,370
22,13,35,384,286,670
11,13,35,227,143,370
19,13,35,378,247,625
22,13,35,384,286,670
4,13,35,57,52,109
24,21,55,526,504,1030
30,38,50,150,1140,1290
8,42,54,5,336,341
29,38,50,87,1102,1189
30,38,50,300,1140,1440
3,38,50,33,114,147
3,38,50,30,114,144
1,1266,2320,961,1266,2227
1,1266,2320,1008,1266,2274
1,1252,2295,722,1252,1974
1,1266,2320,1008,1266,2274
1,1266,2320,961,1266,2227
1,1266,2320,1008,1266,2274
1,2171,3578,942,2171,3113
1,2171,3578,835,2171,3006
1,344,540,185,344,529
1,1519,2443,533,1519,2052
1,2171,3578,620,2171,2791
1,344,540,126,344,470
26,26,70,1071,676,1747
12,26,70,511,312,823
30,3,9,175,90,265
20,1,2,19,20,39
29,1,2,28,29,57
9,1,2,9,9,18
23,1,2,21,23,44
25,1,2,19,25,44
1,1,2,1,1,2
24,1,2,23,24,47
29,1,2,28,29,57
5,1,2,5,5,10
12,1,2,10,12,22
3,1,2,3,3,6
14,1,2,10,14,24
5,1,2,3,5,8
17,2,5,50,34,84
30,2,5,89,60,149
29,1,4,72,29,101
25,1,4,62,25,87
13,2,5,25,26,51
14,2,5,41,28,69
16,2,5,46,32,78
25,1,4,68,25,93
26,1,4,71,26,97
15,1,4,44,15,59
24,1,4,70,24,94
2,1,4,6,2,8
22,1,2,20,22,42
21,1,2,19,21,40
25,2,5,68,50,118
12,11,29,209,132,341
13,11,29,226,143,369
11,8,21,134,88,222
30,8,21,365,240,605
3,2,5,8,6,14
14,2,5,37,28,65
24,9,25,360,216,576
24,9,25,360,216,576
10,8,21,86,80,166
6,8,21,52,48,100
5,8,21,43,40,83
18,8,21,155,144,299
10,11,29,177,110,287
30,1,2,17,30,47
1,755,1215,266,755,1021
1,461,742,274,461,735
1,1482,2384,854,1482,2336
1,1482,2384,378,1482,1860
1,461,742,274,461,735
6,45,120,443,270,713
10,45,120,534,450,984
15,4,10,66,60,126
23,4,10,129,92,221
13,4,10,73,52,125
23,2,5,64,46,110
22,2,5,62,44,106
21,2,5,40,42,82
18,4,10,68,72,140
5,4,10,19,20,39
25,2,5,48,50,98
13,2,5,25,26,51
6,2,5,14,12,26
15,2,5,35,30,65
3,2,5,6,6,12
22,2,5,42,44,86
14,2,5,41,28,69
16,2,5,46,32,78
10,2,5,19,20,39
16,2,5,30,32,62
8,3,9,47,24,71
10,3,9,59,30,89
4,2,5,11,8,19
22,2,5,62,44,106
4,2,5,12,8,20
7,2,5,16,14,30
2,4,10,8,8,16
1,4,10,4,4,8
30,2,5,57,60,117
23,3,9,111,69,180
11,3,9,53,33,86
16,2,5,30,32,62
27,2,5,51,54,105
11,7,9,18,77,95
22,7,9,8,154,162
27,7,9,52,189,241
19,7,9,36,133,169
26,7,9,43,182,225
3,7,9,2,21,23
4,7,9,8,28,36
11,3,8,54,33,87
23,3,8,75,69,144
11,3,8,44,33,77
27,3,8,90,81,171
11,3,8,39,33,72
8,3,8,39,24,63
5,8,22,68,40,108
9,8,22,122,72,194
16,8,22,217,128,345
4,8,22,44,32,76
7,8,22,95,56,151
18,8,22,181,144,325
25,8,22,251,200,451
11,8,22,152,88,240
13,8,22,145,104,249
5,9,24,73,45,118
7,13,35,144,91,235
3,13,35,62,39,101
10,13,35,213,130,343
14,13,35,230,182,412
1,13,35,22,13,35
18,13,35,264,234,498
11,13,35,173,143,316
18,13,35,257,234,491
9,13,35,185,117,302
4,13,35,82,52,134
15,13,35,215,195,410
30,13,35,587,390,977
29,13,35,597,377,974
3,13,35,47,39,86
27,13,35,575,351,926
1,13,35,22,13,35
15,13,35,325,195,520
10,13,35,213,130,343
11,13,35,161,143,304
16,13,35,341,208,549
14,13,35,200,182,382
12,13,35,176,156,332
21,13,35,366,273,639
5,38,50,58,190,248
25,38,50,125,950,1075
11,38,50,11,418,429
9,38,50,90,342,432
1,38,50,11,38,49
30,42,54,247,1260,1507
1,1252,2295,997,1252,2249
1,1252,2295,722,1252,1974
1,1252,2295,538,1252,1790
1,1898,3375,937,1898,2835
1,1266,2320,961,1266,2227
1,1266,2320,961,1266,2227
1,420,769,334,420,754
1,295,540,148,295,443
1,1266,2320,752,1266,2018
1,1266,2320,1031,1266,2297
1,1252,2295,997,1252,2249
1,1252,2295,745,1252,1997
1,344,540,174,344,518
1,487,783,124,487,611
1,344,540,77,344,421
1,1555,2443,839,1555,2394
1,2171,3578,656,2171,2827
1,1083,1701,499,1083,1582
1,1083,1701,550,1083,1633
1,713,1120,172,713,885
1,487,783,132,487,619
1,713,1120,205,713,918
1,344,540,126,344,470
20,26,70,866,520,1386
23,3,9,111,69,180
4,3,9,18,12,30
10,3,9,40,30,70
19,1,2,17,19,36
14,1,2,13,14,27
2,1,2,2,2,4
4,1,2,4,4,8
25,1,2,24,25,49
21,2,5,59,42,101
23,2,5,64,46,110
6,2,5,17,12,29
26,2,5,73,52,125
20,2,5,58,40,98
11,1,2,11,11,22
14,1,2,13,14,27
24,2,5,67,48,115
13,2,5,36,26,62
21,2,5,59,42,101
19,1,2,11,19,30
1,1,2,1,1,2
2,9,25,22,18,40
1,9,25,11,9,20
7,12,33,117,84,201
1,12,33,17,12,29
13,2,5,38,26,64
11,2,5,32,22,54
8,2,5,24,16,40
2,2,5,6,4,10
14,2,5,41,28,69
28,2,5,74,56,130
2,2,5,5,4,9
2,1,2,1,2,3
3,1,2,2,3,5
24,1,2,15,24,39
30,1,2,19,30,49
3,12,33,47,36,83
20,1,4,47,20,67
12,1,4,28,12,40
5,9,25,78,45,123
10,9,25,155,90,245
1,9,25,16,9,25
3,9,25,45,27,72
23,2,5,61,46,107
21,2,5,61,42,103
13,2,5,38,26,64
23,2,5,67,46,113
18,1,2,17,18,35
20,11,30,248,220,468
1,1,2,1,1,2
27,2,5,78,54,132
22,2,5,64,44,108
7,2,5,20,14,34
26,8,21,223,208,431
27,8,21,232,216,448
8,2,5,24,16,40
13,2,5,38,26,64
20,8,21,252,160,412
4,1,2,4,4,8
11,1,2,11,11,22
12,1,4,35,12,47
21,1,4,61,21,82
24,1,4,70,24,94
27,1,4,79,27,106
6,9,25,69,54,123
22,9,25,253,198,451
28,9,25,322,252,574
30,1,2,20,30,50
1,1482,2384,807,1482,2289
1,1482,2384,807,1482,2289
1,1482,2384,807,1482,2289
1,461,742,251,461,712
1,461,742,185,461,646
1,755,1215,375,755,1130
1,1482,2384,378,1482,1860
1,755,1215,193,755,948
1,461,742,274,461,735
1,24,64,27,24,51
21,24,64,746,504,1250
19,24,64,541,456,997
18,24,64,478,432,910
6,59,159,390,354,744
22,4,10,86,88,174
29,4,10,113,116,229
24,2,5,71,48,119
4,2,5,12,8,20
8,4,10,43,32,75
15,4,10,71,60,131
7,4,10,33,28,61
23,2,5,44,46,90
29,2,5,55,58,113
10,2,5,28,20,48
4,2,5,11,8,19
27,2,5,78,54,132
15,2,5,33,30,63
10,4,10,42,40,82
13,4,10,55,52,107
22,2,5,43,44,87
29,2,5,68,58,126
15,2,5,44,30,74
30,2,5,87,60,147
23,2,5,68,46,114
21,4,10,122,84,206
18,4,10,104,72,176
22,3,9,118,66,184
26,7,9,3,182,185
27,7,9,49,189,238
15,7,9,0,105,105
9,7,9,12,63,75
7,7,9,4,49,53
5,7,9,4,35,39
6,7,9,2,42,44
20,3,8,70,60,130
15,3,8,70,45,115
6,8,22,55,48,103
20,8,22,223,160,383
12,8,22,163,96,259
25,8,22,345,200,545
6,8,22,83,48,131
6,9,24,89,54,143
16,9,24,236,144,380
19,9,24,203,171,374
13,9,24,154,117,271
25,13,35,340,325,665
15,13,35,320,195,515
5,13,35,68,65,133
6,13,35,86,78,164
3,13,35,65,39,104
20,13,35,391,260,651
10,13,35,164,130,294
14,13,35,200,182,382
25,13,35,515,325,840
13,13,35,281,169,450
14,13,35,205,182,387
4,13,35,63,52,115
26,13,35,454,338,792
6,13,35,105,78,183
27,13,35,585,351,936
14,13,35,220,182,402
7,21,55,230,147,377
3,21,55,72,63,135
6,42,54,66,252,318
15,38,50,150,570,720
11,42,54,25,462,487
7,38,50,21,266,287
8,42,54,87,336,423
30,42,54,344,1260,1604
6,38,50,33,228,261
7,42,54,35,294,329
16,42,54,132,672,804
1,308,565,121,308,429
1,1898,3375,937,1898,2835
1,1252,2295,492,1252,1744
1,1252,2295,905,1252,2157
1,1266,2320,1008,1266,2274
1,2171,3578,1157,2171,3328
1,713,1120,385,713,1098
1,2171,3578,942,2171,3113
1,1083,1701,550,1083,1633
1,713,1120,385,713,1098
1,2171,3578,1371,2171,3542
1,713,1120,261,713,974
1,713,1120,261,713,974
1,713,1120,261,713,974
1,2171,3578,1335,2171,3506
29,26,70,911,754,1665
28,3,9,115,84,199
16,3,9,77,48,125
18,8,21,155,144,299
2,11,29,22,22,44
5,2,5,15,10,25
30,2,5,89,60,149
18,2,5,53,36,89
21,1,2,13,21,34
23,1,2,15,23,38
21,1,2,13,21,34
6,1,2,4,6,10
16,12,33,241,192,433
15,1,2,15,15,30
2,1,2,2,2,4
13,9,25,140,117,257
18,2,5,48,36,84
1,2,5,3,2,5
2,1,4,5,2,7
17,1,4,42,17,59
2,1,2,1,2,3
28,2,5,66,56,122
1,1,2,1,1,2
24,1,2,15,24,39
6,1,2,4,6,10
11,1,2,11,11,22
9,1,2,7,9,16
23,1,2,15,23,38
12,1,2,8,12,20
2,1,2,1,2,3
2,1,2,1,2,3
15,1,4,43,15,58
16,1,4,45,16,61
11,9,25,140,99,239
13,9,25,166,117,283
24,2,5,70,48,118
1,1482,2384,807,1482,2289
1,1482,2384,807,1482,2289
1,461,742,185,461,646
1,461,742,147,461,608
1,461,742,118,461,579
1,461,742,266,461,727
23,24,64,905,552,1457
6,24,64,190,144,334
1,45,120,74,45,119
11,2,5,21,22,43
14,2,5,27,28,55
25,3,9,134,75,209
25,3,9,134,75,209
18,2,5,40,36,76
21,2,5,46,42,88
27,2,5,62,54,116
29,2,5,67,58,125
4,3,9,23,12,35
3,3,9,17,9,26
25,2,5,49,50,99
5,2,5,10,10,20
1,2,5,3,2,5
25,2,5,70,50,120
12,7,9,20,84,104
22,7,9,18,154,172
21,7,9,8,147,155
5,3,8,23,15,38
5,3,8,23,15,38
20,3,8,78,60,138
24,8,22,267,192,459
8,8,22,80,64,144
7,8,22,64,56,120
13,8,22,171,104,275
11,9,24,147,99,246
18,9,24,261,162,423
7,9,24,93,63,156
8,13,35,173,104,277
16,13,35,234,208,442
21,13,35,433,273,706
13,13,35,268,169,437
21,13,35,300,273,573
1,13,35,16,13,29
13,13,35,281,169,450
17,13,35,368,221,589
25,13,35,436,325,761
28,13,35,577,364,941
20,13,35,391,260,651
10,13,35,143,130,273
24,13,35,511,312,823
11,13,35,173,143,316
24,21,55,763,504,1267
11,38,50,110,418,528
2,38,50,23,76,99
17,38,50,170,646,816
25,42,54,84,1050,1134
4,42,54,3,168,171
11,38,50,94,418,512
11,42,54,120,462,582
8,38,50,80,304,384
1,1266,2320,961,1266,2227
1,1266,2320,636,1266,1902
1,1252,2295,951,1252,2203
1,1519,2443,875,1519,2394
1,2171,3578,1264,2171,3435
1,713,1120,161,713,874
1,487,783,280,487,767
1,1083,1701,312,1083,1395
1,713,1120,385,713,1098
1,1083,1701,550,1083,1633
1,1083,1701,550,1083,1633
1,2171,3578,1335,2171,3506
1,344,540,77,344,421
1,487,783,132,487,619
1,344,540,174,344,518
1,344,540,126,344,470
19,1,2,19,19,38
5,1,2,5,5,10
24,8,21,206,192,398
12,8,21,103,96,199
29,2,5,86,58,144
11,2,5,32,22,54
27,2,5,76,54,130
9,2,5,25,18,43
14,11,30,262,154,416
10,1,2,10,10,20
5,1,2,5,5,10
24,1,2,23,24,47
19,1,4,56,19,75
30,1,4,89,30,119
23,1,4,68,23,91
21,2,5,61,42,103
14,2,5,41,28,69
3,2,5,9,6,15
11,2,5,32,22,54
5,1,2,4,5,9
24,1,4,60,24,84
25,2,5,74,50,124
30,1,2,28,30,58
19,1,2,17,19,36
25,1,2,23,25,48
20,9,25,230,180,410
11,9,25,127,99,226
8,2,5,24,16,40
12,2,5,35,24,59
19,1,2,11,19,30
18,1,2,10,18,28
11,1,2,11,11,22
9,1,2,9,9,18
20,1,2,20,20,40
26,11,30,330,286,616
6,2,5,18,12,30
20,11,30,374,220,594
22,9,25,281,198,479
30,9,25,383,270,653
24,1,2,22,24,46
7,1,2,6,7,13
19,1,2,17,19,36
14,1,4,41,14,55
13,1,4,38,13,51
21,8,21,255,168,423
13,1,2,13,13,26
16,1,2,10,16,26
16,1,2,10,16,26
1,1482,2384,878,1482,2360
1,461,742,229,461,690
1,1482,2384,807,1482,2289
1,1482,2384,568,1482,2050
1,1482,2384,735,1482,2217
1,755,1215,436,755,1191
1,461,742,147,461,608
23,24,64,655,552,1207
6,59,159,581,354,935
7,3,9,39,21,60
11,3,9,62,33,95
21,2,5,56,42,98
19,2,5,55,38,93
27,2,5,78,54,132
9,4,10,43,36,79
23,4,10,110,92,202
26,4,10,153,104,257
12,4,10,71,48,119
19,2,5,55,38,93
3,2,5,8,6,14
1,2,5,3,2,5
16,2,5,30,32,62
10,2,5,19,20,39
24,4,10,139,96,235
30,4,10,174,120,294
10,7,9,19,70,89
23,7,9,42,161,203
7,7,9,0,49,49
1,7,9,1,7,8
22,7,9,30,154,184
8,7,9,15,56,71
7,3,8,34,21,55
7,3,8,34,21,55
23,3,8,75,69,144
29,8,22,266,232,498
26,8,22,261,208,469
3,8,22,41,24,65
25,8,22,345,200,545
15,8,22,207,120,327
24,8,22,331,192,523
8,8,22,89,64,153
3,8,22,41,24,65
20,8,22,276,160,436
26,8,22,261,208,469
27,13,35,528,351,879
3,13,35,65,39,104
22,13,35,315,286,601
13,13,35,277,169,446
18,13,35,314,234,548
9,13,35,157,117,274
10,13,35,213,130,343
1,38,50,6,38,44
9,38,50,104,342,446
9,42,54,98,378,476
4,42,54,0,168,168
19,38,50,162,722,884
29,38,50,29,1102,1131
1,1252,2295,997,1252,2249
1,295,540,148,295,443
1,1252,2295,1020,1252,2272
1,1252,2295,997,1252,2249
1,1252,2295,538,1252,1790
1,1266,2320,636,1266,1902
1,1252,2295,630,1252,1882
1,487,783,280,487,767
1,2171,3578,656,2171,2827
1,487,783,194,487,681
1,713,1120,385,713,1098
1,2171,3578,1335,2171,3506
3,1,2,3,3,6
2,9,25,24,18,42
1,9,25,12,9,21
25,2,5,73,50,123
19,1,4,56,19,75
22,11,30,411,242,653
3,11,30,56,33,89
25,2,5,70,50,120
19,2,5,53,38,91
15,2,5,42,30,72
16,2,5,46,32,78
25,2,5,73,50,123
8,12,33,165,96,261
29,1,4,72,29,101
6,1,4,15,6,21
2,1,4,5,2,7
18,2,5,42,36,78
4,2,5,9,8,17
27,1,2,20,27,47
14,1,2,10,14,24
2,2,5,6,4,10
10,2,5,30,20,50
5,2,5,15,10,25
26,2,5,77,52,129
22,1,4,50,22,72
17,1,4,39,17,56
23,8,21,193,184,377
5,8,21,42,40,82
6,12,33,100,72,172
18,12,33,301,216,517
29,2,5,55,58,113
3,12,33,41,36,77
5,12,33,69,60,129
21,2,5,49,42,91
11,1,2,11,11,22
13,1,2,12,13,25
19,2,5,55,38,93
19,2,5,55,38,93
7,1,4,20,7,27
16,1,4,47,16,63
13,1,2,8,13,21
4,1,2,4,4,8
4,1,2,4,4,8
28,1,2,27,28,55
1,1482,2384,616,1482,2098
1,1482,2384,807,1482,2289
5,59,159,397,295,692
16,4,10,90,64,154
12,4,10,67,48,115
20,2,5,42,40,82
13,2,5,27,26,53
12,2,5,35,24,59
13,2,5,38,26,64
20,3,9,116,60,176
26,3,9,151,78,229
5,4,10,30,20,50
13,4,10,78,52,130
30,2,5,71,60,131
21,2,5,43,42,85
18,2,5,37,36,73
10,2,5,30,20,50
25,2,5,70,50,120
21,2,5,59,42,101
15,3,9,62,45,107
23,3,9,95,69,164
3,2,5,9,6,15
26,2,5,75,52,127
12,3,9,48,36,84
14,7,9,23,98,121
3,7,9,5,21,26
9,7,9,16,63,79
18,7,9,10,126,136
4,7,9,7,28,35
2,7,9,1,14,15
25,7,9,46,175,221
26,7,9,47,182,229
7,3,8,34,21,55
27,3,8,87,81,168
8,8,22,75,64,139
7,8,22,96,56,152
1,8,22,11,8,19
4,8,22,54,32,86
30,8,22,334,240,574
9,9,24,126,81,207
10,9,24,145,90,235
6,9,24,89,54,143
2,9,24,29,18,47
28,9,24,333,252,585
6,9,24,64,54,118
14,9,24,210,126,336
7,9,24,83,63,146
21,9,24,249,189,438
9,9,24,87,81,168
15,9,24,178,135,313
16,13,35,341,208,549
17,13,35,368,221,589
29,13,35,618,377,995
5,13,35,103,65,168
4,13,35,70,52,122
16,13,35,251,208,459
15,13,35,309,195,504
6,13,35,105,78,183
4,13,35,85,52,137
30,13,35,639,390,1029
26,13,35,563,338,901
13,13,35,227,169,396
14,13,35,244,182,426
18,13,35,295,234,529
21,13,35,455,273,728
1,13,35,14,13,27
12,13,35,205,156,361
18,21,55,483,378,861
3,21,55,81,63,144
24,38,50,24,912,936
14,38,50,154,532,686
13,42,54,65,546,611
26,42,54,59,1092,1151
18,38,50,45,684,729
9,38,50,104,342,446
20,42,54,67,840,907
25,38,50,138,950,1088
7,38,50,70,266,336
1,1252,2295,722,1252,1974
1,1266,2320,961,1266,2227
1,1252,2295,722,1252,1974
1,420,769,249,420,669
1,308,565,246,308,554
1,1252,2295,630,1252,1882
1,420,769,249,420,669
1,420,769,249,420,669
1,2171,3578,1264,2171,3435
1,1083,1701,618,1083,1701
1,1555,2443,790,1555,2345
1,2171,3578,763,2171,2934
1,2171,3578,942,2171,3113
1,713,1120,385,713,1098
1,2171,3578,727,2171,2898
1,1083,1701,312,1083,1395
1,344,540,83,344,427
1,344,540,99,344,443
1,713,1120,205,713,918
1,713,1120,261,713,974
1,2171,3578,620,2171,2791
1,344,540,174,344,518
21,26,70,659,546,1205
1,26,70,35,26,61
26,3,9,126,78,204
13,3,9,62,39,101
16,1,2,15,16,31
5,13,35,107,65,172
3,13,35,64,39,103
7,2,5,16,14,30
13,2,5,31,26,57
9,11,29,159,99,258
16,11,29,283,176,459
6,2,5,18,12,30
17,2,5,50,34,84
24,1,2,24,24,48
17,1,4,50,17,67
4,1,4,12,4,16
11,1,4,32,11,43
27,2,5,78,54,132
13,2,5,38,26,64
21,2,5,61,42,103
4,2,5,8,8,16
11,2,5,21,22,43
11,13,35,192,143,335
9,1,2,7,9,16
14,1,2,10,14,24
16,1,2,12,16,28
4,11,30,54,44,98
6,11,30,82,66,148
27,1,2,25,27,52
18,1,2,17,18,35
29,1,2,27,29,56
10,1,2,6,10,16
17,1,2,10,17,27
14,2,5,33,28,61
5,1,4,11,5,16
25,1,4,53,25,78
10,1,4,21,10,31
4,1,2,3,4,7
27,1,4,79,27,106
20,1,4,58,20,78
7,1,2,7,7,14
11,1,2,11,11,22
17,2,5,32,34,66
22,2,5,42,44,86
1,12,33,14,12,26
18,1,2,12,18,30
6,9,25,69,54,123
8,9,25,92,72,164
21,9,25,263,189,452
27,9,25,338,243,581
29,2,5,68,58,126
28,12,33,468,336,804
18,12,33,301,216,517
19,8,21,195,152,347
2,8,21,21,16,37
6,8,21,62,48,110
25,1,2,14,25,39
30,2,5,87,60,147
12,1,4,29,12,41
29,1,4,71,29,100
1,1482,2384,807,1482,2289
1,461,742,274,461,735
1,1482,2384,735,1482,2217
1,1482,2384,854,1482,2336
1,755,1215,436,755,1191
1,1482,2384,854,1482,2336
1,1482,2384,854,1482,2336
30,24,64,797,720,1517
24,24,64,714,576,1290
14,24,64,542,336,878
2,59,159,187,118,305
20,2,5,56,40,96
10,2,5,28,20,48
7,2,5,16,14,30
30,2,5,71,60,131
15,2,5,42,30,72
22,2,5,62,44,106
20,2,5,59,40,99
30,2,5,89,60,149
26,2,5,49,52,101
8,2,5,15,16,31
21,2,5,49,42,91
5,4,10,30,20,50
1,3,9,6,3,9
19,3,9,112,57,169
24,2,5,70,48,118
27,2,5,78,54,132
7,2,5,21,14,35
9,2,5,27,18,45
17,3,9,82,51,133
13,3,9,63,39,102
16,2,5,46,32,78
22,3,9,124,66,190
7,3,9,39,21,60
12,2,5,28,24,52
15,7,9,25,105,130
21,7,9,17,147,164
22,7,9,36,154,190
10,7,9,18,70,88
20,7,9,38,140,178
4,3,8,20,12,32
13,3,8,64,39,103
9,3,8,29,27,56
7,8,22,64,56,120
2,8,22,27,16,43
5,8,22,47,40,87
8,9,24,78,72,150
10,9,24,145,90,235
4,13,35,85,52,137
30,13,35,618,390,1008
10,13,35,206,130,336
6,13,35,124,78,202
28,13,35,489,364,853
26,13,35,372,338,710
19,13,35,325,247,572
20,13,35,286,260,546
20,13,35,349,260,609
29,13,35,394,377,771
21,13,35,366,273,639
25,13,35,366,325,691
11,13,35,227,143,370
21,21,55,564,441,1005
2,21,55,66,42,108
20,21,55,658,420,1078
30,21,55,954,630,1584
1,38,50,1,38,39
30,38,50,330,1140,1470
3,42,54,33,126,159
28,42,54,321,1176,1497
2,38,50,6,76,82
16,38,50,88,608,696
14,38,50,140,532,672
2,38,50,22,76,98
23,42,54,127,966,1093
1,1252,2295,951,1252,2203
1,1266,2320,636,1266,1902
1,1266,2320,544,1266,1810
1,1266,2320,892,1266,2158
1,1252,2295,997,1252,2249
1,2171,3578,942,2171,3113
1,1083,1701,550,1083,1633
1,1555,2443,448,1555,2003
1,2171,3578,1371,2171,3542
1,487,783,194,487,681
1,2171,3578,1371,2171,3542
1,2171,3578,620,2171,2791
1,2171,3578,1335,2171,3506
12,26,70,343,312,655
19,26,70,809,494,1303
21,26,70,748,546,1294
23,3,9,134,69,203
11,3,9,64,33,97
8,3,9,33,24,57
1,3,9,4,3,7
23,3,9,130,69,199
12,13,35,256,156,412
1,13,35,21,13,34
9,13,35,132,117,249
22,2,5,62,44,106
2,2,5,6,4,10
10,1,2,10,10,20
1,1,2,1,1,2
14,13,35,239,182,421
27,13,35,462,351,813
30,2,5,84,60,144
13,2,5,25,26,51
13,2,5,25,26,51
13,13,35,186,169,355
6,2,5,14,12,26
30,2,5,69,60,129
19,1,2,14,19,33
18,2,5,34,36,70
23,2,5,44,46,90
19,11,30,224,209,433
23,2,5,64,46,110
15,2,5,42,30,72
14,1,4,34,14,48
27,1,4,66,27,93
26,2,5,73,52,125
15,1,2,14,15,29
17,2,5,48,34,82
6,2,5,17,12,29
20,9,25,310,180,490
29,1,4,61,29,90
13,1,4,28,13,41
26,1,2,15,26,41
1,1482,2384,401,1482,1883
1,1482,2384,807,1482,2289
1,1482,2384,878,1482,2360
1,461,742,147,461,608
30,24,64,1162,720,1882
26,45,120,1825,1170,2995
3,59,159,200,177,377
5,59,159,484,295,779
14,3,9,61,42,103
13,3,9,57,39,96
19,4,10,84,76,160
19,4,10,84,76,160
24,4,10,139,96,235
28,4,10,162,112,274
28,2,5,83,56,139
19,2,5,56,38,94
10,2,5,30,20,50
29,3,9,132,87,219
12,2,5,28,24,52
7,2,5,16,14,30
26,2,5,61,52,113
10,3,9,59,30,89
3,2,5,9,6,15
12,2,5,35,24,59
6,2,5,18,12,30
27,2,5,80,54,134
10,7,9,6,70,76
25,7,9,10,175,185
15,7,9,29,105,134
7,7,9,13,49,62
5,7,9,9,35,44
21,7,9,40,147,187
9,3,8,44,27,71
6,3,8,24,18,42
5,8,22,56,40,96
26,8,22,353,208,561
3,8,22,31,24,55
16,8,22,168,128,296
2,8,22,19,16,35
10,8,22,92,80,172
24,8,22,220,192,412
25,8,22,345,200,545
29,9,24,428,261,689
4,9,24,53,36,89
25,9,24,351,225,576
18,9,24,261,162,423
5,13,35,107,65,172
16,13,35,346,208,554
26,13,35,554,338,892
16,13,35,274,208,482
28,13,35,489,364,853
19,13,35,292,247,539
15,13,35,309,195,504
19,13,35,391,247,638
12,13,35,163,156,319
11,13,35,157,143,300
7,13,35,137,91,228
3,13,35,64,39,103
19,13,35,312,247,559
21,13,35,300,273,573
4,13,35,78,52,130
7,13,35,144,91,235
6,13,35,130,78,208
13,13,35,186,169,355
1,13,35,16,13,29
29,13,35,506,377,883
24,42,54,275,1008,1283
1,38,50,12,38,50
29,42,54,332,1218,1550
16,42,54,54,672,726
20,38,50,0,760,760
14,38,50,77,532,609
17,42,54,85,714,799
2,38,50,20,76,96
1,1266,2320,544,1266,1810
1,1898,3375,937,1898,2835
1,1266,2320,752,1266,2018
1,1266,2320,1031,1266,2297
1,1252,2295,951,1252,2203
1,1266,2320,961,1266,2227
1,295,540,126,295,421
1,308,565,251,308,559
1,1266,2320,1008,1266,2274
1,344,540,99,344,443
1,1555,2443,839,1555,2394
1,2171,3578,1264,2171,3435
1,2171,3578,942,2171,3113
1,1555,2443,302,1555,1857
1,1083,1701,397,1083,1480
1,713,1120,329,713,1042
1,2171,3578,727,2171,2898
1,344,540,158,344,502
1,344,540,174,344,518
1,344,540,174,344,518
8,9,25,126,72,198
9,1,2,5,9,14
10,1,2,7,10,17
7,1,2,5,7,12
8,1,2,6,8,14
20,1,2,15,20,35
20,2,5,59,40,99
15,2,5,44,30,74
7,2,5,21,14,35
6,1,2,4,6,10
30,1,4,82,30,112
29,13,35,618,377,995
3,9,25,43,27,70
6,9,25,86,54,140
19,1,2,18,19,37
4,1,2,4,4,8
24,1,2,23,24,47
13,2,5,25,26,51
13,2,5,25,26,51
27,2,5,49,54,103
21,11,30,386,231,617
28,11,30,515,308,823
30,11,30,552,330,882
24,11,30,442,264,706
10,1,2,9,10,19
30,9,25,465,270,735
8,9,25,124,72,196
28,1,2,27,28,55
14,1,2,10,14,24
8,1,2,6,8,14
26,2,5,77,52,129
21,2,5,62,42,104
3,1,4,9,3,12
22,1,2,12,22,34
1,1,2,1,1,2
9,2,5,21,18,39
14,8,21,170,112,282
8,2,5,19,16,35
15,8,21,189,120,309
14,1,2,13,14,27
14,2,5,41,28,69
20,8,21,159,160,319
28,8,21,223,224,447
30,8,21,239,240,479
6,2,5,17,12,29
16,2,5,46,32,78
21,2,5,61,42,103
1,461,742,125,461,586
1,461,742,185,461,646
27,24,64,1063,648,1711
3,45,120,149,135,284
2,4,10,8,8,16
15,4,10,63,60,123
17,4,10,71,68,139
13,4,10,55,52,107
20,3,9,97,60,157
6,3,9,29,18,47
8,4,10,30,32,62
1,4,10,4,4,8
14,2,5,33,28,61
12,2,5,28,24,52
1,2,5,2,2,4
5,2,5,15,10,25
27,2,5,80,54,134
20,2,5,42,40,82
3,2,5,6,6,12
9,2,5,21,18,39
4,2,5,12,8,20
6,2,5,18,12,30
1,2,5,3,2,5
29,2,5,67,58,125
9,2,5,21,18,39
25,2,5,53,50,103
2,2,5,4,4,8
13,3,9,52,39,91
21,2,5,61,42,103
20,2,5,58,40,98
30,7,9,49,210,259
8,7,9,11,56,67
19,7,9,36,133,169
25,7,9,46,175,221
30,8,22,407,240,647
28,8,22,367,224,591
7,8,22,95,56,151
8,8,22,73,64,137
10,8,22,100,80,180
18,8,22,177,144,321
2,8,22,28,16,44
7,8,22,87,56,143
5,8,22,46,40,86
26,8,22,238,208,446
9,9,24,131,81,212
24,9,24,348,216,564
11,13,35,157,143,300
22,13,35,384,286,670
22,13,35,469,286,755
11,13,35,234,143,377
9,13,35,141,117,258
1,13,35,16,13,29
21,13,35,433,273,706
19,13,35,391,247,638
6,13,35,105,78,183
27,13,35,443,351,794
15,13,35,309,195,504
6,13,35,117,78,195
29,13,35,618,377,995
22,13,35,476,286,762
12,13,35,209,156,365
25,21,55,795,525,1320
2,21,55,45,42,87
1,38,50,1,38,39
7,38,50,18,266,284
4,42,54,20,168,188
12,42,54,60,504,564
5,38,50,58,190,248
1,1252,2295,538,1252,1790
1,1252,2295,722,1252,1974
1,1252,2295,561,1252,1813
1,1252,2295,951,1252,2203
1,1266,2320,892,1266,2158
1,295,540,148,295,443
1,295,540,126,295,421
1,295,540,234,295,529
1,295,540,240,295,535
1,1519,2443,753,1519,2272
1,2171,3578,942,2171,3113
1,2171,3578,835,2171,3006
1,487,783,155,487,642
1,713,1120,396,713,1109
1,2171,3578,763,2171,2934
1,487,783,265,487,752
1,1555,2443,570,1555,2125
1,344,540,126,344,470
12,26,70,410,312,722
30,3,9,177,90,267
20,3,9,80,60,140
25,1,2,25,25,50
30,1,2,29,30,59
20,1,2,19,20,39
30,1,2,29,30,59
6,1,2,4,6,10
13,1,2,10,13,23
11,2,5,32,22,54
21,2,5,61,42,103
12,2,5,23,24,47
3,2,5,9,6,15
24,2,5,71,48,119
9,1,4,19,9,28
5,1,4,11,5,16
4,9,25,57,36,93
28,9,25,399,252,651
18,2,5,50,36,86
17,2,5,48,34,82
30,2,5,87,60,147
29,2,5,84,58,142
7,9,25,105,63,168
4,1,2,3,4,7
1,1,2,1,1,2
19,1,4,45,19,64
22,11,30,372,242,614
11,11,30,186,121,307
5,9,25,75,45,120
3,9,25,45,27,72
14,9,25,175,126,301
18,8,21,155,144,299
22,8,21,189,176,365
26,2,5,49,52,101
12,2,5,23,24,47
10,2,5,21,20,41
23,2,5,48,46,94
6,1,2,6,6,12
29,1,2,25,29,54
8,1,2,7,8,15
26,1,2,22,26,48
1,1,4,2,1,3
22,1,4,54,22,76
5,1,4,12,5,17
1,1482,2384,592,1482,2074
1,1482,2384,878,1482,2360
1,1482,2384,807,1482,2289
1,755,1215,241,755,996
1,461,742,177,461,638
17,24,64,484,408,892
7,59,159,678,413,1091
13,2,5,31,26,57
27,2,5,63,54,117
23,2,5,64,46,110
3,2,5,8,6,14
28,2,5,83,56,139
19,2,5,56,38,94
4,4,10,24,16,40
7,3,9,34,21,55
1,3,9,5,3,8
18,3,9,82,54,136
11,2,5,32,22,54
13,2,5,38,26,64
6,2,5,18,12,30
2,2,5,4,4,8
26,2,5,49,52,101
30,2,5,71,60,131
6,2,5,14,12,26
23,2,5,61,46,107
29,2,5,77,58,135
24,4,10,139,96,235
5,4,10,29,20,49
17,2,5,33,34,67
13,2,5,25,26,51
17,3,9,99,51,150
5,2,5,12,10,22
27,2,5,63,54,117
28,2,5,74,56,130
13,3,9,73,39,112
10,3,9,56,30,86
10,2,5,19,20,39
27,2,5,51,54,105
25,7,9,1,175,176
26,7,9,1,182,183
29,7,9,53,203,256
3,7,9,4,21,25
5,3,8,20,15,35
18,3,8,70,54,124
28,3,8,93,84,177
26,3,8,93,78,171
5,8,22,68,40,108
24,8,22,325,192,517
24,8,22,325,192,517
20,8,22,223,160,383
17,8,22,231,136,367
30,8,22,328,240,568
12,8,22,163,96,259
18,9,24,266,162,428
14,9,24,203,126,329
20,9,24,185,180,365
5,9,24,73,45,118
15,13,35,309,195,504
17,13,35,362,221,583
7,13,35,149,91,240
4,13,35,82,52,134
8,13,35,165,104,269
9,13,35,176,117,293
11,13,35,150,143,293
4,13,35,57,52,109
20,13,35,412,260,672
15,13,35,309,195,504
20,13,35,391,260,651
28,13,35,606,364,970
21,13,35,447,273,720
7,13,35,122,91,213
15,13,35,262,195,457
9,13,35,192,117,309
26,13,35,372,338,710
26,13,35,554,338,892
4,21,55,107,84,191
18,21,55,572,378,950
3,21,55,99,63,162
21,42,54,14,882,896
25,38,50,288,950,1238
30,38,50,165,1140,1305
16,38,50,176,608,784
19,38,50,190,722,912
20,42,54,-19,840,821
11,38,50,11,418,429
15,42,54,148,630,778
5,38,50,55,190,245
18,42,54,206,756,962
25,42,54,3,1050,1053
1,1266,2320,752,1266,2018
1,1252,2295,745,1252,1997
1,1252,2295,997,1252,2249
1,420,769,334,420,754
1,1266,2320,1008,1266,2274
1,1266,2320,892,1266,2158
1,2171,3578,620,2171,2791
1,2171,3578,1371,2171,3542
1,2171,3578,763,2171,2934
1,1083,1701,244,1083,1327
1,2171,3578,656,2171,2827
1,713,1120,385,713,1098
1,1083,1701,550,1083,1633
1,2171,3578,1335,2171,3506
1,2171,3578,1371,2171,3542
1,344,540,185,344,529
1,1519,2443,606,1519,2125
17,26,70,498,442,940
14,26,70,400,364,764
19,3,9,92,57,149
11,3,9,62,33,95
27,3,9,157,81,238
20,3,9,118,60,178
23,3,9,105,69,174
28,2,5,81,56,137
3,8,21,36,24,60
25,2,5,70,50,120
19,13,35,411,247,658
7,13,35,152,91,243
11,1,2,11,11,22
2,13,35,43,26,69
1,1,2,1,1,2
5,1,2,3,5,8
3,13,35,52,39,91
27,13,35,471,351,822
1,9,25,13,9,22
29,1,2,16,29,45
28,1,2,27,28,55
6,2,5,18,12,30
26,2,5,51,52,103
18,2,5,35,36,71
14,2,5,27,28,55
21,2,5,40,42,82
16,2,5,30,32,62
15,11,30,177,165,342
5,11,30,59,55,114
27,2,5,72,54,126
29,2,5,61,58,119
30,2,5,63,60,123
28,2,5,59,56,115
15,1,2,14,15,29
1,1,2,1,1,2
7,2,5,13,14,27
22,2,5,42,44,86
2,1,2,2,2,4
14,1,2,14,14,28
5,1,4,14,5,19
11,2,5,32,22,54
14,2,5,41,28,69
26,1,2,19,26,45
2,1,2,1,2,3
23,1,2,17,23,40
9,11,30,166,99,265
23,2,5,54,46,100
21,2,5,49,42,91
14,1,2,13,14,27
6,9,25,77,54,131
2,9,25,26,18,44
20,11,30,368,220,588
28,1,2,16,28,44
14,9,25,147,126,273
28,9,25,294,252,546
8,2,5,23,16,39
27,2,5,78,54,132
8,1,2,8,8,16
4,1,2,4,4,8
28,1,2,27,28,55
1,1482,2384,807,1482,2289
1,1482,2384,807,1482,2289
1,1482,2384,735,1482,2217
1,461,742,266,461,727
1,461,742,147,461,608
2,24,64,77,48,125
13,24,64,512,312,824
7,24,64,222,168,390
8,24,64,284,192,476
9,2,5,24,18,42
30,2,5,89,60,149
20,4,10,116,80,196
23,4,10,133,92,225
29,3,9,164,87,251
5,2,5,10,10,20
22,2,5,46,44,90
19,3,9,111,57,168
10,3,9,58,30,88
12,4,10,70,48,118
7,4,10,41,28,69
4,2,5,8,8,16
12,2,5,35,24,59
18,2,5,52,36,88
1,2,5,3,2,5
18,2,5,42,36,78
18,2,5,42,36,78
8,3,9,36,24,60
18,2,5,52,36,88
2,2,5,6,4,10
11,7,9,18,77,95
19,7,9,36,133,169
1,3,8,4,3,7
24,8,22,267,192,459
26,8,22,353,208,561
21,8,22,276,168,444
16,8,22,210,128,338
8,8,22,110,64,174
5,8,22,69,40,109
8,8,22,110,64,174
23,9,24,334,207,541
23,9,24,323,207,530
23,9,24,240,207,447
12,9,24,177,108,285
2,13,35,43,26,69
16,13,35,313,208,521
3,13,35,62,39,101
11,13,35,227,143,370
2,13,35,35,26,61
30,13,35,650,390,1040
9,13,35,195,117,312
21,13,35,455,273,728
8,13,35,126,104,230
17,13,35,362,221,583
3,13,35,64,39,103
25,13,35,384,325,709
11,13,35,161,143,304
18,21,55,394,378,772
8,21,55,241,168,409
22,38,50,66,836,902
28,38,50,126,1064,1190
8,38,50,92,304,396
7,38,50,81,266,347
30,42,54,344,1260,1604
6,38,50,66,228,294
5,42,54,55,210,265
24,38,50,132,912,1044
21,38,50,63,798,861
1,1252,2295,1020,1252,2272
1,420,769,234,420,654
1,1252,2295,745,1252,1997
1,420,769,334,420,754
1,1266,2320,544,1266,1810
1,420,769,341,420,761
1,1266,2320,1008,1266,2274
1,308,565,121,308,429
1,1266,2320,961,1266,2227
1,1266,2320,961,1266,2227
1,295,540,169,295,464
1,487,783,265,487,752
1,2171,3578,763,2171,2934
1,344,540,185,344,529
1,713,1120,205,713,918
1,344,540,185,344,529
1,1519,2443,460,1519,1979
1,344,540,126,344,470
1,1555,2443,864,1555,2419
1,344,540,110,344,454
1,1555,2443,448,1555,2003
1,2171,3578,1335,2171,3506
21,26,70,909,546,1455
21,26,70,865,546,1411
20,3,9,116,60,176
23,3,9,107,69,176
2,13,35,34,26,60
12,13,35,205,156,361
22,8,21,254,176,430
16,8,21,184,128,312
15,13,35,325,195,520
11,1,2,8,11,19
1,1,2,1,1,2
15,2,5,44,30,74
23,2,5,68,46,114
19,1,2,11,19,30
27,1,2,15,27,42
21,1,2,20,21,41
3,12,33,62,36,98
9,12,33,186,108,294
20,9,25,200,180,380
22,9,25,220,198,418
29,1,2,21,29,50
13,1,2,10,13,23
3,1,2,2,3,5
20,2,5,58,40,98
21,2,5,61,42,103
28,1,2,27,28,55
6,1,4,16,6,22
8,2,5,22,16,38
18,2,5,50,36,86
29,2,5,81,58,139
13,1,4,38,13,51
7,1,4,20,7,27
14,2,5,41,28,69
13,1,2,13,13,26
26,8,21,267,208,475
18,2,5,50,36,86
1,2,5,3,2,5
23,1,2,20,23,43
30,1,2,26,30,56
8,2,5,15,16,31
27,1,2,26,27,53
8,1,2,8,8,16
5,1,4,12,5,17
21,8,21,264,168,432
23,8,21,289,184,473
13,8,21,164,104,268
7,2,5,15,14,29
22,2,5,46,44,90
1,1482,2384,473,1482,1955
1,755,1215,375,755,1130
10,59,159,968,590,1558
3,59,159,233,177,410
8,59,159,635,472,1107
23,2,5,48,46,94
10,2,5,27,20,47
27,2,5,72,54,126
4,2,5,11,8,19
7,2,5,20,14,34
4,4,10,21,16,37
9,4,10,48,36,84
22,4,10,128,88,216
1,4,10,6,4,10
21,2,5,44,42,86
2,4,10,11,8,19
15,4,10,84,60,144
13,4,10,60,52,112
21,4,10,97,84,181
27,2,5,51,54,105
7,2,5,13,14,27
12,2,5,23,24,47
5,2,5,12,10,22
18,7,9,5,126,131
29,7,9,48,203,251
18,7,9,34,126,160
19,7,9,31,133,164
20,7,9,33,140,173
29,7,9,24,203,227
6,7,9,0,42,42
15,7,9,2,105,107
24,3,8,116,72,188
24,3,8,93,72,165
6,3,8,19,18,37
12,3,8,58,36,94
23,3,8,75,69,144
14,8,22,174,112,286
2,8,22,18,16,34
10,8,22,136,80,216
18,8,22,165,144,309
8,8,22,110,64,174
11,9,24,123,99,222
1,9,24,10,9,19
20,9,24,223,180,403
3,13,35,47,39,86
6,13,35,128,78,206
19,13,35,278,247,525
30,13,35,587,390,977
22,13,35,430,286,716
5,13,35,107,65,172
25,13,35,410,325,735
14,13,35,220,182,402
22,13,35,453,286,739
7,13,35,120,91,211
5,13,35,72,65,137
6,13,35,105,78,183
1,21,55,30,21,51
4,21,55,107,84,191
6,21,55,161,126,287
23,38,50,69,874,943
3,42,54,10,126,136
16,38,50,136,608,744
23,38,50,230,874,1104
28,42,54,276,1176,1452
1,1252,2295,1020,1252,2272
1,1252,2295,538,1252,1790
1,1252,2295,722,1252,1974
1,1266,2320,892,1266,2158
1,308,565,155,308,463
1,1252,2295,997,1252,2249
1,1252,2295,882,1252,2134
1,1252,2295,538,1252,1790
1,420,769,249,420,669
1,1083,1701,346,1083,1429
1,1083,1701,380,1083,1463
1,344,540,126,344,470
3,26,70,86,78,164
23,3,9,134,69,203
30,1,2,17,30,47
16,1,2,9,16,25
10,1,2,6,10,16
22,13,35,322,286,608
12,1,2,9,12,21
3,1,2,2,3,5
15,2,5,42,30,72
18,2,5,52,36,88
9,9,25,97,81,178
5,1,2,5,5,10
29,1,2,28,29,57
15,9,25,214,135,349
3,9,25,43,27,70
27,2,5,53,54,107
7,2,5,14,14,28
21,1,4,52,21,73
28,12,33,468,336,804
26,1,2,25,26,51
21,9,25,331,189,520
9,9,25,142,81,223
3,1,2,2,3,5
10,1,2,7,10,17
4,1,4,10,4,14
9,1,4,22,9,31
19,1,4,56,19,75
30,1,4,89,30,119
19,2,5,56,38,94
5,2,5,15,10,25
25,2,5,74,50,124
19,11,30,287,209,496
15,11,30,227,165,392
3,1,2,2,3,5
3,1,2,2,3,5
13,1,2,7,13,20
12,2,5,23,24,47
23,2,5,44,46,90
27,12,33,549,324,873
19,12,33,386,228,614
10,1,2,10,10,20
20,1,2,15,20,35
8,1,2,6,8,14
19,1,4,41,19,60
12,1,4,26,12,38
12,8,21,123,96,219
10,8,21,103,80,183
17,8,21,175,136,311
5,8,21,61,40,101
1,11,29,16,11,27
28,1,2,20,28,48
29,1,2,21,29,50
1,1482,2384,735,1482,2217
1,461,742,118,461,579
1,755,1215,436,755,1191
1,755,1215,436,755,1191
1,1482,2384,592,1482,2074
1,461,742,118,461,579
1,461,742,229,461,690
1,1482,2384,854,1482,2336
6,24,64,236,144,380
10,45,120,594,450,1044
8,2,5,17,16,33
9,2,5,19,18,37
18,2,5,52,36,88
16,2,5,46,32,78
10,2,5,29,20,49
18,2,5,35,36,71
3,2,5,7,6,13
1,2,5,2,2,4
28,2,5,55,56,111
20,2,5,58,40,98
29,2,5,84,58,142
24,2,5,70,48,118
12,2,5,23,24,47
10,2,5,20,20,40
7,2,5,16,14,30
30,2,5,59,60,119
30,2,5,89,60,149
7,2,5,20,14,34
13,3,9,53,39,92
6,3,9,32,18,50
20,3,9,107,60,167
30,3,9,161,90,251
22,3,9,118,66,184
22,4,10,92,88,180
2,4,10,8,8,16
16,7,9,31,112,143
9,7,9,7,63,70
7,7,9,11,49,60
1,7,9,0,7,7
20,7,9,2,140,142
5,7,9,9,35,44
20,7,9,17,140,157
29,7,9,11,203,214
6,3,8,30,18,48
8,3,8,39,24,63
16,3,8,53,48,101
20,3,8,66,60,126
1,8,22,14,8,22
23,8,22,211,184,395
28,8,22,380,224,604
2,8,22,19,16,35
18,8,22,244,144,388
19,9,24,280,171,451
22,9,24,214,198,412
3,9,24,44,27,71
30,9,24,436,270,706
9,9,24,96,81,177
18,9,24,240,162,402
7,13,35,103,91,194
25,13,35,393,325,718
29,13,35,628,377,1005
9,13,35,151,117,268
22,13,35,322,286,608
9,13,35,192,117,309
12,13,35,205,156,361
8,13,35,165,104,269
16,13,35,251,208,459
23,13,35,377,299,676
23,13,35,450,299,749
3,13,35,47,39,86
27,21,55,888,567,1455
15,21,55,378,315,693
9,38,50,104,342,446
28,38,50,238,1064,1302
2,42,54,0,84,84
17,42,54,75,714,789
7,38,50,60,266,326
9,42,54,1,378,379
3,42,54,15,126,141
1,1898,3375,768,1898,2666
1,1266,2320,892,1266,2158
1,308,565,184,308,492
1,420,769,249,420,669
1,308,565,246,308,554
1,1898,3375,1410,1898,3308
1,2171,3578,656,2171,2827
1,2171,3578,942,2171,3113
1,1519,2443,606,1519,2125
1,1555,2443,570,1555,2125
1,344,540,99,344,443
1,1083,1701,499,1083,1582
1,1519,2443,533,1519,2052
1,2171,3578,1335,2171,3506
1,487,783,132,487,619
22,26,70,953,572,1525
15,3,9,87,45,132
18,3,9,105,54,159
1,3,9,6,3,9
8,2,5,15,16,31
29,2,5,55,58,113
22,13,35,476,286,762
22,13,35,476,286,762
21,13,35,455,273,728
9,1,2,8,9,17
3,1,2,2,3,5
26,1,2,19,26,45
7,1,2,5,7,12
19,1,2,14,19,33
26,1,2,19,26,45
1,11,30,19,11,30
2,11,30,37,22,59
12,1,4,36,12,48
6,1,2,4,6,10
15,1,2,10,15,25
12,9,25,129,108,237
18,9,25,194,162,356
24,9,25,258,216,474
19,13,35,405,247,652
10,13,35,213,130,343
18,12,33,372,216,588
10,1,2,10,10,20
25,1,2,24,25,49
15,1,2,14,15,29
3,1,2,2,3,5
2,1,2,1,2,3
5,1,2,5,5,10
10,9,25,123,90,213
24,9,25,294,216,510
4,1,4,12,4,16
19,11,30,241,209,450
3,11,30,38,33,71
26,11,30,330,286,616
16,1,4,36,16,52
21,1,4,48,21,69
2,1,4,6,2,8
4,2,5,9,8,17
3,2,5,7,6,13
13,1,4,32,13,45
18,1,2,15,18,33
8,1,2,7,8,15
21,2,5,61,42,103
21,2,5,61,42,103
1,461,742,185,461,646
1,1482,2384,854,1482,2336
1,461,742,147,461,608
1,755,1215,375,755,1130
1,461,742,147,461,608
1,461,742,229,461,690
6,45,120,443,270,713
2,45,120,133,90,223
3,45,120,218,135,353
1,3,9,4,3,7
24,4,10,110,96,206
28,4,10,129,112,241
19,2,5,53,38,91
21,4,10,88,84,172
22,2,5,64,44,108
14,2,5,41,28,69
20,2,5,58,40,98
19,2,5,55,38,93
14,4,10,77,56,133
18,4,10,99,72,171
24,2,5,70,48,118
20,2,5,49,40,89
2,2,5,5,4,9
27,2,5,51,54,105
11,2,5,21,22,43
10,4,10,38,40,78
18,4,10,68,72,140
13,2,5,38,26,64
5,2,5,15,10,25
15,2,5,44,30,74
8,2,5,24,16,40
1,2,5,2,2,4
14,2,5,29,28,57
8,7,9,13,56,69
25,7,9,34,175,209
23,7,9,42,161,203
21,7,9,12,147,159
2,7,9,3,14,17
27,7,9,44,189,233
23,7,9,9,161,170
22,7,9,40,154,194
13,7,9,25,91,116
16,3,8,79,48,127
14,3,8,68,42,110
16,3,8,79,48,127
29,3,8,103,87,190
21,8,22,229,168,397
2,8,22,20,16,36
22,8,22,240,176,416
1,8,22,12,8,20
3,8,22,41,24,65
28,8,22,386,224,610
23,9,24,246,207,453
16,9,24,236,144,380
17,13,35,368,221,589
23,13,35,401,299,700
12,13,35,209,156,365
15,13,35,293,195,488
7,13,35,137,91,228
10,13,35,213,130,343
16,13,35,274,208,482
18,13,35,314,234,548
9,13,35,141,117,258
14,13,35,298,182,480
23,13,35,474,299,773
30,13,35,513,390,903
26,13,35,563,338,901
20,13,35,286,260,546
17,13,35,362,221,583
22,13,35,453,286,739
14,13,35,230,182,412
13,13,35,204,169,373
18,21,55,473,378,851
3,21,55,99,63,162
20,21,55,669,420,1089
21,21,55,691,441,1132
21,38,50,242,798,1040
6,42,54,36,252,288
14,42,54,2,588,590
11,38,50,110,418,528
23,38,50,230,874,1104
14,38,50,161,532,693
27,38,50,81,1026,1107
22,42,54,216,924,1140
1,1266,2320,544,1266,1810
1,1252,2295,882,1252,2134
1,1266,2320,636,1266,1902
1,1252,2295,676,1252,1928
1,1266,2320,1008,1266,2274
1,1266,2320,799,1266,2065
1,1252,2295,791,1252,2043
1,1912,3400,740,1912,2652
1,1266,2320,1008,1266,2274
1,1252,2295,722,1252,1974
1,1252,2295,538,1252,1790
1,344,540,99,344,443
1,2171,3578,620,2171,2791
1,1555,2443,790,1555,2345
1,1555,2443,448,1555,2003
1,713,1120,172,713,885
1,344,540,174,344,518
1,2171,3578,906,2171,3077
1,2171,3578,1335,2171,3506
13,26,70,563,338,901
26,3,9,107,78,185
27,1,2,15,27,42
23,1,2,13,23,36
23,2,5,67,46,113
14,2,5,41,28,69
3,1,2,2,3,5
8,1,2,6,8,14
18,1,2,13,18,31
29,8,21,249,232,481
7,8,21,60,56,116
8,2,5,24,16,40
9,2,5,27,18,45
25,2,5,74,50,124
20,9,25,250,180,430
7,9,25,88,63,151
13,9,25,163,117,280
14,2,5,33,28,61
7,2,5,16,14,30
22,13,35,476,286,762
16,13,35,346,208,554
7,13,35,152,91,243
2,1,2,2,2,4
22,1,2,20,22,42
1,11,29,13,11,24
2,1,2,2,2,4
11,1,2,11,11,22
27,1,4,67,27,94
9,1,4,22,9,31
12,1,2,9,12,21
4,1,2,3,4,7
30,2,5,89,60,149
21,2,5,46,42,88
13,9,25,185,117,302
12,9,25,171,108,279
9,2,5,17,18,35
8,2,5,15,16,31
26,1,4,59,26,85
29,1,4,66,29,95
27,2,5,53,54,107
5,2,5,10,10,20
3,1,2,3,3,6
29,9,25,370,261,631
20,2,5,56,40,96
9,2,5,25,18,43
12,1,2,7,12,19
30,1,2,28,30,58
25,1,2,23,25,48
20,1,4,50,20,70
27,1,4,67,27,94
14,1,2,9,14,23
29,2,5,55,58,113
27,2,5,51,54,105
22,1,4,64,22,86
4,1,4,8,4,12
20,1,4,42,20,62
27,1,4,57,27,84
8,1,4,17,8,25
16,11,29,228,176,404
1,1482,2384,807,1482,2289
1,1482,2384,807,1482,2289
1,755,1215,241,755,996
1,755,1215,436,755,1191
1,1482,2384,378,1482,1860
1,461,742,229,461,690
1,461,742,147,461,608
3,24,64,112,72,184
29,2,5,86,58,144
28,2,5,83,56,139
17,3,9,82,51,133
19,3,9,92,57,149
28,4,10,165,112,277
9,4,10,53,36,89
30,2,5,63,60,123
28,2,5,59,56,115
28,2,5,53,56,109
11,2,5,21,22,43
28,2,5,78,56,134
24,2,5,70,48,118
18,2,5,52,36,88
7,2,5,13,14,27
15,3,9,68,45,113
15,3,9,68,45,113
19,2,5,56,38,94
13,2,5,38,26,64
22,2,5,64,44,108
21,2,5,61,42,103
19,2,5,45,38,83
22,2,5,52,44,96
7,2,5,15,14,29
7,2,5,15,14,29
14,3,9,66,42,108
11,2,5,27,22,49
14,2,5,34,28,62
10,2,5,29,20,49
12,2,5,35,24,59
18,7,9,15,126,141
13,7,9,21,91,112
4,7,9,2,28,30
15,7,9,2,105,107
28,7,9,23,196,219
14,7,9,8,98,106
23,7,9,44,161,205
29,7,9,40,203,243
3,7,9,6,21,27
24,3,8,93,72,165
19,3,8,71,57,128
3,3,8,10,9,19
21,3,8,102,63,165
17,8,22,156,136,292
24,8,22,267,192,459
4,8,22,54,32,86
15,8,22,157,120,277
19,8,22,262,152,414
6,9,24,89,54,143
20,9,24,295,180,475
25,13,35,410,325,735
4,13,35,71,52,123
24,13,35,377,312,689
17,13,35,297,221,518
28,13,35,489,364,853
24,13,35,436,312,748
10,13,35,157,130,287
17,13,35,332,221,553
12,13,35,235,156,391
5,21,55,159,105,264
27,21,55,562,567,1129
26,21,55,569,546,1115
23,21,55,580,483,1063
29,21,55,970,609,1579
14,21,55,461,294,755
6,42,54,69,252,321
27,38,50,27,1026,1053
11,38,50,127,418,545
11,42,54,37,462,499
1,38,50,5,38,43
13,42,54,149,546,695
21,42,54,105,882,987
25,42,54,17,1050,1067
9,42,54,89,378,467
16,42,54,80,672,752
1,1266,2320,752,1266,2018
1,420,769,249,420,669
1,420,769,211,420,631
1,1266,2320,961,1266,2227
1,1266,2320,544,1266,1810
1,1252,2295,951,1252,2203
1,1252,2295,492,1252,1744
1,1252,2295,951,1252,2203
1,1519,2443,631,1519,2150
1,1519,2443,484,1519,2003
1,344,540,174,344,518
1,344,540,185,344,529
1,1555,2443,570,1555,2125
1,2171,3578,1335,2171,3506
1,344,540,174,344,518
1,344,540,158,344,502
1,2171,3578,1335,2171,3506
23,26,70,722,598,1320
20,26,70,866,520,1386
10,26,70,342,260,602
18,26,70,779,468,1247
23,3,9,101,69,170
5,3,9,29,15,44
20,1,2,11,20,31
22,1,2,12,22,34
21,1,2,12,21,33
27,2,5,80,54,134
22,2,5,65,44,109
2,2,5,6,4,10
7,1,2,4,7,11
26,11,30,486,286,772
4,11,30,75,44,119
26,2,5,47,52,99
21,2,5,38,42,80
12,1,2,10,12,22
2,1,2,2,2,4
10,12,33,157,120,277
6,12,33,94,72,166
27,1,2,23,27,50
25,1,2,22,25,47
12,1,2,8,12,20
13,1,2,8,13,21
23,1,2,15,23,38
10,1,4,28,10,38
20,1,2,13,20,33
15,1,2,10,15,25
22,1,2,20,22,42
29,1,2,17,29,46
28,1,4,82,28,110
9,11,30,166,99,265
16,12,33,325,192,517
17,12,33,346,204,550
24,12,33,488,288,776
11,1,2,6,11,17
22,2,5,62,44,106
17,1,4,50,17,67
11,1,4,32,11,43
14,2,5,33,28,61
28,8,21,340,224,564
2,8,21,24,16,40
1,1482,2384,592,1482,2074
1,1482,2384,521,1482,2003
1,1482,2384,878,1482,2360
1,1482,2384,473,1482,1955
1,1482,2384,640,1482,2122
18,3,9,102,54,156
2,3,9,11,6,17
18,4,10,79,72,151
27,4,10,119,108,227
2,3,9,11,6,17
20,3,9,113,60,173
30,4,10,177,120,297
16,4,10,61,64,125
12,4,10,46,48,94
13,3,9,63,39,102
7,3,9,34,21,55
18,2,5,52,36,88
16,2,5,46,32,78
22,2,5,64,44,108
16,2,5,46,32,78
1,4,10,4,4,8
10,2,5,22,20,42
20,2,5,44,40,84
28,2,5,53,56,109
8,2,5,23,16,39
7,2,5,20,14,34
12,2,5,35,24,59
9,2,5,26,18,44
27,2,5,78,54,132
30,2,5,84,60,144
13,2,5,36,26,62
6,2,5,14,12,26
19,2,5,37,38,75
28,2,5,55,56,111
8,2,5,24,16,40
25,2,5,74,50,124
28,3,9,135,84,219
24,3,9,116,72,188
27,7,9,52,189,241
4,7,9,7,28,35
16,7,9,29,112,141
22,7,9,40,154,194
12,7,9,10,84,94
4,7,9,3,28,31
16,7,9,5,112,117
2,7,9,0,14,14
25,7,9,1,175,176
1,7,9,1,7,8
30,7,9,3,210,213
9,3,8,44,27,71
12,3,8,53,36,89
25,3,8,111,75,186
24,8,22,225,192,417
22,8,22,231,176,407
24,8,22,331,192,523
3,8,22,33,24,57
2,8,22,20,16,36
5,9,24,56,45,101
25,9,24,369,225,594
26,9,24,378,234,612
22,13,35,453,286,739
28,13,35,577,364,941
10,13,35,213,130,343
22,13,35,361,286,647
11,13,35,180,143,323
17,13,35,261,221,482
11,13,35,227,143,370
19,13,35,391,247,638
23,13,35,474,299,773
27,13,35,528,351,879
10,13,35,175,130,305
6,13,35,94,78,172
15,13,35,325,195,520
27,13,35,443,351,794
29,13,35,506,377,883
21,13,35,352,273,625
19,13,35,405,247,652
19,13,35,338,247,585
23,13,35,401,299,700
16,13,35,279,208,487
6,13,35,94,78,172
26,13,35,554,338,892
12,13,35,209,156,365
25,21,55,685,525,1210
5,38,50,58,190,248
20,38,50,50,760,810
6,42,54,66,252,318
4,42,54,20,168,188
9,38,50,50,342,392
16,42,54,183,672,855
24,42,54,120,1008,1128
11,42,54,55,462,517
16,42,54,157,672,829
1,42,54,11,42,53
1,1912,3400,1352,1912,3264
1,1898,3375,937,1898,2835
1,1912,3400,1046,1912,2958
1,1266,2320,752,1266,2018
1,420,769,334,420,754
1,420,769,334,420,754
1,1252,2295,745,1252,1997
1,1266,2320,892,1266,2158
1,420,769,249,420,669
1,1266,2320,636,1266,1902
1,1252,2295,997,1252,2249
1,308,565,246,308,554
1,487,783,124,487,611
1,2171,3578,942,2171,3113
1,2171,3578,942,2171,3113
1,344,540,185,344,529
1,344,540,126,344,470
1,713,1120,205,713,918
1,344,540,174,344,518
1,344,540,83,344,427
1,344,540,83,344,427
8,26,70,229,208,437
29,26,70,1235,754,1989
21,26,70,909,546,1455
17,3,9,99,51,150
27,3,9,130,81,211
24,13,35,520,312,832
25,13,35,541,325,866
12,1,2,8,12,20
21,1,2,14,21,35
6,2,5,17,12,29
30,2,5,59,60,119
27,1,2,20,27,47
2,1,2,1,2,3
8,13,35,156,104,260
17,13,35,332,221,553
26,13,35,454,338,792
18,13,35,314,234,548
6,1,4,13,6,19
3,2,5,8,6,14
6,2,5,18,12,30
6,1,2,6,6,12
18,1,2,17,18,35
5,2,5,15,10,25
19,2,5,56,38,94
11,1,4,25,11,36
30,2,5,71,60,131
5,1,2,5,5,10
13,2,5,38,26,64
4,2,5,12,8,20
30,1,2,21,30,51
10,1,2,7,10,17
3,9,25,47,27,74
6,9,25,93,54,147
4,1,2,3,4,7
20,11,29,348,220,568
8,11,29,139,88,227
8,1,4,23,8,31
9,1,4,23,9,32
27,1,4,68,27,95
16,2,5,38,32,70
2,1,2,2,2,4
5,1,4,14,5,19
20,1,4,57,20,77
7,1,4,20,7,27
19,1,4,55,19,74
2,2,5,5,4,9
12,2,5,28,24,52
8,8,21,101,64,165
23,8,21,289,184,473
13,1,2,11,13,24
3,1,2,3,3,6
22,8,21,203,176,379
9,8,21,83,72,155
1,461,742,251,461,712
1,461,742,251,461,712
1,1482,2384,807,1482,2289
1,1482,2384,592,1482,2074
1,755,1215,436,755,1191
24,24,64,929,576,1505
1,45,120,49,45,94
6,45,120,349,270,619
1,59,159,79,59,138
30,4,10,141,120,261
13,4,10,61,52,113
24,2,5,67,48,115
8,2,5,22,16,38
20,2,5,56,40,96
4,2,5,11,8,19
18,2,5,52,36,88
23,2,5,67,46,113
4,2,5,12,8,20
6,2,5,18,12,30
16,2,5,46,32,78
7,2,5,20,14,34
3,2,5,9,6,15
20,2,5,58,40,98
18,2,5,52,36,88
25,2,5,70,50,120
26,2,5,75,52,127
9,3,9,39,27,66
14,3,9,61,42,103
1,7,9,2,7,9
3,7,9,1,21,22
2,7,9,4,14,18
10,7,9,18,70,88
28,9,24,407,252,659
2,9,24,30,18,48
9,9,24,107,81,188
1,9,24,15,9,24
8,13,35,173,104,277
14,13,35,244,182,426
4,13,35,59,52,111
22,13,35,476,286,762
16,13,35,330,208,538
12,13,35,172,156,328
28,13,35,606,364,970
4,13,35,63,52,115
19,13,35,391,247,638
22,13,35,476,286,762
26,13,35,426,338,764
2,13,35,43,26,69
30,13,35,639,390,1029
27,13,35,386,351,737
29,13,35,455,377,832
22,38,50,253,836,1089
1,42,54,11,42,53
12,38,50,138,456,594
18,38,50,45,684,729
3,42,54,15,126,141
1,38,50,11,38,49
1,1898,3375,937,1898,2835
1,1266,2320,961,1266,2227
1,1252,2295,997,1252,2249
1,1555,2443,790,1555,2345
1,713,1120,385,713,1098
1,713,1120,385,713,1098
1,1555,2443,790,1555,2345
1,487,783,155,487,642
1,713,1120,250,713,963
1,713,1120,172,713,885
1,344,540,99,344,443
16,26,70,659,416,1075
1,26,70,29,26,55
20,3,9,80,60,140
5,1,2,5,5,10
7,1,2,7,7,14
10,1,2,6,10,16
1,1,2,1,1,2
12,8,21,103,96,199
29,2,5,84,58,142
16,1,2,16,16,32
7,11,30,131,77,208
29,11,30,542,319,861
8,2,5,24,16,40
29,1,2,20,29,49
11,2,5,32,22,54
19,1,2,14,19,33
11,1,2,8,11,19
10,1,2,7,10,17
18,2,5,42,36,78
8,2,5,19,16,35
3,9,25,45,27,72
29,9,25,435,261,696
26,2,5,61,52,113
20,12,33,334,240,574
23,9,25,362,207,569
4,9,25,63,36,99
1,1,4,2,1,3
19,1,4,43,19,62
27,1,4,62,27,89
4,2,5,9,8,17
22,2,5,52,44,96
20,1,2,20,20,40
10,1,2,10,10,20
29,1,2,20,29,49
7,1,2,5,7,12
4,2,5,8,8,16
16,2,5,30,32,62
8,2,5,15,16,31
30,2,5,63,60,123
10,2,5,21,20,41
28,1,2,16,28,44
14,8,21,129,112,241
9,8,21,83,72,155
10,1,2,8,10,18
16,8,21,164,128,292
11,8,21,113,88,201
15,8,21,154,120,274
1,1482,2384,592,1482,2074
1,461,742,185,461,646
1,461,742,185,461,646
1,1482,2384,807,1482,2289
1,1482,2384,473,1482,1955
1,755,1215,436,755,1191
1,1482,2384,378,1482,1860
1,461,742,162,461,623
19,24,64,711,456,1167
22,3,9,124,66,190
3,3,9,17,9,26
14,2,5,27,28,55
17,4,10,95,68,163
3,2,5,9,6,15
9,2,5,27,18,45
23,4,10,136,92,228
2,2,5,4,4,8
9,2,5,18,18,36
10,2,5,29,20,49
20,2,5,58,40,98
19,2,5,36,38,74
7,2,5,13,14,27
11,2,5,32,22,54
16,2,5,46,32,78
8,2,5,15,16,31
13,2,5,38,26,64
30,2,5,89,60,149
22,2,5,58,44,102
23,2,5,61,46,107
27,3,9,160,81,241
18,3,9,106,54,160
8,2,5,19,16,35
28,2,5,66,56,122
13,7,9,1,91,92
22,7,9,20,154,174
24,7,9,39,168,207
25,7,9,41,175,216
18,7,9,33,126,159
25,7,9,48,175,223
12,7,9,10,84,94
30,7,9,55,210,265
17,7,9,31,119,150
12,7,9,0,84,84
18,3,8,87,54,141
21,3,8,68,63,131
2,3,8,10,6,16
27,8,22,372,216,588
19,8,22,258,152,410
15,8,22,203,120,323
21,8,22,239,168,407
18,8,22,248,144,392
30,8,22,275,240,515
11,8,22,152,88,240
29,8,22,400,232,632
18,8,22,248,144,392
29,8,22,400,232,632
23,9,24,339,207,546
10,9,24,148,90,238
27,9,24,399,243,642
1,9,24,15,9,24
10,9,24,145,90,235
19,9,24,276,171,447
21,9,24,305,189,494
9,13,35,195,117,312
15,13,35,215,195,410
27,13,35,424,351,775
10,13,35,206,130,336
25,13,35,419,325,744
4,13,35,54,52,106
20,13,35,426,260,686
5,13,35,107,65,172
18,13,35,383,234,617
14,13,35,298,182,480
11,13,35,157,143,300
16,13,35,341,208,549
3,13,35,64,39,103
27,13,35,575,351,926
9,13,35,192,117,309
4,13,35,71,52,123
12,13,35,256,156,412
9,13,35,192,117,309
25,42,54,287,1050,1337
26,42,54,3,1092,1095
6,42,54,69,252,321
13,38,50,143,494,637
23,42,54,115,966,1081
6,38,50,69,228,297
22,42,54,216,924,1140
30,38,50,30,1140,1170
10,42,54,109,420,529
28,42,54,306,1176,1482
23,42,54,189,966,1155
7,42,54,76,294,370
1,1252,2295,630,1252,1882
1,308,565,172,308,480
1,1252,2295,997,1252,2249
1,1252,2295,630,1252,1882
1,1266,2320,1008,1266,2274
1,1266,2320,752,1266,2018
1,1266,2320,1031,1266,2297
1,420,769,249,420,669
1,308,565,189,308,497
1,344,540,185,344,529
1,487,783,124,487,611
1,344,540,185,344,529
1,2171,3578,942,2171,3113
1,1083,1701,244,1083,1327
1,713,1120,340,713,1053
1,487,783,265,487,752
1,344,540,185,344,529
1,344,540,185,344,529
1,344,540,158,344,502
1,344,540,185,344,529
1,344,540,66,344,410
1,1555,2443,864,1555,2419
1,2171,3578,1335,2171,3506
1,3,9,6,3,9
20,2,5,58,40,98
26,13,35,554,338,892
9,13,35,192,117,309
7,2,5,21,14,35
6,2,5,18,12,30
21,2,5,49,42,91
15,2,5,44,30,74
13,2,5,38,26,64
19,2,5,53,38,91
30,1,2,26,30,56
1,1,2,1,1,2
18,1,2,13,18,31
23,13,35,361,299,660
30,13,35,471,390,861
18,13,35,283,234,517
26,1,2,25,26,51
28,1,2,27,28,55
20,1,2,19,20,39
13,1,2,12,13,25
15,1,2,14,15,29
18,1,2,17,18,35
22,1,2,12,22,34
21,9,25,315,189,504
22,9,25,330,198,528
17,1,2,15,17,32
23,1,2,20,23,43
10,1,2,9,10,19
14,12,33,220,168,388
15,12,33,211,180,391
13,12,33,183,156,339
26,1,2,19,26,45
17,2,5,49,34,83
2,1,4,6,2,8
16,1,4,47,16,63
20,1,4,58,20,78
24,2,5,70,48,118
21,1,2,21,21,42
1,11,30,15,11,26
24,11,30,362,264,626
29,11,30,438,319,757
25,1,2,24,25,49
18,1,2,17,18,35
21,1,2,20,21,41
13,8,21,112,104,216
5,8,21,43,40,83
16,8,21,137,128,265
14,1,2,14,14,28
5,11,29,64,55,119
25,11,29,320,275,595
22,1,4,64,22,86
14,2,5,41,28,69
7,2,5,20,14,34
12,1,2,12,12,24
6,1,4,18,6,24
7,1,4,20,7,27
1,1482,2384,807,1482,2289
1,1482,2384,807,1482,2289
1,461,742,125,461,586
4,24,64,157,96,253
4,24,64,155,96,251
11,2,5,31,22,53
3,2,5,8,6,14
25,2,5,66,50,116
8,2,5,15,16,31
30,2,5,87,60,147
27,2,5,78,54,132
15,2,5,44,30,74
6,4,10,35,24,59
30,2,5,66,60,126
13,3,9,52,39,91
9,3,9,43,27,70
16,3,9,76,48,124
29,3,9,171,87,258
8,3,9,47,24,71
22,3,9,100,66,166
23,3,9,105,69,174
18,4,10,70,72,142
6,4,10,23,24,47
13,7,9,21,91,112
3,7,9,5,21,26
2,7,9,1,14,15
8,7,9,6,56,62
23,7,9,0,161,161
23,7,9,17,161,178
22,7,9,0,154,154
1,7,9,0,7,7
8,7,9,1,56,57
26,3,8,126,78,204
16,8,22,178,128,306
2,8,22,22,16,38
29,8,22,317,232,549
27,8,22,354,216,570
29,9,24,324,261,585
19,9,24,221,171,392
18,9,24,214,162,376
19,13,35,312,247,559
1,13,35,20,13,33
9,13,35,185,117,302
19,13,35,391,247,638
18,13,35,383,234,617
1,13,35,21,13,34
28,13,35,479,364,843
11,13,35,238,143,381
24,13,35,419,312,731
12,13,35,247,156,403
24,13,35,511,312,823
11,13,35,192,143,335
22,13,35,469,286,755
30,13,35,513,390,903
1,13,35,21,13,34
2,21,55,64,42,106
13,21,55,428,273,701
16,21,55,526,336,862
16,21,55,535,336,871
4,42,54,20,168,188
17,42,54,186,714,900
11,42,54,120,462,582
1,38,50,11,38,49
3,42,54,30,126,156
30,38,50,150,1140,1290
24,38,50,96,912,1008
25,42,54,111,1050,1161
25,42,54,125,1050,1175
16,42,54,80,672,752
20,42,54,13,840,853
1,1252,2295,1020,1252,2272
1,1266,2320,961,1266,2227
1,1266,2320,544,1266,1810
1,308,565,234,308,542
1,1252,2295,951,1252,2203
1,1266,2320,1008,1266,2274
1,2171,3578,942,2171,3113
1,713,1120,362,713,1075
1,713,1120,172,713,885
1,487,783,194,487,681
1,344,540,126,344,470
1,2171,3578,1335,2171,3506
22,26,70,937,572,1509
15,26,70,639,390,1029
3,26,70,130,78,208
17,3,9,100,51,151
18,9,25,284,162,446
17,1,2,15,17,32
21,1,2,20,21,41
27,1,2,26,27,53
26,9,25,332,234,566
9,9,25,115,81,196
19,1,2,12,19,31
13,1,2,8,13,21
9,1,2,6,9,15
23,1,2,22,23,45
12,1,2,12,12,24
23,1,2,17,23,40
27,1,2,20,27,47
22,12,33,433,264,697
28,12,33,551,336,887
4,2,5,12,8,20
1,11,30,19,11,30
12,11,30,224,132,356
16,2,5,47,32,79
8,1,2,5,8,13
2,1,2,1,2,3
12,1,2,8,12,20
12,1,2,12,12,24
24,1,2,23,24,47
10,2,5,21,20,41
16,2,5,34,32,66
21,2,5,49,42,91
16,1,2,15,16,31
27,8,21,277,216,493
30,8,21,308,240,548
25,8,21,257,200,457
12,2,5,35,24,59
14,2,5,41,28,69
30,1,2,29,30,59
26,1,2,25,26,51
1,2,5,2,2,4
20,11,29,238,220,458
4,1,2,4,4,8
28,1,2,26,28,54
22,12,33,360,264,624
6,12,33,98,72,170
14,2,5,33,28,61
1,1,2,1,1,2
30,1,2,22,30,52
26,2,5,75,52,127
21,2,5,61,42,103
19,2,5,55,38,93
23,2,5,67,46,113
21,2,5,61,42,103
6,2,5,17,12,29
21,8,21,211,168,379
18,8,21,181,144,325
25,1,2,14,25,39
24,1,4,60,24,84
14,1,4,35,14,49
1,1,4,2,1,3
1,1482,2384,735,1482,2217
1,755,1215,411,755,1166
1,1482,2384,878,1482,2360
1,1482,2384,854,1482,2336
1,461,742,177,461,638
1,1482,2384,807,1482,2289
19,24,64,711,456,1167
9,24,64,348,216,564
8,24,64,310,192,502
8,45,120,398,360,758
5,59,159,397,295,692
25,2,5,59,50,109
19,2,5,45,38,83
19,2,5,53,38,91
3,2,5,8,6,14
26,2,5,73,52,125
16,3,9,93,48,141
25,3,9,146,75,221
6,2,5,17,12,29
24,2,5,56,48,104
13,2,5,38,26,64
7,2,5,20,14,34
25,3,9,148,75,223
4,3,9,24,12,36
24,2,5,46,48,94
5,2,5,10,10,20
15,4,10,57,60,117
14,3,9,79,42,121
11,3,9,62,33,95
25,3,9,119,75,194
14,3,9,66,42,108
24,3,9,135,72,207
23,3,9,130,69,199
12,2,5,28,24,52
9,2,5,21,18,39
1,2,5,3,2,5
7,2,5,20,14,34
2,7,9,0,14,14
19,7,9,14,133,147
24,7,9,33,168,201
16,7,9,26,112,138
21,7,9,34,147,181
6,7,9,11,42,53
14,7,9,25,98,123
11,7,9,9,77,86
20,7,9,36,140,176
8,7,9,15,56,71
25,7,9,21,175,196
30,3,8,119,90,209
16,8,22,199,128,327
4,8,22,38,32,70
30,8,22,328,240,568
23,8,22,251,184,435
22,8,22,202,176,378
15,8,22,207,120,327
19,8,22,262,152,414
16,9,24,225,144,369
14,9,24,156,126,282
15,9,24,149,135,284
14,9,24,156,126,282
17,9,24,202,153,355
14,13,35,230,182,412
2,13,35,29,26,55
8,13,35,173,104,277
22,13,35,476,286,762
26,13,35,372,338,710
2,13,35,41,26,67
16,13,35,330,208,538
13,13,35,268,169,437
2,13,35,39,26,65
5,13,35,107,65,172
5,13,35,103,65,168
4,13,35,87,52,139
7,13,35,144,91,235
3,13,35,47,39,86
27,13,35,443,351,794
8,13,35,156,104,260
15,13,35,257,195,452
19,21,55,416,399,815
30,21,55,987,630,1617
2,38,50,10,76,86
23,38,50,265,874,1139
30,38,50,30,1140,1170
30,42,54,344,1260,1604
22,38,50,121,836,957
15,38,50,75,570,645
14,38,50,140,532,672
8,42,54,40,336,376
1,1252,2295,538,1252,1790
1,1912,3400,1046,1912,2958
1,1912,3400,774,1912,2686
1,1912,3400,774,1912,2686
1,1252,2295,722,1252,1974
1,1252,2295,997,1252,2249
1,1252,2295,722,1252,1974
1,1266,2320,961,1266,2227
1,1252,2295,1020,1252,2272
1,308,565,234,308,542
1,308,565,234,308,542
1,1252,2295,882,1252,2134
1,2171,3578,620,2171,2791
1,2171,3578,1335,2171,3506
1,713,1120,205,713,918
1,487,783,280,487,767
1,1555,2443,790,1555,2345
1,1555,2443,790,1555,2345
1,1519,2443,753,1519,2272
1,487,783,265,487,752
1,713,1120,161,713,874
1,344,540,174,344,518
1,344,540,191,344,535
1,344,540,126,344,470
1,487,783,194,487,681
1,344,540,174,344,518
1,344,540,126,344,470
15,26,70,618,390,1008
21,26,70,895,546,1441
2,1,4,4,2,6
8,1,4,17,8,25
21,1,2,19,21,40
26,1,2,24,26,50
17,1,2,17,17,34
5,13,35,107,65,172
20,13,35,426,260,686
20,1,2,19,20,39
4,12,33,67,48,115
10,1,4,24,10,34
4,1,4,9,4,13
5,1,2,5,5,10
23,1,2,21,23,44
4,2,5,12,8,20
29,1,2,27,29,56
3,2,5,9,6,15
28,2,5,83,56,139
14,1,4,40,14,54
9,1,4,26,9,35
11,2,5,23,22,45
28,8,21,340,224,564
6,8,21,73,48,121
17,1,4,48,17,65
1,1,4,3,1,4
18,1,4,51,18,69
21,11,30,317,231,548
12,12,33,165,144,309
16,1,2,9,16,25
24,1,2,15,24,39
29,2,5,84,58,142
28,1,4,68,28,96
25,1,4,61,25,86
5,1,4,14,5,19
27,1,4,73,27,100
1,1482,2384,521,1482,2003
1,755,1215,266,755,1021
1,1482,2384,878,1482,2360
1,755,1215,302,755,1057
1,461,742,125,461,586
1,1482,2384,735,1482,2217
1,461,742,177,461,638
1,755,1215,302,755,1057
1,1482,2384,854,1482,2336
1,461,742,185,461,646
29,24,64,770,696,1466
10,24,64,394,240,634
6,3,9,26,18,44
1,3,9,4,3,7
18,4,10,85,72,157
9,4,10,42,36,78
28,2,5,78,56,134
3,3,9,12,9,21
1,3,9,4,3,7
30,3,9,137,90,227
20,3,9,91,60,151
13,2,5,27,26,53
16,2,5,34,32,66
5,2,5,15,10,25
1,2,5,3,2,5
6,2,5,17,12,29
14,2,5,39,28,67
5,2,5,14,10,24
20,2,5,56,40,96
4,2,5,12,8,20
16,2,5,46,32,78
5,2,5,15,10,25
18,4,10,104,72,176
12,4,10,70,48,118
20,4,10,116,80,196
20,4,10,116,80,196
23,4,10,133,92,225
22,4,10,128,88,216
4,2,5,8,8,16
26,2,5,55,52,107
24,2,5,54,48,102
4,2,5,9,8,17
14,2,5,39,28,67
16,3,9,66,48,114
7,2,5,20,14,34
1,2,5,3,2,5
13,7,9,25,91,116
27,7,9,49,189,238
4,7,9,7,28,35
23,7,9,44,161,205
22,7,9,40,154,194
2,7,9,3,14,17
14,7,9,25,98,123
6,7,9,2,42,44
3,7,9,5,21,26
20,7,9,15,140,155
2,7,9,3,14,17
2,7,9,2,14,16
29,7,9,53,203,256
19,3,8,68,57,125
16,3,8,61,48,109
12,8,22,110,96,206
1,9,24,15,9,24
23,9,24,273,207,480
3,13,35,62,39,101
16,13,35,341,208,549
22,13,35,453,286,739
28,13,35,440,364,804
9,13,35,157,117,274
15,13,35,309,195,504
3,13,35,62,39,101
21,13,35,447,273,720
3,13,35,64,39,103
18,13,35,264,234,498
21,13,35,433,273,706
9,13,35,148,117,265
13,13,35,227,169,396
10,13,35,175,130,305
10,13,35,217,130,347
13,13,35,190,169,359
4,42,54,46,168,214
15,38,50,165,570,735
2,38,50,23,76,99
1,38,50,1,38,39
24,38,50,132,912,1044
28,42,54,306,1176,1482
15,42,54,164,630,794
25,38,50,250,950,1200
8,38,50,24,304,328
1,1266,2320,752,1266,2018
1,1252,2295,997,1252,2249
1,1252,2295,1020,1252,2272
1,295,540,148,295,443
1,1266,2320,961,1266,2227
1,1266,2320,567,1266,1833
1,1266,2320,636,1266,1902
1,2171,3578,1371,2171,3542
1,713,1120,385,713,1098
1,713,1120,385,713,1098
1,1519,2443,484,1519,2003
1,1519,2443,826,1519,2345
1,344,540,185,344,529
1,1555,2443,570,1555,2125
1,1083,1701,363,1083,1446
1,344,540,66,344,410
1,344,540,185,344,529
1,713,1120,261,713,974
1,487,783,132,487,619
1,2171,3578,1335,2171,3506
1,344,540,83,344,427
1,2171,3578,656,2171,2827
3,26,70,130,78,208
17,26,70,581,442,1023
27,2,5,78,54,132
17,2,5,49,34,83
10,13,35,147,130,277
30,1,2,29,30,59
11,13,35,238,143,381
9,13,35,195,117,312
22,1,2,21,22,43
2,13,35,43,26,69
13,13,35,277,169,446
30,1,2,29,30,59
26,1,2,25,26,51
15,1,2,14,15,29
16,9,25,172,144,316
30,1,2,19,30,49
6,1,2,4,6,10
8,1,2,7,8,15
18,1,2,17,18,35
20,1,2,12,20,32
17,1,2,10,17,27
12,2,5,22,24,46
29,2,5,52,58,110
4,2,5,9,8,17
10,2,5,24,20,44
6,11,29,105,66,171
8,11,29,139,88,227
1,2,5,2,2,4
12,2,5,23,24,47
30,2,5,57,60,117
18,8,21,226,144,370
13,1,4,32,13,45
17,1,4,41,17,58
10,2,5,24,20,44
30,2,5,71,60,131
6,2,5,14,12,26
1,1482,2384,473,1482,1955
1,1482,2384,521,1482,2003
1,755,1215,205,755,960
1,1482,2384,807,1482,2289
1,755,1215,436,755,1191
1,1482,2384,854,1482,2336
1,1482,2384,807,1482,2289
8,24,64,310,192,502
5,59,159,397,295,692
24,2,5,71,48,119
22,2,5,65,44,109
26,2,5,73,52,125
20,2,5,56,40,96
24,2,5,70,48,118
13,3,9,70,39,109
8,3,9,43,24,67
1,2,5,3,2,5
25,2,5,66,50,116
7,3,9,41,21,62
4,3,9,23,12,35
20,3,9,91,60,151
24,3,9,109,72,181
30,3,9,121,90,211
11,3,9,44,33,77
24,2,5,56,48,104
2,2,5,5,4,9
26,3,9,114,78,192
10,3,9,44,30,74
7,2,5,15,14,29
9,2,5,19,18,37
28,2,5,78,56,134
8,2,5,22,16,38
24,2,5,67,48,115
2,7,9,3,14,17
3,7,9,2,21,23
19,7,9,19,133,152
19,7,9,16,133,149
2,3,8,8,6,14
6,3,8,30,18,48
20,3,8,74,60,134
10,3,8,40,30,70
18,3,8,89,54,143
14,3,8,66,42,108
18,8,22,197,144,341
13,8,22,142,104,246
7,8,22,76,56,132
1,8,22,14,8,22
1,8,22,13,8,21
11,8,22,152,88,240
19,8,22,262,152,414
2,9,24,29,18,47
20,9,24,290,180,470
29,13,35,425,377,802
27,13,35,462,351,813
1,13,35,21,13,34
21,13,35,433,273,706
23,13,35,401,299,700
23,13,35,474,299,773
19,13,35,405,247,652
18,13,35,283,234,517
28,13,35,410,364,774
21,13,35,359,273,632
6,13,35,130,78,208
16,13,35,290,208,498
9,13,35,141,117,258
10,13,35,213,130,343
19,13,35,272,247,519
19,13,35,272,247,519
2,13,35,31,26,57
21,13,35,300,273,573
7,13,35,120,91,211
3,38,50,17,114,131
2,38,50,23,76,99
17,42,54,75,714,789
17,38,50,145,646,791
26,38,50,299,988,1287
15,42,54,148,630,778
1,38,50,7,38,45
1,1266,2320,636,1266,1902
1,420,769,295,420,715
1,1252,2295,951,1252,2203
1,1252,2295,951,1252,2203
1,295,540,126,295,421
1,308,565,246,308,554
1,487,783,186,487,673
1,713,1120,329,713,1042
1,1083,1701,550,1083,1633
1,1083,1701,499,1083,1582
1,487,783,288,487,775
1,1555,2443,497,1555,2052
1,713,1120,205,713,918
1,713,1120,205,713,918
19,26,70,809,494,1303
30,26,70,1299,780,2079
18,3,9,102,54,156
11,1,2,6,11,17
9,2,5,27,18,45
3,2,5,9,6,15
9,2,5,27,18,45
4,2,5,12,8,20
14,2,5,41,28,69
9,11,29,128,99,227
6,11,29,85,66,151
8,11,29,114,88,202
7,2,5,14,14,28
26,2,5,51,52,103
2,9,25,22,18,40
4,1,2,4,4,8
15,2,5,29,30,59
5,2,5,10,10,20
28,1,2,27,28,55
24,1,2,24,24,48
12,1,2,12,12,24
30,2,5,84,60,144
4,12,33,60,48,108
5,12,33,75,60,135
28,11,30,440,308,748
24,11,30,377,264,641
25,1,4,73,25,98
4,1,2,2,4,6
19,1,2,11,19,30
6,1,2,3,6,9
21,1,2,20,21,41
19,1,2,18,19,37
23,1,4,67,23,90
3,1,4,9,3,12
13,2,5,30,26,56
4,1,2,3,4,7
25,1,2,18,25,43
27,2,5,63,54,117
10,1,4,29,10,39
26,1,4,76,26,102
22,1,2,15,22,37
1,1482,2384,401,1482,1883
1,1482,2384,807,1482,2289
1,461,742,185,461,646
1,461,742,118,461,579
27,2,5,53,54,107
15,2,5,29,30,59
11,2,5,32,22,54
1,2,5,3,2,5
17,2,5,32,34,66
12,2,5,35,24,59
18,4,10,70,72,142
3,4,10,12,12,24
8,2,5,24,16,40
16,2,5,47,32,79
16,2,5,34,32,66
23,2,5,48,46,94
26,3,9,119,78,197
6,3,9,27,18,45
3,3,9,14,9,23
18,2,5,35,36,71
19,2,5,37,38,75
4,2,5,12,8,20
4,2,5,8,8,16
18,2,5,41,36,77
7,2,5,16,14,30
27,4,10,103,108,211
17,3,9,91,51,142
22,3,9,118,66,184
30,3,9,121,90,211
15,3,9,60,45,105
15,7,9,29,105,134
18,7,9,2,126,128
24,7,9,0,168,168
16,3,8,77,48,125
10,3,8,49,30,79
26,8,22,358,208,566
13,8,22,142,104,246
13,8,22,119,104,223
3,8,22,41,24,65
23,8,22,241,184,425
24,8,22,331,192,523
16,8,22,178,128,306
26,9,24,290,234,524
14,9,24,197,126,323
5,9,24,53,45,98
25,13,35,410,325,735
17,13,35,267,221,488
12,13,35,188,156,344
18,13,35,257,234,491
5,13,35,77,65,142
6,13,35,103,78,181
3,13,35,44,39,83
26,13,35,536,338,874
16,13,35,346,208,554
30,13,35,650,390,1040
4,13,35,59,52,111
1,13,35,17,13,30
19,13,35,325,247,572
2,13,35,35,26,61
19,21,55,636,399,1035
14,21,55,468,294,762
17,21,55,456,357,813
9,21,55,271,189,460
15,38,50,128,570,698
14,38,50,161,532,693
30,38,50,300,1140,1440
7,38,50,81,266,347
28,38,50,84,1064,1148
28,42,54,139,1176,1315
17,42,54,11,714,725
24,42,54,197,1008,1205
1,1252,2295,1020,1252,2272
1,1252,2295,997,1252,2249
1,1266,2320,544,1266,1810
1,1252,2295,722,1252,1974
1,1266,2320,729,1266,1995
1,1252,2295,745,1252,1997
1,308,565,251,308,559
1,308,565,251,308,559
1,295,540,126,295,421
1,1266,2320,636,1266,1902
1,1252,2295,630,1252,1882
1,344,540,185,344,529
1,344,540,77,344,421
1,344,540,158,344,502
1,344,540,83,344,427
1,487,783,194,487,681
1,344,540,174,344,518
19,3,9,90,57,147
5,3,9,28,15,43
24,3,9,116,72,188
16,1,2,9,16,25
4,1,2,2,4,6
22,1,2,22,22,44
21,1,2,21,21,42
23,2,5,45,46,91
26,2,5,77,52,129
21,2,5,62,42,104
27,2,5,80,54,134
26,11,29,438,286,724
27,11,29,455,297,752
28,12,33,422,336,758
23,2,5,47,46,93
7,2,5,14,14,28
21,2,5,59,42,101
30,2,5,59,60,119
23,2,5,45,46,91
27,2,5,51,54,105
14,2,5,27,28,55
24,1,4,68,24,92
1,1,2,1,1,2
8,1,2,7,8,15
10,1,2,9,10,19
17,1,2,16,17,33
10,1,2,9,10,19
25,2,5,74,50,124
23,2,5,68,46,114
26,2,5,77,52,129
29,1,2,28,29,57
21,1,2,21,21,42
10,1,2,7,10,17
28,11,30,498,308,806
10,8,21,92,80,172
28,8,21,258,224,482
23,8,21,231,184,415
7,8,21,70,56,126
25,2,5,59,50,109
12,2,5,28,24,52
26,9,25,332,234,566
23,9,25,293,207,500
20,2,5,53,40,93
14,2,5,37,28,65
3,1,2,2,3,5
3,1,2,2,3,5
5,1,2,4,5,9
24,1,2,13,24,37
20,1,2,11,20,31
2,2,5,4,4,8
28,2,5,59,56,115
19,1,4,55,19,74
15,1,4,44,15,59
2,2,5,5,4,9
19,2,5,45,38,83
1,1,4,2,1,3
9,1,2,9,9,18
22,1,2,21,22,43
4,1,2,4,4,8
20,2,5,53,40,93
18,8,21,219,144,363
29,8,21,353,232,585
1,1482,2384,521,1482,2003
1,1482,2384,401,1482,1883
1,1482,2384,378,1482,1860
1,755,1215,241,755,996
1,1482,2384,568,1482,2050
3,24,64,95,72,167
6,24,64,236,144,380
23,24,64,817,552,1369
6,3,9,34,18,52
5,3,9,28,15,43
18,2,5,53,36,89
15,2,5,44,30,74
2,4,10,12,8,20
8,4,10,45,32,77
7,4,10,39,28,67
30,4,10,174,120,294
15,4,10,87,60,147
4,2,5,11,8,19
14,2,5,39,28,67
24,2,5,71,48,119
2,2,5,6,4,10
17,2,5,31,34,65
7,2,5,13,14,27
17,2,5,40,34,74
12,2,5,28,24,52
27,2,5,59,54,113
9,2,5,20,18,38
4,2,5,9,8,17
17,2,5,40,34,74
2,2,5,6,4,10
3,2,5,9,6,15
18,3,9,72,54,126
1,3,9,4,3,7
21,7,9,34,147,181
2,7,9,3,14,17
14,7,9,8,98,106
22,8,22,298,176,474
9,8,22,122,72,194
11,8,22,152,88,240
14,8,22,193,112,305
15,9,24,149,135,284
23,9,24,224,207,431
10,13,35,164,130,294
28,13,35,606,364,970
4,13,35,68,52,120
8,13,35,131,104,235
3,13,35,65,39,104
26,13,35,554,338,892
10,13,35,175,130,305
12,13,35,172,156,328
10,21,55,252,210,462
21,38,50,63,798,861
25,42,54,111,1050,1161
1,38,50,2,38,40
2,38,50,2,76,78
13,42,54,58,546,604
29,42,54,97,1218,1315
1,1266,2320,683,1266,1949
1,1266,2320,752,1266,2018
1,1266,2320,544,1266,1810
1,1266,2320,961,1266,2227
1,420,769,318,420,738
1,1266,2320,961,1266,2227
1,1266,2320,961,1266,2227
1,308,565,251,308,559
1,1252,2295,722,1252,1974
1,487,783,124,487,611
1,1519,2443,826,1519,2345
1,2171,3578,835,2171,3006
1,1555,2443,302,1555,1857
1,713,1120,205,713,918
1,344,540,120,344,464
1,2171,3578,835,2171,3006
6,26,70,205,156,361
25,26,70,1030,650,1680
3,26,70,103,78,181
10,26,70,356,260,616
20,3,9,116,60,176
3,8,21,38,24,62
7,8,21,88,56,144
6,1,2,6,6,12
15,11,30,281,165,446
12,11,30,224,132,356
15,11,30,281,165,446
6,2,5,17,12,29
27,2,5,62,54,116
3,2,5,7,6,13
13,1,2,9,13,22
6,2,5,18,12,30
30,1,4,74,30,104
3,12,33,50,36,86
21,12,33,351,252,603
12,9,25,156,108,264
18,9,25,234,162,396
26,9,25,338,234,572
21,12,33,330,252,582
11,2,5,32,22,54
4,2,5,12,8,20
27,1,2,26,27,53
21,1,4,60,21,81
15,1,2,10,15,25
25,1,2,17,25,42
12,2,5,35,24,59
19,2,5,55,38,93
7,2,5,20,14,34
17,2,5,40,34,74
15,8,21,151,120,271
17,8,21,171,136,307
29,2,5,68,58,126
10,1,4,24,10,34
14,1,4,34,14,48
11,1,4,27,11,38
9,1,4,22,9,31
30,1,4,73,30,103
1,1482,2384,521,1482,2003
1,1482,2384,807,1482,2289
1,1482,2384,854,1482,2336
1,461,742,266,461,727
30,45,120,2178,1350,3528
4,3,9,16,12,28
22,3,9,90,66,156
7,2,5,13,14,27
8,2,5,15,16,31
27,4,10,159,108,267
30,4,10,177,120,297
16,4,10,94,64,158
20,2,5,56,40,96
28,2,5,78,56,134
6,2,5,18,12,30
11,2,5,32,22,54
29,2,5,84,58,142
28,2,5,81,56,137
12,2,5,34,24,58
5,2,5,14,10,24
30,2,5,57,60,117
4,2,5,12,8,20
6,2,5,17,12,29
15,2,5,44,30,74
1,2,5,3,2,5
21,3,9,122,63,185
30,3,9,175,90,265
30,2,5,69,60,129
27,2,5,55,54,109
15,2,5,31,30,61
4,2,5,11,8,19
14,2,5,39,28,67
15,2,5,35,30,65
4,2,5,9,8,17
30,3,9,137,90,227
4,7,9,8,28,36
21,7,9,16,147,163
23,7,9,9,161,170
29,7,9,8,203,211
26,7,9,43,182,225
19,7,9,7,133,140
19,7,9,11,133,144
26,3,8,126,78,204
10,3,8,36,30,66
23,8,22,216,184,400
20,8,22,271,160,431
23,8,22,317,184,501
28,8,22,380,224,604
30,8,22,407,240,647
14,8,22,156,112,268
28,8,22,386,224,610
22,9,24,325,198,523
17,9,24,251,153,404
9,9,24,105,81,186
29,9,24,324,261,585
16,13,35,330,208,538
4,13,35,59,52,111
22,13,35,476,286,762
28,13,35,410,364,774
25,13,35,515,325,840
7,13,35,95,91,186
9,13,35,157,117,274
23,13,35,498,299,797
1,13,35,17,13,30
18,13,35,295,234,529
30,13,35,639,390,1029
11,13,35,180,143,323
12,13,35,176,156,332
30,13,35,513,390,903
18,13,35,383,234,617
21,13,35,447,273,720
5,13,35,82,65,147
13,21,55,328,273,601
27,38,50,311,1026,1337
28,42,54,18,1176,1194
5,42,54,11,210,221
24,38,50,240,912,1152
17,38,50,196,646,842
21,38,50,105,798,903
25,42,54,111,1050,1161
4,38,50,16,152,168
6,42,54,1,252,253
12,38,50,36,456,492
25,38,50,275,950,1225
1,1898,3375,768,1898,2666
1,420,769,334,420,754
1,1252,2295,997,1252,2249
1,1266,2320,1008,1266,2274
1,1519,2443,875,1519,2394
1,1083,1701,210,1083,1293
1,2171,3578,835,2171,3006
1,487,783,265,487,752
1,2171,3578,656,2171,2827
1,713,1120,329,713,1042
1,344,540,185,344,529
1,344,540,77,344,421
1,344,540,93,344,437
6,26,70,205,156,361
4,26,70,170,104,274
4,26,70,170,104,274
4,26,70,137,104,241
24,3,9,105,72,177
30,3,9,142,90,232
29,3,9,156,87,243
24,13,35,511,312,823
22,13,35,469,286,755
12,13,35,205,156,361
14,13,35,239,182,421
4,1,2,4,4,8
27,1,2,26,27,53
7,13,35,149,91,240
22,13,35,469,286,755
17,13,35,362,221,583
3,13,35,65,39,104
20,1,2,15,20,35
3,1,2,2,3,5
20,1,2,19,20,39
8,1,2,5,8,13
22,1,2,13,22,35
13,1,2,8,13,21
16,2,5,35,32,67
5,2,5,10,10,20
15,2,5,29,30,59
24,2,5,47,48,95
3,1,4,7,3,10
29,1,4,72,29,101
10,1,4,25,10,35
15,1,4,35,15,50
16,1,4,38,16,54
2,1,4,6,2,8
14,1,2,14,14,28
8,1,2,8,8,16
15,1,2,11,15,26
22,1,2,16,22,38
10,9,25,150,90,240
22,9,25,330,198,528
6,1,4,14,6,20
8,1,4,18,8,26
19,1,4,43,19,62
6,1,2,6,6,12
27,8,21,249,216,465
8,2,5,15,16,31
17,2,5,32,34,66
24,2,5,46,48,94
22,1,2,16,22,38
18,1,2,17,18,35
18,1,2,17,18,35
22,8,21,203,176,379
21,1,2,21,21,42
23,1,2,22,23,45
13,1,2,12,13,25
29,1,4,85,29,114
20,2,5,56,40,96
4,2,5,11,8,19
25,2,5,70,50,120
1,1482,2384,807,1482,2289
1,1482,2384,854,1482,2336
1,755,1215,205,755,960
1,461,742,125,461,586
1,1482,2384,521,1482,2003
4,24,64,155,96,251
13,24,64,345,312,657
3,59,159,214,177,391
7,59,159,522,413,935
24,2,5,46,48,94
18,2,5,50,36,86
28,2,5,55,56,111
14,2,5,27,28,55
30,2,5,89,60,149
2,2,5,6,4,10
8,2,5,16,16,32
21,2,5,43,42,85
3,2,5,8,6,14
25,3,9,141,75,216
4,2,5,9,8,17
13,4,10,60,52,112
3,4,10,14,12,26
7,2,5,19,14,33
18,2,5,53,36,89
17,2,5,50,34,84
12,2,5,35,24,59
19,2,5,36,38,74
5,7,9,10,35,45
18,7,9,33,126,159
19,7,9,26,133,159
11,7,9,18,77,95
20,7,9,11,140,151
25,7,9,41,175,216
10,7,9,4,70,74
14,7,9,19,98,117
11,3,8,54,33,87
5,8,22,49,40,89
7,8,22,95,56,151
29,8,22,266,232,498
19,8,22,237,152,389
25,9,24,249,225,474
29,9,24,421,261,682
5,9,24,73,45,118
16,13,35,246,208,454
18,13,35,295,234,529
25,13,35,498,325,823
18,13,35,295,234,529
20,13,35,391,260,651
29,13,35,597,377,974
17,13,35,368,221,589
13,13,35,277,169,446
27,13,35,556,351,907
21,13,35,455,273,728
24,13,35,494,312,806
11,13,35,157,143,300
1,13,35,14,13,27
27,13,35,575,351,926
15,13,35,220,195,415
16,13,35,229,208,437
21,13,35,330,273,603
17,13,35,243,221,464
10,13,35,196,130,326
7,13,35,144,91,235
13,13,35,222,169,391
26,42,54,17,1092,1109
3,38,50,33,114,147
8,38,50,24,304,328
22,42,54,15,924,939
22,42,54,50,924,974
12,42,54,53,504,557
18,42,54,90,756,846
10,38,50,30,380,410
1,1912,3400,944,1912,2856
1,1252,2295,538,1252,1790
1,1252,2295,951,1252,2203
1,1252,2295,676,1252,1928
1,1252,2295,607,1252,1859
1,420,769,188,420,608
1,1252,2295,951,1252,2203
1,308,565,223,308,531
1,1252,2295,882,1252,2134
1,1252,2295,951,1252,2203
1,1252,2295,997,1252,2249
1,2171,3578,763,2171,2934
1,1519,2443,875,1519,2394
1,1083,1701,312,1083,1395
1,2171,3578,656,2171,2827
1,713,1120,362,713,1075
1,713,1120,385,713,1098
1,344,540,185,344,529
1,344,540,174,344,518
1,1555,2443,448,1555,2003
28,26,70,1193,728,1921
1,26,70,43,26,69
28,3,9,123,84,207
24,1,2,23,24,47
21,2,5,61,42,103
17,2,5,49,34,83
21,1,2,14,21,35
9,1,2,6,9,15
29,9,25,370,261,631
30,8,21,277,240,517
19,1,2,14,19,33
18,1,2,13,18,31
17,1,2,16,17,33
3,1,2,3,3,6
8,2,5,17,16,33
29,2,5,61,58,119
4,1,2,4,4,8
5,2,5,15,10,25
20,1,4,47,20,67
3,1,4,7,3,10
10,2,5,19,20,39
4,1,2,3,4,7
2,1,2,2,2,4
4,1,2,2,4,6
24,2,5,71,48,119
12,2,5,35,24,59
9,9,25,135,81,216
8,9,25,120,72,192
18,1,2,17,18,35
6,1,2,6,6,12
15,2,5,44,30,74
26,2,5,75,52,127
16,1,2,15,16,31
20,1,2,19,20,39
26,1,2,18,26,44
2,1,2,1,2,3
27,1,2,18,27,45
16,1,2,11,16,27
27,1,2,18,27,45
15,2,5,44,30,74
25,2,5,74,50,124
4,2,5,8,8,16
12,2,5,25,24,49
24,11,29,279,264,543
12,1,4,35,12,47
3,1,4,9,3,12
30,8,21,377,240,617
17,8,21,214,136,350
1,755,1215,375,755,1130
1,1482,2384,378,1482,1860
1,1482,2384,854,1482,2336
1,1482,2384,568,1482,2050
17,24,64,658,408,1066
5,24,64,130,120,250
4,45,120,238,180,418
8,45,120,590,360,950
10,59,159,968,590,1558
3,2,5,9,6,15
17,2,5,49,34,83
28,2,5,59,56,115
29,2,5,68,58,126
1,2,5,3,2,5
3,2,5,9,6,15
18,2,5,41,36,77
5,2,5,12,10,22
18,2,5,37,36,73
8,2,5,24,16,40
9,2,5,27,18,45
16,2,5,46,32,78
8,2,5,23,16,39
9,2,5,21,18,39
24,2,5,56,48,104
9,7,9,5,63,68
14,7,9,25,98,123
6,7,9,5,42,47
16,7,9,22,112,134
13,8,22,131,104,235
20,8,22,271,160,431
17,8,22,186,136,322
30,8,22,407,240,647
28,8,22,386,224,610
6,8,22,56,48,104
10,9,24,119,90,209
29,9,24,421,261,682
20,9,24,233,180,413
18,13,35,383,234,617
20,13,35,412,260,672
20,13,35,426,260,686
3,13,35,59,39,98
11,13,35,227,143,370
4,13,35,82,52,134
10,13,35,175,130,305
30,13,35,639,390,1029
13,13,35,277,169,446
19,13,35,391,247,638
16,13,35,279,208,487
1,13,35,17,13,30
17,21,55,541,357,898
27,21,55,888,567,1455
5,21,55,134,105,239
4,42,54,0,168,168
5,38,50,15,190,205
6,38,50,60,228,288
7,42,54,24,294,318
24,42,54,197,1008,1205
18,38,50,99,684,783
17,38,50,85,646,731
13,42,54,-12,546,534
1,1898,3375,1038,1898,2936
1,1266,2320,636,1266,1902
1,1266,2320,1008,1266,2274
1,1252,2295,722,1252,1974
1,420,769,334,420,754
1,1266,2320,1031,1266,2297
1,1266,2320,961,1266,2227
1,308,565,184,308,492
1,1252,2295,882,1252,2134
1,1252,2295,1020,1252,2272
1,1252,2295,997,1252,2249
1,2171,3578,1264,2171,3435
1,487,783,280,487,767
1,1083,1701,244,1083,1327
1,1555,2443,790,1555,2345
1,1083,1701,499,1083,1582
1,487,783,155,487,642
1,1083,1701,346,1083,1429
1,344,540,126,344,470
1,713,1120,205,713,918
1,2171,3578,1335,2171,3506
9,26,70,308,234,542
25,26,70,1065,650,1715
17,3,9,100,51,151
7,3,9,41,21,62
1,1,2,1,1,2
20,1,2,14,20,34
9,2,5,21,18,39
2,2,5,5,4,9
24,2,5,56,48,104
1,1,2,1,1,2
16,1,2,15,16,31
20,1,2,18,20,38
17,2,5,50,34,84
30,2,5,89,60,149
8,2,5,24,16,40
15,13,35,320,195,515
17,13,35,362,221,583
19,1,2,11,19,30
13,1,2,12,13,25
16,2,5,46,32,78
27,2,5,51,54,105
15,2,5,29,30,59
7,2,5,13,14,27
7,13,35,149,91,240
18,13,35,383,234,617
8,1,2,8,8,16
29,1,2,21,29,50
3,1,2,2,3,5
24,1,2,22,24,46
5,1,2,5,5,10
29,1,4,82,29,111
24,8,21,277,192,469
29,8,21,334,232,566
4,1,2,4,4,8
14,9,25,179,126,305
16,1,2,10,16,26
20,1,2,15,20,35
13,1,2,10,13,23
12,2,5,28,24,52
28,2,5,81,56,137
2,2,5,6,4,10
6,11,29,70,66,136
3,11,29,35,33,68
7,11,29,89,77,166
1,755,1215,302,755,1057
1,461,742,251,461,712
1,1482,2384,473,1482,1955
1,1482,2384,592,1482,2074
1,1482,2384,592,1482,2074
30,24,64,1162,720,1882
5,59,159,468,295,763
21,4,10,92,84,176
5,4,10,22,20,42
11,4,10,65,44,109
17,4,10,100,68,168
21,2,5,40,42,82
9,2,5,17,18,35
12,3,9,68,36,104
11,3,9,62,33,95
11,4,10,42,44,86
20,4,10,76,80,156
2,2,5,4,4,8
1,2,5,2,2,4
1,2,5,3,2,5
18,2,5,52,36,88
7,2,5,21,14,35
14,2,5,41,28,69
28,2,5,81,56,137
15,2,5,44,30,74
9,2,5,17,18,35
13,2,5,25,26,51
9,2,5,27,18,45
2,2,5,6,4,10
10,2,5,29,20,49
18,3,9,85,54,139
6,3,9,28,18,46
26,2,5,55,52,107
7,2,5,15,14,29
30,4,10,177,120,297
8,4,10,47,32,79
28,2,5,66,56,122
21,2,5,49,42,91
9,2,5,21,18,39
23,2,5,47,46,93
18,2,5,37,36,73
3,7,9,2,21,23
5,7,9,0,35,35
2,7,9,0,14,14
5,7,9,10,35,45
21,7,9,38,147,185
19,7,9,35,133,168
14,7,9,4,98,102
24,3,8,116,72,188
10,8,22,92,80,172
23,8,22,312,184,496
1,8,22,11,8,19
28,8,22,256,224,480
16,8,22,217,128,345
27,8,22,354,216,570
5,9,24,73,45,118
11,9,24,162,99,261
27,9,24,392,243,635
20,9,24,290,180,470
17,13,35,332,221,553
11,13,35,173,143,316
26,13,35,454,338,792
24,13,35,511,312,823
1,13,35,21,13,34
5,13,35,68,65,133
18,13,35,390,234,624
24,13,35,343,312,655
11,13,35,238,143,381
25,13,35,533,325,858
20,13,35,426,260,686
19,13,35,405,247,652
8,13,35,140,104,244
21,13,35,330,273,603
26,38,50,260,988,1248
24,38,50,24,912,936
22,42,54,240,924,1164
17,38,50,94,646,740
24,42,54,3,1008,1011
12,38,50,138,456,594
26,38,50,78,988,1066
18,42,54,80,756,836
7,42,54,35,294,329
1,1912,3400,1046,1912,2958
1,1252,2295,538,1252,1790
1,1266,2320,729,1266,1995
1,420,769,318,420,738
1,295,540,223,295,518
1,1252,2295,630,1252,1882
1,1266,2320,544,1266,1810
1,1252,2295,997,1252,2249
1,1266,2320,1031,1266,2297
1,1266,2320,961,1266,2227
1,1266,2320,1008,1266,2274
1,487,783,280,487,767
1,2171,3578,835,2171,3006
1,1555,2443,839,1555,2394
1,1555,2443,351,1555,1906
1,1555,2443,497,1555,2052
1,713,1120,261,713,974
1,487,783,194,487,681
13,26,70,445,338,783
1,26,70,41,26,67
3,26,70,130,78,208
4,26,70,170,104,274
20,3,9,116,60,176
20,3,9,91,60,151
6,1,2,6,6,12
25,1,2,25,25,50
10,9,25,120,90,210
26,1,2,25,26,51
17,13,35,368,221,589
5,13,35,87,65,152
15,13,35,262,195,457
13,1,4,38,13,51
30,2,5,63,60,123
9,2,5,27,18,45
4,2,5,12,8,20
13,1,2,13,13,26
3,1,2,3,3,6
18,2,5,34,36,70
30,2,5,84,60,144
7,2,5,21,14,35
27,2,5,80,54,134
12,1,2,9,12,21
24,1,2,15,24,39
28,2,5,83,56,139
27,2,5,49,54,103
25,2,5,45,50,95
9,9,25,135,81,216
25,9,25,375,225,600
4,9,25,60,36,96
18,2,5,52,36,88
9,2,5,26,18,44
6,2,5,17,12,29
24,2,5,70,48,118
8,1,2,6,8,14
2,2,5,6,4,10
1,1482,2384,592,1482,2074
1,1482,2384,592,1482,2074
1,1482,2384,878,1482,2360
1,1482,2384,878,1482,2360
1,1482,2384,807,1482,2289
1,1482,2384,473,1482,1955
1,1482,2384,473,1482,1955
1,1482,2384,854,1482,2336
1,461,742,229,461,690
1,461,742,266,461,727
22,2,5,52,44,96
23,2,5,44,46,90
10,2,5,19,20,39
5,4,10,21,20,41
17,4,10,71,68,139
24,4,10,139,96,235
10,4,10,58,40,98
15,4,10,87,60,147
6,2,5,11,12,23
7,4,10,27,28,55
6,4,10,23,24,47
22,4,10,123,88,211
11,4,10,62,44,106
26,2,5,75,52,127
8,2,5,23,16,39
10,2,5,24,20,44
9,2,5,21,18,39
22,2,5,65,44,109
6,7,9,0,42,42
4,7,9,3,28,31
8,7,9,0,56,56
12,3,8,48,36,84
3,3,8,10,9,19
9,3,8,32,27,59
28,8,22,281,224,505
28,8,22,380,224,604
4,8,22,54,32,86
22,8,22,303,176,479
4,9,24,58,36,94
5,9,24,73,45,118
10,9,24,107,90,197
6,9,24,87,54,141
30,13,35,513,390,903
25,13,35,533,325,858
9,13,35,148,117,265
7,13,35,137,91,228
6,13,35,130,78,208
26,13,35,408,338,746
25,13,35,541,325,866
25,13,35,533,325,858
29,13,35,567,377,944
7,13,35,149,91,240
15,13,35,236,195,431
8,13,35,140,104,244
28,13,35,577,364,941
26,13,35,554,338,892
10,21,55,252,210,462
25,21,55,671,525,1196
15,42,54,172,630,802
26,38,50,78,988,1066
25,38,50,75,950,1025
19,38,50,209,722,931
17,38,50,51,646,697
1,1252,2295,882,1252,2134
1,1266,2320,1008,1266,2274
1,1266,2320,961,1266,2227
1,344,540,99,344,443
1,344,540,185,344,529
1,1555,2443,448,1555,2003
1,1083,1701,499,1083,1582
1,487,783,155,487,642
1,487,783,155,487,642
1,1519,2443,606,1519,2125
1,1083,1701,397,1083,1480
1,344,540,191,344,535
1,1,2,1,1,2
12,1,2,12,12,24
15,1,2,14,15,29
8,1,2,5,8,13
17,1,2,12,17,29
14,2,5,39,28,67
29,2,5,81,58,139
19,2,5,53,38,91
19,2,5,56,38,94
1,2,5,3,2,5
2,11,30,27,22,49
8,2,5,23,16,39
2,9,25,32,18,50
15,2,5,32,30,62
30,2,5,63,60,123
13,1,2,9,13,22
21,1,2,14,21,35
25,2,5,58,50,108
1,11,30,19,11,30
12,11,30,224,132,356
25,1,2,16,25,41
9,9,25,104,81,185
5,9,25,58,45,103
1,12,33,21,12,33
26,12,33,537,312,849
14,2,5,27,28,55
27,2,5,51,54,105
17,2,5,49,34,83
8,2,5,15,16,31
26,2,5,49,52,101
28,1,4,64,28,92
29,2,5,68,58,126
18,1,4,53,18,71
1,1,4,3,1,4
22,1,2,12,22,34
3,2,5,8,6,14
3,2,5,8,6,14
18,1,2,18,18,36
16,1,2,16,16,32
7,1,2,7,7,14
29,2,5,61,58,119
15,2,5,32,30,62
28,2,5,59,56,115
8,11,29,102,88,190
4,11,29,51,44,95
1,1482,2384,521,1482,2003
1,755,1215,302,755,1057
1,1482,2384,592,1482,2074
1,461,742,118,461,579
29,24,64,900,696,1596
30,24,64,950,720,1670
13,24,64,337,312,649
28,2,5,74,56,130
16,2,5,42,32,74
18,3,9,79,54,133
10,3,9,44,30,74
28,4,10,162,112,274
11,3,9,59,33,92
19,3,9,102,57,159
5,2,5,12,10,22
28,2,5,66,56,122
20,2,5,47,40,87
19,2,5,45,38,83
23,2,5,51,46,97
24,2,5,53,48,101
24,2,5,67,48,115
11,2,5,31,22,53
13,2,5,38,26,64
14,2,5,41,28,69
5,2,5,15,10,25
2,2,5,6,4,10
21,2,5,62,42,104
20,2,5,39,40,79
11,2,5,32,22,54
6,2,5,18,12,30
24,3,9,129,72,201
10,3,9,54,30,84
10,2,5,29,20,49
3,7,9,6,21,27
9,7,9,17,63,80
2,7,9,4,14,18
20,7,9,0,140,140
16,7,9,31,112,143
18,3,8,87,54,141
28,3,8,91,84,175
29,3,8,101,87,188
21,3,8,83,63,146
3,8,22,29,24,53
9,8,22,90,72,162
13,8,22,179,104,283
21,8,22,289,168,457
12,8,22,165,96,261
4,8,22,38,32,70
27,9,24,392,243,635
7,9,24,102,63,165
8,9,24,95,72,167
20,9,24,266,180,446
15,9,24,146,135,281
6,9,24,70,54,124
24,9,24,354,216,570
25,9,24,369,225,594
13,13,35,268,169,437
9,13,35,195,117,312
21,13,35,455,273,728
27,13,35,585,351,936
19,13,35,391,247,638
23,13,35,450,299,749
8,13,35,140,104,244
9,13,35,148,117,265
23,13,35,474,299,773
30,13,35,639,390,1029
27,13,35,556,351,907
1,13,35,17,13,30
27,13,35,585,351,936
23,13,35,498,299,797
25,13,35,533,325,858
10,13,35,213,130,343
21,13,35,308,273,581
10,13,35,213,130,343
30,13,35,524,390,914
2,13,35,29,26,55
8,13,35,114,104,218
18,13,35,257,234,491
4,21,55,134,84,218
8,21,55,193,168,361
7,21,55,223,147,370
25,21,55,630,525,1155
8,42,54,92,336,428
7,38,50,81,266,347
1,1252,2295,951,1252,2203
1,1252,2295,951,1252,2203
1,1266,2320,961,1266,2227
1,1266,2320,683,1266,1949
1,1252,2295,882,1252,2134
1,1252,2295,951,1252,2203
1,1252,2295,538,1252,1790
1,420,769,249,420,669
1,1266,2320,544,1266,1810
1,295,540,148,295,443
1,1252,2295,1020,1252,2272
1,2171,3578,620,2171,2791
1,1555,2443,448,1555,2003
1,713,1120,385,713,1098
1,2171,3578,835,2171,3006
1,713,1120,362,713,1075
1,713,1120,385,713,1098
1,2171,3578,942,2171,3113
1,713,1120,261,713,974
1,1519,2443,606,1519,2125
1,1083,1701,584,1083,1667
1,487,783,132,487,619
1,1519,2443,900,1519,2419
1,344,540,126,344,470
16,26,70,458,416,874
4,26,70,173,104,277
22,3,9,96,66,162
21,3,9,122,63,185
27,1,2,26,27,53
4,1,2,4,4,8
29,2,5,55,58,113
15,2,5,29,30,59
16,2,5,47,32,79
27,1,2,25,27,52
8,1,2,6,8,14
10,1,2,7,10,17
17,1,2,11,17,28
25,1,2,16,25,41
6,1,2,3,6,9
10,1,2,6,10,16
3,11,30,56,33,89
29,11,30,542,319,861
1,2,5,2,2,4
13,2,5,38,26,64
10,2,5,30,20,50
24,11,30,305,264,569
27,1,2,23,27,50
6,1,2,5,6,11
1,2,5,3,2,5
13,2,5,36,26,62
1,2,5,3,2,5
6,2,5,17,12,29
30,2,5,63,60,123
1,2,5,2,2,4
28,2,5,66,56,122
28,2,5,66,56,122
11,13,35,157,143,300
9,13,35,129,117,246
19,13,35,272,247,519
13,2,5,38,26,64
17,2,5,49,34,83
2,2,5,5,4,9
6,2,5,14,12,26
8,1,2,6,8,14
8,1,2,6,8,14
7,2,5,20,14,34
9,2,5,25,18,43
21,1,2,15,21,36
2,1,2,1,2,3
1,8,21,8,8,16
13,8,21,109,104,213
11,2,5,32,22,54
7,2,5,19,14,33
22,2,5,58,44,102
2,1,2,2,2,4
22,1,2,21,22,43
11,1,2,11,11,22
3,12,33,41,36,77
6,2,5,14,12,26
4,12,33,55,48,103
22,1,2,22,22,44
30,1,2,29,30,59
15,1,2,15,15,30
28,1,2,27,28,55
10,1,4,28,10,38
25,1,4,71,25,96
12,1,2,11,12,23
22,11,29,281,242,523
1,1,2,1,1,2
10,1,4,27,10,37
15,1,4,41,15,56
14,1,2,8,14,22
15,1,2,8,15,23
25,2,5,59,50,109
29,2,5,68,58,126
5,1,4,11,5,16
9,1,4,19,9,28
1,1482,2384,807,1482,2289
1,1482,2384,473,1482,1955
1,755,1215,375,755,1130
1,1482,2384,378,1482,1860
1,1482,2384,854,1482,2336
18,24,64,674,432,1106
16,24,64,456,384,840
4,24,64,157,96,253
2,45,120,148,90,238
6,59,159,476,354,830
8,59,159,520,472,992
30,4,10,168,120,288
22,2,5,43,44,87
9,2,5,18,18,36
7,3,9,27,21,48
27,3,9,104,81,185
29,2,5,86,58,144
13,2,5,38,26,64
7,2,5,16,14,30
18,2,5,42,36,78
1,2,5,3,2,5
27,2,5,78,54,132
11,2,5,32,22,54
5,2,5,10,10,20
29,2,5,81,58,139
14,2,5,41,28,69
19,2,5,55,38,93
8,3,9,47,24,71
6,3,9,35,18,53
27,2,5,78,54,132
30,4,10,168,120,288
7,4,10,39,28,67
17,2,5,45,34,79
23,2,5,61,46,107
9,3,9,43,27,70
1,3,9,5,3,8
9,2,5,25,18,43
7,2,5,20,14,34
10,7,9,6,70,76
28,7,9,46,196,242
30,7,9,11,210,221
12,7,9,20,84,104
15,7,9,27,105,132
18,7,9,30,126,156
4,7,9,3,28,31
25,3,8,121,75,196
26,3,8,84,78,162
2,3,8,10,6,16
12,3,8,53,36,89
19,3,8,89,57,146
28,3,8,136,84,220
18,8,22,197,144,341
23,8,22,231,184,415
14,9,24,129,126,255
5,9,24,59,45,104
24,9,24,337,216,553
29,9,24,345,261,606
9,13,35,185,117,302
27,13,35,556,351,907
2,13,35,35,26,61
4,13,35,57,52,109
7,13,35,127,91,218
22,13,35,453,286,739
30,13,35,639,390,1029
18,13,35,371,234,605
2,13,35,41,26,67
12,13,35,247,156,403
17,13,35,243,221,464
24,13,35,394,312,706
19,13,35,298,247,545
16,13,35,330,208,538
24,13,35,511,312,823
14,13,35,298,182,480
14,13,35,288,182,470
7,13,35,110,91,201
10,21,55,335,210,545
18,21,55,572,378,950
25,21,55,823,525,1348
7,38,50,70,266,336
11,38,50,110,418,528
1,38,50,11,38,49
18,38,50,54,684,738
25,42,54,273,1050,1323
1,42,54,5,42,47
1,1912,3400,944,1912,2856
1,1266,2320,497,1266,1763
1,1252,2295,745,1252,1997
1,420,769,334,420,754
1,1266,2320,544,1266,1810
1,1266,2320,1008,1266,2274
1,1252,2295,630,1252,1882
1,1266,2320,961,1266,2227
1,295,540,207,295,502
1,2171,3578,1335,2171,3506
1,2171,3578,1335,2171,3506
1,2171,3578,1264,2171,3435
1,344,540,77,344,421
1,344,540,185,344,529
1,2171,3578,942,2171,3113
1,1083,1701,550,1083,1633
1,713,1120,362,713,1075
1,344,540,185,344,529
1,487,783,194,487,681
1,1555,2443,864,1555,2419
7,26,70,298,182,480
22,26,70,937,572,1509
4,26,70,140,104,244
12,3,9,70,36,106
5,3,9,29,15,44
9,3,9,52,27,79
11,3,9,53,33,86
26,1,2,25,26,51
7,1,2,7,7,14
25,13,35,533,325,858
10,13,35,213,130,343
16,13,35,341,208,549
22,2,5,64,44,108
6,1,2,4,6,10
18,1,2,12,18,30
6,1,2,4,6,10
15,13,35,257,195,452
10,2,5,30,20,50
29,2,5,86,58,144
7,2,5,21,14,35
14,13,35,303,182,485
9,13,35,195,117,312
11,13,35,238,143,381
5,13,35,108,65,173
29,13,35,628,377,1005
17,1,2,16,17,33
30,1,2,29,30,59
3,1,2,2,3,5
15,13,35,262,195,457
9,1,2,6,9,15
11,1,2,7,11,18
24,1,2,19,24,43
17,1,2,16,17,33
16,2,5,47,32,79
23,2,5,68,46,114
27,1,2,26,27,53
22,1,2,21,22,43
2,1,2,2,2,4
5,2,5,14,10,24
12,1,2,9,12,21
8,1,2,6,8,14
12,2,5,23,24,47
11,2,5,21,22,43
22,11,30,279,242,521
11,11,30,140,121,261
10,2,5,21,20,41
15,2,5,32,30,62
9,9,25,142,81,223
25,1,2,23,25,48
2,1,2,2,2,4
27,1,2,25,27,52
12,1,2,9,12,21
10,1,2,7,10,17
15,9,25,191,135,326
22,9,25,281,198,479
15,2,5,29,30,59
1,2,5,3,2,5
18,1,4,51,18,69
15,1,4,43,15,58
30,1,2,29,30,59
2,1,2,2,2,4
14,2,5,27,28,55
16,1,2,9,16,25
25,1,2,14,25,39
3,2,5,9,6,15
1,2,5,3,2,5
9,2,5,19,18,37
29,2,5,61,58,119
12,2,5,25,24,49
4,2,5,12,8,20
2,2,5,6,4,10
25,2,5,74,50,124
10,2,5,28,20,48
1,461,742,147,461,608
1,755,1215,411,755,1166
1,1482,2384,878,1482,2360
1,461,742,185,461,646
1,1482,2384,854,1482,2336
1,1482,2384,854,1482,2336
1,461,742,118,461,579
1,1482,2384,854,1482,2336
2,45,120,107,90,197
10,59,159,793,590,1383
30,2,5,84,60,144
10,2,5,27,20,47
1,2,5,3,2,5
7,4,10,41,28,69
8,2,5,24,16,40
18,2,5,53,36,89
2,2,5,4,4,8
22,2,5,46,44,90
2,2,5,4,4,8
17,2,5,36,34,70
20,2,5,38,40,78
29,2,5,55,58,113
22,3,9,88,66,154
11,3,9,44,33,77
7,2,5,16,14,30
14,2,5,33,28,61
8,4,10,46,32,78
24,3,9,129,72,201
6,3,9,35,18,53
28,3,9,163,84,247
9,2,5,18,18,36
8,4,10,31,32,63
1,4,10,4,4,8
2,7,9,3,14,17
9,7,9,1,63,64
5,7,9,9,35,44
5,7,9,1,35,36
13,7,9,11,91,102
21,7,9,0,147,147
26,7,9,1,182,183
11,7,9,1,77,78
25,7,9,41,175,216
14,3,8,50,42,92
13,3,8,42,39,81
2,8,22,27,16,43
27,8,22,366,216,582
5,8,22,68,40,108
13,8,22,171,104,275
23,9,24,224,207,431
2,9,24,28,18,46
8,9,24,116,72,188
12,9,24,168,108,276
9,13,35,176,117,293
6,13,35,124,78,202
12,13,35,209,156,365
18,13,35,314,234,548
30,13,35,650,390,1040
13,13,35,227,169,396
2,13,35,43,26,69
1,13,35,21,13,34
12,13,35,256,156,412
9,13,35,129,117,246
2,13,35,31,26,57
28,21,55,937,588,1525
25,42,54,206,1050,1256
12,38,50,120,456,576
2,42,54,5,84,89
13,38,50,72,494,566
29,38,50,0,1102,1102
27,38,50,270,1026,1296
22,38,50,242,836,1078
16,38,50,160,608,768
10,42,54,50,420,470
1,1266,2320,497,1266,1763
1,1252,2295,882,1252,2134
1,1252,2295,630,1252,1882
1,1252,2295,630,1252,1882
1,1266,2320,1008,1266,2274
1,1252,2295,997,1252,2249
1,1252,2295,951,1252,2203
1,1252,2295,1020,1252,2272
1,1519,2443,826,1519,2345
1,1083,1701,244,1083,1327
1,487,783,194,487,681
1,344,540,77,344,421
1,1083,1701,584,1083,1667
1,1083,1701,584,1083,1667
1,344,540,158,344,502
9,26,70,383,234,617
29,3,9,119,87,206
5,3,9,28,15,43
3,3,9,17,9,26
16,2,5,30,32,62
10,13,35,213,130,343
6,13,35,128,78,206
21,13,35,447,273,720
15,1,2,10,15,25
6,1,2,4,6,10
11,2,5,29,22,51
1,2,5,3,2,5
7,1,2,7,7,14
12,2,5,23,24,47
11,2,5,21,22,43
29,11,30,542,319,861
11,11,30,206,121,327
15,11,30,281,165,446
16,2,5,47,32,79
15,1,4,35,15,50
30,1,4,71,30,101
6,1,2,6,6,12
9,13,35,192,117,309
3,13,35,64,39,103
30,1,4,74,30,104
14,2,5,41,28,69
28,2,5,83,56,139
2,2,5,6,4,10
30,2,5,84,60,144
10,2,5,28,20,48
16,2,5,47,32,79
25,2,5,74,50,124
26,1,4,59,26,85
27,2,5,63,54,117
25,2,5,59,50,109
26,2,5,57,52,109
23,1,2,23,23,46
3,2,5,9,6,15
16,11,30,237,176,413
23,11,30,340,253,593
8,2,5,19,16,35
11,2,5,26,22,48
10,2,5,24,20,44
21,1,4,61,21,82
9,2,5,25,18,43
12,1,4,27,12,39
3,8,21,26,24,50
3,8,21,26,24,50
8,1,4,17,8,25
2,1,4,4,2,6
12,1,4,25,12,37
13,1,4,28,13,41
24,1,2,13,24,37
5,1,2,3,5,8
2,1,2,1,2,3
7,2,5,21,14,35
10,2,5,30,20,50
18,8,21,226,144,370
27,8,21,340,216,556
30,8,21,377,240,617
26,9,25,403,234,637
1,461,742,251,461,712
1,1482,2384,807,1482,2289
1,755,1215,241,755,996
1,1482,2384,854,1482,2336
1,1482,2384,378,1482,1860
12,24,64,380,288,668
7,45,120,416,315,731
6,59,159,562,354,916
22,4,10,130,88,218
3,4,10,18,12,30
30,2,5,84,60,144
13,2,5,36,26,62
4,2,5,8,8,16
8,2,5,15,16,31
4,2,5,8,8,16
3,2,5,7,6,13
6,2,5,13,12,25
19,2,5,55,38,93
17,3,9,82,51,133
22,3,9,106,66,172
20,4,10,116,80,196
28,4,10,162,112,274
30,2,5,87,60,147
26,2,5,75,52,127
6,3,9,29,18,47
11,3,9,53,33,86
9,2,5,27,18,45
6,2,5,18,12,30
10,2,5,23,20,43
26,2,5,60,52,112
13,2,5,34,26,60
18,4,10,104,72,176
13,4,10,75,52,127
26,2,5,55,52,107
12,4,10,46,48,94
30,4,10,114,120,234
17,2,5,48,34,82
6,2,5,17,12,29
16,2,5,46,32,78
21,2,5,61,42,103
17,2,5,40,34,74
6,2,5,14,12,26
8,2,5,23,16,39
4,2,5,12,8,20
1,2,5,2,2,4
17,7,9,28,119,147
12,7,9,5,84,89
2,7,9,4,14,18
16,7,9,9,112,121
27,7,9,44,189,233
17,7,9,31,119,150
7,7,9,6,49,55
30,7,9,25,210,235
15,7,9,6,105,111
22,7,9,16,154,170
18,3,8,87,54,141
25,3,8,83,75,158
22,3,8,78,66,144
19,3,8,62,57,119
10,8,22,136,80,216
16,8,22,210,128,338
11,8,22,149,88,237
22,8,22,298,176,474
30,8,22,394,240,634
16,8,22,140,128,268
23,8,22,287,184,471
6,8,22,83,48,131
6,8,22,67,48,115
6,8,22,83,48,131
19,8,22,262,152,414
2,8,22,18,16,34
25,9,24,333,225,558
8,9,24,118,72,190
12,9,24,174,108,282
20,9,24,281,180,461
18,9,24,179,162,341
13,9,24,154,117,271
25,9,24,297,225,522
6,13,35,124,78,202
27,13,35,424,351,775
6,13,35,130,78,208
3,13,35,44,39,83
13,13,35,268,169,437
9,13,35,157,117,274
1,13,35,17,13,30
26,13,35,563,338,901
4,13,35,78,52,130
20,13,35,293,260,553
10,13,35,175,130,305
4,13,35,63,52,115
20,13,35,426,260,686
3,13,35,64,39,103
11,13,35,161,143,304
25,13,35,393,325,718
28,13,35,440,364,804
17,13,35,297,221,518
21,13,35,330,273,603
16,13,35,234,208,442
22,13,35,315,286,601
25,13,35,489,325,814
28,13,35,489,364,853
14,21,55,461,294,755
22,42,54,110,924,1034
17,38,50,196,646,842
16,38,50,176,608,784
1,38,50,3,38,41
26,38,50,78,988,1066
26,42,54,284,1092,1376
9,42,54,98,378,476
4,42,54,44,168,212
13,42,54,2,546,548
13,42,54,65,546,611
1,1252,2295,997,1252,2249
1,1252,2295,997,1252,2249
1,1252,2295,997,1252,2249
1,1252,2295,561,1252,1813
1,1266,2320,683,1266,1949
1,1252,2295,951,1252,2203
1,308,565,217,308,525
1,308,565,155,308,463
1,1252,2295,951,1252,2203
1,1252,2295,997,1252,2249
1,1266,2320,497,1266,1763
1,295,540,207,295,502
1,1252,2295,745,1252,1997
1,1252,2295,538,1252,1790
1,1252,2295,745,1252,1997
1,420,769,241,420,661
1,1266,2320,961,1266,2227
1,1252,2295,630,1252,1882
1,308,565,234,308,542
1,344,540,185,344,529
1,1555,2443,448,1555,2003
1,2171,3578,656,2171,2827
1,1519,2443,900,1519,2419
1,1519,2443,753,1519,2272
1,1555,2443,448,1555,2003
1,1555,2443,839,1555,2394
1,1555,2443,546,1555,2101
1,487,783,265,487,752
1,1519,2443,606,1519,2125
1,487,783,155,487,642
1,713,1120,329,713,1042
1,344,540,99,344,443
1,344,540,126,344,470
15,26,70,513,390,903
20,26,70,684,520,1204
18,3,9,102,54,156
20,3,9,80,60,140
4,3,9,19,12,31
17,1,2,16,17,33
8,1,2,7,8,15
8,1,2,7,8,15
3,1,2,3,3,6
5,9,25,64,45,109
23,2,5,64,46,110
27,13,35,575,351,926
27,2,5,78,54,132
1,2,5,2,2,4
24,2,5,56,48,104
16,9,25,172,144,316
18,9,25,194,162,356
23,2,5,54,46,100
26,1,2,18,26,44
2,2,5,5,4,9
19,13,35,332,247,579
27,2,5,76,54,130
5,2,5,14,10,24
10,2,5,28,20,48
16,2,5,45,32,77
26,1,4,55,26,81
3,1,4,6,3,9
15,1,2,11,15,26
23,1,2,17,23,40
22,1,2,16,22,38
5,1,2,4,5,9
2,1,2,1,2,3
17,9,25,196,153,349
30,11,30,381,330,711
21,11,30,267,231,498
9,2,5,27,18,45
19,2,5,56,38,94
8,1,2,7,8,15
23,1,2,12,23,35
5,1,4,11,5,16
2,1,4,5,2,7
16,1,4,36,16,52
7,9,25,89,63,152
25,9,25,319,225,544
30,8,21,377,240,617
27,8,21,340,216,556
9,1,4,21,9,30
3,1,4,7,3,10
23,8,21,193,184,377
7,8,21,59,56,115
10,11,30,184,110,294
29,11,30,534,319,853
20,11,30,368,220,588
16,12,33,262,192,454
2,11,29,26,22,48
8,11,29,102,88,190
17,11,29,217,187,404
11,1,4,32,11,43
20,1,4,58,20,78
13,9,25,156,117,273
5,1,2,3,5,8
10,1,2,6,10,16
8,1,2,8,8,16
6,1,4,15,6,21
16,1,4,40,16,56
17,1,4,50,17,67
19,1,4,55,19,74
11,1,4,32,11,43
26,1,2,25,26,51
30,1,2,29,30,59
23,2,5,48,46,94
5,2,5,11,10,21
13,1,4,32,13,45
1,755,1215,411,755,1166
1,1482,2384,592,1482,2074
1,1482,2384,854,1482,2336
1,1482,2384,878,1482,2360
1,1482,2384,854,1482,2336
28,24,64,887,672,1559
6,24,64,232,144,376
3,24,64,116,72,188
25,24,64,968,600,1568
4,45,120,233,180,413
7,45,120,340,315,655
4,59,159,375,236,611
11,3,9,50,33,83
18,2,5,38,36,74
9,2,5,19,18,37
12,2,5,35,24,59
27,2,5,80,54,134
24,2,5,43,48,91
10,2,5,30,20,50
24,2,5,70,48,118
13,2,5,38,26,64
16,3,9,93,48,141
13,2,5,25,26,51
1,2,5,2,2,4
29,2,5,55,58,113
22,2,5,42,44,86
11,2,5,24,22,46
20,2,5,44,40,84
30,2,5,57,60,117
10,2,5,19,20,39
16,2,5,30,32,62
16,2,5,30,32,62
27,4,10,103,108,211
17,4,10,65,68,133
1,3,9,4,3,7
2,3,9,8,6,14
6,2,5,14,12,26
29,2,5,68,58,126
16,4,10,61,64,125
27,4,10,103,108,211
9,2,5,27,18,45
22,3,9,90,66,156
7,2,5,15,14,29
16,7,9,2,112,114
28,7,9,1,196,197
20,7,9,33,140,173
18,7,9,30,126,156
3,7,9,5,21,26
9,3,8,44,27,71
11,3,8,41,33,74
11,8,22,123,88,211
5,8,22,69,40,109
6,9,24,89,54,143
4,9,24,59,36,95
12,9,24,120,108,228
2,9,24,22,18,40
27,9,24,301,243,544
23,9,24,224,207,431
11,9,24,131,99,230
5,9,24,49,45,94
17,13,35,249,221,470
16,13,35,279,208,487
6,13,35,124,78,202
4,13,35,82,52,134
9,13,35,195,117,312
30,13,35,639,390,1029
9,13,35,148,117,265
5,13,35,87,65,152
7,13,35,122,91,213
19,13,35,332,247,579
17,13,35,243,221,464
30,13,35,471,390,861
3,13,35,43,39,82
19,13,35,391,247,638
25,13,35,393,325,718
22,13,35,345,286,631
26,13,35,454,338,792
4,13,35,70,52,122
16,13,35,274,208,482
29,21,55,954,609,1563
7,21,55,157,147,304
2,42,54,23,84,107
7,42,54,5,294,299
14,42,54,77,588,665
2,42,54,0,84,84
5,38,50,15,190,205
4,42,54,20,168,188
1,1266,2320,544,1266,1810
1,1266,2320,683,1266,1949
1,1252,2295,492,1252,1744
1,308,565,246,308,554
1,308,565,155,308,463
1,1252,2295,538,1252,1790
1,1266,2320,544,1266,1810
1,1083,1701,244,1083,1327
1,487,783,265,487,752
1,2171,3578,942,2171,3113
1,1555,2443,570,1555,2125
1,713,1120,385,713,1098
1,344,540,191,344,535
1,487,783,132,487,619
1,344,540,110,344,454
1,26,70,29,26,55
2,26,70,87,52,139
22,26,70,629,572,1201
6,3,9,29,18,47
21,1,4,62,21,83
26,8,21,223,208,431
11,13,35,161,143,304
19,13,35,278,247,525
7,13,35,103,91,194
30,11,30,561,330,891
25,1,4,71,25,96
26,1,4,74,26,100
11,13,35,188,143,331
4,13,35,68,52,120
9,13,35,154,117,271
5,1,2,5,5,10
3,11,30,45,33,78
16,11,30,242,176,418
11,1,4,27,11,38
28,1,4,69,28,97
9,1,2,5,9,14
19,1,4,47,19,66
4,1,4,10,4,14
9,11,30,166,99,265
20,11,30,368,220,588
7,11,30,129,77,206
20,9,25,315,180,495
12,9,25,189,108,297
25,9,25,394,225,619
14,11,30,249,154,403
23,9,25,265,207,472
22,9,25,253,198,451
3,2,5,9,6,15
16,2,5,38,32,70
1,2,5,2,2,4
29,11,30,542,319,861
1,11,30,19,11,30
14,1,4,41,14,55
12,1,4,35,12,47
4,11,29,51,44,95
23,11,29,294,253,547
15,1,4,44,15,59
18,1,4,53,18,71
10,1,2,6,10,16
11,1,2,7,11,18
7,8,21,85,56,141
1,2,5,2,2,4
12,2,5,28,24,52
27,2,5,63,54,117
12,1,2,9,12,21
21,1,2,15,21,36
26,1,2,16,26,42
30,1,2,19,30,49
8,2,5,17,16,33
28,2,5,62,56,118
1,2,5,2,2,4
10,9,25,105,90,195
29,9,25,305,261,566
21,1,4,52,21,73
1,461,742,185,461,646
1,1482,2384,807,1482,2289
1,1482,2384,378,1482,1860
1,755,1215,436,755,1191
1,755,1215,436,755,1191
1,461,742,185,461,646
11,24,64,313,264,577
22,24,64,852,528,1380
22,45,120,1096,990,2086
3,59,159,238,177,415
13,3,9,73,39,112
10,3,9,56,30,86
19,3,9,102,57,159
15,3,9,81,45,126
15,2,5,29,30,59
25,2,5,48,50,98
24,4,10,142,96,238
29,2,5,68,58,126
14,2,5,33,28,61
29,4,10,110,116,226
6,2,5,14,12,26
23,2,5,53,46,99
5,4,10,22,20,42
12,4,10,53,48,101
29,2,5,84,58,142
12,2,5,35,24,59
13,3,9,76,39,115
14,3,9,81,42,123
8,3,9,33,24,57
3,3,9,12,9,21
21,3,9,90,63,153
26,2,5,61,52,113
28,2,5,66,56,122
21,7,9,40,147,187
27,7,9,22,189,211
25,7,9,46,175,221
7,7,9,6,49,55
3,7,9,5,21,26
11,3,8,37,33,70
12,3,8,48,36,84
6,3,8,24,18,42
13,8,22,162,104,266
17,8,22,234,136,370
19,8,22,237,152,389
17,9,24,251,153,404
7,9,24,102,63,165
9,9,24,96,81,177
16,9,24,232,144,376
10,9,24,100,90,190
10,9,24,104,90,194
17,13,35,297,221,518
17,13,35,332,221,553
25,13,35,489,325,814
15,13,35,320,195,515
14,13,35,303,182,485
25,13,35,410,325,735
28,13,35,596,364,960
26,13,35,563,338,901
4,13,35,73,52,125
29,13,35,597,377,974
5,13,35,79,65,144
12,13,35,205,156,361
19,13,35,405,247,652
30,13,35,471,390,861
12,21,55,289,252,541
17,21,55,428,357,785
7,42,54,80,294,374
1,38,50,12,38,50
10,42,54,115,420,535
19,42,54,187,798,985
12,38,50,120,456,576
22,42,54,216,924,1140
21,42,54,173,882,1055
9,42,54,40,378,418
1,1266,2320,752,1266,2018
1,1266,2320,1008,1266,2274
1,420,769,180,420,600
1,420,769,295,420,715
1,308,565,155,308,463
1,1266,2320,683,1266,1949
1,1266,2320,636,1266,1902
1,1252,2295,1020,1252,2272
1,420,769,318,420,738
1,1252,2295,1020,1252,2272
1,1252,2295,882,1252,2134
1,487,783,280,487,767
1,2171,3578,942,2171,3113
1,713,1120,205,713,918
1,344,540,174,344,518
3,26,70,130,78,208
15,2,5,44,30,74
29,1,2,21,29,50
22,1,2,16,22,38
8,1,2,6,8,14
24,1,2,23,24,47
2,1,2,2,2,4
1,13,35,21,13,34
14,13,35,298,182,480
3,12,33,45,36,81
10,2,5,30,20,50
29,2,5,86,58,144
20,2,5,46,40,86
2,1,2,1,2,3
21,11,30,286,231,517
9,11,30,122,99,221
3,11,30,55,33,88
13,11,30,239,143,382
30,11,30,552,330,882
15,11,30,236,165,401
5,11,30,79,55,134
6,1,2,4,6,10
11,9,25,165,99,264
20,1,2,14,20,34
7,1,2,5,7,12
28,1,2,20,28,48
5,2,5,15,10,25
26,2,5,75,52,127
21,1,2,12,21,33
6,1,2,3,6,9
4,2,5,9,8,17
28,2,5,66,56,122
17,2,5,40,34,74
26,1,4,76,26,102
1,1482,2384,401,1482,1883
1,755,1215,411,755,1166
1,1482,2384,854,1482,2336
1,755,1215,375,755,1130
1,461,742,251,461,712
28,2,5,66,56,122
16,2,5,38,32,70
29,2,5,71,58,129
23,2,5,56,46,102
4,3,9,23,12,35
22,4,10,130,88,218
27,4,10,159,108,267
2,2,5,6,4,10
2,2,5,6,4,10
29,2,5,81,58,139
14,2,5,39,28,67
3,2,5,9,6,15
20,2,5,58,40,98
16,2,5,46,32,78
17,2,5,50,34,84
14,2,5,27,28,55
7,2,5,13,14,27
27,3,9,111,81,192
11,3,9,48,33,81
5,3,9,22,15,37
3,2,5,7,6,13
6,2,5,14,12,26
30,3,9,169,90,259
13,7,9,21,91,112
27,7,9,49,189,238
25,3,8,117,75,192
21,3,8,102,63,165
21,3,8,70,63,133
23,8,22,211,184,395
1,8,22,14,8,22
15,8,22,197,120,317
28,8,22,386,224,610
20,9,24,238,180,418
15,9,24,218,135,353
10,9,24,145,90,235
24,13,35,419,312,731
16,13,35,330,208,538
21,13,35,447,273,720
23,13,35,490,299,789
2,13,35,43,26,69
10,13,35,175,130,305
19,13,35,298,247,545
22,13,35,430,286,716
23,13,35,474,299,773
12,13,35,247,156,403
3,13,35,51,39,90
29,13,35,506,377,883
3,13,35,65,39,104
22,13,35,376,286,662
5,38,50,5,190,195
7,38,50,70,266,336
24,42,54,262,1008,1270
19,38,50,219,722,941
1,1912,3400,1046,1912,2958
1,420,769,318,420,738
1,1266,2320,544,1266,1810
1,1266,2320,1008,1266,2274
1,1266,2320,961,1266,2227
1,420,769,249,420,669
1,420,769,318,420,738
1,1266,2320,636,1266,1902
1,308,565,234,308,542
1,1555,2443,790,1555,2345
1,1519,2443,606,1519,2125
1,1083,1701,431,1083,1514
1,344,540,77,344,421
1,344,540,191,344,535
1,487,783,132,487,619
1,344,540,126,344,470
7,26,70,288,182,470
28,26,70,1193,728,1921
14,26,70,596,364,960
22,3,9,128,66,194
15,2,5,44,30,74
16,13,35,341,208,549
9,13,35,192,117,309
8,2,5,16,16,32
11,2,5,21,22,43
8,1,2,8,8,16
20,1,2,19,20,39
14,1,2,13,14,27
3,1,2,3,3,6
17,2,5,50,34,84
18,2,5,53,36,89
1,1,2,1,1,2
5,1,2,5,5,10
18,2,5,42,36,78
8,2,5,19,16,35
9,2,5,21,18,39
17,1,4,50,17,67
30,1,4,89,30,119
25,13,35,489,325,814
20,13,35,391,260,651
27,2,5,80,54,134
15,2,5,42,30,72
30,1,2,22,30,52
15,1,2,10,15,25
1,1,2,1,1,2
7,2,5,13,14,27
30,2,5,57,60,117
2,2,5,4,4,8
13,2,5,25,26,51
30,2,5,74,60,134
4,2,5,10,8,18
26,12,33,357,312,669
3,12,33,41,36,77
20,12,33,275,240,515
18,2,5,41,36,77
13,1,4,37,13,50
21,2,5,49,42,91
11,2,5,26,22,48
30,2,5,71,60,131
21,2,5,49,42,91
19,2,5,44,38,82
28,2,5,64,56,120
25,2,5,73,50,123
19,2,5,55,38,93
19,1,4,54,19,73
1,1,4,3,1,4
17,8,21,207,136,343
20,8,21,243,160,403
1,1482,2384,330,1482,1812
1,1482,2384,401,1482,1883
1,755,1215,302,755,1057
1,1482,2384,807,1482,2289
1,755,1215,436,755,1191
1,755,1215,241,755,996
1,1482,2384,854,1482,2336
1,1482,2384,378,1482,1860
1,461,742,274,461,735
1,461,742,266,461,727
28,3,9,135,84,219
7,3,9,34,21,55
22,2,5,52,44,96
22,2,5,52,44,96
10,2,5,24,20,44
30,2,5,63,60,123
18,2,5,38,36,74
22,2,5,51,44,95
7,2,5,16,14,30
5,2,5,12,10,22
24,2,5,70,48,118
10,2,5,29,20,49
20,2,5,58,40,98
17,2,5,39,34,73
8,2,5,23,16,39
5,2,5,15,10,25
6,2,5,11,12,23
3,2,5,6,6,12
12,2,5,32,24,56
4,4,10,23,16,39
13,4,10,75,52,127
10,3,9,59,30,89
8,3,9,47,24,71
9,3,9,37,27,64
14,3,9,58,42,100
7,2,5,16,14,30
4,2,5,9,8,17
30,4,10,177,120,297
26,2,5,77,52,129
12,2,5,28,24,52
24,2,5,56,48,104
9,7,9,7,63,70
9,7,9,16,63,79
30,7,9,49,210,259
5,7,9,1,35,36
22,7,9,8,154,162
22,7,9,-4,154,150
23,7,9,42,161,203
19,7,9,0,133,133
10,7,9,1,70,71
25,7,9,19,175,194
13,3,8,42,39,81
9,3,8,36,27,63
17,3,8,67,51,118
17,3,8,80,51,131
26,3,8,103,78,181
13,8,22,171,104,275
24,8,22,267,192,459
27,8,22,366,216,582
17,8,22,156,136,292
26,8,22,290,208,498
14,9,24,136,126,262
1,9,24,15,9,24
23,9,24,323,207,530
15,13,35,236,195,431
14,13,35,230,182,412
24,13,35,419,312,731
3,13,35,62,39,101
21,13,35,433,273,706
10,13,35,213,130,343
11,13,35,157,143,300
4,13,35,78,52,130
18,13,35,383,234,617
26,13,35,454,338,792
19,13,35,272,247,519
15,13,35,320,195,515
21,13,35,366,273,639
20,13,35,426,260,686
25,13,35,541,325,866
23,13,35,401,299,700
16,13,35,341,208,549
9,13,35,185,117,302
17,21,55,410,357,767
20,38,50,110,760,870
3,38,50,33,114,147
18,42,54,2,756,758
8,38,50,88,304,392
5,42,54,49,210,259
1,1252,2295,997,1252,2249
1,1252,2295,745,1252,1997
1,1252,2295,722,1252,1974
1,420,769,334,420,754
1,1252,2295,951,1252,2203
1,1266,2320,752,1266,2018
1,1252,2295,951,1252,2203
1,295,540,234,295,529
1,1266,2320,752,1266,2018
1,308,565,184,308,492
1,1266,2320,544,1266,1810
1,1252,2295,538,1252,1790
1,1898,3375,1443,1898,3341
1,2171,3578,1335,2171,3506
1,1519,2443,826,1519,2345
1,1083,1701,210,1083,1293
1,2171,3578,942,2171,3113
1,713,1120,362,713,1075
1,344,540,174,344,518
1,344,540,191,344,535
1,344,540,174,344,518
7,26,70,303,182,485
14,26,70,606,364,970
19,26,70,543,494,1037
4,3,9,24,12,36
30,2,5,87,60,147
14,2,5,41,28,69
18,2,5,52,36,88
16,1,2,15,16,31
11,1,2,8,11,19
27,1,2,19,27,46
20,1,2,15,20,35
6,1,2,6,6,12
17,1,2,16,17,33
21,1,2,20,21,41
15,9,25,191,135,326
14,9,25,179,126,305
7,9,25,89,63,152
25,1,2,16,25,41
5,1,2,3,5,8
18,2,5,48,36,84
22,2,5,58,44,102
11,2,5,26,22,48
9,9,25,115,81,196
5,1,2,4,5,9
14,1,2,12,14,26
25,1,2,25,25,50
24,1,2,24,24,48
8,11,30,142,88,230
2,1,2,1,2,3
23,1,2,13,23,36
7,1,2,4,7,11
12,11,30,149,132,281
2,2,5,5,4,9
4,2,5,9,8,17
28,2,5,66,56,122
13,2,5,25,26,51
12,8,21,123,96,219
30,8,21,308,240,548
27,1,2,19,27,46
27,1,2,19,27,46
17,2,5,32,34,66
5,2,5,14,10,24
24,1,4,68,24,92
26,1,4,74,26,100
1,1482,2384,735,1482,2217
1,1482,2384,592,1482,2074
1,1482,2384,401,1482,1883
1,1482,2384,521,1482,2003
1,1482,2384,592,1482,2074
1,1482,2384,473,1482,1955
1,1482,2384,854,1482,2336
1,755,1215,241,755,996
16,2,5,38,32,70
28,2,5,66,56,122
16,4,10,90,64,154
21,2,5,61,42,103
13,2,5,38,26,64
20,2,5,47,40,87
12,2,5,28,24,52
18,2,5,41,36,77
19,2,5,44,38,82
19,2,5,36,38,74
26,2,5,49,52,101
6,2,5,11,12,23
4,3,9,16,12,28
4,3,9,16,12,28
24,7,9,20,168,188
23,7,9,44,161,205
11,7,9,1,77,78
16,7,9,13,112,125
4,7,9,0,28,28
17,3,8,80,51,131
18,8,22,165,144,309
24,8,22,315,192,507
1,8,22,9,8,17
3,9,24,35,27,62
8,9,24,95,72,167
22,13,35,376,286,662
9,13,35,192,117,309
28,13,35,577,364,941
18,13,35,383,234,617
1,13,35,21,13,34
21,13,35,300,273,573
1,13,35,15,13,28
24,13,35,494,312,806
27,13,35,443,351,794
24,21,55,803,504,1307
13,38,50,13,494,507
14,42,54,9,588,597
30,38,50,300,1140,1440
23,42,54,115,966,1081
1,1252,2295,951,1252,2203
1,1252,2295,951,1252,2203
1,420,769,341,420,761
1,420,769,188,420,608
1,1252,2295,538,1252,1790
1,295,540,126,295,421
1,308,565,184,308,492
1,1555,2443,790,1555,2345
1,1083,1701,550,1083,1633
1,713,1120,250,713,963
1,713,1120,385,713,1098
1,487,783,265,487,752
1,1083,1701,312,1083,1395
20,26,70,866,520,1386
3,26,70,130,78,208
2,26,70,85,52,137
1,26,70,33,26,59
17,2,5,49,34,83
22,2,5,64,44,108
14,13,35,239,182,421
5,13,35,86,65,151
23,2,5,64,46,110
14,2,5,39,28,67
11,1,2,10,11,21
22,1,2,20,22,42
8,1,2,5,8,13
8,1,2,7,8,15
9,1,2,8,9,17
6,1,2,5,6,11
27,1,2,18,27,45
18,1,2,12,18,30
19,11,30,338,209,547
12,11,30,214,132,346
18,13,35,314,234,548
4,13,35,70,52,122
28,1,2,18,28,46
20,1,2,18,20,38
24,1,2,22,24,46
16,11,30,299,176,475
15,11,30,281,165,446
19,2,5,45,38,83
21,2,5,40,42,82
8,2,5,15,16,31
8,11,30,99,88,187
6,11,30,74,66,140
22,1,2,21,22,43
27,1,2,26,27,53
14,2,5,41,28,69
9,1,4,22,9,31
9,45,120,448,405,853
9,4,10,50,36,86
20,4,10,112,80,192
21,2,5,41,42,83
10,2,5,20,20,40
22,2,5,65,44,109
4,2,5,12,8,20
2,2,5,5,4,9
7,2,5,19,14,33
6,2,5,17,12,29
18,2,5,38,36,74
29,2,5,55,58,113
1,2,5,2,2,4
25,4,10,95,100,195
15,4,10,57,60,117
17,4,10,78,68,146
17,7,9,13,119,132
12,7,9,16,84,100
1,7,9,0,7,7
18,7,9,15,126,141
3,7,9,4,21,25
6,3,8,19,18,37
12,3,8,56,36,92
6,3,8,27,18,45
15,3,8,49,45,94
21,8,22,285,168,453
6,8,22,81,48,129
27,8,22,366,216,582
29,8,22,361,232,593
3,9,24,29,27,56
10,9,24,112,90,202
20,9,24,214,180,394
11,9,24,160,99,259
16,13,35,279,208,487
30,13,35,618,390,1008
19,13,35,332,247,579
2,13,35,29,26,55
3,13,35,62,39,101
4,13,35,82,52,134
2,13,35,35,26,61
10,13,35,213,130,343
18,13,35,283,234,517
18,13,35,308,234,542
18,13,35,314,234,548
11,13,35,215,143,358
24,13,35,343,312,655
16,21,55,350,336,686
22,21,55,724,462,1186
6,42,54,66,252,318
10,38,50,100,380,480
20,42,54,13,840,853
17,38,50,68,646,714
28,38,50,322,1064,1386
17,42,54,94,714,808
18,42,54,12,756,768
1,1266,2320,961,1266,2227
1,1252,2295,951,1252,2203
1,1266,2320,1008,1266,2274
1,1252,2295,882,1252,2134
1,308,565,246,308,554
1,344,540,185,344,529
1,1555,2443,717,1555,2272
1,1083,1701,499,1083,1582
1,2171,3578,656,2171,2827
1,2171,3578,835,2171,3006
1,1555,2443,570,1555,2125
1,344,540,120,344,464
1,344,540,185,344,529
1,2171,3578,1335,2171,3506
1,713,1120,172,713,885
24,26,70,703,624,1327
5,26,70,143,130,273
18,26,70,515,468,983
11,1,2,11,11,22
8,2,5,19,16,35
4,2,5,9,8,17
12,2,5,32,24,56
19,2,5,50,38,88
20,2,5,47,40,87
11,2,5,26,22,48
7,2,5,20,14,34
15,2,5,44,30,74
13,2,5,38,26,64
11,9,25,171,99,270
20,9,25,310,180,490
30,2,5,57,60,117
29,2,5,81,58,139
8,2,5,22,16,38
9,2,5,25,18,43
1,1,2,1,1,2
9,2,5,25,18,43
26,2,5,73,52,125
28,1,2,16,28,44
19,1,2,11,19,30
8,1,2,8,8,16
29,1,2,28,29,57
6,1,2,6,6,12
4,2,5,8,8,16
24,1,2,18,24,42
30,2,5,71,60,131
22,2,5,64,44,108
2,2,5,6,4,10
29,1,4,73,29,102
24,9,25,360,216,576
11,9,25,165,99,264
16,2,5,47,32,79
23,1,2,13,23,36
4,1,2,2,4,6
1,1482,2384,592,1482,2074
1,1482,2384,807,1482,2289
1,461,742,185,461,646
1,461,742,229,461,690
2,45,120,97,90,187
1,59,159,98,59,157
11,2,5,26,22,48
10,2,5,19,20,39
27,2,5,51,54,105
26,2,5,49,52,101
3,2,5,6,6,12
19,2,5,45,38,83
19,2,5,45,38,83
24,4,10,139,96,235
29,4,10,168,116,284
8,2,5,24,16,40
14,2,5,41,28,69
4,2,5,9,8,17
30,2,5,71,60,131
15,3,9,72,45,117
18,2,5,42,36,78
3,2,5,6,6,12
4,2,5,8,8,16
8,3,9,45,24,69
29,2,5,84,58,142
9,2,5,26,18,44
18,2,5,50,36,86
11,2,5,31,22,53
7,7,9,13,49,62
27,7,9,22,189,211
4,7,9,4,28,32
13,7,9,25,91,116
19,7,9,11,133,144
13,7,9,11,91,102
17,7,9,28,119,147
4,7,9,3,28,31
1,7,9,1,7,8
11,3,8,53,33,86
20,3,8,97,60,157
20,3,8,71,60,131
17,3,8,55,51,106
11,8,22,120,88,208
8,8,22,108,64,172
26,8,22,358,208,566
26,8,22,358,208,566
25,9,24,369,225,594
4,9,24,58,36,94
11,9,24,160,99,259
24,9,24,354,216,570
1,13,35,21,13,34
12,13,35,260,156,416
12,13,35,260,156,416
28,13,35,577,364,941
6,13,35,130,78,208
2,13,35,41,26,67
24,13,35,520,312,832
14,13,35,254,182,436
25,13,35,436,325,761
21,13,35,455,273,728
6,13,35,86,78,164
10,13,35,206,130,336
8,13,35,170,104,274
16,13,35,341,208,549
6,13,35,105,78,183
28,13,35,577,364,941
20,13,35,398,260,658
8,13,35,114,104,218
17,13,35,243,221,464
23,21,55,757,483,1240
8,21,55,175,168,343
6,42,54,69,252,321
24,38,50,276,912,1188
30,38,50,30,1140,1170
24,42,54,120,1008,1128
9,38,50,104,342,446
9,38,50,50,342,392
27,38,50,27,1026,1053
30,38,50,345,1140,1485
25,42,54,17,1050,1067
29,38,50,319,1102,1421
19,38,50,171,722,893
1,1252,2295,997,1252,2249
1,1266,2320,544,1266,1810
1,1266,2320,636,1266,1902
1,420,769,341,420,761
1,1252,2295,630,1252,1882
1,1266,2320,1008,1266,2274
1,1083,1701,397,1083,1480
1,1555,2443,864,1555,2419
1,344,540,174,344,518
16,26,70,693,416,1109
27,3,9,111,81,192
5,2,5,10,10,20
27,2,5,78,54,132
24,2,5,70,48,118
5,13,35,107,65,172
8,1,2,8,8,16
27,2,5,63,54,117
2,2,5,5,4,9
29,2,5,81,58,139
17,2,5,48,34,82
23,11,30,430,253,683
18,11,30,337,198,535
24,1,2,13,24,37
11,2,5,31,22,53
11,2,5,31,22,53
6,9,25,65,54,119
20,9,25,215,180,395
12,1,2,12,12,24
30,12,33,620,360,980
19,12,33,393,228,621
26,2,5,49,52,101
18,2,5,34,36,70
23,1,2,22,23,45
26,1,2,20,26,46
20,1,2,16,20,36
16,1,2,12,16,28
20,1,2,15,20,35
2,2,5,6,4,10
17,2,5,40,34,74
4,2,5,9,8,17
6,9,25,95,54,149
19,9,25,299,171,470
3,1,4,9,3,12
16,1,4,45,16,61
15,2,5,35,30,65
3,2,5,7,6,13
23,1,2,17,23,40
1,1,2,1,1,2
18,2,5,53,36,89
13,2,5,38,26,64
28,1,4,59,28,87
28,1,2,27,28,55
29,1,2,28,29,57
11,1,2,7,11,18
24,1,2,15,24,39
21,12,33,427,252,679
15,12,33,305,180,485
5,1,2,5,5,10
8,1,2,8,8,16
14,2,5,41,28,69
4,2,5,11,8,19
20,2,5,54,40,94
11,1,2,8,11,19
16,1,2,9,16,25
24,1,2,13,24,37
29,1,2,16,29,45
14,1,4,41,14,55
22,1,4,64,22,86
1,1,4,3,1,4
7,1,4,20,7,27
1,461,742,266,461,727
1,461,742,118,461,579
1,1482,2384,807,1482,2289
15,45,120,1089,675,1764
3,45,120,160,135,295
8,3,9,43,24,67
19,3,9,102,57,159
3,2,5,6,6,12
12,2,5,23,24,47
18,2,5,52,36,88
28,2,5,81,56,137
7,2,5,21,14,35
3,2,5,9,6,15
25,3,9,141,75,216
18,3,9,102,54,156
17,2,5,48,34,82
20,3,9,116,60,176
8,3,9,47,24,71
13,3,9,73,39,112
14,2,5,41,28,69
13,2,5,38,26,64
30,2,5,66,60,126
16,7,9,6,112,118
11,7,9,15,77,92
10,7,9,19,70,89
30,7,9,25,210,235
3,7,9,2,21,23
3,7,9,5,21,26
19,3,8,75,57,132
16,3,8,77,48,125
15,3,8,50,45,95
22,3,8,71,66,137
16,8,22,217,128,345
16,8,22,217,128,345
2,8,22,25,16,41
29,8,22,323,232,555
5,8,22,52,40,92
5,9,24,67,45,112
6,9,24,87,54,141
5,13,35,107,65,172
5,13,35,73,65,138
2,13,35,39,26,65
21,13,35,330,273,603
29,13,35,425,377,802
13,13,35,277,169,446
30,13,35,618,390,1008
28,13,35,596,364,960
10,13,35,196,130,326
9,13,35,192,117,309
24,13,35,419,312,731
24,13,35,520,312,832
24,13,35,511,312,823
21,13,35,447,273,720
27,13,35,575,351,926
18,13,35,283,234,517
25,13,35,358,325,683
14,13,35,298,182,480
2,13,35,29,26,55
21,13,35,433,273,706
3,13,35,64,39,103
24,13,35,511,312,823
9,13,35,192,117,309
1,13,35,14,13,27
26,21,55,584,546,1130
17,38,50,196,646,842
21,42,54,48,882,930
20,42,54,100,840,940
3,38,50,30,114,144
14,42,54,9,588,597
1,1252,2295,882,1252,2134
1,420,769,334,420,754
1,295,540,148,295,443
1,1266,2320,1008,1266,2274
1,1266,2320,892,1266,2158
1,1266,2320,1008,1266,2274
1,1252,2295,882,1252,2134
1,1252,2295,745,1252,1997
1,420,769,249,420,669
1,308,565,246,308,554
1,295,540,126,295,421
1,1555,2443,570,1555,2125
1,344,540,185,344,529
1,2171,3578,835,2171,3006
1,2171,3578,656,2171,2827
1,713,1120,161,713,874
1,713,1120,385,713,1098
1,713,1120,205,713,918
1,1555,2443,375,1555,1930
1,713,1120,362,713,1075
1,344,540,185,344,529
1,344,540,185,344,529
1,344,540,99,344,443
1,1083,1701,550,1083,1633
1,713,1120,362,713,1075
27,26,70,772,702,1474
12,3,9,49,36,85
11,3,9,64,33,97
21,13,35,447,273,720
21,1,2,20,21,41
24,1,2,23,24,47
28,1,4,80,28,108
21,1,4,60,21,81
7,2,5,20,14,34
18,2,5,50,36,86
13,8,21,112,104,216
23,8,21,198,184,382
16,2,5,47,32,79
1,9,25,11,9,20
16,9,25,172,144,316
4,12,33,79,48,127
30,12,33,590,360,950
16,12,33,315,192,507
27,13,35,575,351,926
4,13,35,70,52,122
4,1,2,3,4,7
19,1,2,14,19,33
21,12,33,434,252,686
24,12,33,496,288,784
26,2,5,49,52,101
18,2,5,34,36,70
10,2,5,30,20,50
24,2,5,50,48,98
3,2,5,7,6,13
8,2,5,19,16,35
3,2,5,9,6,15
17,2,5,49,34,83
14,9,25,179,126,305
17,9,25,217,153,370
1,9,25,13,9,22
22,1,2,16,22,38
12,1,2,9,12,21
15,12,33,226,180,406
1,12,33,15,12,27
21,1,2,16,21,37
1,2,5,2,2,4
2,2,5,4,4,8
3,2,5,6,6,12
17,1,2,15,17,32
24,1,2,21,24,45
7,8,21,72,56,128
11,2,5,21,22,43
20,2,5,38,40,78
15,11,29,192,165,357
6,11,29,77,66,143
26,1,2,22,26,48
20,8,21,243,160,403
13,8,21,158,104,262
2,2,5,4,4,8
16,2,5,30,32,62
4,2,5,9,8,17
1,1482,2384,401,1482,1883
1,1482,2384,807,1482,2289
1,755,1215,436,755,1191
1,1482,2384,854,1482,2336
1,461,742,185,461,646
1,461,742,266,461,727
5,24,64,130,120,250
12,24,64,449,288,737
2,45,120,100,90,190
6,45,120,349,270,619
7,45,120,323,315,638
12,4,10,67,48,115
20,2,5,39,40,79
8,2,5,16,16,32
7,2,5,20,14,34
4,2,5,11,8,19
26,4,10,146,104,250
5,4,10,28,20,48
30,2,5,71,60,131
25,2,5,59,50,109
10,4,10,59,40,99
29,2,5,68,58,126
23,2,5,54,46,100
6,3,9,27,18,45
26,3,9,119,78,197
11,2,5,32,22,54
28,2,5,81,56,137
26,2,5,75,52,127
9,2,5,26,18,44
25,2,5,59,50,109
18,4,10,68,72,140
13,4,10,49,52,101
11,2,5,32,22,54
11,2,5,32,22,54
15,2,5,44,30,74
25,2,5,53,50,103
14,2,5,29,28,57
14,2,5,37,28,65
25,2,5,66,50,116
7,2,5,20,14,34
3,2,5,8,6,14
8,2,5,22,16,38
19,3,9,112,57,169
23,3,9,136,69,205
5,3,9,20,15,35
8,3,9,32,24,56
28,2,5,62,56,118
11,2,5,24,22,46
4,2,5,11,8,19
17,2,5,48,34,82
23,3,9,111,69,180
27,3,9,130,81,211
9,2,5,26,18,44
27,3,9,130,81,211
24,3,9,116,72,188
3,7,9,2,21,23
23,7,9,19,161,180
24,7,9,0,168,168
4,7,9,7,28,35
2,7,9,4,14,18
1,7,9,2,7,9
8,7,9,15,56,71
18,7,9,33,126,159
11,7,9,9,77,86
21,7,9,40,147,187
25,7,9,10,175,185
4,7,9,3,28,31
2,7,9,4,14,18
21,7,9,40,147,187
11,3,8,51,33,84
30,3,8,148,90,238
13,3,8,61,39,100
4,8,22,44,32,76
22,8,22,202,176,378
23,8,22,302,184,486
1,8,22,14,8,22
26,8,22,238,208,446
30,8,22,301,240,541
14,8,22,128,112,240
22,8,22,303,176,479
23,8,22,256,184,440
3,9,24,44,27,71
19,9,24,212,171,383
12,9,24,120,108,228
7,9,24,103,63,166
18,9,24,175,162,337
18,9,24,261,162,423
28,9,24,373,252,625
29,9,24,338,261,599
29,9,24,345,261,606
18,13,35,264,234,498
3,13,35,62,39,101
13,13,35,213,169,382
11,13,35,238,143,381
14,13,35,274,182,456
29,13,35,597,377,974
14,13,35,288,182,470
24,13,35,494,312,806
21,13,35,300,273,573
26,13,35,536,338,874
1,13,35,22,13,35
4,13,35,71,52,123
9,13,35,176,117,293
22,13,35,376,286,662
10,13,35,213,130,343
8,13,35,131,104,235
3,13,35,51,39,90
2,13,35,43,26,69
9,13,35,157,117,274
2,13,35,35,26,61
23,13,35,377,299,676
16,13,35,285,208,493
29,13,35,506,377,883
3,13,35,47,39,86
15,13,35,246,195,441
21,13,35,455,273,728
4,13,35,87,52,139
28,13,35,479,364,843
1,13,35,20,13,33
3,13,35,62,39,101
8,13,35,140,104,244
2,13,35,31,26,57
22,21,55,724,462,1186
17,21,55,541,357,898
9,21,55,301,189,490
9,21,55,242,189,431
23,21,55,757,483,1240
1,21,55,33,21,54
24,21,55,644,504,1148
24,21,55,644,504,1148
3,21,55,72,63,135
7,42,54,69,294,363
5,38,50,55,190,245
13,38,50,65,494,559
12,38,50,120,456,576
4,38,50,4,152,156
10,42,54,109,420,529
20,38,50,200,760,960
30,38,50,330,1140,1470
28,38,50,280,1064,1344
19,38,50,29,722,751
29,42,54,332,1218,1550
23,38,50,115,874,989
29,38,50,87,1102,1189
20,42,54,100,840,940
10,42,54,82,420,502
1,1912,3400,944,1912,2856
1,1252,2295,1020,1252,2272
1,1898,3375,937,1898,2835
1,1266,2320,961,1266,2227
1,1266,2320,961,1266,2227
1,1252,2295,745,1252,1997
1,1266,2320,1008,1266,2274
1,1252,2295,997,1252,2249
1,1252,2295,538,1252,1790
1,1252,2295,951,1252,2203
1,1252,2295,676,1252,1928
1,1252,2295,1020,1252,2272
1,308,565,184,308,492
1,1252,2295,997,1252,2249
1,1252,2295,951,1252,2203
1,1252,2295,538,1252,1790
1,1266,2320,961,1266,2227
1,1266,2320,752,1266,2018
1,487,783,280,487,767
1,1555,2443,790,1555,2345
1,1519,2443,753,1519,2272
1,2171,3578,942,2171,3113
1,713,1120,362,713,1075
1,2171,3578,942,2171,3113
1,1519,2443,533,1519,2052
1,344,540,174,344,518
1,344,540,174,344,518
1,713,1120,138,713,851
1,1083,1701,584,1083,1667
1,1519,2443,411,1519,1930
1,1083,1701,312,1083,1395
1,344,540,131,344,475
1,487,783,194,487,681
1,1083,1701,550,1083,1633
1,344,540,99,344,443
1,487,783,194,487,681
1,344,540,174,344,518
1,344,540,126,344,470
1,2171,3578,656,2171,2827
4,26,70,131,104,235
11,26,70,469,286,755
23,26,70,803,598,1401
6,3,9,35,18,53
21,3,9,113,63,176
5,3,9,29,15,44
17,3,9,82,51,133
12,1,4,25,12,37
22,1,4,47,22,69
7,1,4,15,7,22
17,8,21,146,136,282
6,1,2,6,6,12
20,2,5,59,40,99
5,1,2,5,5,10
18,1,2,17,18,35
29,1,2,21,29,50
16,1,2,12,16,28
3,12,33,59,36,95
7,2,5,16,14,30
17,1,2,13,17,30
28,1,2,21,28,49
5,12,33,98,60,158
16,1,2,9,16,25
1,11,29,18,11,29
25,1,2,18,25,43
12,1,2,9,12,21
30,1,4,71,30,101
5,2,5,10,10,20
2,2,5,5,4,9
21,2,5,48,42,90
3,2,5,6,6,12
7,1,2,7,7,14
23,2,5,68,46,114
19,9,25,219,171,390
29,1,2,27,29,56
18,1,2,17,18,35
7,12,33,110,84,194
22,12,33,346,264,610
17,12,33,267,204,471
18,13,35,257,234,491
11,2,5,32,22,54
2,2,5,6,4,10
23,1,4,68,23,91
5,1,4,15,5,20
21,11,30,386,231,617
9,11,30,166,99,265
14,1,2,10,14,24
10,1,2,7,10,17
22,1,2,16,22,38
11,1,2,8,11,19
12,1,2,9,12,21
7,2,5,15,14,29
25,2,5,55,50,105
21,2,5,61,42,103
12,1,2,11,12,23
3,9,25,47,27,74
28,1,2,26,28,54
23,1,2,21,23,44
21,1,2,19,21,40
28,1,2,26,28,54
18,1,2,17,18,35
29,1,2,22,29,51
24,13,35,352,312,664
24,13,35,352,312,664
18,13,35,264,234,498
30,2,5,63,60,123
3,2,5,6,6,12
17,2,5,49,34,83
5,1,2,5,5,10
19,2,5,56,38,94
16,2,5,47,32,79
11,2,5,29,22,51
26,2,5,57,52,109
28,2,5,83,56,139
24,1,4,65,24,89
26,1,2,24,26,50
10,1,2,9,10,19
30,1,4,71,30,101
6,1,4,18,6,24
14,1,4,32,14,46
25,1,4,57,25,82
8,1,4,24,8,32
10,1,4,30,10,40
8,9,25,120,72,192
27,9,25,405,243,648
16,8,21,201,128,329
2,8,21,25,16,41
17,1,4,42,17,59
10,8,21,126,80,206
30,1,4,73,30,103
25,1,4,61,25,86
15,1,2,11,15,26
20,1,2,14,20,34
25,1,2,18,25,43
8,1,2,7,8,15
8,1,2,7,8,15
20,1,2,11,20,31
11,1,4,32,11,43
1,755,1215,411,755,1166
1,461,742,251,461,712
1,1482,2384,878,1482,2360
1,1482,2384,473,1482,1955
1,1482,2384,854,1482,2336
1,1482,2384,592,1482,2074
1,755,1215,290,755,1045
1,1482,2384,854,1482,2336
1,1482,2384,854,1482,2336
1,461,742,229,461,690
1,1482,2384,807,1482,2289
9,24,64,337,216,553
15,24,64,475,360,835
3,45,120,218,135,353
7,45,120,340,315,655
11,2,5,21,22,43
24,2,5,46,48,94
10,2,5,28,20,48
6,2,5,17,12,29
18,3,9,102,54,156
13,2,5,38,26,64
10,2,5,27,20,47
7,2,5,13,14,27
2,2,5,4,4,8
14,2,5,39,28,67
23,2,5,64,46,110
16,3,9,76,48,124
26,3,9,123,78,201
22,2,5,43,44,87
1,2,5,2,2,4
26,4,10,122,104,226
24,4,10,113,96,209
21,2,5,59,42,101
8,2,5,22,16,38
12,3,9,64,36,100
11,3,9,59,33,92
28,3,9,123,84,207
7,3,9,31,21,52
2,7,9,3,14,17
10,7,9,0,70,70
21,7,9,38,147,185
12,7,9,22,84,106
2,7,9,3,14,17
2,7,9,1,14,15
17,7,9,28,119,147
17,8,22,231,136,367
4,8,22,37,32,69
4,8,22,37,32,69
29,8,22,291,232,523
19,8,22,258,152,410
26,8,22,353,208,561
17,9,24,247,153,400
4,9,24,59,36,95
6,13,35,88,78,166
7,13,35,103,91,194
2,13,35,31,26,57
6,13,35,86,78,164
26,13,35,554,338,892
27,13,35,575,351,926
23,13,35,474,299,773
9,13,35,122,117,239
15,13,35,293,195,488
21,13,35,433,273,706
12,13,35,205,156,361
8,13,35,156,104,260
3,13,35,52,39,91
17,13,35,350,221,571
24,21,55,763,504,1267
14,21,55,337,294,631
11,38,50,17,418,435
9,42,54,89,378,467
5,42,54,3,210,213
23,38,50,69,874,943
20,38,50,220,760,980
12,38,50,12,456,468
5,42,54,55,210,265
6,42,54,66,252,318
1,1898,3375,1038,1898,2936
1,1252,2295,561,1252,1813
1,420,769,249,420,669
1,1252,2295,538,1252,1790
1,420,769,318,420,738
1,1252,2295,997,1252,2249
1,308,565,246,308,554
1,713,1120,362,713,1075
1,1519,2443,484,1519,2003
1,2171,3578,656,2171,2827
1,1519,2443,606,1519,2125
1,1555,2443,570,1555,2125
1,344,540,185,344,529
1,344,540,174,344,518
1,713,1120,362,713,1075
1,344,540,126,344,470
11,26,70,469,286,755
25,26,70,1065,650,1715
12,26,70,511,312,823
17,3,9,96,51,147
27,3,9,157,81,238
18,3,9,85,54,139
23,13,35,337,299,636
24,12,33,472,288,760
30,12,33,590,360,950
14,1,2,9,14,23
14,13,35,239,182,421
24,13,35,410,312,722
2,2,5,5,4,9
2,2,5,5,4,9
7,2,5,16,14,30
22,1,2,12,22,34
22,11,30,405,242,647
16,11,30,294,176,470
8,2,5,23,16,39
17,2,5,49,34,83
7,2,5,20,14,34
18,9,25,284,162,446
20,9,25,315,180,495
4,2,5,7,8,15
20,1,2,20,20,40
6,1,2,6,6,12
9,1,4,24,9,33
2,1,4,6,2,8
6,1,4,17,6,23
2,2,5,6,4,10
5,2,5,15,10,25
20,1,4,57,20,77
27,1,4,77,27,104
30,8,21,365,240,605
3,8,21,36,24,60
1,755,1215,241,755,996
1,1482,2384,568,1482,2050
1,755,1215,375,755,1130
1,1482,2384,807,1482,2289
19,24,64,736,456,1192
8,4,10,45,32,77
7,4,10,39,28,67
18,4,10,106,72,178
21,3,9,122,63,185
25,3,9,146,75,221
11,2,5,32,22,54
11,2,5,31,22,53
27,3,9,118,81,199
1,3,9,4,3,7
9,4,10,53,36,89
18,4,10,106,72,178
17,2,5,42,34,76
26,4,10,151,104,255
13,2,5,25,26,51
2,2,5,4,4,8
13,2,5,38,26,64
13,2,5,38,26,64
3,2,5,6,6,12
11,2,5,32,22,54
6,2,5,18,12,30
17,2,5,33,34,67
14,2,5,27,28,55
23,7,9,38,161,199
17,7,9,17,119,136
1,7,9,0,7,7
1,7,9,2,7,9
20,7,9,2,140,142
27,3,8,105,81,186
22,3,8,108,66,174
1,3,8,5,3,8
7,8,22,95,56,151
30,8,22,407,240,647
4,8,22,45,32,77
29,8,22,291,232,523
8,8,22,89,64,153
5,9,24,53,45,98
24,9,24,320,216,536
11,9,24,162,99,261
15,9,24,167,135,302
9,13,35,192,117,309
20,13,35,342,260,602
19,13,35,312,247,559
7,13,35,149,91,240
28,13,35,596,364,960
17,13,35,362,221,583
7,13,35,149,91,240
29,13,35,455,377,832
8,13,35,173,104,277
19,13,35,298,247,545
17,13,35,243,221,464
26,13,35,554,338,892
23,13,35,361,299,660
19,13,35,391,247,638
7,13,35,149,91,240
14,21,55,461,294,755
2,21,55,67,42,109
12,38,50,102,456,558
3,38,50,35,114,149
29,42,54,332,1218,1550
4,42,54,24,168,192
11,42,54,25,462,487
21,42,54,207,882,1089
20,38,50,110,760,870
19,38,50,105,722,827
5,38,50,28,190,218
1,1898,3375,1038,1898,2936
1,1252,2295,745,1252,1997
1,1266,2320,1008,1266,2274
1,1266,2320,1031,1266,2297
1,1266,2320,636,1266,1902
1,1266,2320,961,1266,2227
1,295,540,234,295,529
1,1898,3375,1038,1898,2936
1,2171,3578,1157,2171,3328
1,1555,2443,448,1555,2003
1,713,1120,362,713,1075
1,487,783,155,487,642
1,1555,2443,448,1555,2003
1,344,540,77,344,421
1,1083,1701,397,1083,1480
1,2171,3578,1335,2171,3506
28,26,70,801,728,1529
23,3,9,109,69,178
12,3,9,71,36,107
11,2,5,32,22,54
11,2,5,32,22,54
16,2,5,47,32,79
21,2,5,62,42,104
9,13,35,195,117,312
16,13,35,346,208,554
4,1,2,4,4,8
10,1,2,10,10,20
18,12,33,271,216,487
5,12,33,75,60,135
8,1,2,8,8,16
7,2,5,21,14,35
6,2,5,18,12,30
1,2,5,3,2,5
28,2,5,53,56,109
24,2,5,46,48,94
15,1,2,9,15,24
4,1,2,2,4,6
12,2,5,25,24,49
6,2,5,14,12,26
6,2,5,14,12,26
7,8,21,60,56,116
20,12,33,275,240,515
3,12,33,41,36,77
28,9,25,315,252,567
19,1,2,11,19,30
4,1,4,9,4,13
17,2,5,39,34,73
8,2,5,18,16,34
19,8,21,175,152,327
7,8,21,65,56,121
14,2,5,27,28,55
17,2,5,32,34,66
11,1,4,32,11,43
27,1,4,79,27,106
1,461,742,147,461,608
1,1482,2384,854,1482,2336
1,461,742,266,461,727
4,24,64,111,96,207
4,45,120,290,180,470
8,45,120,398,360,758
8,2,5,15,16,31
1,2,5,2,2,4
5,2,5,15,10,25
26,2,5,77,52,129
5,2,5,15,10,25
6,2,5,18,12,30
16,2,5,46,32,78
22,2,5,64,44,108
4,2,5,11,8,19
19,2,5,53,38,91
20,2,5,58,40,98
22,2,5,64,44,108
17,4,10,99,68,167
16,4,10,93,64,157
1,4,10,6,4,10
18,2,5,52,36,88
24,4,10,91,96,187
9,4,10,34,36,70
20,2,5,58,40,98
6,2,5,17,12,29
30,2,5,59,60,119
27,2,5,53,54,107
10,2,5,24,20,44
16,2,5,38,32,70
26,3,9,123,78,201
13,3,9,62,39,101
20,2,5,39,40,79
20,3,9,80,60,140
14,3,9,56,42,98
28,7,9,46,196,242
8,7,9,0,56,56
13,7,9,11,91,102
29,7,9,55,203,258
14,7,9,12,98,110
12,7,9,16,84,100
4,3,8,19,12,31
14,3,8,54,42,96
16,3,8,77,48,125
28,3,8,91,84,175
9,8,22,82,72,154
25,8,22,251,200,451
26,8,22,227,208,435
7,8,22,78,56,134
9,8,22,124,72,196
1,9,24,10,9,19
25,9,24,351,225,576
25,9,24,291,225,516
16,13,35,279,208,487
3,13,35,62,39,101
14,13,35,190,182,372
20,13,35,356,260,616
8,13,35,140,104,244
22,13,35,476,286,762
24,13,35,511,312,823
11,13,35,157,143,300
29,13,35,455,377,832
23,13,35,490,299,789
6,13,35,128,78,206
21,13,35,447,273,720
22,13,35,376,286,662
13,21,55,428,273,701
13,21,55,413,273,686
12,42,54,138,504,642
12,38,50,138,456,594
13,42,54,128,546,674
14,38,50,140,532,672
29,42,54,97,1218,1315
11,42,54,120,462,582
1,1898,3375,1038,1898,2936
1,420,769,249,420,669
1,308,565,234,308,542
1,1252,2295,492,1252,1744
1,1083,1701,584,1083,1667
1,1083,1701,244,1083,1327
1,2171,3578,835,2171,3006
1,1519,2443,606,1519,2125
1,1519,2443,533,1519,2052
1,2171,3578,1335,2171,3506
1,713,1120,205,713,918
1,487,783,132,487,619
1,344,540,126,344,470
1,2171,3578,1335,2171,3506
17,3,9,100,51,151
19,13,35,405,247,652
8,12,33,150,96,246
14,11,29,179,154,333
2,9,25,22,18,40
25,9,25,269,225,494
26,2,5,61,52,113
22,2,5,52,44,96
21,1,2,16,21,37
11,1,2,8,11,19
19,11,29,320,209,529
21,11,29,354,231,585
21,2,5,49,42,91
8,2,5,19,16,35
25,1,2,19,25,44
20,1,2,20,20,40
28,1,2,27,28,55
5,2,5,13,10,23
9,2,5,24,18,42
6,2,5,16,12,28
7,2,5,20,14,34
2,2,5,6,4,10
19,2,5,53,38,91
15,2,5,32,30,62
3,2,5,6,6,12
20,2,5,42,40,82
25,11,29,399,275,674
28,11,29,447,308,755
13,11,29,208,143,351
11,11,30,136,121,257
2,11,30,27,22,49
28,1,2,24,28,52
7,1,2,6,7,13
8,1,2,8,8,16
27,1,2,26,27,53
18,12,33,247,216,463
18,2,5,50,36,86
30,2,5,84,60,144
22,2,5,62,44,106
5,2,5,10,10,20
4,2,5,12,8,20
6,8,21,75,48,123
25,2,5,58,50,108
19,1,2,12,19,31
17,1,2,11,17,28
1,461,742,125,461,586
1,1482,2384,807,1482,2289
1,461,742,185,461,646
1,1482,2384,735,1482,2217
1,461,742,118,461,579
11,24,64,327,264,591
24,24,64,684,576,1260
4,2,5,12,8,20
19,2,5,45,38,83
26,2,5,61,52,113
8,2,5,24,16,40
24,2,5,67,48,115
26,2,5,73,52,125
20,4,10,84,80,164
16,4,10,67,64,131
25,4,10,148,100,248
28,3,9,163,84,247
23,3,9,134,69,203
12,2,5,35,24,59
7,2,5,20,14,34
19,2,5,55,38,93
4,2,5,11,8,19
8,2,5,22,16,38
29,2,5,68,58,126
8,2,5,19,16,35
19,2,5,44,38,82
25,2,5,58,50,108
25,2,5,74,50,124
20,2,5,46,40,86
24,2,5,55,48,103
17,7,9,10,119,129
29,7,9,16,203,219
26,7,9,22,182,204
15,7,9,6,105,111
24,7,9,33,168,201
15,7,9,0,105,105
20,7,9,8,140,148
2,3,8,7,6,13
6,8,22,81,48,129
19,8,22,262,152,414
5,8,22,46,40,86
16,8,22,217,128,345
29,8,22,291,232,523
19,8,22,258,152,410
27,8,22,366,216,582
15,13,35,215,195,410
7,13,35,120,91,211
3,13,35,51,39,90
12,13,35,209,156,365
19,13,35,391,247,638
8,13,35,173,104,277
27,13,35,585,351,936
16,13,35,313,208,521
16,13,35,330,208,538
2,13,35,34,26,60
30,13,35,471,390,861
3,13,35,59,39,98
9,13,35,185,117,302
11,13,35,180,143,323
12,13,35,184,156,340
18,13,35,371,234,605
24,13,35,469,312,781
19,21,55,625,399,1024
27,42,54,295,1134,1429
1,38,50,5,38,43
12,42,54,8,504,512
28,38,50,154,1064,1218
22,38,50,220,836,1056
22,42,54,3,924,927
13,38,50,111,494,605
3,42,54,34,126,160
28,38,50,70,1064,1134
1,420,769,334,420,754
1,420,769,318,420,738
1,308,565,234,308,542
1,1252,2295,882,1252,2134
1,1266,2320,636,1266,1902
1,295,540,234,295,529
1,1266,2320,1008,1266,2274
1,1555,2443,375,1555,1930
1,713,1120,194,713,907
14,9,25,151,126,277
14,13,35,298,182,480
18,13,35,390,234,624
5,1,2,5,5,10
23,1,2,23,23,46
17,1,2,17,17,34
22,2,5,65,44,109
18,2,5,53,36,89
15,2,5,44,30,74
2,2,5,6,4,10
8,12,33,150,96,246
8,13,35,140,104,244
22,11,29,351,242,593
28,2,5,83,56,139
5,2,5,15,10,25
21,2,5,62,42,104
20,2,5,38,40,78
22,2,5,42,44,86
12,2,5,35,24,59
28,2,5,83,56,139
11,2,5,32,22,54
3,1,2,3,3,6
3,1,2,3,3,6
30,2,5,57,60,117
14,11,30,174,154,328
24,1,2,17,24,41
14,2,5,29,28,57
23,8,21,265,184,449
3,1,4,9,3,12
30,1,4,85,30,115
6,8,21,62,48,110
5,8,21,51,40,91
29,2,5,84,58,142
8,8,21,74,64,138
27,2,5,76,54,130
13,2,5,36,26,62
15,1,4,43,15,58
16,1,4,45,16,61
10,1,4,24,10,34
4,1,4,10,4,14
1,755,1215,266,755,1021
1,1482,2384,878,1482,2360
1,1482,2384,807,1482,2289
1,1482,2384,807,1482,2289
1,461,742,118,461,579
1,755,1215,375,755,1130
1,461,742,147,461,608
1,461,742,229,461,690
4,24,64,157,96,253
29,24,64,826,696,1522
7,24,64,276,168,444
18,4,10,85,72,157
16,4,10,75,64,139
2,2,5,6,4,10
30,2,5,89,60,149
7,2,5,21,14,35
15,2,5,44,30,74
2,2,5,6,4,10
26,2,5,73,52,125
30,2,5,84,60,144
12,2,5,34,24,58
13,2,5,36,26,62
9,2,5,25,18,43
3,2,5,9,6,15
18,2,5,38,36,74
30,2,5,63,60,123
14,3,9,81,42,123
19,3,9,111,57,168
7,2,5,16,14,30
5,2,5,12,10,22
26,2,5,51,52,103
24,2,5,47,48,95
30,2,5,87,60,147
25,2,5,73,50,123
30,2,5,89,60,149
28,2,5,83,56,139
20,7,9,17,140,157
1,7,9,0,7,7
21,7,9,8,147,155
9,7,9,17,63,80
20,3,8,65,60,125
20,3,8,97,60,157
13,8,22,136,104,240
16,8,22,220,128,348
22,8,22,289,176,465
17,8,22,189,136,325
13,9,24,145,117,262
15,9,24,149,135,284
13,13,35,190,169,359
23,13,35,329,299,628
22,13,35,361,286,647
16,13,35,346,208,554
23,13,35,361,299,660
20,13,35,314,260,574
4,13,35,87,52,139
18,13,35,390,234,624
3,13,35,62,39,101
13,13,35,277,169,446
30,13,35,639,390,1029
10,13,35,175,130,305
25,13,35,393,325,718
21,13,35,433,273,706
9,13,35,192,117,309
16,13,35,330,208,538
13,13,35,190,169,359
20,13,35,286,260,546
12,13,35,205,156,361
7,13,35,115,91,206
26,21,55,698,546,1244
3,38,50,30,114,144
9,38,50,50,342,392
15,38,50,83,570,653
23,42,54,15,966,981
18,38,50,180,684,864
22,38,50,253,836,1089
27,42,54,266,1134,1400
24,38,50,264,912,1176
1,42,54,11,42,53
2,38,50,23,76,99
1,1252,2295,997,1252,2249
1,1252,2295,745,1252,1997
1,1252,2295,951,1252,2203
1,1252,2295,561,1252,1813
1,1266,2320,961,1266,2227
1,1266,2320,961,1266,2227
1,308,565,178,308,486
1,420,769,211,420,631
1,1252,2295,951,1252,2203
1,2171,3578,763,2171,2934
1,2171,3578,1264,2171,3435
1,487,783,155,487,642
1,1519,2443,411,1519,1930
1,1519,2443,533,1519,2052
1,713,1120,228,713,941
1,2171,3578,1335,2171,3506
21,26,70,865,546,1411
8,26,70,341,208,549
15,26,70,639,390,1029
21,3,9,122,63,185
11,2,5,23,22,45
21,2,5,44,42,86
16,2,5,47,32,79
18,11,30,256,198,454
13,12,33,256,156,412
29,12,33,571,348,919
5,1,2,5,5,10
4,1,2,4,4,8
17,12,33,256,204,460
30,12,33,452,360,812
27,2,5,51,54,105
7,2,5,13,14,27
2,9,25,31,18,49
1,9,25,16,9,25
9,9,25,142,81,223
13,1,2,10,13,23
6,1,2,4,6,10
27,1,2,20,27,47
24,13,35,394,312,706
4,8,21,41,32,73
26,8,21,267,208,475
21,8,21,216,168,384
6,2,5,17,12,29
28,2,5,81,56,137
2,2,5,6,4,10
20,1,2,18,20,38
6,11,30,110,66,176
11,2,5,32,22,54
25,2,5,73,50,123
10,1,4,24,10,34
22,1,4,54,22,76
8,1,2,8,8,16
7,1,2,7,7,14
11,1,4,27,11,38
7,1,4,15,7,22
20,1,2,14,20,34
2,1,2,1,2,3
27,13,35,396,351,747
17,13,35,249,221,470
18,1,2,10,18,28
1,1482,2384,878,1482,2360
1,461,742,125,461,586
17,24,64,669,408,1077
4,2,5,11,8,19
6,2,5,16,12,28
14,2,5,27,28,55
27,4,10,105,108,213
14,2,5,41,28,69
23,2,5,68,46,114
12,2,5,35,24,59
8,2,5,23,16,39
24,2,5,70,48,118
1,2,5,3,2,5
6,2,5,17,12,29
3,2,5,9,6,15
24,3,9,96,72,168
30,4,10,174,120,294
28,4,10,162,112,274
17,2,5,50,34,84
1,2,5,3,2,5
15,2,5,44,30,74
14,2,5,41,28,69
29,2,5,86,58,144
25,3,9,103,75,178
11,3,9,45,33,78
3,2,5,8,6,14
7,2,5,20,14,34
30,2,5,84,60,144
22,7,9,0,154,154
2,7,9,4,14,18
14,7,9,23,98,121
3,7,9,1,21,22
11,7,9,0,77,77
16,7,9,13,112,125
5,7,9,4,35,39
23,7,9,32,161,193
5,3,8,24,15,39
4,3,8,19,12,31
29,8,22,400,232,632
17,8,22,156,136,292
6,8,22,81,48,129
29,8,22,272,232,504
24,8,22,331,192,523
4,8,22,54,32,86
8,8,22,73,64,137
15,8,22,207,120,327
12,9,24,177,108,285
4,9,24,58,36,94
16,9,24,232,144,376
19,13,35,411,247,658
1,13,35,17,13,30
29,13,35,577,377,954
21,13,35,455,273,728
2,13,35,31,26,57
2,13,35,41,26,67
25,13,35,436,325,761
26,13,35,536,338,874
11,13,35,157,143,300
30,13,35,618,390,1008
26,13,35,563,338,901
2,13,35,31,26,57
11,13,35,238,143,381
6,13,35,105,78,183
23,13,35,353,299,652
28,13,35,577,364,941
6,13,35,105,78,183
29,13,35,597,377,974
7,13,35,137,91,228
21,21,55,564,441,1005
10,21,55,329,210,539
7,42,54,1,294,295
20,38,50,110,760,870
28,42,54,245,1176,1421
24,38,50,264,912,1176
11,42,54,120,462,582
19,38,50,219,722,941
4,42,54,13,168,181
23,42,54,251,966,1217
20,38,50,200,760,960
25,38,50,250,950,1200
1,42,54,11,42,53
1,38,50,12,38,50
3,42,54,10,126,136
22,38,50,253,836,1089
1,1266,2320,636,1266,1902
1,420,769,318,420,738
1,420,769,341,420,761
1,295,540,132,295,427
1,1252,2295,951,1252,2203
1,295,540,126,295,421
1,308,565,251,308,559
1,1266,2320,1008,1266,2274
1,713,1120,385,713,1098
1,1519,2443,826,1519,2345
1,1083,1701,584,1083,1667
1,2171,3578,835,2171,3006
1,1519,2443,606,1519,2125
1,344,540,185,344,529
1,344,540,93,344,437
1,487,783,132,487,619
1,713,1120,228,713,941
1,713,1120,329,713,1042
29,26,70,829,754,1583
8,26,70,274,208,482
6,3,9,35,18,53
30,3,9,121,90,211
2,1,2,1,2,3
22,1,2,12,22,34
22,13,35,315,286,601
19,1,2,19,19,38
21,1,2,21,21,42
8,2,5,15,16,31
6,2,5,11,12,23
6,12,33,90,72,162
21,12,33,316,252,568
24,2,5,71,48,119
29,2,5,86,58,144
21,2,5,62,42,104
30,2,5,84,60,144
26,1,2,24,26,50
23,1,2,22,23,45
13,1,2,12,13,25
25,1,2,24,25,49
20,11,30,254,220,474
10,11,30,127,110,237
7,1,2,4,7,11
17,1,4,48,17,65
2,2,5,4,4,8
4,1,2,4,4,8
18,1,2,17,18,35
13,1,2,11,13,24
5,2,5,13,10,23
19,2,5,50,38,88
17,12,33,267,204,471
8,12,33,126,96,222
10,1,2,7,10,17
4,1,2,3,4,7
5,9,25,79,45,124
12,9,25,189,108,297
21,1,4,62,21,83
29,1,4,86,29,115
14,2,5,41,28,69
28,2,5,81,56,137
16,2,5,46,32,78
24,2,5,70,48,118
15,1,2,14,15,29
29,1,2,27,29,56
3,1,2,2,3,5
1,2,5,3,2,5
3,2,5,9,6,15
25,1,4,62,25,87
2,1,4,5,2,7
1,461,742,251,461,712
1,1482,2384,878,1482,2360
1,461,742,185,461,646
26,24,64,1023,624,1647
10,2,5,27,20,47
5,2,5,13,10,23
24,2,5,46,48,94
18,2,5,34,36,70
19,2,5,53,38,91
3,2,5,8,6,14
4,2,5,9,8,17
5,2,5,12,10,22
8,2,5,23,16,39
1,2,5,3,2,5
15,2,5,29,30,59
20,2,5,38,40,78
5,4,10,19,20,39
11,2,5,31,22,53
29,2,5,68,58,126
30,2,5,71,60,131
13,2,5,31,26,57
4,2,5,9,8,17
10,3,9,48,30,78
25,3,9,121,75,196
29,3,9,119,87,206
16,3,9,66,48,114
2,7,9,0,14,14
20,7,9,11,140,151
9,8,22,100,72,172
9,8,22,98,72,170
12,8,22,157,96,253
26,8,22,244,208,452
22,9,24,256,198,454
16,9,24,156,144,300
7,9,24,81,63,144
15,9,24,160,135,295
10,13,35,213,130,343
27,13,35,528,351,879
13,13,35,227,169,396
1,13,35,16,13,29
5,13,35,103,65,168
6,13,35,128,78,206
27,13,35,396,351,747
13,13,35,222,169,391
19,13,35,371,247,618
26,13,35,408,338,746
2,13,35,43,26,69
20,13,35,426,260,686
23,13,35,498,299,797
11,13,35,173,143,316
24,13,35,494,312,806
20,13,35,286,260,546
10,13,35,157,130,287
9,21,55,296,189,485
16,42,54,2,672,674
26,42,54,115,1092,1207
15,42,54,123,630,753
19,38,50,19,722,741
10,38,50,110,380,490
25,42,54,57,1050,1107
14,38,50,21,532,553
1,1266,2320,752,1266,2018
1,1252,2295,882,1252,2134
1,420,769,241,420,661
1,1252,2295,951,1252,2203
1,1252,2295,882,1252,2134
1,1252,2295,630,1252,1882
1,713,1120,250,713,963
1,487,783,124,487,611
1,713,1120,161,713,874
1,344,540,77,344,421
1,1083,1701,584,1083,1667
1,344,540,77,344,421
1,344,540,174,344,518
1,1083,1701,550,1083,1633
1,344,540,126,344,470
1,1083,1701,550,1083,1633
1,344,540,126,344,470
1,26,70,39,26,65
27,3,9,152,81,233
1,3,9,6,3,9
8,1,2,8,8,16
11,13,35,180,143,323
25,2,5,74,50,124
9,2,5,26,18,44
1,2,5,3,2,5
12,2,5,34,24,58
5,2,5,14,10,24
23,1,2,16,23,39
27,8,21,272,216,488
6,2,5,18,12,30
24,2,5,70,48,118
12,2,5,35,24,59
4,2,5,12,8,20
5,2,5,12,10,22
14,2,5,33,28,61
13,1,2,13,13,26
27,2,5,51,54,105
12,1,4,27,12,39
4,1,2,4,4,8
3,12,33,41,36,77
19,12,33,261,228,489
7,2,5,20,14,34
20,12,33,334,240,574
25,12,33,418,300,718
15,2,5,32,30,62
8,2,5,17,16,33
12,1,2,8,12,20
27,1,2,18,27,45
1,1482,2384,807,1482,2289
1,755,1215,241,755,996
1,461,742,185,461,646
1,1482,2384,854,1482,2336
13,24,64,487,312,799
18,24,64,570,432,1002
1,45,120,70,45,115
2,45,120,145,90,235
6,59,159,476,354,830
6,59,159,562,354,916
10,2,5,20,20,40
3,2,5,6,6,12
15,2,5,35,30,65
26,2,5,77,52,129
13,4,10,60,52,112
15,3,9,81,45,126
14,3,9,75,42,117
15,4,10,87,60,147
1,2,5,2,2,4
22,2,5,52,44,96
16,2,5,38,32,70
9,3,9,52,27,79
22,3,9,128,66,194
22,2,5,65,44,109
4,2,5,12,8,20
29,3,9,119,87,206
16,7,9,26,112,138
28,7,9,21,196,217
30,7,9,22,210,232
12,7,9,5,84,89
12,7,9,22,84,106
2,7,9,0,14,14
25,7,9,41,175,216
2,7,9,1,14,15
15,7,9,8,105,113
24,3,8,118,72,190
30,3,8,119,90,209
29,8,22,266,232,498
12,8,22,163,96,259
30,8,22,328,240,568
1,8,22,14,8,22
21,8,22,285,168,453
28,8,22,386,224,610
12,8,22,165,96,261
23,9,24,334,207,541
1,9,24,15,9,24
26,9,24,378,234,612
23,9,24,334,207,541
25,13,35,533,325,858
23,13,35,474,299,773
17,13,35,267,221,488
3,13,35,43,39,82
7,13,35,149,91,240
3,13,35,64,39,103
10,13,35,175,130,305
21,13,35,447,273,720
18,13,35,352,234,586
25,13,35,489,325,814
10,13,35,217,130,347
5,13,35,79,65,144
19,13,35,405,247,652
21,13,35,447,273,720
23,13,35,361,299,660
17,13,35,243,221,464
29,13,35,618,377,995
28,13,35,577,364,941
22,13,35,469,286,755
22,21,55,724,462,1186
2,21,55,53,42,95
16,21,55,509,336,845
27,42,54,134,1134,1268
12,42,54,118,504,622
20,42,54,89,840,929
8,38,50,40,304,344
5,38,50,25,190,215
30,38,50,345,1140,1485
13,38,50,130,494,624
15,42,54,164,630,794
4,38,50,46,152,198
7,42,54,24,294,318
1,1912,3400,944,1912,2856
1,1266,2320,729,1266,1995
1,420,769,249,420,669
1,1252,2295,997,1252,2249
1,1252,2295,538,1252,1790
1,420,769,249,420,669
1,1252,2295,722,1252,1974
1,420,769,341,420,761
1,1252,2295,951,1252,2203
1,713,1120,362,713,1075
1,1555,2443,839,1555,2394
1,487,783,202,487,689
1,713,1120,362,713,1075
1,713,1120,385,713,1098
1,487,783,241,487,728
1,344,540,99,344,443
1,1555,2443,497,1555,2052
1,344,540,191,344,535
1,344,540,185,344,529
1,1083,1701,584,1083,1667
1,344,540,185,344,529
1,713,1120,329,713,1042
1,2171,3578,906,2171,3077
14,26,70,459,364,823
15,3,9,89,45,134
18,2,5,50,36,86
1,2,5,3,2,5
1,2,5,3,2,5
29,2,5,84,58,142
25,1,2,24,25,49
13,2,5,38,26,64
25,1,2,25,25,50
30,1,2,19,30,49
7,1,2,4,7,11
14,9,25,161,126,287
12,1,4,30,12,42
19,9,25,271,171,442
16,9,25,228,144,372
21,13,35,366,273,639
2,13,35,35,26,61
2,13,35,41,26,67
9,13,35,185,117,302
30,1,4,74,30,104
20,1,4,50,20,70
13,1,4,33,13,46
26,1,4,66,26,92
7,1,4,18,7,25
5,11,29,84,55,139
20,11,29,337,220,557
26,1,2,25,26,51
9,9,25,115,81,196
12,9,25,153,108,261
15,1,2,10,15,25
10,1,4,24,10,34
25,2,5,49,50,99
19,2,5,37,38,75
2,11,30,37,22,59
14,2,5,29,28,57
25,2,5,53,50,103
27,8,21,226,216,442
6,8,21,50,48,98
28,1,2,16,28,44
19,1,2,11,19,30
24,2,5,46,48,94
7,2,5,13,14,27
26,1,4,76,26,102
16,1,4,47,16,63
26,1,4,77,26,103
4,1,2,4,4,8
21,1,2,20,21,41
28,1,2,27,28,55
21,11,29,366,231,597
11,11,29,192,121,313
25,1,2,16,25,41
27,2,5,78,54,132
18,2,5,52,36,88
15,1,2,10,15,25
10,11,29,168,110,278
7,11,29,118,77,195
27,2,5,63,54,117
20,2,5,47,40,87
19,2,5,55,38,93
1,1482,2384,878,1482,2360
1,461,742,147,461,608
1,1482,2384,854,1482,2336
1,755,1215,205,755,960
6,24,64,190,144,334
1,45,120,53,45,98
5,45,120,369,225,594
9,59,159,714,531,1245
12,4,10,71,48,119
20,2,5,59,40,99
6,2,5,18,12,30
28,2,5,59,56,115
12,2,5,25,24,49
22,2,5,42,44,86
27,2,5,51,54,105
26,2,5,77,52,129
7,2,5,21,14,35
23,2,5,64,46,110
2,2,5,6,4,10
6,3,9,27,18,45
3,3,9,14,9,23
3,3,9,17,9,26
23,2,5,64,46,110
16,2,5,45,32,77
13,4,10,49,52,101
10,2,5,21,20,41
29,2,5,86,58,144
12,2,5,28,24,52
17,2,5,50,34,84
8,2,5,15,16,31
12,2,5,35,24,59
9,2,5,26,18,44
15,2,5,44,30,74
18,7,9,26,126,152
30,7,9,57,210,267
29,7,9,11,203,214
28,7,9,51,196,247
9,7,9,16,63,79
17,7,9,14,119,133
21,3,8,98,63,161
20,3,8,97,60,157
19,8,22,207,152,359
20,8,22,218,160,378
20,8,22,276,160,436
16,9,24,156,144,300
8,9,24,112,72,184
30,9,24,443,270,713
5,13,35,72,65,137
1,13,35,17,13,30
17,13,35,350,221,571
26,13,35,517,338,855
21,13,35,366,273,639
24,13,35,377,312,689
25,13,35,366,325,691
27,13,35,386,351,737
22,13,35,345,286,631
3,13,35,49,39,88
30,13,35,650,390,1040
22,13,35,315,286,601
26,13,35,536,338,874
4,13,35,82,52,134
25,13,35,533,325,858
8,13,35,173,104,277
30,13,35,618,390,1008
23,13,35,490,299,789
21,13,35,359,273,632
3,13,35,52,39,91
30,21,55,987,630,1617
12,38,50,138,456,594
21,38,50,116,798,914
10,38,50,115,380,495
8,38,50,92,304,396
23,42,54,52,966,1018
1,38,50,1,38,39
1,42,54,10,42,52
1,38,50,3,38,41
12,38,50,18,456,474
21,38,50,242,798,1040
2,42,54,0,84,84
1,1252,2295,538,1252,1790
1,1252,2295,538,1252,1790
1,1252,2295,1020,1252,2272
1,1252,2295,630,1252,1882
1,1252,2295,630,1252,1882
1,1266,2320,1008,1266,2274
1,487,783,155,487,642
1,1083,1701,244,1083,1327
1,1083,1701,244,1083,1327
1,1555,2443,570,1555,2125
1,487,783,265,487,752
1,344,540,174,344,518
1,1083,1701,261,1083,1344
1,1083,1701,346,1083,1429
1,344,540,126,344,470
3,26,70,130,78,208
17,26,70,724,442,1166
12,26,70,352,312,664
4,26,70,173,104,277
14,26,70,606,364,970
12,3,9,58,36,94
20,13,35,314,260,574
3,13,35,47,39,86
26,13,35,408,338,746
5,1,2,3,5,8
22,1,2,19,22,41
2,1,2,2,2,4
23,2,5,64,46,110
5,2,5,14,10,24
6,2,5,17,12,29
2,2,5,6,4,10
25,2,5,68,50,118
3,1,2,2,3,5
25,1,2,24,25,49
16,2,5,47,32,79
14,2,5,41,28,69
15,2,5,44,30,74
20,1,2,14,20,34
16,1,2,11,16,27
12,1,2,11,12,23
2,11,30,37,22,59
27,11,30,497,297,794
27,1,2,17,27,44
19,1,2,12,19,31
10,1,2,10,10,20
3,9,25,47,27,74
24,9,25,306,216,522
27,9,25,344,243,587
17,2,5,32,34,66
11,2,5,21,22,43
18,11,30,223,198,421
16,11,30,198,176,374
12,1,2,7,12,19
4,1,4,10,4,14
9,1,4,23,9,32
28,8,21,340,224,564
22,8,21,268,176,444
25,8,21,304,200,504
3,8,21,36,24,60
6,1,2,4,6,10
21,11,29,299,231,530
10,1,2,7,10,17
14,1,2,10,14,24
11,1,4,32,11,43
3,1,4,9,3,12
12,2,5,34,24,58
26,1,4,64,26,90
6,1,4,15,6,21
1,1482,2384,807,1482,2289
1,1482,2384,807,1482,2289
1,1482,2384,401,1482,1883
1,1482,2384,807,1482,2289
24,2,5,47,48,95
10,3,9,59,30,89
23,3,9,136,69,205
9,2,5,27,18,45
18,2,5,53,36,89
26,2,5,57,52,109
5,2,5,11,10,21
28,2,5,66,56,122
26,2,5,61,52,113
7,2,5,20,14,34
27,2,5,78,54,132
24,4,10,139,96,235
16,4,10,93,64,157
4,2,5,8,8,16
16,2,5,34,32,66
27,4,10,157,108,265
4,4,10,23,16,39
17,2,5,45,34,79
11,3,9,42,33,75
21,3,9,81,63,144
8,2,5,21,16,37
5,2,5,13,10,23
6,2,5,16,12,28
11,2,5,29,22,51
16,2,5,46,32,78
23,4,10,87,92,179
21,4,10,80,84,164
8,2,5,22,16,38
16,2,5,38,32,70
10,2,5,24,20,44
21,2,5,56,42,98
14,2,5,37,28,65
11,2,5,26,22,48
19,2,5,45,38,83
6,7,9,11,42,53
13,7,9,-2,91,89
1,7,9,1,7,8
21,7,9,34,147,181
19,7,9,36,133,169
15,7,9,12,105,117
27,8,22,366,216,582
24,8,22,325,192,517
10,8,22,136,80,216
26,8,22,238,208,446
10,8,22,100,80,180
24,8,22,325,192,517
23,8,22,302,184,486
13,8,22,176,104,280
23,8,22,287,184,471
1,8,22,13,8,21
3,8,22,37,24,61
6,9,24,67,54,121
1,13,35,16,13,29
15,13,35,309,195,504
15,13,35,325,195,520
15,13,35,236,195,431
8,13,35,126,104,230
28,13,35,489,364,853
17,13,35,332,221,553
14,13,35,288,182,470
15,13,35,325,195,520
24,13,35,394,312,706
15,13,35,309,195,504
13,13,35,281,169,450
9,13,35,129,117,246
5,13,35,108,65,173
23,13,35,474,299,773
1,21,55,22,21,43
24,21,55,790,504,1294
27,21,55,606,567,1173
21,38,50,63,798,861
4,38,50,12,152,164
17,38,50,196,646,842
12,38,50,132,456,588
5,42,54,11,210,221
1,1266,2320,636,1266,1902
1,1266,2320,544,1266,1810
1,420,769,318,420,738
1,1266,2320,1008,1266,2274
1,1266,2320,1008,1266,2274
1,420,769,211,420,631
1,1266,2320,636,1266,1902
1,1252,2295,492,1252,1744
1,1266,2320,892,1266,2158
1,420,769,211,420,631
1,308,565,246,308,554
1,1266,2320,1008,1266,2274
1,2171,3578,1157,2171,3328
1,1555,2443,497,1555,2052
1,713,1120,228,713,941
28,26,70,1193,728,1921
10,26,70,314,260,574
12,3,9,71,36,107
15,2,5,44,30,74
7,1,2,7,7,14
6,1,2,6,6,12
13,13,35,277,169,446
4,13,35,85,52,137
4,2,5,9,8,17
25,2,5,58,50,108
4,9,25,46,36,82
5,9,25,75,45,120
24,9,25,360,216,576
21,13,35,330,273,603
4,1,2,3,4,7
3,1,4,9,3,12
16,1,4,47,16,63
28,8,21,323,224,547
29,8,21,334,232,566
21,1,4,60,21,81
17,1,2,11,17,28
10,1,2,6,10,16
14,2,5,33,28,61
16,2,5,38,32,70
25,1,4,74,25,99
5,1,4,15,5,20
3,13,35,49,39,88
14,1,4,41,14,55
7,2,5,16,14,30
4,8,21,37,32,69
24,1,2,24,24,48
26,1,2,25,26,51
13,1,4,38,13,51
15,1,4,37,15,52
17,1,4,41,17,58
12,1,4,29,12,41
26,11,29,453,286,739
7,11,29,122,77,199
12,2,5,34,24,58
26,2,5,77,52,129
19,8,21,239,152,391
1,8,21,13,8,21
19,2,5,45,38,83
16,2,5,38,32,70
7,2,5,16,14,30
30,2,5,87,60,147
1,1482,2384,473,1482,1955
1,461,742,185,461,646
1,1482,2384,735,1482,2217
1,1482,2384,878,1482,2360
7,24,64,276,168,444
2,24,64,57,48,105
22,24,64,852,528,1380
7,45,120,391,315,706
1,59,159,98,59,157
19,2,5,50,38,88
8,2,5,21,16,37
1,2,5,2,2,4
12,2,5,23,24,47
28,4,10,132,112,244
26,4,10,122,104,226
3,3,9,14,9,23
4,2,5,11,8,19
1,2,5,3,2,5
23,2,5,61,46,107
14,2,5,37,28,65
19,4,10,89,76,165
9,4,10,42,36,78
5,2,5,12,10,22
24,2,5,70,48,118
13,4,10,49,52,101
27,4,10,103,108,211
12,2,5,35,24,59
16,2,5,46,32,78
26,2,5,55,52,107
4,2,5,9,8,17
1,2,5,2,2,4
1,2,5,3,2,5
11,2,5,32,22,54
6,2,5,11,12,23
10,2,5,19,20,39
1,7,9,0,7,7
3,7,9,1,21,22
18,7,9,33,126,159
3,3,8,15,9,24
11,3,8,53,33,86
6,3,8,30,18,48
21,3,8,83,63,146
13,3,8,51,39,90
1,8,22,9,8,17
4,8,22,45,32,77
8,8,22,108,64,172
19,8,22,199,152,351
25,8,22,251,200,451
28,8,22,349,224,573
5,9,24,59,45,104
21,9,24,295,189,484
19,9,24,267,171,438
22,9,24,319,198,517
21,9,24,249,189,438
4,13,35,57,52,109
27,13,35,528,351,879
20,13,35,293,260,553
22,13,35,384,286,670
16,13,35,346,208,554
27,13,35,556,351,907
8,13,35,140,104,244
22,13,35,430,286,716
8,13,35,165,104,269
29,13,35,506,377,883
1,13,35,14,13,27
17,13,35,362,221,583
16,13,35,279,208,487
17,13,35,362,221,583
23,13,35,329,299,628
15,13,35,320,195,515
13,13,35,277,169,446
4,13,35,70,52,122
1,42,54,0,42,42
8,42,54,66,336,402
29,38,50,29,1102,1131
30,42,54,149,1260,1409
23,38,50,253,874,1127
22,38,50,22,836,858
14,38,50,154,532,686
20,38,50,110,760,870
26,38,50,299,988,1287
4,38,50,40,152,192
12,42,54,1,504,505
30,42,54,328,1260,1588
1,1898,3375,937,1898,2835
1,1252,2295,882,1252,2134
1,1252,2295,997,1252,2249
1,1266,2320,752,1266,2018
1,1266,2320,567,1266,1833
1,1266,2320,1008,1266,2274
1,1266,2320,544,1266,1810
1,1266,2320,636,1266,1902
1,1252,2295,745,1252,1997
1,1252,2295,951,1252,2203
1,1266,2320,544,1266,1810
1,1266,2320,892,1266,2158
1,1266,2320,752,1266,2018
1,295,540,234,295,529
1,1252,2295,1020,1252,2272
1,2171,3578,942,2171,3113
1,487,783,280,487,767
1,487,783,280,487,767
1,1519,2443,753,1519,2272
1,1083,1701,244,1083,1327
1,2171,3578,656,2171,2827
1,487,783,288,487,775
1,713,1120,161,713,874
1,713,1120,261,713,974
1,344,540,174,344,518
19,26,70,557,494,1051
21,26,70,895,546,1441
13,3,9,70,39,109
3,3,9,17,9,26
10,3,9,58,30,88
7,2,5,13,14,27
21,2,5,40,42,82
7,9,25,75,63,138
5,9,25,54,45,99
2,9,25,22,18,40
12,2,5,26,24,50
26,2,5,57,52,109
27,2,5,59,54,113
27,2,5,78,54,132
22,1,2,20,22,42
10,1,2,9,10,19
28,1,4,83,28,111
9,1,2,5,9,14
26,1,2,15,26,41
5,2,5,15,10,25
18,1,4,45,18,63
5,1,4,12,5,17
17,1,2,13,17,30
5,2,5,10,10,20
14,2,5,27,28,55
24,13,35,343,312,655
17,13,35,243,221,464
11,11,30,202,121,323
23,2,5,68,46,114
9,2,5,27,18,45
5,1,4,12,5,17
8,1,2,8,8,16
18,1,2,18,18,36
12,2,5,35,24,59
24,2,5,56,48,104
2,2,5,5,4,9
3,1,2,2,3,5
17,1,2,10,17,27
4,2,5,12,8,20
21,2,5,62,42,104
1,2,5,3,2,5
1,2,5,2,2,4
8,1,4,23,8,31
24,1,4,70,24,94
16,2,5,38,32,70
17,2,5,40,34,74
24,1,2,18,24,42
25,1,2,19,25,44
1,2,5,3,2,5
1,1482,2384,735,1482,2217
1,755,1215,411,755,1166
1,461,742,185,461,646
1,1482,2384,854,1482,2336
1,1482,2384,854,1482,2336
1,1482,2384,592,1482,2074
1,755,1215,375,755,1130
1,1482,2384,378,1482,1860
20,45,120,1476,900,2376
6,45,120,436,270,706
6,59,159,400,354,754
30,2,5,89,60,149
29,2,5,86,58,144
11,4,10,65,44,109
2,4,10,12,8,20
6,4,10,35,24,59
17,4,10,99,68,167
15,2,5,44,30,74
25,2,5,73,50,123
13,2,5,25,26,51
18,2,5,52,36,88
25,2,5,73,50,123
4,2,5,7,8,15
17,2,5,39,34,73
17,2,5,39,34,73
26,2,5,57,52,109
12,4,10,56,48,104
2,4,10,9,8,17
7,4,10,33,28,61
23,3,9,105,69,174
10,2,5,22,20,42
24,2,5,53,48,101
18,7,9,34,126,160
15,7,9,27,105,132
19,7,9,31,133,164
11,7,9,15,77,92
30,7,9,-5,210,205
3,7,9,3,21,24
8,7,9,1,56,57
4,3,8,18,12,30
27,3,8,133,81,214
28,3,8,109,84,193
6,8,22,55,48,103
11,8,22,115,88,203
3,8,22,27,24,51
21,9,24,310,189,499
3,9,24,44,27,71
13,9,24,154,117,271
28,9,24,413,252,665
12,13,35,176,156,332
5,13,35,108,65,173
25,13,35,541,325,866
10,13,35,196,130,326
20,13,35,349,260,609
15,13,35,320,195,515
23,13,35,450,299,749
27,13,35,556,351,907
2,13,35,43,26,69
5,13,35,108,65,173
24,13,35,419,312,731
26,13,35,472,338,810
4,13,35,82,52,134
29,13,35,415,377,792
12,21,55,269,252,521
21,21,55,691,441,1132
10,21,55,329,210,539
27,21,55,710,567,1277
3,21,55,90,63,153
6,21,55,197,126,323
20,21,55,504,420,924
4,38,50,4,152,156
10,38,50,115,380,495
21,42,54,241,882,1123
10,38,50,15,380,395
21,42,54,229,882,1111
9,42,54,1,378,379
1,1898,3375,768,1898,2666
1,1266,2320,892,1266,2158
1,1266,2320,961,1266,2227
1,1266,2320,567,1266,1833
1,1252,2295,676,1252,1928
1,1252,2295,951,1252,2203
1,1266,2320,1008,1266,2274
1,420,769,318,420,738
1,420,769,211,420,631
1,1555,2443,717,1555,2272
1,2171,3578,656,2171,2827
1,1519,2443,606,1519,2125
1,344,540,185,344,529
1,487,783,132,487,619
1,344,540,126,344,470
1,713,1120,172,713,885
1,2171,3578,1335,2171,3506
1,2171,3578,906,2171,3077
29,26,70,1256,754,2010
16,3,9,64,48,112
25,3,9,141,75,216
22,3,9,88,66,154
17,3,9,68,51,119
19,3,9,111,57,168
24,2,5,47,48,95
21,2,5,41,42,83
23,1,4,68,23,91
13,1,4,38,13,51
4,8,21,34,32,66
3,1,2,3,3,6
4,2,5,11,8,19
17,2,5,48,34,82
21,13,35,447,273,720
28,13,35,596,364,960
17,2,5,48,34,82
15,2,5,42,30,72
12,12,33,224,144,368
25,12,33,467,300,767
19,2,5,56,38,94
15,2,5,44,30,74
14,11,29,199,154,353
21,11,29,299,231,530
19,2,5,53,38,91
19,1,2,14,19,33
14,1,2,13,14,27
9,1,2,9,9,18
29,1,2,25,29,54
13,1,2,11,13,24
15,9,25,161,135,296
1,9,25,14,9,23
16,9,25,228,144,372
24,9,25,276,216,492
27,9,25,311,243,554
17,9,25,196,153,349
19,1,2,14,19,33
5,1,4,14,5,19
11,1,4,31,11,42
29,1,4,82,29,111
9,1,2,9,9,18
10,1,2,10,10,20
21,2,5,51,42,93
5,2,5,14,10,24
16,2,5,45,32,77
25,2,5,70,50,120
4,9,25,62,36,98
18,9,25,279,162,441
16,2,5,45,32,77
27,2,5,76,54,130
25,1,4,74,25,99
30,1,4,89,30,119
2,2,5,5,4,9
5,2,5,15,10,25
11,2,5,32,22,54
25,12,33,418,300,718
10,12,33,203,120,323
14,1,2,13,14,27
6,8,21,62,48,110
16,8,21,164,128,292
24,12,33,330,288,618
2,2,5,5,4,9
6,8,21,75,48,123
18,8,21,226,144,370
26,8,21,327,208,535
23,1,4,65,23,88
16,1,4,45,16,61
22,1,4,62,22,84
9,1,4,26,9,35
26,1,4,76,26,102
28,8,21,352,224,576
18,2,5,40,36,76
21,2,5,46,42,88
27,1,2,15,27,42
6,1,2,3,6,9
16,9,25,248,144,392
23,9,25,357,207,564
1,461,742,251,461,712
1,1482,2384,807,1482,2289
1,1482,2384,807,1482,2289
1,1482,2384,878,1482,2360
1,1482,2384,878,1482,2360
1,755,1215,436,755,1191
1,755,1215,436,755,1191
1,461,742,274,461,735
5,45,120,297,225,522
7,59,159,455,413,868
21,3,9,118,63,181
11,3,9,62,33,95
25,2,5,48,50,98
8,2,5,15,16,31
23,2,5,45,46,91
12,2,5,23,24,47
2,4,10,9,8,17
17,4,10,99,68,167
26,4,10,151,104,255
23,2,5,67,46,113
20,2,5,58,40,98
6,2,5,17,12,29
29,2,5,84,58,142
3,2,5,8,6,14
13,2,5,38,26,64
14,2,5,41,28,69
22,2,5,42,44,86
10,2,5,29,20,49
16,2,5,38,32,70
27,2,5,63,54,117
19,4,10,110,76,186
26,2,5,77,52,129
19,2,5,56,38,94
10,2,5,29,20,49
5,2,5,15,10,25
18,7,9,33,126,159
23,7,9,17,161,178
3,7,9,5,21,26
15,7,9,0,105,105
17,7,9,23,119,142
8,3,8,27,24,51
14,8,22,190,112,302
16,8,22,217,128,345
4,8,22,44,32,76
26,8,22,238,208,446
11,8,22,152,88,240
24,8,22,267,192,459
24,8,22,325,192,517
5,9,24,59,45,104
7,13,35,144,91,235
7,13,35,122,91,213
4,13,35,87,52,139
6,13,35,128,78,206
10,13,35,206,130,336
21,13,35,447,273,720
27,13,35,575,351,926
28,13,35,547,364,911
17,13,35,368,221,589
30,13,35,492,390,882
4,13,35,82,52,134
2,13,35,43,26,69
25,21,55,823,525,1348
27,42,54,295,1134,1429
14,42,54,138,588,726
6,42,54,27,252,279
18,42,54,90,756,846
22,38,50,220,836,1056
28,42,54,230,1176,1406
27,38,50,27,1026,1053
1,1252,2295,1020,1252,2272
1,1252,2295,722,1252,1974
1,1252,2295,538,1252,1790
1,1266,2320,752,1266,2018
1,1266,2320,1008,1266,2274
1,1266,2320,892,1266,2158
1,420,769,295,420,715
1,2171,3578,1264,2171,3435
1,487,783,280,487,767
1,1555,2443,717,1555,2272
1,1083,1701,261,1083,1344
1,713,1120,385,713,1098
1,2171,3578,620,2171,2791
1,487,783,132,487,619
1,713,1120,362,713,1075
20,26,70,684,520,1204
26,26,70,744,676,1420
7,3,9,28,21,49
16,3,9,73,48,121
21,2,5,61,42,103
2,2,5,6,4,10
7,2,5,20,14,34
11,1,2,8,11,19
5,2,5,10,10,20
11,9,25,157,99,256
15,1,2,11,15,26
24,2,5,53,48,101
7,2,5,15,14,29
11,1,2,11,11,22
13,1,2,13,13,26
16,1,2,16,16,32
25,1,2,19,25,44
16,1,2,12,16,28
2,1,2,1,2,3
28,2,5,66,56,122
23,2,5,67,46,113
28,8,21,235,224,459
29,8,21,243,232,475
7,8,21,59,56,115
20,8,21,252,160,412
28,8,21,352,224,576
13,11,30,239,143,382
24,9,25,360,216,576
11,9,25,165,99,264
10,1,4,29,10,39
11,1,4,32,11,43
14,2,5,41,28,69
12,1,2,12,12,24
16,2,5,45,32,77
28,2,5,78,56,134
1,1482,2384,401,1482,1883
1,755,1215,266,755,1021
1,461,742,266,461,727
2,24,64,53,48,101
3,59,159,195,177,372
18,4,10,70,72,142
20,4,10,78,80,158
25,2,5,59,50,109
5,2,5,12,10,22
26,2,5,77,52,129
17,2,5,50,34,84
27,2,5,53,54,107
6,2,5,12,12,24
2,2,5,6,4,10
5,2,5,14,10,24
18,2,5,50,36,86
15,2,5,42,30,72
24,2,5,71,48,119
19,4,10,110,76,186
15,4,10,87,60,147
15,2,5,44,30,74
20,2,5,58,40,98
16,3,9,93,48,141
15,3,9,87,45,132
25,2,5,48,50,98
20,2,5,38,40,78
30,2,5,84,60,144
2,2,5,6,4,10
15,3,9,87,45,132
12,3,9,70,36,106
13,2,5,31,26,57
24,2,5,56,48,104
14,7,9,23,98,121
19,7,9,11,133,144
15,7,9,6,105,111
8,7,9,6,56,62
22,3,8,108,66,174
20,3,8,97,60,157
30,8,22,407,240,647
20,8,22,271,160,431
7,8,22,64,56,120
29,8,22,266,232,498
27,8,22,366,216,582
17,9,24,165,153,318
22,9,24,214,198,412
20,13,35,293,260,553
9,13,35,192,117,309
17,13,35,297,221,518
1,13,35,21,13,34
13,13,35,281,169,450
25,13,35,541,325,866
16,13,35,330,208,538
4,13,35,70,52,122
8,13,35,173,104,277
10,13,35,217,130,347
9,13,35,185,117,302
26,13,35,454,338,792
11,13,35,234,143,377
8,13,35,170,104,274
11,13,35,157,143,300
3,21,55,100,63,163
3,38,50,33,114,147
3,38,50,30,114,144
15,42,54,50,630,680
1,1252,2295,997,1252,2249
1,420,769,334,420,754
1,420,769,211,420,631
1,1252,2295,997,1252,2249
1,2171,3578,1264,2171,3435
1,713,1120,362,713,1075
1,713,1120,261,713,974
1,487,783,132,487,619
1,2171,3578,1335,2171,3506
1,344,540,83,344,427
12,26,70,494,312,806
28,3,9,163,84,247
10,3,9,59,30,89
25,2,5,49,50,99
17,2,5,33,34,67
16,1,2,15,16,31
9,1,2,8,9,17
5,1,2,5,5,10
26,2,5,75,52,127
21,2,5,61,42,103
14,2,5,41,28,69
17,2,5,49,34,83
22,9,25,275,198,473
16,9,25,200,144,344
8,2,5,15,16,31
21,13,35,455,273,728
8,12,33,165,96,261
29,12,33,599,348,947
19,12,33,393,228,621
7,12,33,145,84,229
8,12,33,165,96,261
6,2,5,18,12,30
15,9,25,236,135,371
2,11,30,37,22,59
29,1,2,17,29,46
5,1,2,3,5,8
28,2,5,66,56,122
1,2,5,2,2,4
2,1,2,2,2,4
12,1,2,12,12,24
22,8,21,189,176,365
3,8,21,26,24,50
6,9,25,77,54,131
28,9,25,357,252,609
16,9,25,204,144,348
6,8,21,50,48,98
18,8,21,151,144,295
30,2,5,89,60,149
22,2,5,65,44,109
22,2,5,65,44,109
20,1,2,13,20,33
2,1,2,2,2,4
3,8,21,28,24,52
11,8,21,101,88,189
16,2,5,37,32,69
26,2,5,60,52,112
4,2,5,8,8,16
6,2,5,13,12,25
14,2,5,29,28,57
9,1,4,26,9,35
2,1,4,6,2,8
8,2,5,15,16,31
5,9,25,78,45,123
21,9,25,326,189,515
3,1,4,6,3,9
29,1,4,63,29,92
1,1482,2384,807,1482,2289
1,755,1215,302,755,1057
1,461,742,251,461,712
1,1482,2384,807,1482,2289
10,24,64,310,240,550
29,2,5,84,58,142
26,2,5,75,52,127
7,4,10,39,28,67
24,4,10,134,96,230
21,2,5,49,42,91
7,2,5,14,14,28
29,2,5,59,58,117
22,2,5,65,44,109
10,2,5,30,20,50
22,2,5,64,44,108
26,2,5,75,52,127
24,2,5,56,48,104
6,2,5,12,12,24
27,2,5,53,54,107
7,2,5,16,14,30
2,2,5,5,4,9
10,3,9,40,30,70
6,3,9,35,18,53
14,2,5,27,28,55
9,7,9,15,63,78
18,7,9,10,126,136
12,7,9,9,84,93
18,7,9,25,126,151
24,7,9,39,168,207
10,3,8,39,30,69
26,8,22,358,208,566
7,9,24,73,63,136
4,9,24,39,36,75
19,9,24,185,171,356
16,13,35,234,208,442
19,13,35,411,247,658
25,13,35,515,325,840
3,13,35,59,39,98
10,13,35,157,130,287
1,13,35,20,13,33
17,13,35,368,221,589
18,13,35,257,234,491
9,21,55,242,189,431
29,21,55,954,609,1563
25,21,55,561,525,1086
16,38,50,160,608,768
22,42,54,15,924,939
27,38,50,27,1026,1053
11,42,54,120,462,582
1,1252,2295,630,1252,1882
1,1252,2295,997,1252,2249
1,1266,2320,544,1266,1810
1,1252,2295,745,1252,1997
1,487,783,186,487,673
1,1083,1701,244,1083,1327
1,2171,3578,763,2171,2934
1,713,1120,362,713,1075
1,1555,2443,546,1555,2101
1,1555,2443,546,1555,2101
1,713,1120,396,713,1109
1,1083,1701,499,1083,1582
1,1519,2443,606,1519,2125
1,713,1120,228,713,941
1,344,540,83,344,427
1,713,1120,194,713,907
1,2171,3578,1335,2171,3506
21,26,70,909,546,1455
25,26,70,1065,650,1715
23,3,9,111,69,180
30,1,2,17,30,47
6,2,5,17,12,29
11,2,5,32,22,54
29,9,25,312,261,573
14,9,25,151,126,277
13,11,30,192,143,335
14,2,5,27,28,55
11,2,5,21,22,43
9,1,2,6,9,15
29,1,2,21,29,50
29,11,29,488,319,807
3,2,5,6,6,12
16,8,21,137,128,265
23,1,2,21,23,44
30,2,5,89,60,149
21,2,5,62,42,104
7,2,5,16,14,30
10,1,2,10,10,20
9,1,2,9,9,18
7,1,2,4,7,11
5,2,5,10,10,20
17,1,2,13,17,30
22,2,5,46,44,90
30,9,25,315,270,585
1,1482,2384,807,1482,2289
1,1482,2384,854,1482,2336
21,24,64,652,504,1156
2,59,159,187,118,305
10,59,159,793,590,1383
15,2,5,44,30,74
4,2,5,12,8,20
15,2,5,44,30,74
15,2,5,44,30,74
24,2,5,71,48,119
5,2,5,15,10,25
4,2,5,12,8,20
8,3,9,35,24,59
11,3,9,48,33,81
30,2,5,57,60,117
7,2,5,19,14,33
17,2,5,49,34,83
2,2,5,6,4,10
13,4,10,75,52,127
29,4,10,168,116,284
14,4,10,53,56,109
10,2,5,21,20,41
29,2,5,61,58,119
10,3,9,54,30,84
30,3,9,123,90,213
3,3,9,12,9,21
11,2,5,32,22,54
11,2,5,32,22,54
11,7,9,4,77,81
18,7,9,7,126,133
20,7,9,38,140,178
3,7,9,2,21,23
17,7,9,23,119,142
11,3,8,51,33,84
1,3,8,3,3,6
12,8,22,163,96,259
6,8,22,81,48,129
17,8,22,234,136,370
8,9,24,118,72,190
3,9,24,44,27,71
24,9,24,239,216,455
5,13,35,72,65,137
19,13,35,411,247,658
3,13,35,65,39,104
11,13,35,238,143,381
25,13,35,358,325,683
23,13,35,498,299,797
26,13,35,372,338,710
16,13,35,341,208,549
20,13,35,426,260,686
13,13,35,281,169,450
2,13,35,35,26,61
23,13,35,490,299,789
14,13,35,298,182,480
16,21,55,350,336,686
4,21,55,96,84,180
9,38,50,27,342,369
1,42,54,1,42,43
17,38,50,51,646,697
12,38,50,102,456,558
16,42,54,54,672,726
24,38,50,204,912,1116
26,42,54,129,1092,1221
18,38,50,90,684,774
1,1266,2320,961,1266,2227
1,1266,2320,567,1266,1833
1,1252,2295,997,1252,2249
1,420,769,341,420,761
1,308,565,184,308,492
1,1266,2320,1031,1266,2297
1,295,540,234,295,529
1,295,540,234,295,529
1,1898,3375,1410,1898,3308
1,1266,2320,544,1266,1810
1,2171,3578,656,2171,2827
1,344,540,174,344,518
1,713,1120,205,713,918
1,1083,1701,584,1083,1667
1,1083,1701,499,1083,1582
4,26,70,165,104,269
16,26,70,558,416,974
15,26,70,524,390,914
12,2,5,35,24,59
17,13,35,368,221,589
3,13,35,65,39,104
17,13,35,362,221,583
23,13,35,490,299,789
7,1,2,7,7,14
8,1,2,8,8,16
2,1,2,2,2,4
14,11,30,262,154,416
14,11,30,262,154,416
3,2,5,9,6,15
17,2,5,50,34,84
22,2,5,43,44,87
22,2,5,43,44,87
13,2,5,38,26,64
17,2,5,49,34,83
3,2,5,9,6,15
21,2,5,40,42,82
28,2,5,53,56,109
20,11,30,302,220,522
25,11,30,378,275,653
7,2,5,16,14,30
3,2,5,7,6,13
12,2,5,28,24,52
16,1,2,12,16,28
10,1,2,7,10,17
11,1,2,6,11,17
3,1,2,2,3,5
18,11,30,337,198,535
28,11,30,524,308,832
27,8,21,328,216,544
19,8,21,231,152,383
25,11,29,399,275,674
7,11,29,112,77,189
20,2,5,59,40,99
15,2,5,44,30,74
7,1,4,16,7,23
8,1,4,18,8,26
3,1,2,2,3,5
8,2,5,15,16,31
26,2,5,49,52,101
1,1482,2384,473,1482,1955
1,461,742,125,461,586
1,1482,2384,878,1482,2360
1,755,1215,241,755,996
1,755,1215,290,755,1045
1,461,742,185,461,646
7,45,120,374,315,689
7,45,120,508,315,823
19,2,5,37,38,75
6,2,5,12,12,24
4,2,5,12,8,20
13,4,10,55,52,107
3,4,10,13,12,25
13,2,5,31,26,57
11,2,5,26,22,48
29,3,9,171,87,258
8,3,9,47,24,71
5,2,5,15,10,25
5,2,5,15,10,25
24,3,9,142,72,214
18,3,9,106,54,160
11,2,5,26,22,48
25,2,5,60,50,110
20,4,10,76,80,156
4,2,5,12,8,20
4,2,5,12,8,20
28,3,9,158,84,242
3,3,9,17,9,26
4,7,9,3,28,31
8,7,9,7,56,63
12,7,9,5,84,89
26,7,9,43,182,225
19,7,9,31,133,164
2,3,8,10,6,16
14,8,22,128,112,240
14,8,22,190,112,302
2,8,22,22,16,38
27,8,22,247,216,463
22,9,24,325,198,523
20,13,35,412,260,672
27,13,35,556,351,907
12,13,35,209,156,365
2,13,35,43,26,69
19,13,35,332,247,579
18,13,35,371,234,605
18,13,35,390,234,624
8,13,35,173,104,277
20,13,35,412,260,672
17,13,35,303,221,524
14,13,35,220,182,402
16,13,35,341,208,549
13,13,35,277,169,446
3,13,35,43,39,82
1,13,35,18,13,31
26,13,35,408,338,746
17,13,35,291,221,512
16,21,55,430,336,766
15,21,55,362,315,677
29,38,50,29,1102,1131
2,38,50,20,76,96
5,38,50,58,190,248
23,38,50,23,874,897
15,38,50,173,570,743
14,38,50,140,532,672
1,1252,2295,745,1252,1997
1,1252,2295,1020,1252,2272
1,1252,2295,745,1252,1997
1,1266,2320,1008,1266,2274
1,420,769,318,420,738
1,1266,2320,544,1266,1810
1,420,769,249,420,669
1,308,565,246,308,554
1,1519,2443,826,1519,2345
1,2171,3578,1264,2171,3435
1,487,783,194,487,681
1,1555,2443,790,1555,2345
1,1083,1701,601,1083,1684
1,1555,2443,570,1555,2125
1,1555,2443,570,1555,2125
1,1555,2443,448,1555,2003
1,344,540,185,344,529
1,2171,3578,1371,2171,3542
1,344,540,99,344,443
1,344,540,131,344,475
1,344,540,137,344,481
7,26,70,200,182,382
15,3,9,89,45,134
8,3,9,47,24,71
18,1,2,12,18,30
23,8,21,193,184,377
10,2,5,24,20,44
26,2,5,77,52,129
2,1,2,2,2,4
1,1,2,1,1,2
28,2,5,78,56,134
25,1,2,16,25,41
9,1,2,6,9,15
24,1,2,15,24,39
15,1,4,37,15,52
11,1,2,10,11,21
8,1,2,7,8,15
20,2,5,47,40,87
6,1,2,4,6,10
5,1,4,13,5,18
21,2,5,59,42,101
12,2,5,34,24,58
6,1,4,13,6,19
6,1,2,4,6,10
12,1,2,8,12,20
15,1,4,34,15,49
18,1,4,41,18,59
14,2,5,41,28,69
11,12,33,162,132,294
2,1,2,2,2,4
21,1,2,21,21,42
21,1,2,12,21,33
26,1,2,15,26,41
11,8,21,113,88,201
2,11,29,26,22,48
25,11,29,320,275,595
20,1,4,49,20,69
22,9,25,341,198,539
1,1482,2384,616,1482,2098
1,461,742,251,461,712
1,1482,2384,473,1482,1955
1,1482,2384,807,1482,2289
1,1482,2384,473,1482,1955
1,1482,2384,473,1482,1955
1,1482,2384,568,1482,2050
1,461,742,185,461,646
1,1482,2384,854,1482,2336
17,24,64,484,408,892
12,24,64,472,288,760
27,2,5,80,54,134
27,2,5,57,54,111
15,2,5,29,30,59
4,2,5,8,8,16
4,4,10,23,16,39
16,4,10,74,64,138
22,4,10,101,88,189
17,4,10,99,68,167
16,2,5,30,32,62
25,2,5,48,50,98
16,3,9,93,48,141
3,3,9,17,9,26
17,3,9,99,51,150
13,2,5,31,26,57
30,2,5,71,60,131
27,7,9,44,189,233
20,7,9,33,140,173
10,7,9,18,70,88
13,7,9,11,91,102
24,7,9,39,168,207
23,7,9,0,161,161
5,7,9,9,35,44
14,7,9,25,98,123
27,7,9,10,189,199
5,7,9,4,35,39
27,7,9,10,189,199
22,3,8,108,66,174
22,8,22,298,176,474
9,8,22,122,72,194
26,8,22,290,208,498
6,8,22,60,48,108
8,8,22,89,64,153
1,9,24,15,9,24
5,9,24,74,45,119
3,9,24,44,27,71
11,9,24,131,99,230
14,13,35,298,182,480
27,13,35,471,351,822
27,13,35,556,351,907
26,13,35,536,338,874
14,13,35,200,182,382
1,13,35,22,13,35
10,13,35,206,130,336
23,13,35,361,299,660
20,13,35,349,260,609
9,13,35,129,117,246
27,13,35,528,351,879
28,13,35,547,364,911
14,13,35,288,182,470
19,13,35,298,247,545
9,13,35,132,117,249
13,13,35,186,169,355
6,13,35,128,78,206
18,13,35,371,234,605
29,13,35,567,377,944
28,21,55,752,588,1340
16,21,55,535,336,871
21,38,50,242,798,1040
17,38,50,17,646,663
24,38,50,132,912,1044
5,42,54,11,210,221
1,1252,2295,951,1252,2203
1,1266,2320,1008,1266,2274
1,1266,2320,961,1266,2227
1,295,540,223,295,518
1,1266,2320,1008,1266,2274
1,420,769,341,420,761
1,1252,2295,630,1252,1882
1,420,769,188,420,608
1,1252,2295,882,1252,2134
1,2171,3578,763,2171,2934
1,1083,1701,584,1083,1667
1,1083,1701,584,1083,1667
1,487,783,241,487,728
1,1555,2443,351,1555,1906
1,713,1120,329,713,1042
1,1555,2443,570,1555,2125
1,1555,2443,570,1555,2125
1,1083,1701,499,1083,1582
1,487,783,132,487,619
1,344,540,126,344,470
1,344,540,126,344,470
9,26,70,257,234,491
4,26,70,170,104,274
10,26,70,349,260,609
16,26,70,469,416,885
14,3,9,81,42,123
5,1,2,5,5,10
26,8,21,300,208,508
15,8,21,173,120,293
19,9,25,299,171,470
8,9,25,126,72,198
27,2,5,78,54,132
23,2,5,67,46,113
14,2,5,41,28,69
7,2,5,16,14,30
25,13,35,533,325,858
12,13,35,256,156,412
14,2,5,41,28,69
8,2,5,24,16,40
5,11,30,76,55,131
3,11,30,45,33,78
18,1,4,49,18,67
25,1,4,68,25,93
8,1,4,22,8,30
3,9,25,45,27,72
29,2,5,84,58,142
6,2,5,17,12,29
22,1,2,12,22,34
12,1,2,7,12,19
3,8,21,38,24,62
3,1,4,7,3,10
28,12,33,523,336,859
1,12,33,19,12,31
27,11,29,431,297,728
16,2,5,38,32,70
23,1,2,13,23,36
9,1,2,5,9,14
20,1,2,11,20,31
13,1,2,7,13,20
10,1,4,24,10,34
10,12,33,203,120,323
24,12,33,488,288,776
20,1,2,14,20,34
2,1,2,1,2,3
9,1,2,6,9,15
25,2,5,70,50,120
2,2,5,6,4,10
21,2,5,59,42,101
29,8,21,249,232,481
11,1,2,11,11,22
15,1,2,15,15,30
3,1,2,2,3,5
16,1,2,12,16,28
1,461,742,229,461,690
1,1482,2384,807,1482,2289
1,1482,2384,735,1482,2217
1,461,742,251,461,712
10,24,64,317,240,557
29,24,64,752,696,1448
5,24,64,130,120,250
25,4,10,140,100,240
5,4,10,28,20,48
22,3,9,90,66,156
29,3,9,119,87,206
7,2,5,20,14,34
17,2,5,49,34,83
8,2,5,23,16,39
21,4,10,122,84,206
15,4,10,87,60,147
9,2,5,25,18,43
19,2,5,53,38,91
22,2,5,42,44,86
13,2,5,30,26,56
8,3,9,47,24,71
6,3,9,35,18,53
28,2,5,66,56,122
19,2,5,42,38,80
20,2,5,44,40,84
22,2,5,64,44,108
28,2,5,81,56,137
8,2,5,19,16,35
29,4,10,171,116,287
10,4,10,59,40,99
28,2,5,78,56,134
16,2,5,45,32,77
12,2,5,28,24,52
5,2,5,12,10,22
6,2,5,17,12,29
22,2,5,64,44,108
7,7,9,13,49,62
10,7,9,18,70,88
1,7,9,0,7,7
15,7,9,12,105,117
20,7,9,11,140,151
5,3,8,17,15,32
30,3,8,148,90,238
19,8,22,174,152,326
14,8,22,193,112,305
1,8,22,14,8,22
20,9,24,281,180,461
26,9,24,253,234,487
9,9,24,131,81,212
12,9,24,120,108,228
18,9,24,253,162,415
23,13,35,490,299,789
1,13,35,16,13,29
18,13,35,390,234,624
24,13,35,511,312,823
12,13,35,260,156,416
4,13,35,82,52,134
5,13,35,103,65,168
10,13,35,147,130,277
9,13,35,157,117,274
26,13,35,508,338,846
21,13,35,359,273,632
2,13,35,29,26,55
5,13,35,73,65,138
1,13,35,17,13,30
13,21,55,428,273,701
5,21,55,126,105,231
10,21,55,269,210,479
6,42,54,66,252,318
6,38,50,18,228,246
12,42,54,60,504,564
24,38,50,276,912,1188
1,1266,2320,636,1266,1902
1,1266,2320,544,1266,1810
1,308,565,155,308,463
1,1266,2320,1031,1266,2297
1,420,769,249,420,669
1,1266,2320,961,1266,2227
1,2171,3578,1264,2171,3435
1,487,783,280,487,767
1,713,1120,261,713,974
1,2171,3578,835,2171,3006
1,713,1120,250,713,963
1,713,1120,205,713,918
1,1555,2443,497,1555,2052
1,344,540,185,344,529
1,1083,1701,550,1083,1633
1,2171,3578,1371,2171,3542
19,26,70,543,494,1037
19,2,5,55,38,93
5,13,35,73,65,138
22,13,35,322,286,608
6,2,5,17,12,29
20,2,5,56,40,96
30,1,2,22,30,52
12,1,2,9,12,21
9,8,21,83,72,155
26,2,5,69,52,121
7,2,5,19,14,33
12,2,5,35,24,59
9,2,5,27,18,45
21,1,2,16,21,37
15,1,2,11,15,26
1,1,2,1,1,2
26,1,2,17,26,43
2,9,25,22,18,40
6,1,2,4,6,10
24,1,2,18,24,42
5,9,25,71,45,116
24,9,25,342,216,558
4,2,5,9,8,17
14,1,4,33,14,47
22,1,4,52,22,74
3,1,2,2,3,5
17,1,4,50,17,67
9,1,4,27,9,36
9,1,4,22,9,31
5,1,4,12,5,17
24,1,2,18,24,42
26,2,5,51,52,103
2,2,5,4,4,8
6,1,4,18,6,24
8,2,5,23,16,39
14,2,5,41,28,69
20,2,5,58,40,98
24,2,5,46,48,94
19,2,5,36,38,74
20,2,5,38,40,78
12,8,21,138,96,234
28,1,2,20,28,48
3,1,2,2,3,5
23,2,5,64,46,110
5,8,21,48,40,88
27,8,21,260,216,476
5,8,21,61,40,101
10,2,5,29,20,49
28,1,4,68,28,96
18,1,4,44,18,62
1,1482,2384,807,1482,2289
1,1482,2384,568,1482,2050
1,461,742,266,461,727
30,24,64,854,720,1574
19,24,64,602,456,1058
26,24,64,973,624,1597
28,24,64,1084,672,1756
5,45,120,267,225,492
1,59,159,75,59,134
7,59,159,455,413,868
26,2,5,51,52,103
13,2,5,25,26,51
7,2,5,13,14,27
23,2,5,68,46,114
19,3,9,111,57,168
27,3,9,157,81,238
17,2,5,48,34,82
21,2,5,59,42,101
2,2,5,6,4,10
12,2,5,35,24,59
7,2,5,13,14,27
1,2,5,2,2,4
17,2,5,32,34,66
28,2,5,53,56,109
25,2,5,58,50,108
8,4,10,38,32,70
13,4,10,61,52,113
24,2,5,71,48,119
13,2,5,27,26,53
19,2,5,40,38,78
14,2,5,41,28,69
30,2,5,87,60,147
10,2,5,19,20,39
1,2,5,2,2,4
23,2,5,54,46,100
24,2,5,70,48,118
20,2,5,58,40,98
18,2,5,52,36,88
27,2,5,51,54,105
27,2,5,51,54,105
11,2,5,23,22,45
8,2,5,17,16,33
23,2,5,54,46,100
7,2,5,16,14,30
8,3,9,32,24,56
11,3,9,44,33,77
29,3,9,156,87,243
3,3,9,16,9,25
10,7,9,4,70,74
15,7,9,0,105,105
13,7,9,7,91,98
10,7,9,8,70,78
3,7,9,5,21,26
27,7,9,22,189,211
23,7,9,0,161,161
22,7,9,30,154,184
24,7,9,39,168,207
11,7,9,4,77,81
17,7,9,23,119,142
18,3,8,84,54,138
19,3,8,62,57,119
15,8,22,207,120,327
4,9,24,56,36,92
29,13,35,415,377,792
27,13,35,386,351,737
9,13,35,192,117,309
24,13,35,494,312,806
16,13,35,279,208,487
6,13,35,124,78,202
29,13,35,415,377,792
18,13,35,390,234,624
20,13,35,314,260,574
14,13,35,244,182,426
14,13,35,244,182,426
21,13,35,366,273,639
6,13,35,117,78,195
23,13,35,377,299,676
17,13,35,243,221,464
25,13,35,533,325,858
12,13,35,256,156,412
7,13,35,110,91,201
15,13,35,236,195,431
26,13,35,445,338,783
21,13,35,411,273,684
10,21,55,219,210,429
8,21,55,263,168,431
15,42,54,164,630,794
16,38,50,176,608,784
17,42,54,85,714,799
13,38,50,143,494,637
18,38,50,207,684,891
4,38,50,12,152,164
25,42,54,287,1050,1337
12,38,50,12,456,468
17,38,50,187,646,833
6,42,54,30,252,282
2,38,50,8,76,84
25,42,54,246,1050,1296
24,42,54,55,1008,1063
7,38,50,77,266,343
1,1266,2320,544,1266,1810
1,295,540,223,295,518
1,1266,2320,752,1266,2018
1,1266,2320,961,1266,2227
1,1898,3375,1410,1898,3308
1,2171,3578,1264,2171,3435
1,487,783,280,487,767
1,344,540,185,344,529
1,1555,2443,448,1555,2003
1,1555,2443,717,1555,2272
1,2171,3578,763,2171,2934
1,713,1120,161,713,874
1,344,540,99,344,443
1,344,540,174,344,518
1,344,540,174,344,518
1,713,1120,261,713,974
1,344,540,174,344,518
28,26,70,977,728,1705
11,26,70,315,286,601
13,1,2,13,13,26
5,1,2,5,5,10
5,1,2,5,5,10
26,1,2,25,26,51
14,2,5,27,28,55
19,2,5,36,38,74
5,2,5,15,10,25
10,13,35,164,130,294
25,2,5,74,50,124
17,2,5,50,34,84
11,2,5,29,22,51
12,2,5,32,24,56
19,1,2,11,19,30
26,1,2,15,26,41
10,2,5,28,20,48
15,1,2,11,15,26
20,2,5,56,40,96
30,2,5,84,60,144
8,1,2,4,8,12
24,1,2,13,24,37
8,1,2,5,8,13
19,1,2,12,19,31
5,1,2,3,5,8
5,1,2,3,5,8
30,9,25,473,270,743
12,9,25,189,108,297
23,1,4,52,23,75
1,1,4,2,1,3
14,13,35,230,182,412
7,1,2,7,7,14
21,1,2,21,21,42
6,11,29,105,66,171
13,1,2,12,13,25
12,8,21,123,96,219
27,1,4,57,27,84
29,1,4,61,29,90
27,1,2,19,27,46
27,1,2,20,27,47
21,1,2,16,21,37
30,8,21,365,240,605
22,8,21,268,176,444
23,8,21,280,184,464
1,1482,2384,378,1482,1860
1,461,742,266,461,727
1,1482,2384,854,1482,2336
1,461,742,229,461,690
3,24,64,118,72,190
17,24,64,604,408,1012
8,24,64,315,192,507
6,59,159,390,354,744
28,2,5,78,56,134
6,2,5,17,12,29
5,2,5,15,10,25
15,4,10,89,60,149
9,2,5,27,18,45
17,2,5,33,34,67
22,2,5,43,44,87
7,2,5,13,14,27
13,2,5,25,26,51
22,3,9,128,66,194
27,2,5,63,54,117
4,2,5,9,8,17
22,2,5,62,44,106
16,3,9,70,48,118
21,3,9,92,63,155
8,7,9,4,56,60
8,7,9,1,56,57
16,7,9,29,112,141
28,7,9,11,196,207
17,7,9,6,119,125
27,7,9,22,189,211
4,3,8,16,12,28
2,3,8,10,6,16
18,3,8,84,54,138
23,8,22,312,184,496
4,8,22,55,32,87
9,8,22,118,72,190
6,8,22,60,48,108
29,9,24,428,261,689
27,9,24,262,243,505
4,13,35,57,52,109
14,13,35,288,182,470
27,13,35,585,351,936
17,13,35,368,221,589
4,13,35,70,52,122
7,13,35,144,91,235
18,13,35,264,234,498
3,13,35,64,39,103
4,13,35,82,52,134
13,13,35,277,169,446
24,13,35,520,312,832
2,13,35,41,26,67
14,13,35,220,182,402
16,13,35,251,208,459
20,13,35,293,260,553
24,13,35,394,312,706
24,13,35,377,312,689
11,21,55,295,231,526
8,21,55,180,168,348
10,38,50,10,380,390
27,38,50,311,1026,1337
10,42,54,109,420,529
27,42,54,295,1134,1429
15,42,54,34,630,664
13,38,50,130,494,624
18,38,50,180,684,864
20,38,50,110,760,870
1,1252,2295,1020,1252,2272
1,1252,2295,951,1252,2203
1,1252,2295,561,1252,1813
1,1252,2295,951,1252,2203
1,420,769,211,420,631
1,308,565,184,308,492
1,1266,2320,1031,1266,2297
1,420,769,211,420,631
1,1266,2320,1008,1266,2274
1,2171,3578,1157,2171,3328
1,487,783,124,487,611
1,1083,1701,584,1083,1667
1,1519,2443,411,1519,1930
1,487,783,132,487,619
1,487,783,171,487,658
1,344,540,174,344,518
1,26,70,43,26,69
10,26,70,426,260,686
29,3,9,164,87,251
25,1,2,24,25,49
10,2,5,28,20,48
3,2,5,8,6,14
11,2,5,31,22,53
12,1,4,36,12,48
11,1,4,33,11,44
22,9,25,237,198,435
8,9,25,86,72,158
14,2,5,39,28,67
22,2,5,62,44,106
12,2,5,34,24,58
17,9,25,268,153,421
20,2,5,42,40,82
28,2,5,59,56,115
12,9,25,129,108,237
30,2,5,89,60,149
11,2,5,32,22,54
1,2,5,3,2,5
22,12,33,433,264,697
3,12,33,59,36,95
22,2,5,52,44,96
27,2,5,63,54,117
13,2,5,38,26,64
18,2,5,53,36,89
2,2,5,6,4,10
14,1,4,40,14,54
6,1,4,17,6,23
1,12,33,17,12,29
13,12,33,217,156,373
29,2,5,86,58,144
26,2,5,77,52,129
18,11,30,229,198,427
28,1,4,66,28,94
28,1,4,66,28,94
1,1,4,2,1,3
10,2,5,28,20,48
4,1,2,4,4,8
11,1,2,11,11,22
26,1,2,25,26,51
15,1,2,15,15,30
1,2,5,2,2,4
11,1,4,32,11,43
11,1,4,32,11,43
29,1,2,21,29,50
5,1,4,11,5,16
9,1,2,6,9,15
16,1,2,10,16,26
19,8,21,163,152,315
20,8,21,172,160,332
7,8,21,72,56,128
4,8,21,41,32,73
9,2,5,17,18,35
18,1,2,13,18,31
29,1,2,21,29,50
1,1482,2384,592,1482,2074
1,461,742,162,461,623
23,45,120,1366,1035,2401
27,2,5,80,54,134
17,2,5,50,34,84
8,3,9,43,24,67
5,3,9,27,15,42
18,2,5,53,36,89
28,2,5,83,56,139
14,2,5,39,28,67
22,2,5,62,44,106
9,2,5,26,18,44
19,2,5,55,38,93
15,2,5,42,30,72
21,2,5,61,42,103
1,2,5,3,2,5
21,2,5,61,42,103
6,2,5,17,12,29
17,2,5,36,34,70
19,2,5,40,38,78
14,2,5,41,28,69
29,2,5,84,58,142
10,2,5,29,20,49
15,2,5,44,30,74
28,2,5,59,56,115
4,3,9,20,12,32
8,3,9,39,24,63
25,2,5,55,50,105
25,2,5,59,50,109
10,2,5,24,20,44
4,7,9,-1,28,27
11,7,9,20,77,97
23,7,9,42,161,203
19,7,9,36,133,169
18,7,9,15,126,141
5,7,9,9,35,44
28,8,22,380,224,604
10,8,22,111,80,191
5,8,22,69,40,109
26,8,22,324,208,532
7,8,22,96,56,152
17,8,22,171,136,307
14,9,24,207,126,333
18,9,24,261,162,423
25,9,24,363,225,588
27,9,24,392,243,635
5,9,24,56,45,101
9,13,35,185,117,302
22,13,35,315,286,601
29,13,35,415,377,792
10,13,35,217,130,347
20,13,35,426,260,686
3,13,35,53,39,92
5,13,35,108,65,173
29,13,35,618,377,995
13,13,35,200,169,369
2,13,35,43,26,69
6,13,35,86,78,164
11,13,35,227,143,370
4,13,35,57,52,109
22,13,35,430,286,716
11,13,35,227,143,370
15,21,55,502,315,817
22,21,55,700,462,1162
14,21,55,314,294,608
17,21,55,559,357,916
25,38,50,250,950,1200
4,42,54,44,168,212
15,42,54,172,630,802
7,38,50,7,266,273
7,38,50,7,266,273
9,42,54,30,378,408
20,42,54,218,840,1058
20,38,50,80,760,840
25,38,50,75,950,1025
1,42,54,2,42,44
19,42,54,187,798,985
1,1912,3400,1046,1912,2958
1,1898,3375,1038,1898,2936
1,1252,2295,997,1252,2249
1,1252,2295,997,1252,2249
1,1252,2295,882,1252,2134
1,1266,2320,752,1266,2018
1,1266,2320,1031,1266,2297
1,295,540,207,295,502
1,1266,2320,961,1266,2227
1,1266,2320,1008,1266,2274
1,1266,2320,961,1266,2227
1,308,565,246,308,554
1,1266,2320,636,1266,1902
1,1898,3375,1410,1898,3308
1,2171,3578,763,2171,2934
1,713,1120,385,713,1098
1,1555,2443,790,1555,2345
1,1519,2443,533,1519,2052
1,1555,2443,595,1555,2150
1,344,540,191,344,535
1,2171,3578,1335,2171,3506
1,1083,1701,312,1083,1395
1,487,783,171,487,658
1,344,540,110,344,454
1,2171,3578,620,2171,2791
18,26,70,767,468,1235
17,26,70,486,442,928
15,26,70,429,390,819
18,26,70,767,468,1235
3,1,2,3,3,6
27,1,2,26,27,53
12,1,2,7,12,19
3,13,35,62,39,101
24,13,35,494,312,806
2,1,2,1,2,3
25,1,2,16,25,41
25,1,2,16,25,41
7,13,35,152,91,243
16,13,35,346,208,554
9,2,5,25,18,43
16,2,5,45,32,77
26,11,30,393,286,679
27,11,30,383,297,680
26,11,30,369,286,655
12,2,5,23,24,47
4,2,5,8,8,16
13,2,5,31,26,57
9,11,30,166,99,265
1,11,30,18,11,29
1,2,5,3,2,5
26,9,25,410,234,644
22,9,25,347,198,545
18,1,2,10,18,28
24,1,2,24,24,48
12,1,2,7,12,19
15,11,29,179,165,344
15,11,29,179,165,344
9,8,21,87,72,159
19,8,21,183,152,335
30,2,5,87,60,147
5,2,5,14,10,24
14,2,5,39,28,67
19,2,5,53,38,91
10,1,2,6,10,16
29,1,2,17,29,46
1,1482,2384,807,1482,2289
1,755,1215,302,755,1057
1,755,1215,436,755,1191
1,755,1215,436,755,1191
1,1482,2384,854,1482,2336
1,1482,2384,807,1482,2289
22,24,64,852,528,1380
6,45,120,421,270,691
26,3,9,119,78,197
17,2,5,50,34,84
15,2,5,44,30,74
5,3,9,28,15,43
24,3,9,135,72,207
15,2,5,42,30,72
27,2,5,78,54,132
10,2,5,29,20,49
9,2,5,24,18,42
5,2,5,13,10,23
14,3,9,75,42,117
13,2,5,36,26,62
1,2,5,3,2,5
25,4,10,120,100,220
18,4,10,86,72,158
4,4,10,22,16,38
26,4,10,146,104,250
28,2,5,66,56,122
18,2,5,42,36,78
30,2,5,87,60,147
29,2,5,84,58,142
24,2,5,53,48,101
29,2,5,86,58,144
14,2,5,41,28,69
7,3,9,41,21,62
8,3,9,47,24,71
26,2,5,60,52,112
7,2,5,16,14,30
19,2,5,36,38,74
25,2,5,48,50,98
18,7,9,33,126,159
10,7,9,7,70,77
11,7,9,18,77,95
28,7,9,51,196,247
27,3,8,126,81,207
24,3,8,89,72,161
17,8,22,159,136,295
2,8,22,28,16,44
14,8,22,184,112,296
18,8,22,236,144,380
3,9,24,44,27,71
1,9,24,10,9,19
1,13,35,17,13,30
14,13,35,244,182,426
17,13,35,249,221,470
9,13,35,138,117,255
21,13,35,366,273,639
15,13,35,325,195,520
12,13,35,176,156,332
13,13,35,268,169,437
19,13,35,411,247,658
24,13,35,427,312,739
5,13,35,82,65,147
20,13,35,328,260,588
2,13,35,34,26,60
6,13,35,128,78,206
10,13,35,217,130,347
8,13,35,165,104,269
23,13,35,329,299,628
18,13,35,314,234,548
9,13,35,176,117,293
29,13,35,567,377,944
21,13,35,300,273,573
12,42,54,138,504,642
8,42,54,92,336,428
24,42,54,236,1008,1244
1,1912,3400,944,1912,2856
1,1266,2320,752,1266,2018
1,1266,2320,961,1266,2227
1,1266,2320,961,1266,2227
1,1266,2320,544,1266,1810
1,295,540,126,295,421
1,1266,2320,961,1266,2227
1,420,769,295,420,715
1,1252,2295,768,1252,2020
1,1252,2295,997,1252,2249
1,1266,2320,1031,1266,2297
1,1266,2320,961,1266,2227
1,420,769,295,420,715
1,1266,2320,961,1266,2227
1,1519,2443,606,1519,2125
1,487,783,280,487,767
1,1519,2443,411,1519,1930
1,2171,3578,942,2171,3113
1,713,1120,161,713,874
1,1083,1701,346,1083,1429
1,344,540,110,344,454
1,3,9,5,3,8
6,2,5,17,12,29
18,1,2,18,18,36
13,1,2,13,13,26
26,13,35,381,338,719
10,13,35,147,130,277
15,1,4,35,15,50
9,13,35,195,117,312
27,13,35,443,351,794
20,13,35,328,260,588
6,9,25,77,54,131
29,9,25,370,261,631
12,2,5,35,24,59
26,2,5,77,52,129
1,1,2,1,1,2
12,9,25,135,108,243
16,2,5,39,32,71
5,2,5,12,10,22
8,1,2,8,8,16
11,1,2,6,11,17
20,1,2,11,20,31
6,2,5,13,12,25
9,2,5,19,18,37
7,2,5,13,14,27
12,2,5,23,24,47
24,2,5,46,48,94
13,2,5,31,26,57
29,8,21,292,232,524
29,8,21,292,232,524
17,13,35,368,221,589
7,2,5,13,14,27
11,2,5,21,22,43
22,1,2,22,22,44
8,1,2,5,8,13
7,1,2,5,7,12
20,2,5,47,40,87
23,11,30,430,253,683
25,11,30,468,275,743
12,2,5,35,24,59
1,2,5,3,2,5
13,2,5,38,26,64
27,1,2,19,27,46
13,2,5,31,26,57
6,1,2,3,6,9
20,1,2,11,20,31
19,1,4,52,19,71
10,1,4,27,10,37
4,2,5,8,8,16
11,2,5,32,22,54
2,1,2,2,2,4
30,1,2,28,30,58
7,1,4,20,7,27
25,1,4,71,25,96
30,9,25,315,270,585
1,1482,2384,807,1482,2289
1,1482,2384,807,1482,2289
1,755,1215,375,755,1130
2,24,64,79,48,127
20,24,64,570,480,1050
7,45,120,340,315,655
1,59,159,98,59,157
20,2,5,47,40,87
3,2,5,9,6,15
18,2,5,38,36,74
18,2,5,38,36,74
14,4,10,55,56,111
6,4,10,23,24,47
28,2,5,59,56,115
1,2,5,2,2,4
14,4,10,81,56,137
10,4,10,58,40,98
2,2,5,6,4,10
3,2,5,8,6,14
21,2,5,40,42,82
16,2,5,30,32,62
27,2,5,78,54,132
9,3,9,51,27,78
30,3,9,169,90,259
20,2,5,46,40,86
4,3,9,15,12,27
7,3,9,27,21,48
26,2,5,61,52,113
12,3,9,53,36,89
7,7,9,13,49,62
3,7,9,5,21,26
7,7,9,13,49,62
3,7,9,0,21,21
27,7,9,1,189,190
25,7,9,14,175,189
18,7,9,7,126,133
1,7,9,2,7,9
12,7,9,23,84,107
14,7,9,25,98,123
16,7,9,13,112,125
5,7,9,8,35,43
11,3,8,54,33,87
15,3,8,59,45,104
3,8,22,30,24,54
30,8,22,275,240,515
4,8,22,55,32,87
11,9,24,160,99,259
26,9,24,378,234,612
12,9,24,168,108,276
29,13,35,628,377,1005
7,13,35,144,91,235
6,13,35,88,78,166
16,13,35,330,208,538
5,13,35,103,65,168
12,13,35,256,156,412
3,13,35,44,39,83
11,13,35,227,143,370
3,13,35,44,39,83
30,13,35,534,390,924
3,13,35,62,39,101
23,13,35,361,299,660
17,21,55,541,357,898
8,21,55,263,168,431
13,38,50,143,494,637
4,42,54,46,168,214
19,38,50,19,722,741
4,38,50,44,152,196
4,42,54,20,168,188
17,42,54,75,714,789
1,1266,2320,544,1266,1810
1,308,565,246,308,554
1,1555,2443,546,1555,2101
1,1555,2443,839,1555,2394
1,2171,3578,656,2171,2827
1,1555,2443,790,1555,2345
1,1519,2443,484,1519,2003
1,713,1120,362,713,1075
1,344,540,77,344,421
1,344,540,174,344,518
1,1555,2443,570,1555,2125
1,713,1120,205,713,918
1,487,783,194,487,681
1,344,540,99,344,443
1,2171,3578,620,2171,2791
28,26,70,1193,728,1921
29,26,70,1256,754,2010
10,26,70,342,260,602
20,26,70,656,520,1176
21,3,9,92,63,155
12,1,4,36,12,48
9,1,2,9,9,18
20,1,2,20,20,40
3,13,35,52,39,91
7,11,30,131,77,208
24,11,30,449,264,713
15,1,2,14,15,29
8,1,2,8,8,16
15,1,2,14,15,29
5,2,5,14,10,24
6,2,5,17,12,29
8,9,25,126,72,198
5,9,25,79,45,124
3,1,4,7,3,10
2,1,4,5,2,7
22,1,2,13,22,35
17,1,2,10,17,27
17,2,5,48,34,82
26,2,5,73,52,125
14,1,4,35,14,49
14,1,4,30,14,44
17,1,4,36,17,53
3,1,2,2,3,5
11,9,25,140,99,239
26,1,2,15,26,41
27,1,2,15,27,42
5,1,2,3,5,8
26,2,5,73,52,125
3,1,2,2,3,5
22,1,2,14,22,36
26,8,21,223,208,431
25,8,21,215,200,415
20,2,5,38,40,78
24,2,5,46,48,94
15,1,2,15,15,30
16,1,2,16,16,32
25,1,2,25,25,50
14,2,5,41,28,69
4,2,5,12,8,20
9,11,29,131,99,230
16,11,29,232,176,408
6,2,5,11,12,23
29,9,25,363,261,624
1,461,742,251,461,712
1,1482,2384,854,1482,2336
1,1482,2384,378,1482,1860
1,1482,2384,854,1482,2336
1,461,742,192,461,653
11,24,64,327,264,591
9,24,64,285,216,501
6,45,120,436,270,706
7,4,10,41,28,69
27,4,10,159,108,267
16,2,5,46,32,78
18,2,5,38,36,74
19,2,5,40,38,78
18,4,10,74,72,146
14,4,10,57,56,113
25,2,5,48,50,98
12,3,9,71,36,107
12,3,9,71,36,107
16,3,9,93,48,141
7,2,5,15,14,29
12,4,10,70,48,118
4,4,10,23,16,39
7,3,9,28,21,49
17,3,9,68,51,119
28,3,9,115,84,199
6,3,9,25,18,43
24,2,5,67,48,115
7,2,5,15,14,29
3,2,5,6,6,12
17,2,5,49,34,83
19,2,5,55,38,93
18,7,9,7,126,133
19,7,9,26,133,159
3,7,9,0,21,21
13,7,9,10,91,101
6,7,9,5,42,47
16,7,9,22,112,134
18,3,8,89,54,143
20,3,8,90,60,150
3,3,8,15,9,24
23,8,22,312,184,496
17,8,22,178,136,314
23,8,22,251,184,435
1,8,22,14,8,22
23,8,22,287,184,471
27,9,24,399,243,642
3,13,35,65,39,104
8,13,35,140,104,244
4,13,35,66,52,118
25,13,35,428,325,753
25,13,35,489,325,814
18,13,35,352,234,586
18,13,35,264,234,498
10,13,35,196,130,326
12,13,35,247,156,403
4,13,35,85,52,137
7,13,35,122,91,213
19,13,35,332,247,579
2,13,35,29,26,55
11,13,35,173,143,316
8,21,55,268,168,436
15,21,55,337,315,652
5,42,54,3,210,213
7,38,50,7,266,273
30,42,54,101,1260,1361
10,42,54,50,420,470
1,1266,2320,729,1266,1995
1,1898,3375,937,1898,2835
1,1266,2320,915,1266,2181
1,1252,2295,561,1252,1813
1,308,565,155,308,463
1,420,769,203,420,623
1,295,540,126,295,421
1,487,783,280,487,767
1,1083,1701,397,1083,1480
1,2171,3578,942,2171,3113
1,1083,1701,380,1083,1463
1,1083,1701,601,1083,1684
1,487,783,241,487,728
1,2171,3578,656,2171,2827
1,1555,2443,497,1555,2052
1,344,540,126,344,470
1,344,540,83,344,427
3,26,70,88,78,166
4,26,70,170,104,274
11,26,70,469,286,755
4,3,9,23,12,35
3,3,9,17,9,26
14,1,2,14,14,28
7,2,5,20,14,34
4,1,2,4,4,8
3,1,2,3,3,6
12,13,35,239,156,395
10,13,35,199,130,329
5,13,35,100,65,165
24,1,2,23,24,47
5,1,2,5,5,10
16,1,2,15,16,31
16,13,35,313,208,521
2,13,35,39,26,65
14,11,30,237,154,391
16,11,30,270,176,446
29,9,25,312,261,573
24,2,5,65,48,113
2,2,5,5,4,9
2,1,2,1,2,3
9,1,2,6,9,15
18,2,5,53,36,89
13,11,30,189,143,332
5,1,2,4,5,9
3,1,2,2,3,5
16,1,2,12,16,28
21,1,2,16,21,37
14,1,2,14,14,28
26,1,2,25,26,51
24,1,2,23,24,47
6,1,2,6,6,12
8,9,25,124,72,196
1,1482,2384,473,1482,1955
1,1482,2384,735,1482,2217
1,1482,2384,735,1482,2217
21,24,64,638,504,1142
9,45,120,524,405,929
19,2,5,55,38,93
23,2,5,67,46,113
8,2,5,22,16,38
1,4,10,6,4,10
24,4,10,142,96,238
14,2,5,29,28,57
29,2,5,61,58,119
14,2,5,41,28,69
5,2,5,15,10,25
9,2,5,19,18,37
12,2,5,25,24,49
11,2,5,32,22,54
8,2,5,17,16,33
1,2,5,2,2,4
5,3,9,27,15,42
16,3,9,86,48,134
21,2,5,40,42,82
4,2,5,12,8,20
18,2,5,53,36,89
24,2,5,70,48,118
19,2,5,55,38,93
10,7,9,16,70,86
4,7,9,7,28,35
14,7,9,23,98,121
21,7,9,34,147,181
3,7,9,6,21,27
20,7,9,17,140,157
21,7,9,40,147,187
21,7,9,38,147,185
27,7,9,52,189,241
23,3,8,102,69,171
7,3,8,33,21,54
9,8,22,90,72,162
29,8,22,393,232,625
16,8,22,217,128,345
19,8,22,174,152,326
19,8,22,212,152,364
15,8,22,203,120,323
5,8,22,68,40,108
4,8,22,52,32,84
7,8,22,95,56,151
1,8,22,10,8,18
12,8,22,165,96,261
30,9,24,292,270,562
22,9,24,214,198,412
29,13,35,394,377,771
16,13,35,346,208,554
20,13,35,412,260,672
12,13,35,256,156,412
16,13,35,330,208,538
10,13,35,206,130,336
24,13,35,494,312,806
21,13,35,300,273,573
14,13,35,298,182,480
18,13,35,383,234,617
25,13,35,340,325,665
15,13,35,251,195,446
12,13,35,209,156,365
26,13,35,554,338,892
20,13,35,426,260,686
25,13,35,515,325,840
24,13,35,343,312,655
25,13,35,358,325,683
2,13,35,29,26,55
14,13,35,220,182,402
22,13,35,361,286,647
6,21,55,197,126,323
23,21,55,618,483,1101
12,21,55,382,252,634
16,21,55,350,336,686
15,38,50,45,570,615
30,42,54,20,1260,1280
21,42,54,71,882,953
18,38,50,207,684,891
20,42,54,46,840,886
6,42,54,69,252,321
14,38,50,154,532,686
12,42,54,60,504,564
1,1252,2295,630,1252,1882
1,1266,2320,752,1266,2018
1,1266,2320,497,1266,1763
1,1252,2295,561,1252,1813
1,308,565,155,308,463
1,1252,2295,997,1252,2249
1,1266,2320,544,1266,1810
1,295,540,207,295,502
1,420,769,318,420,738
1,308,565,234,308,542
1,1266,2320,1008,1266,2274
1,308,565,246,308,554
1,1266,2320,961,1266,2227
1,1555,2443,448,1555,2003
1,1083,1701,601,1083,1684
1,713,1120,385,713,1098
1,713,1120,161,713,874
1,713,1120,362,713,1075
1,344,540,158,344,502
1,713,1120,239,713,952
1,2171,3578,1335,2171,3506
11,26,70,315,286,601
3,3,9,17,9,26
24,1,2,13,24,37
11,1,2,6,11,17
23,13,35,329,299,628
2,13,35,29,26,55
23,13,35,490,299,789
28,13,35,596,364,960
27,13,35,575,351,926
8,2,5,15,16,31
3,2,5,6,6,12
19,12,33,374,228,602
26,2,5,75,52,127
11,2,5,32,22,54
20,1,2,18,20,38
6,1,2,6,6,12
1,1,2,1,1,2
10,13,35,213,130,343
19,13,35,405,247,652
7,13,35,149,91,240
6,9,25,65,54,119
4,9,25,43,36,79
14,9,25,151,126,277
17,2,5,50,34,84
21,2,5,62,42,104
24,2,5,46,48,94
23,2,5,41,46,87
21,2,5,38,42,80
8,1,2,6,8,14
2,1,2,1,2,3
1,9,25,11,9,20
8,9,25,86,72,158
23,9,25,247,207,454
30,1,2,28,30,58
10,1,2,9,10,19
5,1,4,12,5,17
6,1,4,14,6,20
14,2,5,33,28,61
2,1,2,2,2,4
21,1,2,14,21,35
30,2,5,87,60,147
17,2,5,49,34,83
26,2,5,75,52,127
4,2,5,12,8,20
15,1,2,11,15,26
1,1,2,1,1,2
6,2,5,17,12,29
16,1,2,14,16,30
1,1,2,1,1,2
18,11,29,314,198,512
2,11,29,35,22,57
2,11,29,35,22,57
10,1,2,6,10,16
18,1,2,10,18,28
12,1,4,34,12,46
13,1,2,12,13,25
20,2,5,56,40,96
29,2,5,68,58,126
21,1,4,61,21,82
21,1,4,61,21,82
18,2,5,52,36,88
19,2,5,55,38,93
16,2,5,46,32,78
1,1482,2384,807,1482,2289
1,755,1215,302,755,1057
1,1482,2384,807,1482,2289
1,755,1215,436,755,1191
1,1482,2384,854,1482,2336
1,1482,2384,473,1482,1955
17,24,64,484,408,892
7,45,120,525,315,840
24,2,5,67,48,115
13,2,5,36,26,62
30,2,5,59,60,119
13,2,5,25,26,51
17,2,5,32,34,66
6,2,5,11,12,23
14,2,5,39,28,67
29,2,5,81,58,139
30,2,5,87,60,147
17,2,5,49,34,83
13,2,5,27,26,53
9,2,5,19,18,37
25,2,5,66,50,116
15,4,10,89,60,149
11,2,5,23,22,45
12,2,5,25,24,49
18,3,9,79,54,133
5,7,9,2,35,37
13,7,9,21,91,112
15,7,9,25,105,130
21,7,9,34,147,181
25,7,9,19,175,194
26,7,9,22,182,204
22,7,9,40,154,194
8,7,9,0,56,56
16,7,9,13,112,125
28,7,9,53,196,249
7,7,9,3,49,52
21,7,9,17,147,164
12,8,22,110,96,206
10,8,22,109,80,189
24,8,22,331,192,523
5,8,22,56,40,96
4,8,22,55,32,87
19,8,22,262,152,414
10,8,22,131,80,211
28,9,24,407,252,659
2,9,24,29,18,47
28,9,24,407,252,659
2,13,35,43,26,69
17,13,35,332,221,553
3,13,35,64,39,103
16,13,35,229,208,437
7,13,35,122,91,213
25,13,35,393,325,718
28,13,35,577,364,941
21,13,35,447,273,720
25,13,35,428,325,753
5,13,35,72,65,137
23,13,35,490,299,789
18,13,35,383,234,617
17,13,35,368,221,589
10,13,35,143,130,273
7,13,35,122,91,213
20,13,35,433,260,693
24,13,35,520,312,832
1,13,35,21,13,34
24,13,35,343,312,655
6,13,35,128,78,206
17,13,35,267,221,488
18,42,54,197,756,953
17,38,50,170,646,816
10,42,54,50,420,470
1,42,54,4,42,46
2,42,54,0,84,84
8,38,50,40,304,344
24,42,54,236,1008,1244
22,38,50,121,836,957
25,38,50,138,950,1088
29,38,50,319,1102,1421
17,42,54,195,714,909
19,38,50,162,722,884
16,38,50,184,608,792
20,42,54,197,840,1037
1,1252,2295,538,1252,1790
1,1252,2295,745,1252,1997
1,1252,2295,1020,1252,2272
1,420,769,188,420,608
1,420,769,249,420,669
1,308,565,155,308,463
1,1252,2295,630,1252,1882
1,1252,2295,1020,1252,2272
1,1252,2295,722,1252,1974
1,1252,2295,722,1252,1974
1,1555,2443,790,1555,2345
1,344,540,126,344,470
1,344,540,174,344,518
1,2171,3578,1335,2171,3506
1,344,540,99,344,443
1,2171,3578,620,2171,2791
8,26,70,279,208,487
7,9,25,75,63,138
1,9,25,11,9,20
18,1,2,10,18,28
8,1,2,4,8,12
16,8,21,137,128,265
24,2,5,50,48,98
16,2,5,34,32,66
18,2,5,53,36,89
26,2,5,77,52,129
6,1,2,4,6,10
20,1,2,13,20,33
18,2,5,35,36,71
11,13,35,234,143,377
5,13,35,107,65,172
1,2,5,3,2,5
3,2,5,9,6,15
3,1,2,3,3,6
18,11,30,223,198,421
18,11,30,223,198,421
28,2,5,78,56,134
25,2,5,70,50,120
8,2,5,15,16,31
14,1,2,13,14,27
21,2,5,40,42,82
28,2,5,53,56,109
28,8,21,323,224,547
23,2,5,48,46,94
9,1,2,9,9,18
5,1,2,5,5,10
5,2,5,15,10,25
11,12,33,155,132,287
27,1,2,25,27,52
15,1,2,14,15,29
10,1,2,10,10,20
5,12,33,82,60,142
17,1,4,41,17,58
4,12,33,81,48,129
14,12,33,285,168,453
7,2,5,14,14,28
23,2,5,44,46,90
15,2,5,29,30,59
21,1,4,45,21,66
9,1,2,9,9,18
17,2,5,48,34,82
1,755,1215,411,755,1166
1,1482,2384,878,1482,2360
1,461,742,185,461,646
1,755,1215,241,755,996
13,24,64,345,312,657
3,24,64,85,72,157
6,59,159,390,354,744
21,3,9,118,63,181
5,3,9,28,15,43
16,2,5,30,32,62
21,2,5,40,42,82
21,2,5,44,42,86
26,2,5,55,52,107
21,3,9,96,63,159
14,3,9,64,42,106
16,4,10,74,64,138
6,4,10,28,24,52
8,2,5,21,16,37
9,2,5,24,18,42
30,4,10,168,120,288
22,4,10,123,88,211
23,2,5,53,46,99
26,2,5,49,52,101
24,2,5,46,48,94
11,7,9,9,77,86
24,7,9,18,168,186
20,7,9,33,140,173
8,7,9,3,56,59
22,3,8,78,66,144
19,8,22,258,152,410
3,8,22,41,24,65
9,8,22,82,72,154
5,8,22,47,40,87
3,9,24,42,27,69
8,9,24,118,72,190
29,9,24,421,261,682
11,9,24,147,99,246
13,9,24,189,117,306
6,9,24,84,54,138
3,13,35,43,39,82
30,13,35,587,390,977
18,13,35,352,234,586
3,13,35,43,39,82
4,13,35,85,52,137
29,13,35,597,377,974
24,13,35,343,312,655
4,13,35,82,52,134
6,13,35,105,78,183
21,13,35,433,273,706
6,13,35,128,78,206
15,13,35,220,195,415
10,13,35,206,130,336
3,13,35,59,39,98
14,21,55,337,294,631
10,42,54,98,420,518
8,42,54,14,336,350
16,42,54,175,672,847
1,1898,3375,1038,1898,2936
1,1252,2295,882,1252,2134
1,1252,2295,630,1252,1882
1,420,769,318,420,738
1,420,769,334,420,754
1,1266,2320,892,1266,2158
1,1266,2320,961,1266,2227
1,2171,3578,942,2171,3113
1,1519,2443,826,1519,2345
1,487,783,241,487,728
1,1083,1701,584,1083,1667
1,487,783,265,487,752
1,487,783,147,487,634
1,2171,3578,1335,2171,3506
12,26,70,343,312,655
24,3,9,140,72,212
7,3,9,39,21,60
2,3,9,10,6,16
16,8,21,184,128,312
29,1,2,28,29,57
18,1,2,18,18,36
1,1,2,1,1,2
20,1,2,15,20,35
20,2,5,56,40,96
2,2,5,6,4,10
24,11,30,326,264,590
4,2,5,9,8,17
22,2,5,65,44,109
24,2,5,71,48,119
23,2,5,68,46,114
25,2,5,48,50,98
5,2,5,10,10,20
30,1,4,64,30,94
3,1,4,6,3,9
15,9,25,233,135,368
4,9,25,62,36,98
10,1,4,28,10,38
13,1,4,37,13,50
16,1,4,45,16,61
13,1,4,37,13,50
12,8,21,103,96,199
7,1,2,4,7,11
13,11,30,231,143,374
28,11,30,498,308,806
4,2,5,12,8,20
21,2,5,62,42,104
24,9,25,306,216,522
27,1,2,15,27,42
13,1,2,7,13,20
23,1,4,63,23,86
18,2,5,34,36,70
4,2,5,8,8,16
21,1,4,48,21,69
26,11,29,332,286,618
7,11,29,89,77,166
20,8,21,184,160,344
1,8,21,9,8,17
6,2,5,14,12,26
5,2,5,12,10,22
3,2,5,7,6,13
1,2,5,2,2,4
22,1,2,12,22,34
11,1,2,6,11,17
11,2,5,32,22,54
21,2,5,48,42,90
11,2,5,25,22,47
30,9,25,465,270,735
11,1,4,27,11,38
1,461,742,185,461,646
1,1482,2384,378,1482,1860
1,461,742,251,461,712
8,45,120,446,360,806
9,2,5,27,18,45
16,2,5,47,32,79
9,2,5,27,18,45
28,2,5,83,56,139
11,2,5,32,22,54
7,2,5,21,14,35
1,4,10,6,4,10
3,4,10,17,12,29
5,2,5,10,10,20
14,2,5,27,28,55
2,2,5,6,4,10
2,2,5,6,4,10
23,2,5,67,46,113
5,2,5,15,10,25
3,4,10,14,12,26
14,4,10,66,56,122
28,4,10,162,112,274
4,4,10,23,16,39
22,2,5,51,44,95
17,2,5,32,34,66
7,2,5,13,14,27
6,4,10,23,24,47
9,3,9,52,27,79
15,3,9,87,45,132
27,7,9,52,189,241
5,7,9,9,35,44
9,7,9,7,63,70
29,7,9,24,203,227
4,7,9,0,28,28
25,7,9,3,175,178
30,3,8,148,90,238
19,8,22,174,152,326
13,8,22,176,104,280
4,8,22,37,32,69
22,8,22,231,176,407
20,8,22,276,160,436
30,8,22,394,240,634
21,8,22,289,168,457
14,9,24,203,126,329
18,9,24,253,162,415
13,9,24,139,117,256
6,9,24,87,54,141
29,13,35,394,377,771
11,13,35,238,143,381
17,13,35,368,221,589
14,13,35,288,182,470
14,13,35,303,182,485
21,13,35,447,273,720
11,13,35,192,143,335
10,13,35,143,130,273
10,13,35,213,130,343
5,13,35,82,65,147
3,13,35,64,39,103
24,13,35,410,312,722
5,13,35,108,65,173
30,13,35,524,390,914
27,13,35,471,351,822
20,13,35,391,260,651
30,21,55,987,630,1617
1,21,55,33,21,54
5,42,54,57,210,267
28,42,54,276,1176,1452
25,38,50,288,950,1238
15,38,50,165,570,735
3,42,54,10,126,136
13,38,50,143,494,637
1,38,50,11,38,49
4,42,54,20,168,188
1,38,50,10,38,48
16,38,50,48,608,656
7,38,50,81,266,347
20,38,50,220,760,980
1,1252,2295,1020,1252,2272
1,1266,2320,961,1266,2227
1,1266,2320,752,1266,2018
1,1266,2320,892,1266,2158
1,308,565,246,308,554
1,1266,2320,961,1266,2227
1,295,540,240,295,535
1,1266,2320,544,1266,1810
1,344,540,66,344,410
1,344,540,191,344,535
1,1555,2443,717,1555,2272
1,713,1120,385,713,1098
1,344,540,191,344,535
20,26,70,572,520,1092
17,26,70,498,442,940
26,13,35,445,338,783
19,9,25,242,171,413
11,2,5,32,22,54
27,2,5,80,54,134
16,13,35,346,208,554
9,13,35,195,117,312
16,13,35,346,208,554
3,2,5,6,6,12
5,2,5,10,10,20
13,9,25,150,117,267
26,1,2,24,26,50
10,1,2,9,10,19
24,1,2,22,24,46
15,1,2,15,15,30
12,1,2,7,12,19
12,1,2,7,12,19
19,1,2,11,19,30
9,1,2,9,9,18
10,1,2,10,10,20
21,11,30,374,231,605
23,11,30,409,253,662
14,13,35,205,182,387
11,13,35,161,143,304
23,2,5,67,46,113
15,2,5,44,30,74
24,1,2,16,24,40
11,1,2,7,11,18
14,11,30,165,154,319
2,11,30,24,22,46
7,2,5,16,14,30
4,2,5,9,8,17
23,1,4,67,23,90
2,1,4,6,2,8
23,11,29,407,253,660
23,11,29,407,253,660
26,2,5,61,52,113
4,2,5,9,8,17
14,2,5,33,28,61
16,9,25,248,144,392
16,1,4,47,16,63
17,1,4,50,17,67
21,11,29,232,231,463
6,11,29,66,66,132
6,11,29,77,66,143
12,11,29,153,132,285
1,1482,2384,854,1482,2336
1,755,1215,436,755,1191
1,1482,2384,592,1482,2074
1,755,1215,436,755,1191
1,1482,2384,378,1482,1860
13,24,64,512,312,824
11,45,120,799,495,1294
28,2,5,81,56,137
22,2,5,64,44,108
24,2,5,71,48,119
25,2,5,74,50,124
22,2,5,42,44,86
2,2,5,6,4,10
12,2,5,35,24,59
22,3,9,90,66,156
6,3,9,25,18,43
27,4,10,157,108,265
27,3,9,145,81,226
18,2,5,53,36,89
4,2,5,12,8,20
14,2,5,31,28,59
7,2,5,15,14,29
2,7,9,3,14,17
3,7,9,0,21,21
21,7,9,34,147,181
6,7,9,6,42,48
15,3,8,74,45,119
27,3,8,90,81,171
27,3,8,100,81,181
14,3,8,52,42,94
28,8,22,367,224,591
26,8,22,353,208,561
21,8,22,285,168,453
27,8,22,372,216,588
17,9,24,202,153,355
25,9,24,351,225,576
12,9,24,117,108,225
19,13,35,405,247,652
21,13,35,359,273,632
10,13,35,206,130,336
4,13,35,57,52,109
4,13,35,57,52,109
7,13,35,122,91,213
27,13,35,575,351,926
23,13,35,401,299,700
1,13,35,17,13,30
7,13,35,103,91,194
28,13,35,479,364,843
25,13,35,358,325,683
29,21,55,635,609,1244
3,38,50,35,114,149
23,42,54,15,966,981
24,38,50,72,912,984
1,42,54,11,42,53
9,42,54,45,378,423
19,42,54,207,798,1005
1,1252,2295,538,1252,1790
1,1252,2295,951,1252,2203
1,1252,2295,997,1252,2249
1,1266,2320,1008,1266,2274
1,1266,2320,567,1266,1833
1,1252,2295,997,1252,2249
1,1252,2295,997,1252,2249
1,1252,2295,630,1252,1882
1,1266,2320,1008,1266,2274
1,1266,2320,1008,1266,2274
1,1266,2320,1008,1266,2274
1,1555,2443,717,1555,2272
1,1519,2443,582,1519,2101
1,1083,1701,244,1083,1327
1,2171,3578,942,2171,3113
1,713,1120,250,713,963
1,344,540,174,344,518
1,487,783,171,487,658
1,2171,3578,1335,2171,3506
22,26,70,937,572,1509
3,26,70,86,78,164
4,26,70,170,104,274
30,3,9,131,90,221
22,3,9,128,66,194
2,3,9,12,6,18
23,2,5,44,46,90
14,2,5,27,28,55
4,2,5,8,8,16
4,13,35,82,52,134
12,13,35,247,156,403
6,1,2,6,6,12
4,1,2,2,4,6
26,1,2,15,26,41
6,1,2,3,6,9
19,1,2,11,19,30
19,1,4,45,19,64
6,9,25,65,54,119
6,13,35,128,78,206
26,13,35,554,338,892
19,1,2,19,19,38
7,11,30,89,77,166
5,11,30,64,55,119
17,12,33,351,204,555
6,2,5,17,12,29
27,2,5,78,54,132
27,9,25,344,243,587
3,9,25,38,27,65
28,12,33,394,336,730
13,1,2,10,13,23
13,1,4,31,13,44
17,1,4,40,17,57
7,1,4,17,7,24
17,2,5,41,34,75
18,2,5,43,36,79
9,1,2,9,9,18
15,1,2,15,15,30
12,1,2,11,12,23
24,1,4,68,24,92
17,1,4,48,17,65
27,8,21,340,216,556
3,9,25,47,27,74
10,1,4,29,10,39
2,1,4,6,2,8
26,1,4,63,26,89
8,1,4,20,8,28
1,1482,2384,807,1482,2289
1,755,1215,193,755,948
1,1482,2384,854,1482,2336
1,1482,2384,854,1482,2336
5,24,64,187,120,307
17,2,5,50,34,84
30,3,9,145,90,235
2,3,9,10,6,16
5,3,9,21,15,36
24,2,5,71,48,119
9,2,5,27,18,45
28,2,5,64,56,120
24,3,9,109,72,181
12,3,9,55,36,91
23,4,10,133,92,225
10,4,10,58,40,98
14,2,5,41,28,69
27,2,5,78,54,132
14,2,5,41,28,69
2,2,5,5,4,9
27,2,5,78,54,132
11,3,9,65,33,98
1,3,9,6,3,9
20,3,9,95,60,155
9,2,5,26,18,44
12,2,5,35,24,59
17,2,5,45,34,79
25,2,5,66,50,116
16,2,5,38,32,70
13,2,5,31,26,57
17,7,9,32,119,151
29,7,9,11,203,214
18,7,9,25,126,151
23,7,9,13,161,174
14,7,9,23,98,121
21,7,9,0,147,147
13,3,8,63,39,102
11,3,8,44,33,77
30,3,8,148,90,238
4,3,8,16,12,28
18,8,22,197,144,341
26,8,22,290,208,498
19,8,22,207,152,359
1,9,24,11,9,20
28,13,35,479,364,843
5,13,35,108,65,173
10,13,35,217,130,347
13,13,35,204,169,373
11,13,35,227,143,370
9,13,35,185,117,302
14,13,35,230,182,412
18,13,35,283,234,517
10,13,35,206,130,336
27,13,35,386,351,737
6,13,35,128,78,206
14,13,35,298,182,480
16,13,35,285,208,493
25,13,35,533,325,858
3,13,35,64,39,103
4,13,35,54,52,106
13,13,35,227,169,396
6,13,35,130,78,208
14,13,35,244,182,426
21,38,50,242,798,1040
27,42,54,62,1134,1196
16,38,50,136,608,744
11,38,50,127,418,545
1,42,54,11,42,53
5,42,54,17,210,227
6,42,54,59,252,311
30,42,54,295,1260,1555
2,42,54,0,84,84
6,38,50,24,228,252
2,42,54,22,84,106
17,38,50,0,646,646
1,1252,2295,722,1252,1974
1,1266,2320,1008,1266,2274
1,1252,2295,745,1252,1997
1,1252,2295,997,1252,2249
1,1519,2443,875,1519,2394
1,2171,3578,1157,2171,3328
1,487,783,265,487,752
1,487,783,155,487,642
1,487,783,155,487,642
1,1083,1701,244,1083,1327
1,2171,3578,835,2171,3006
1,713,1120,385,713,1098
1,344,540,77,344,421
1,344,540,120,344,464
1,1083,1701,499,1083,1582
1,1555,2443,497,1555,2052
1,713,1120,273,713,986
1,344,540,77,344,421
1,344,540,185,344,529
1,713,1120,261,713,974
1,344,540,66,344,410
1,344,540,66,344,410
1,713,1120,261,713,974
1,2171,3578,620,2171,2791
19,26,70,783,494,1277
18,26,70,779,468,1247
11,2,5,32,22,54
11,2,5,25,22,47
9,1,2,9,9,18
8,1,2,8,8,16
19,1,2,18,19,37
21,1,2,20,21,41
4,1,2,4,4,8
29,2,5,81,58,139
11,1,4,23,11,34
4,1,4,8,4,12
9,1,2,6,9,15
20,1,2,14,20,34
29,1,2,16,29,45
8,1,2,4,8,12
18,2,5,53,36,89
15,2,5,44,30,74
17,1,2,10,17,27
24,1,2,13,24,37
5,1,2,3,5,8
20,1,2,13,20,33
17,1,2,11,17,28
19,9,25,242,171,413
25,9,25,319,225,544
13,9,25,166,117,283
2,2,5,6,4,10
2,2,5,6,4,10
29,2,5,84,58,142
24,2,5,70,48,118
23,9,25,362,207,569
9,9,25,142,81,223
21,9,25,331,189,520
21,2,5,62,42,104
9,2,5,27,18,45
12,2,5,28,24,52
17,2,5,40,34,74
10,1,2,6,10,16
14,1,2,8,14,22
8,1,2,5,8,13
26,2,5,77,52,129
16,2,5,30,32,62
21,2,5,40,42,82
4,1,2,2,4,6
2,1,4,5,2,7
9,1,4,22,9,31
25,1,2,19,25,44
19,1,2,14,19,33
4,1,2,3,4,7
8,1,2,8,8,16
1,2,5,3,2,5
7,1,4,20,7,27
15,1,4,44,15,59
28,1,4,82,28,110
1,1482,2384,401,1482,1883
1,461,742,251,461,712
1,1482,2384,854,1482,2336
29,2,5,86,58,144
3,2,5,9,6,15
26,2,5,61,52,113
12,2,5,28,24,52
15,2,5,44,30,74
2,2,5,6,4,10
23,4,10,87,92,179
6,4,10,23,24,47
15,4,10,59,60,119
25,4,10,98,100,198
26,2,5,75,52,127
23,2,5,44,46,90
7,2,5,13,14,27
16,2,5,31,32,63
26,2,5,51,52,103
5,3,9,27,15,42
4,3,9,21,12,33
2,4,10,11,8,19
9,4,10,48,36,84
14,2,5,41,28,69
21,2,5,62,42,104
18,2,5,53,36,89
11,2,5,32,22,54
16,2,5,38,32,70
14,2,5,25,28,53
4,2,5,7,8,15
25,2,5,73,50,123
13,2,5,38,26,64
7,2,5,20,14,34
18,3,9,82,54,136
8,3,9,36,24,60
21,7,9,29,147,176
3,7,9,5,21,26
16,7,9,31,112,143
30,7,9,49,210,259
23,7,9,-4,161,157
12,7,9,10,84,94
21,7,9,38,147,185
11,3,8,51,33,84
21,3,8,102,63,165
3,3,8,10,9,19
4,3,8,13,12,25
25,3,8,81,75,156
1,8,22,14,8,22
13,8,22,122,104,226
15,8,22,187,120,307
19,9,24,226,171,397
12,9,24,174,108,282
4,13,35,66,52,118
19,13,35,272,247,519
16,13,35,346,208,554
4,13,35,78,52,130
21,13,35,308,273,581
14,13,35,303,182,485
9,13,35,192,117,309
4,13,35,78,52,130
26,13,35,454,338,792
28,13,35,400,364,764
5,13,35,107,65,172
6,13,35,124,78,202
28,13,35,547,364,911
2,13,35,35,26,61
27,13,35,396,351,747
13,13,35,177,169,346
8,13,35,114,104,218
6,13,35,98,78,176
6,13,35,94,78,172
17,13,35,350,221,571
19,13,35,325,247,572
5,21,55,121,105,226
17,38,50,196,646,842
24,42,54,236,1008,1244
12,38,50,138,456,594
20,38,50,230,760,990
21,38,50,231,798,1029
1,1266,2320,1031,1266,2297
1,1252,2295,722,1252,1974
1,1266,2320,636,1266,1902
1,1266,2320,892,1266,2158
1,420,769,318,420,738
1,1266,2320,892,1266,2158
1,1252,2295,882,1252,2134
1,1898,3375,735,1898,2633
1,1266,2320,544,1266,1810
1,2171,3578,942,2171,3113
1,2171,3578,656,2171,2827
1,1555,2443,717,1555,2272
1,1083,1701,601,1083,1684
1,1083,1701,601,1083,1684
1,2171,3578,835,2171,3006
1,713,1120,396,713,1109
1,344,540,66,344,410
1,344,540,99,344,443
1,2171,3578,1371,2171,3542
6,3,9,28,18,46
10,3,9,58,30,88
13,3,9,70,39,109
16,3,9,77,48,125
17,13,35,291,221,512
11,13,35,188,143,331
6,1,2,6,6,12
25,1,2,24,25,49
21,12,33,413,252,665
12,12,33,236,144,380
5,12,33,98,60,158
9,1,2,5,9,14
19,1,2,11,19,30
24,2,5,67,48,115
11,2,5,31,22,53
25,9,25,388,225,613
15,9,25,233,135,368
13,9,25,202,117,319
16,1,2,12,16,28
7,2,5,15,14,29
8,2,5,17,16,33
13,2,5,27,26,53
16,2,5,47,32,79
2,13,35,29,26,55
11,13,35,161,143,304
30,2,5,71,60,131
13,2,5,31,26,57
19,12,33,317,228,545
18,8,21,155,144,299
14,1,2,13,14,27
26,1,2,24,26,50
21,2,5,61,42,103
23,2,5,67,46,113
7,1,2,5,7,12
22,1,2,16,22,38
21,2,5,41,42,83
29,2,5,55,58,113
13,1,4,38,13,51
25,1,4,74,25,99
24,1,2,22,24,46
11,1,2,10,11,21
8,1,2,7,8,15
24,12,33,330,288,618
2,12,33,27,24,51
10,2,5,23,20,43
1,2,5,2,2,4
9,9,25,115,81,196
29,8,21,298,232,530
1,8,21,10,8,18
18,2,5,34,36,70
21,2,5,40,42,82
20,8,21,243,160,403
23,9,25,357,207,564
1,461,742,162,461,623
1,1482,2384,878,1482,2360
1,461,742,251,461,712
1,755,1215,266,755,1021
1,1482,2384,735,1482,2217
1,1482,2384,854,1482,2336
1,461,742,147,461,608
1,1482,2384,807,1482,2289
1,1482,2384,807,1482,2289
1,461,742,266,461,727
20,24,64,531,480,1011
22,24,64,655,528,1183
2,59,159,197,118,315
6,59,159,476,354,830
7,59,159,500,413,913
30,2,5,71,60,131
10,2,5,24,20,44
1,2,5,3,2,5
20,2,5,59,40,99
17,2,5,48,34,82
28,2,5,78,56,134
29,2,5,67,58,125
26,2,5,73,52,125
19,2,5,53,38,91
7,2,5,15,14,29
16,2,5,35,32,67
10,2,5,27,20,47
1,2,5,3,2,5
2,2,5,4,4,8
4,2,5,8,8,16
27,2,5,78,54,132
1,2,5,3,2,5
9,4,10,53,36,89
30,4,10,177,120,297
29,2,5,68,58,126
16,2,5,38,32,70
2,2,5,5,4,9
2,2,5,6,4,10
14,2,5,39,28,67
6,3,9,35,18,53
1,3,9,6,3,9
6,2,5,14,12,26
23,2,5,53,46,99
1,2,5,3,2,5
3,2,5,9,6,15
29,2,5,84,58,142
5,2,5,15,10,25
30,2,5,71,60,131
11,2,5,26,22,48
8,3,9,35,24,59
9,3,9,39,27,66
6,2,5,14,12,26
28,2,5,66,56,122
20,2,5,47,40,87
18,3,9,79,54,133
24,3,9,105,72,177
22,2,5,43,44,87
6,2,5,12,12,24
27,2,5,78,54,132
29,2,5,84,58,142
25,3,9,148,75,223
10,3,9,59,30,89
25,7,9,48,175,223
15,7,9,29,105,134
11,7,9,18,77,95
3,7,9,5,21,26
21,7,9,34,147,181
27,7,9,20,189,209
1,7,9,0,7,7
26,7,9,22,182,204
27,7,9,3,189,192
19,7,9,36,133,169
1,3,8,3,3,6
1,3,8,5,3,8
28,8,22,306,224,530
1,8,22,14,8,22
8,8,22,110,64,174
28,8,22,367,224,591
22,8,22,303,176,479
28,9,24,272,252,524
18,9,24,214,162,376
24,9,24,268,216,484
27,9,24,392,243,635
5,13,35,107,65,172
12,13,35,247,156,403
22,13,35,361,286,647
11,13,35,161,143,304
30,13,35,524,390,914
9,13,35,179,117,296
28,13,35,489,364,853
17,13,35,362,221,583
14,13,35,200,182,382
3,13,35,43,39,82
30,13,35,650,390,1040
5,13,35,103,65,168
2,13,35,41,26,67
30,13,35,587,390,977
15,13,35,236,195,431
6,13,35,128,78,206
28,13,35,577,364,941
28,13,35,577,364,941
26,21,55,584,546,1130
5,21,55,121,105,226
23,21,55,731,483,1214
20,21,55,537,420,957
5,38,50,43,190,233
5,42,54,57,210,267
26,38,50,143,988,1131
2,42,54,1,84,85
24,38,50,36,912,948
3,42,54,34,126,160
10,42,54,44,420,464
20,42,54,67,840,907
21,42,54,3,882,885
30,42,54,344,1260,1604
21,42,54,207,882,1089
26,38,50,260,988,1248
7,38,50,39,266,305
5,38,50,58,190,248
24,38,50,0,912,912
1,1252,2295,951,1252,2203
1,420,769,341,420,761
1,1252,2295,1020,1252,2272
1,420,769,334,420,754
1,420,769,249,420,669
1,1252,2295,676,1252,1928
1,1266,2320,636,1266,1902
1,1266,2320,915,1266,2181
1,420,769,249,420,669
1,420,769,188,420,608
1,295,540,234,295,529
1,308,565,246,308,554
1,487,783,280,487,767
1,1555,2443,790,1555,2345
1,1555,2443,717,1555,2272
1,713,1120,385,713,1098
1,344,540,77,344,421
1,344,540,158,344,502
1,344,540,99,344,443
1,713,1120,261,713,974
1,487,783,194,487,681
1,487,783,194,487,681
1,487,783,132,487,619
1,344,540,191,344,535
1,2171,3578,1335,2171,3506
4,26,70,131,104,235
20,26,70,852,520,1372
11,26,70,469,286,755
27,3,9,130,81,211
15,1,2,15,15,30
20,9,25,255,180,435
14,2,5,41,28,69
29,2,5,57,58,115
13,2,5,25,26,51
9,2,5,18,18,36
1,11,29,18,11,29
3,11,29,53,33,86
22,1,4,65,22,87
15,1,4,44,15,59
18,11,29,287,198,485
1,11,29,16,11,27
15,11,29,240,165,405
8,9,25,86,72,158
9,9,25,97,81,178
16,1,2,9,16,25
23,1,2,13,23,36
5,1,2,3,5,8
28,1,2,21,28,49
8,1,2,7,8,15
28,1,2,26,28,54
14,9,25,161,126,287
27,9,25,311,243,554
1,12,33,21,12,33
3,12,33,62,36,98
14,2,5,33,28,61
7,2,5,21,14,35
27,2,5,80,54,134
21,2,5,62,42,104
13,1,4,32,13,45
2,1,4,5,2,7
3,13,35,62,39,101
12,13,35,247,156,403
13,2,5,31,26,57
25,2,5,55,50,105
27,2,5,59,54,113
12,2,5,26,24,50
10,11,30,169,110,279
18,11,30,304,198,502
17,9,25,217,153,370
16,9,25,204,144,348
19,1,2,17,19,36
30,1,2,28,30,58
3,1,2,2,3,5
30,1,2,17,30,47
7,9,25,105,63,168
1,9,25,15,9,24
27,1,4,80,27,107
15,1,4,44,15,59
10,1,4,30,10,40
20,11,30,374,220,594
4,11,30,75,44,119
16,11,30,294,176,470
29,11,30,534,319,853
4,1,2,2,4,6
25,12,33,344,300,644
7,2,5,15,14,29
22,1,2,21,22,43
5,1,2,5,5,10
10,1,4,29,10,39
5,8,21,61,40,101
4,2,5,12,8,20
8,2,5,24,16,40
15,1,2,14,15,29
16,1,2,15,16,31
26,8,21,327,208,535
29,2,5,55,58,113
1,8,21,12,8,20
29,2,5,68,58,126
14,2,5,33,28,61
1,2,5,2,2,4
13,1,4,38,13,51
1,461,742,140,461,601
1,755,1215,375,755,1130
1,461,742,251,461,712
1,461,742,147,461,608
1,461,742,266,461,727
5,24,64,187,120,307
7,24,64,222,168,390
5,24,64,158,120,278
16,24,64,620,384,1004
8,59,159,571,472,1043
27,2,5,80,54,134
26,3,9,119,78,197
5,3,9,23,15,38
14,2,5,41,28,69
9,2,5,27,18,45
3,2,5,9,6,15
28,2,5,81,56,137
20,2,5,59,40,99
29,4,10,168,116,284
26,4,10,151,104,255
23,2,5,41,46,87
17,3,9,74,51,125
1,3,9,4,3,7
11,3,9,64,33,97
24,4,10,134,96,230
4,2,5,9,8,17
12,2,5,28,24,52
7,2,5,20,14,34
1,2,5,3,2,5
23,7,9,17,161,178
21,7,9,40,147,187
18,7,9,30,126,156
7,7,9,11,49,60
28,7,9,11,196,207
17,3,8,70,51,121
28,3,8,100,84,184
5,3,8,24,15,39
30,8,22,301,240,541
17,8,22,186,136,322
3,8,22,27,24,51
22,8,22,298,176,474
1,8,22,14,8,22
15,8,22,207,120,327
12,8,22,165,96,261
4,9,24,39,36,75
15,9,24,211,135,346
30,13,35,639,390,1029
14,13,35,298,182,480
10,13,35,206,130,336
8,13,35,140,104,244
13,13,35,186,169,355
9,13,35,141,117,258
5,13,35,107,65,172
19,13,35,371,247,618
28,13,35,596,364,960
7,13,35,115,91,206
19,13,35,371,247,618
26,21,55,827,546,1373
15,21,55,477,315,792
24,38,50,240,912,1152
2,42,54,0,84,84
14,38,50,70,532,602
6,38,50,33,228,261
7,38,50,81,266,347
29,38,50,334,1102,1436
7,38,50,39,266,305
9,38,50,90,342,432
21,38,50,242,798,1040
12,42,54,27,504,531
16,38,50,160,608,768
18,42,54,90,756,846
2,42,54,20,84,104
14,38,50,140,532,672
1,1266,2320,1008,1266,2274
1,1266,2320,961,1266,2227
1,1266,2320,752,1266,2018
1,420,769,211,420,631
1,1266,2320,1008,1266,2274
1,295,540,240,295,535
1,1266,2320,636,1266,1902
1,308,565,121,308,429
1,1252,2295,630,1252,1882
1,1266,2320,636,1266,1902
1,2171,3578,1013,2171,3184
1,1519,2443,606,1519,2125
1,487,783,194,487,681
1,1555,2443,790,1555,2345
1,487,783,194,487,681
1,1083,1701,601,1083,1684
1,487,783,265,487,752
1,344,540,77,344,421
1,1083,1701,312,1083,1395
1,487,783,132,487,619
1,344,540,126,344,470
19,26,70,650,494,1144
20,26,70,852,520,1372
13,26,70,381,338,719
15,3,9,60,45,105
19,3,9,90,57,147
23,3,9,136,69,205
25,1,4,74,25,99
23,1,4,68,23,91
30,13,35,650,390,1040
21,13,35,455,273,728
12,2,5,32,24,56
24,13,35,511,312,823
13,13,35,277,169,446
21,13,35,447,273,720
5,1,2,4,5,9
22,1,2,17,22,39
28,8,21,340,224,564
25,2,5,73,50,123
3,2,5,9,6,15
29,2,5,68,58,126
10,2,5,24,20,44
15,2,5,35,30,65
2,1,2,1,2,3
3,1,2,3,3,6
7,1,2,5,7,12
3,1,2,3,3,6
25,1,2,16,25,41
15,1,2,10,15,25
2,1,2,2,2,4
1,1,2,1,1,2
23,11,30,285,253,538
19,11,30,236,209,445
11,2,5,32,22,54
11,1,2,6,11,17
9,8,21,77,72,149
14,1,4,41,14,55
24,1,4,70,24,94
29,11,29,337,319,656
26,1,4,63,26,89
7,1,4,17,7,24
3,1,2,3,3,6
16,1,2,15,16,31
18,1,2,12,18,30
23,1,2,15,23,38
7,1,4,20,7,27
1,1482,2384,473,1482,1955
1,1482,2384,878,1482,2360
1,1482,2384,807,1482,2289
1,755,1215,436,755,1191
1,1482,2384,854,1482,2336
1,1482,2384,735,1482,2217
3,24,64,118,72,190
14,24,64,399,336,735
4,59,159,387,236,623
16,2,5,45,32,77
8,2,5,22,16,38
20,4,10,94,80,174
6,4,10,28,24,52
28,2,5,59,56,115
30,2,5,63,60,123
2,2,5,6,4,10
15,2,5,44,30,74
30,3,9,177,90,267
22,2,5,65,44,109
1,2,5,3,2,5
15,2,5,33,30,63
17,2,5,37,34,71
2,3,9,12,6,18
10,2,5,24,20,44
19,2,5,45,38,83
13,3,9,76,39,115
16,3,9,93,48,141
19,2,5,45,38,83
9,2,5,21,18,39
2,2,5,5,4,9
18,7,9,34,126,160
24,7,9,9,168,177
26,7,9,22,182,204
21,7,9,17,147,164
1,7,9,2,7,9
7,7,9,6,49,55
30,7,9,28,210,238
22,7,9,40,154,194
4,3,8,20,12,32
11,3,8,41,33,74
20,8,22,223,160,383
10,8,22,138,80,218
24,9,24,233,216,449
10,9,24,119,90,209
10,9,24,97,90,187
13,13,35,281,169,450
15,13,35,236,195,431
8,13,35,173,104,277
22,13,35,315,286,601
13,13,35,204,169,373
11,13,35,192,143,335
8,13,35,173,104,277
9,13,35,185,117,302
17,13,35,243,221,464
29,13,35,516,377,893
26,42,54,3,1092,1095
4,38,50,12,152,164
2,38,50,3,76,79
29,42,54,144,1218,1362
10,38,50,55,380,435
2,42,54,10,84,94
4,42,54,18,168,186
3,42,54,33,126,159
1,1252,2295,676,1252,1928
1,1555,2443,448,1555,2003
1,2171,3578,942,2171,3113
14,26,70,410,364,774
8,26,70,229,208,437
1,26,70,34,26,60
30,26,70,984,780,1764
8,3,9,47,24,71
27,1,4,80,27,107
30,1,4,89,30,119
13,1,2,13,13,26
30,13,35,650,390,1040
18,13,35,390,234,624
20,2,5,38,40,78
11,2,5,21,22,43
12,1,2,12,12,24
12,1,2,12,12,24
11,2,5,31,22,53
15,13,35,293,195,488
8,13,35,156,104,260
19,13,35,371,247,618
23,1,2,17,23,40
15,12,33,280,180,460
22,11,30,411,242,653
29,9,25,457,261,718
1,13,35,21,13,34
9,13,35,192,117,309
16,1,2,16,16,32
7,2,5,20,14,34
6,11,30,91,66,157
5,9,25,79,45,124
13,9,25,205,117,322
7,9,25,110,63,173
29,1,4,66,29,95
2,1,4,5,2,7
24,1,2,13,24,37
27,1,2,15,27,42
13,2,5,30,26,56
2,2,5,5,4,9
3,2,5,7,6,13
10,1,4,24,10,34
8,1,4,20,8,28
27,1,2,17,27,44
17,1,2,11,17,28
24,8,21,252,192,444
1,8,21,10,8,18
5,9,25,75,45,120
14,9,25,210,126,336
28,2,5,83,56,139
10,8,21,101,80,181
22,8,21,221,176,397
12,1,2,7,12,19
11,1,2,6,11,17
30,1,2,20,30,50
28,1,2,19,28,47
6,1,2,4,6,10
1,755,1215,411,755,1166
1,755,1215,436,755,1191
1,1482,2384,378,1482,1860
1,461,742,185,461,646
6,45,120,421,270,691
6,59,159,581,354,935
6,2,5,18,12,30
2,2,5,6,4,10
19,4,10,110,76,186
21,4,10,122,84,206
22,2,5,52,44,96
5,2,5,12,10,22
26,2,5,60,52,112
11,2,5,32,22,54
11,2,5,32,22,54
13,2,5,38,26,64
21,2,5,41,42,83
25,2,5,49,50,99
11,2,5,32,22,54
4,2,5,12,8,20
16,4,10,74,64,138
11,2,5,21,22,43
2,2,5,4,4,8
30,2,5,57,60,117
8,2,5,15,16,31
12,2,5,35,24,59
12,2,5,35,24,59
21,2,5,62,42,104
14,3,9,79,42,121
17,7,9,23,119,142
20,7,9,17,140,157
2,7,9,2,14,16
20,7,9,36,140,176
20,7,9,36,140,176
27,7,9,49,189,238
19,7,9,31,133,164
26,7,9,50,182,232
28,7,9,51,196,247
26,3,8,126,78,204
1,8,22,14,8,22
3,8,22,27,24,51
28,8,22,306,224,530
10,8,22,136,80,216
28,8,22,380,224,604
14,8,22,190,112,302
1,8,22,14,8,22
11,8,22,123,88,211
13,8,22,179,104,283
6,9,24,67,54,121
29,9,24,421,261,682
8,9,24,116,72,188
26,9,24,378,234,612
29,9,24,289,261,550
7,13,35,137,91,228
4,13,35,85,52,137
9,13,35,148,117,265
6,13,35,128,78,206
4,13,35,68,52,120
30,13,35,440,390,830
25,13,35,533,325,858
5,13,35,103,65,168
14,13,35,220,182,402
23,13,35,474,299,773
28,13,35,489,364,853
24,13,35,410,312,722
9,13,35,157,117,274
1,13,35,21,13,34
26,13,35,536,338,874
10,13,35,217,130,347
25,13,35,541,325,866
29,13,35,618,377,995
16,13,35,346,208,554
9,13,35,185,117,302
25,13,35,358,325,683
12,13,35,172,156,328
6,13,35,88,78,166
13,13,35,222,169,391
27,42,54,295,1134,1429
23,38,50,265,874,1139
3,38,50,33,114,147
19,38,50,209,722,931
2,38,50,2,76,78
16,42,54,175,672,847
15,38,50,165,570,735
10,38,50,110,380,490
17,42,54,11,714,725
1,1252,2295,722,1252,1974
1,1266,2320,1008,1266,2274
1,1266,2320,1008,1266,2274
1,1252,2295,1020,1252,2272
1,1252,2295,676,1252,1928
1,1252,2295,722,1252,1974
1,1266,2320,544,1266,1810
1,1252,2295,951,1252,2203
1,1252,2295,745,1252,1997
1,295,540,234,295,529
1,1266,2320,961,1266,2227
1,1912,3400,740,1912,2652
1,487,783,280,487,767
1,713,1120,396,713,1109
1,1519,2443,826,1519,2345
1,2171,3578,942,2171,3113
1,2171,3578,656,2171,2827
1,713,1120,385,713,1098
1,713,1120,385,713,1098
1,344,540,158,344,502
1,2171,3578,1371,2171,3542
1,487,783,155,487,642
1,713,1120,329,713,1042
1,2171,3578,1335,2171,3506
24,26,70,1039,624,1663
11,26,70,361,286,647
7,26,70,298,182,480
7,26,70,200,182,382
22,26,70,722,572,1294
23,3,9,105,69,174
14,3,9,79,42,121
26,3,9,119,78,197
24,1,2,23,24,47
14,1,2,13,14,27
1,1,2,1,1,2
10,1,2,7,10,17
12,1,2,8,12,20
4,11,30,75,44,119
21,11,30,393,231,624
27,13,35,575,351,926
28,13,35,596,364,960
15,2,5,44,30,74
1,2,5,3,2,5
17,2,5,49,34,83
14,1,4,41,14,55
15,2,5,44,30,74
8,2,5,24,16,40
9,11,29,128,99,227
16,11,29,228,176,404
14,1,2,8,14,22
27,1,2,16,27,43
26,2,5,60,52,112
23,2,5,64,46,110
10,1,2,7,10,17
7,11,30,131,77,208
15,11,30,276,165,441
7,11,30,129,77,206
20,9,25,315,180,495
15,9,25,236,135,371
26,2,5,73,52,125
26,2,5,73,52,125
18,1,2,17,18,35
26,1,2,25,26,51
16,8,21,164,128,292
23,8,21,236,184,420
24,2,5,50,48,98
18,2,5,38,36,74
26,2,5,55,52,107
11,2,5,23,22,45
24,2,5,50,48,98
19,2,5,55,38,93
1,1482,2384,473,1482,1955
1,1482,2384,807,1482,2289
1,1482,2384,854,1482,2336
1,1482,2384,854,1482,2336
1,1482,2384,378,1482,1860
28,24,64,887,672,1559
26,24,64,1007,624,1631
25,24,64,792,600,1392
2,45,120,140,90,230
29,3,9,164,87,251
22,3,9,124,66,190
30,2,5,84,60,144
30,2,5,63,60,123
8,2,5,17,16,33
16,2,5,45,32,77
1,4,10,5,4,9
8,2,5,22,16,38
16,2,5,43,32,75
19,2,5,45,38,83
8,2,5,19,16,35
7,2,5,16,14,30
4,2,5,9,8,17
18,2,5,42,36,78
5,2,5,12,10,22
29,4,10,171,116,287
12,4,10,71,48,119
8,2,5,17,16,33
27,4,10,157,108,265
9,4,10,52,36,88
27,2,5,78,54,132
8,2,5,23,16,39
20,3,9,116,60,176
1,3,9,6,3,9
23,3,9,136,69,205
13,2,5,38,26,64
29,2,5,84,58,142
6,7,9,10,42,52
17,7,9,14,119,133
18,7,9,33,126,159
25,7,9,41,175,216
29,7,9,21,203,224
22,7,9,42,154,196
14,7,9,5,98,103
3,3,8,15,9,24
21,3,8,78,63,141
11,3,8,53,33,86
18,8,22,197,144,341
12,8,22,163,96,259
6,8,22,81,48,129
18,8,22,236,144,380
28,8,22,281,224,505
27,9,24,288,243,531
25,9,24,267,225,492
14,9,24,139,126,265
12,13,35,172,156,328
29,13,35,618,377,995
27,13,35,537,351,888
8,13,35,156,104,260
9,13,35,185,117,302
28,13,35,440,364,804
14,13,35,288,182,470
5,13,35,87,65,152
9,13,35,192,117,309
9,13,35,154,117,271
22,13,35,345,286,631
28,13,35,547,364,911
7,13,35,100,91,191
26,13,35,381,338,719
25,13,35,515,325,840
13,13,35,277,169,446
22,13,35,453,286,739
16,13,35,234,208,442
6,13,35,105,78,183
11,21,55,295,231,526
26,38,50,286,988,1274
8,38,50,88,304,392
11,42,54,55,462,517
30,42,54,68,1260,1328
12,42,54,60,504,564
1,38,50,10,38,48
26,38,50,130,988,1118
1,1252,2295,722,1252,1974
1,1252,2295,997,1252,2249
1,1252,2295,951,1252,2203
1,1252,2295,905,1252,2157
1,1266,2320,892,1266,2158
1,1266,2320,961,1266,2227
1,420,769,318,420,738
1,420,769,249,420,669
1,1266,2320,1008,1266,2274
1,308,565,155,308,463
1,2171,3578,620,2171,2791
1,1083,1701,312,1083,1395
1,2171,3578,942,2171,3113
1,1083,1701,312,1083,1395
1,487,783,265,487,752
1,344,540,185,344,529
1,713,1120,172,713,885
16,26,70,659,416,1075
7,26,70,298,182,480
27,26,70,923,702,1625
6,26,70,197,156,353
26,3,9,123,78,201
14,2,5,41,28,69
12,2,5,35,24,59
19,9,25,228,171,399
19,2,5,36,38,74
6,1,2,3,6,9
25,2,5,70,50,120
8,2,5,22,16,38
13,1,2,9,13,22
18,1,2,12,18,30
28,9,25,301,252,553
29,1,2,17,29,46
18,2,5,53,36,89
21,2,5,59,42,101
11,2,5,31,22,53
4,9,25,46,36,82
2,9,25,23,18,41
14,9,25,200,126,326
16,9,25,228,144,372
21,13,35,433,273,706
21,13,35,433,273,706
15,1,2,10,15,25
16,1,2,12,16,28
27,1,2,19,27,46
29,8,21,292,232,524
16,8,21,161,128,289
14,8,21,141,112,253
3,2,5,6,6,12
16,2,5,30,32,62
24,2,5,46,48,94
3,1,2,3,3,6
2,1,2,2,2,4
29,1,2,27,29,56
7,1,2,5,7,12
3,1,2,2,3,5
23,2,5,45,46,91
6,2,5,12,12,24
30,2,5,87,60,147
22,11,30,411,242,653
13,11,30,243,143,386
25,1,4,68,25,93
10,1,2,6,10,16
5,2,5,10,10,20
18,2,5,34,36,70
1,1,4,3,1,4
19,1,4,54,19,73
22,1,2,20,22,42
10,2,5,29,20,49
13,2,5,38,26,64
7,2,5,20,14,34
13,1,4,32,13,45
1,1482,2384,401,1482,1883
1,461,742,185,461,646
1,461,742,251,461,712
1,755,1215,375,755,1130
1,1482,2384,807,1482,2289
1,1482,2384,473,1482,1955
1,461,742,185,461,646
1,461,742,266,461,727
1,24,64,39,24,63
5,2,5,15,10,25
4,2,5,12,8,20
13,2,5,34,26,60
21,2,5,56,42,98
9,2,5,25,18,43
26,2,5,73,52,125
18,4,10,104,72,176
28,4,10,162,112,274
30,2,5,71,60,131
29,2,5,68,58,126
25,2,5,59,50,109
21,2,5,49,42,91
5,2,5,15,10,25
13,3,9,76,39,115
2,3,9,12,6,18
13,2,5,38,26,64
20,3,9,80,60,140
9,3,9,36,27,63
27,3,9,152,81,233
24,2,5,53,48,101
24,2,5,53,48,101
19,3,9,83,57,140
25,3,9,110,75,185
26,2,5,57,52,109
16,2,5,38,32,70
1,2,5,2,2,4
12,7,9,7,84,91
7,7,9,11,49,60
20,7,9,8,140,148
12,7,9,0,84,84
4,7,9,3,28,31
13,7,9,-2,91,89
28,3,8,138,84,222
2,3,8,10,6,16
18,8,22,244,144,388
22,8,22,202,176,378
30,8,22,301,240,541
24,8,22,325,192,517
23,8,22,211,184,395
10,13,35,213,130,343
2,13,35,34,26,60
8,13,35,156,104,260
14,13,35,220,182,402
14,13,35,190,182,372
14,13,35,220,182,402
29,13,35,415,377,792
27,13,35,443,351,794
11,13,35,173,143,316
9,13,35,157,117,274
10,13,35,213,130,343
17,13,35,362,221,583
13,13,35,268,169,437
16,13,35,341,208,549
18,13,35,371,234,605
12,13,35,247,156,403
12,13,35,256,156,412
30,13,35,650,390,1040
4,42,54,44,168,212
18,42,54,206,756,962
1,42,54,2,42,44
29,38,50,29,1102,1131
15,38,50,15,570,585
14,38,50,77,532,609
4,38,50,4,152,156
11,38,50,11,418,429
15,42,54,26,630,656
13,42,54,58,546,604
7,38,50,70,266,336
10,42,54,23,420,443
1,1266,2320,1031,1266,2297
1,1252,2295,1020,1252,2272
1,1266,2320,636,1266,1902
1,420,769,318,420,738
1,308,565,184,308,492
1,1252,2295,997,1252,2249
1,1252,2295,538,1252,1790
1,1266,2320,892,1266,2158
1,1555,2443,717,1555,2272
1,1555,2443,448,1555,2003
1,1555,2443,546,1555,2101
1,1555,2443,448,1555,2003
1,487,783,265,487,752
1,1555,2443,424,1555,1979
1,344,540,66,344,410
8,26,70,341,208,549
23,3,9,134,69,203
29,2,5,55,58,113
8,13,35,170,104,274
11,1,2,6,11,17
27,1,2,15,27,42
9,2,5,21,18,39
21,2,5,49,42,91
20,2,5,47,40,87
15,1,2,10,15,25
27,1,2,26,27,53
12,1,2,12,12,24
17,8,21,207,136,343
30,1,2,22,30,52
2,1,2,1,2,3
14,1,2,8,14,22
6,2,5,14,12,26
16,2,5,37,32,69
17,2,5,39,34,73
23,12,33,453,276,729
30,2,5,69,60,129
27,2,5,62,54,116
11,2,5,25,22,47
16,1,2,9,16,25
16,1,2,9,16,25
18,1,2,13,18,31
25,2,5,73,50,123
26,2,5,75,52,127
2,9,25,29,18,47
19,2,5,56,38,94
7,2,5,21,14,35
15,1,2,15,15,30
29,1,2,28,29,57
20,1,2,13,20,33
20,1,2,13,20,33
20,2,5,56,40,96
6,2,5,17,12,29
5,1,2,5,5,10
2,1,4,5,2,7
4,1,4,10,4,14
22,1,2,16,22,38
27,2,5,80,54,134
23,2,5,68,46,114
22,2,5,65,44,109
6,11,30,110,66,176
3,11,30,55,33,88
28,1,2,16,28,44
10,8,21,86,80,166
27,8,21,232,216,448
23,8,21,198,184,382
11,9,25,116,99,215
26,9,25,273,234,507
23,1,2,17,23,40
25,1,2,18,25,43
25,1,2,18,25,43
15,1,2,11,15,26
26,2,5,75,52,127
27,2,5,78,54,132
9,2,5,26,18,44
5,1,4,15,5,20
17,1,4,50,17,67
4,1,4,11,4,15
13,1,4,37,13,50
1,1482,2384,592,1482,2074
1,755,1215,290,755,1045
17,24,64,658,408,1066
18,24,64,513,432,945
26,2,5,61,52,113
29,2,5,86,58,144
27,2,5,63,54,117
24,2,5,56,48,104
29,2,5,77,58,135
15,2,5,40,30,70
13,2,5,36,26,62
27,2,5,76,54,130
6,2,5,11,12,23
24,2,5,67,48,115
4,2,5,12,8,20
9,2,5,26,18,44
17,2,5,49,34,83
15,2,5,32,30,62
29,2,5,61,58,119
13,3,9,52,39,91
16,3,9,64,48,112
20,3,9,116,60,176
8,2,5,19,16,35
22,2,5,52,44,96
28,2,5,78,56,134
27,2,5,76,54,130
3,2,5,8,6,14
2,2,5,6,4,10
11,7,9,18,77,95
15,7,9,27,105,132
2,7,9,0,14,14
3,7,9,4,21,25
24,7,9,0,168,168
15,7,9,27,105,132
19,7,9,7,133,140
19,3,8,75,57,132
4,8,22,54,32,86
21,8,22,285,168,453
9,8,22,122,72,194
7,8,22,64,56,120
8,8,22,89,64,153
24,8,22,267,192,459
29,9,24,428,261,689
30,9,24,349,270,619
8,9,24,112,72,184
18,9,24,261,162,423
9,13,35,195,117,312
3,13,35,64,39,103
21,13,35,366,273,639
3,13,35,65,39,104
6,13,35,130,78,208
5,13,35,98,65,163
1,13,35,14,13,27
18,13,35,371,234,605
15,13,35,325,195,520
9,13,35,141,117,258
12,13,35,197,156,353
8,13,35,165,104,269
1,13,35,21,13,34
20,13,35,349,260,609
18,13,35,257,234,491
22,13,35,376,286,662
22,13,35,315,286,601
26,13,35,536,338,874
13,38,50,130,494,624
20,42,54,218,840,1058
20,42,54,218,840,1058
27,38,50,27,1026,1053
11,38,50,121,418,539
2,42,54,22,84,106
27,38,50,270,1026,1296
26,38,50,78,988,1066
1,1266,2320,752,1266,2018
1,1266,2320,961,1266,2227
1,1252,2295,997,1252,2249
1,420,769,334,420,754
1,1266,2320,1008,1266,2274
1,1252,2295,745,1252,1997
1,1555,2443,717,1555,2272
1,487,783,108,487,595
1,487,783,265,487,752
1,1083,1701,380,1083,1463
1,713,1120,396,713,1109
1,2171,3578,835,2171,3006
1,1555,2443,864,1555,2419
1,344,540,77,344,421
1,487,783,194,487,681
1,487,783,288,487,775
1,344,540,174,344,518
1,344,540,174,344,518
1,2171,3578,620,2171,2791
1,2171,3578,620,2171,2791
1,2171,3578,1335,2171,3506
6,26,70,256,156,412
14,26,70,400,364,764
10,26,70,314,260,574
13,13,35,213,169,382
24,1,2,24,24,48
30,1,2,29,30,59
24,1,2,23,24,47
7,1,2,7,7,14
16,1,2,16,16,32
25,13,35,533,325,858
3,2,5,9,6,15
28,1,4,69,28,97
15,1,4,37,15,52
21,2,5,44,42,86
20,1,2,20,20,40
2,1,2,2,2,4
24,1,2,24,24,48
5,1,4,15,5,20
16,1,2,9,16,25
6,8,21,75,48,123
19,8,21,175,152,327
29,2,5,84,58,142
22,2,5,64,44,108
21,2,5,61,42,103
7,2,5,16,14,30
28,2,5,64,56,120
15,2,5,35,30,65
17,1,2,16,17,33
26,1,2,24,26,50
5,1,2,5,5,10
2,8,21,18,16,34
20,8,21,180,160,340
17,8,21,196,136,332
12,8,21,138,96,234
22,2,5,64,44,108
3,2,5,9,6,15
27,2,5,72,54,126
17,2,5,45,34,79
5,2,5,13,10,23
1,1482,2384,592,1482,2074
1,461,742,147,461,608
1,1482,2384,807,1482,2289
1,1482,2384,378,1482,1860
1,461,742,229,461,690
25,24,64,792,600,1392
3,45,120,218,135,353
20,2,5,47,40,87
27,2,5,63,54,117
23,2,5,61,46,107
10,2,5,27,20,47
26,2,5,49,52,101
1,2,5,2,2,4
28,2,5,64,56,120
19,2,5,55,38,93
22,2,5,64,44,108
24,2,5,47,48,95
4,2,5,9,8,17
5,2,5,12,10,22
15,2,5,33,30,63
8,2,5,18,16,34
22,2,5,52,44,96
26,2,5,61,52,113
12,2,5,28,24,52
28,2,5,66,56,122
18,3,9,102,54,156
8,3,9,45,24,69
12,7,9,20,84,104
21,7,9,29,147,176
30,7,9,41,210,251
17,7,9,6,119,125
18,7,9,13,126,139
10,3,8,33,30,63
25,3,8,83,75,158
25,3,8,111,75,186
21,3,8,83,63,146
21,8,22,197,168,365
27,8,22,271,216,487
12,8,22,110,96,206
19,8,22,199,152,351
22,9,24,325,198,523
16,9,24,159,144,303
27,9,24,321,243,564
4,9,24,48,36,84
23,9,24,334,207,541
25,13,35,410,325,735
4,13,35,70,52,122
10,13,35,164,130,294
26,13,35,563,338,901
1,13,35,16,13,29
24,13,35,494,312,806
18,13,35,371,234,605
30,13,35,639,390,1029
23,13,35,401,299,700
17,13,35,279,221,500
29,13,35,567,377,944
19,13,35,371,247,618
4,13,35,63,52,115
11,13,35,238,143,381
11,13,35,157,143,300
10,13,35,213,130,343
22,13,35,384,286,670
27,13,35,556,351,907
9,21,55,286,189,475
21,21,55,471,441,912
20,42,54,100,840,940
20,42,54,100,840,940
8,42,54,79,336,415
1,1252,2295,951,1252,2203
1,1252,2295,630,1252,1882
1,1266,2320,892,1266,2158
1,1252,2295,630,1252,1882
1,2171,3578,620,2171,2791
1,2171,3578,1264,2171,3435
1,713,1120,396,713,1109
1,1519,2443,753,1519,2272
1,1555,2443,570,1555,2125
1,1519,2443,826,1519,2345
1,1083,1701,601,1083,1684
1,2171,3578,620,2171,2791
1,344,540,77,344,421
1,344,540,126,344,470
1,713,1120,261,713,974
1,487,783,194,487,681
1,344,540,126,344,470
1,344,540,174,344,518
11,13,35,161,143,304
17,13,35,249,221,470
29,1,2,28,29,57
16,2,5,47,32,79
11,2,5,32,22,54
14,1,2,10,14,24
10,2,5,28,20,48
2,2,5,6,4,10
8,2,5,23,16,39
6,2,5,17,12,29
2,1,2,1,2,3
23,2,5,68,46,114
6,2,5,18,12,30
2,1,4,5,2,7
23,1,4,52,23,75
13,2,5,36,26,62
2,2,5,6,4,10
30,1,4,74,30,104
10,2,5,19,20,39
23,2,5,64,46,110
18,2,5,50,36,86
26,2,5,73,52,125
3,2,5,8,6,14
23,1,2,17,23,40
16,2,5,37,32,69
10,2,5,29,20,49
7,2,5,20,14,34
17,1,2,12,17,29
11,1,2,7,11,18
7,1,2,5,7,12
22,1,2,16,22,38
15,1,2,13,15,28
16,1,2,14,16,30
18,2,5,38,36,74
30,2,5,63,60,123
29,1,2,27,29,56
28,1,2,26,28,54
9,1,2,5,9,14
14,11,30,174,154,328
9,11,30,112,99,211
2,11,30,25,22,47
6,2,5,11,12,23
10,2,5,19,20,39
21,2,5,40,42,82
8,1,4,18,8,26
28,1,4,64,28,92
7,1,4,16,7,23
28,1,2,21,28,49
4,1,2,3,4,7
19,1,2,14,19,33
8,1,2,6,8,14
17,1,2,12,17,29
3,9,25,38,27,65
20,9,25,250,180,430
18,1,4,45,18,63
24,1,4,60,24,84
20,1,2,17,20,37
21,1,2,18,21,39
27,1,4,79,27,106
4,1,4,12,4,16
29,1,2,21,29,50
15,2,5,44,30,74
11,9,25,171,99,270
2,9,25,31,18,49
25,1,4,71,25,96
27,1,4,77,27,104
1,1482,2384,807,1482,2289
1,755,1215,411,755,1166
1,461,742,266,461,727
1,755,1215,375,755,1130
1,461,742,274,461,735
27,24,64,769,648,1417
28,24,64,995,672,1667
5,59,159,492,295,787
15,2,5,44,30,74
2,2,5,6,4,10
30,2,5,87,60,147
25,2,5,73,50,123
4,2,5,12,8,20
11,2,5,26,22,48
20,2,5,48,40,88
30,2,5,87,60,147
11,2,5,32,22,54
10,2,5,28,20,48
16,4,10,70,64,134
27,3,9,130,81,211
3,3,9,14,9,23
5,2,5,12,10,22
21,2,5,49,42,91
28,3,9,128,84,212
5,7,9,3,35,38
12,7,9,10,84,94
24,7,9,39,168,207
19,7,9,26,133,159
8,7,9,13,56,69
6,7,9,6,42,48
13,3,8,51,39,90
24,3,8,116,72,188
21,8,22,285,168,453
27,8,22,372,216,588
15,8,22,207,120,327
25,9,24,243,225,468
6,9,24,87,54,141
24,9,24,285,216,501
2,13,35,43,26,69
7,13,35,149,91,240
19,13,35,272,247,519
9,13,35,129,117,246
1,13,35,21,13,34
27,13,35,528,351,879
19,13,35,405,247,652
17,13,35,279,221,500
28,13,35,410,364,774
24,13,35,427,312,739
25,13,35,436,325,761
16,13,35,279,208,487
3,13,35,64,39,103
19,21,55,625,399,1024
2,42,54,1,84,85
7,42,54,69,294,363
26,38,50,286,988,1274
26,42,54,17,1092,1109
11,42,54,37,462,499
11,42,54,25,462,487
28,42,54,306,1176,1482
1,1266,2320,752,1266,2018
1,1252,2295,997,1252,2249
1,1266,2320,1008,1266,2274
1,1266,2320,1031,1266,2297
1,2171,3578,1335,2171,3506
1,713,1120,261,713,974
1,1083,1701,601,1083,1684
1,713,1120,385,713,1098
1,1555,2443,497,1555,2052
1,2171,3578,1371,2171,3542
1,1555,2443,497,1555,2052
1,713,1120,273,713,986
1,344,540,185,344,529
1,487,783,194,487,681
1,2171,3578,620,2171,2791
1,2171,3578,1335,2171,3506
1,2171,3578,1335,2171,3506
9,8,21,113,72,185
28,8,21,352,224,576
30,2,5,87,60,147
16,2,5,46,32,78
26,13,35,554,338,892
16,1,2,10,16,26
19,1,2,11,19,30
16,1,2,9,16,25
21,2,5,48,42,90
22,1,2,13,22,35
3,1,2,2,3,5
22,2,5,58,44,102
15,2,5,40,30,70
20,2,5,38,40,78
29,2,5,55,58,113
19,2,5,53,38,91
2,2,5,5,4,9
11,2,5,26,22,48
5,2,5,12,10,22
28,1,4,69,28,97
12,1,4,30,12,42
7,2,5,15,14,29
29,2,5,61,58,119
16,2,5,34,32,66
3,13,35,65,39,104
26,11,30,330,286,616
29,11,30,368,319,687
1,11,30,13,11,24
2,1,4,5,2,7
6,1,4,15,6,21
14,2,5,41,28,69
2,2,5,6,4,10
24,1,2,24,24,48
14,1,2,14,14,28
28,2,5,83,56,139
20,2,5,59,40,99
17,1,2,10,17,27
14,1,4,32,14,46
13,1,4,30,13,43
5,1,4,11,5,16
5,1,4,11,5,16
7,1,4,15,7,22
30,1,4,88,30,118
10,2,5,28,20,48
6,2,5,17,12,29
30,1,2,22,30,52
24,1,2,17,24,41
14,2,5,29,28,57
1,2,5,2,2,4
29,1,2,28,29,57
11,1,4,32,11,43
1,461,742,162,461,623
1,461,742,147,461,608
1,1482,2384,592,1482,2074
1,461,742,266,461,727
1,59,159,98,59,157
15,4,10,71,60,131
13,4,10,69,52,121
20,4,10,106,80,186
12,2,5,34,24,58
28,2,5,53,56,109
13,2,5,25,26,51
26,4,10,146,104,250
12,4,10,67,48,115
6,2,5,18,12,30
26,2,5,77,52,129
7,2,5,16,14,30
20,2,5,58,40,98
5,2,5,15,10,25
24,2,5,71,48,119
10,2,5,19,20,39
13,2,5,38,26,64
6,2,5,14,12,26
4,2,5,9,8,17
27,7,9,37,189,226
30,7,9,1,210,211
3,7,9,5,21,26
12,3,8,56,36,92
16,3,8,52,48,100
1,8,22,9,8,17
25,8,22,345,200,545
13,8,22,171,104,275
16,8,22,220,128,348
4,8,22,52,32,84
18,8,22,248,144,392
9,9,24,107,81,188
16,9,24,236,144,380
8,9,24,118,72,190
1,9,24,10,9,19
7,13,35,152,91,243
7,13,35,122,91,213
1,13,35,22,13,35
14,13,35,288,182,470
29,13,35,618,377,995
12,13,35,260,156,416
3,13,35,59,39,98
13,13,35,204,169,373
16,13,35,346,208,554
10,13,35,164,130,294
6,13,35,130,78,208
11,13,35,238,143,381
14,13,35,303,182,485
19,13,35,272,247,519
21,13,35,374,273,647
16,13,35,229,208,437
28,13,35,577,364,941
17,21,55,456,357,813
7,38,50,77,266,343
18,42,54,90,756,846
24,38,50,24,912,936
8,38,50,44,304,348
21,42,54,241,882,1123
5,42,54,57,210,267
14,38,50,154,532,686
17,42,54,85,714,799
28,42,54,49,1176,1225
3,38,50,30,114,144
3,42,54,25,126,151
1,1266,2320,752,1266,2018
1,1266,2320,892,1266,2158
1,1252,2295,997,1252,2249
1,420,769,341,420,761
1,1252,2295,1020,1252,2272
1,1266,2320,1008,1266,2274
1,295,540,223,295,518
1,308,565,234,308,542
1,295,540,240,295,535
1,1252,2295,630,1252,1882
1,1266,2320,961,1266,2227
1,1555,2443,717,1555,2272
1,1083,1701,499,1083,1582
1,2171,3578,942,2171,3113
1,2171,3578,835,2171,3006
1,487,783,265,487,752
1,713,1120,205,713,918
1,1519,2443,900,1519,2419
1,344,540,174,344,518
11,26,70,476,286,762
15,26,70,639,390,1029
2,26,70,57,52,109
28,3,9,165,84,249
9,3,9,36,27,63
2,3,9,8,6,14
21,3,9,118,63,181
12,9,25,144,108,252
16,9,25,192,144,336
19,2,5,56,38,94
26,2,5,77,52,129
12,1,2,12,12,24
7,1,2,7,7,14
3,2,5,9,6,15
11,2,5,32,22,54
11,13,35,238,143,381
4,13,35,87,52,139
17,1,2,16,17,33
19,1,2,18,19,37
6,2,5,17,12,29
29,2,5,81,58,139
1,9,25,11,9,20
5,2,5,15,10,25
29,2,5,84,58,142
23,9,25,357,207,564
26,11,30,463,286,749
5,1,2,4,5,9
21,1,2,18,21,39
18,1,2,17,18,35
6,1,2,6,6,12
25,1,4,74,25,99
1,1,4,3,1,4
4,1,2,3,4,7
16,12,33,252,192,444
26,12,33,409,312,721
5,11,30,89,55,144
29,1,2,16,29,45
18,1,2,10,18,28
2,8,21,21,16,37
1,12,33,17,12,29
26,8,21,327,208,535
2,8,21,25,16,41
12,8,21,151,96,247
18,1,2,15,18,33
19,1,2,16,19,35
27,2,5,51,54,105
20,1,2,19,20,39
8,8,21,101,64,165
27,11,29,345,297,642
2,11,29,26,22,48
1,1482,2384,592,1482,2074
1,1482,2384,878,1482,2360
1,1482,2384,878,1482,2360
1,1482,2384,592,1482,2074
27,24,64,700,648,1348
6,24,64,225,144,369
5,45,120,279,225,504
5,45,120,369,225,594
9,59,159,585,531,1116
29,2,5,55,58,113
3,2,5,6,6,12
29,2,5,55,58,113
21,2,5,61,42,103
3,2,5,6,6,12
14,2,5,27,28,55
19,2,5,45,38,83
26,2,5,61,52,113
10,2,5,21,20,41
19,2,5,40,38,78
5,2,5,15,10,25
18,2,5,52,36,88
28,3,9,150,84,234
25,3,9,134,75,209
6,2,5,14,12,26
27,2,5,63,54,117
18,7,9,34,126,160
3,7,9,0,21,21
8,7,9,6,56,62
25,7,9,41,175,216
7,7,9,6,49,55
13,7,9,24,91,115
6,7,9,5,42,47
22,7,9,16,154,170
21,8,22,276,168,444
13,8,22,145,104,249
21,9,24,310,189,499
11,13,35,173,143,316
22,13,35,376,286,662
19,13,35,272,247,519
6,13,35,86,78,164
2,13,35,29,26,55
19,13,35,391,247,638
6,13,35,124,78,202
9,13,35,185,117,302
9,13,35,185,117,302
18,13,35,383,234,617
4,13,35,57,52,109
22,38,50,220,836,1056
30,42,54,344,1260,1604
12,38,50,120,456,576
19,42,54,2,798,800
22,38,50,220,836,1056
18,38,50,153,684,837
16,42,54,175,672,847
28,42,54,306,1176,1482
24,42,54,3,1008,1011
28,38,50,322,1064,1386
1,42,54,2,42,44
2,38,50,2,76,78
1,1266,2320,961,1266,2227
1,1252,2295,630,1252,1882
1,1252,2295,538,1252,1790
1,1252,2295,951,1252,2203
1,420,769,318,420,738
1,2171,3578,1264,2171,3435
1,344,540,185,344,529
1,1519,2443,900,1519,2419
1,487,783,241,487,728
1,487,783,265,487,752
1,1083,1701,295,1083,1378
30,26,70,1299,780,2079
1,26,70,43,26,69
11,26,70,469,286,755
23,26,70,658,598,1256
10,1,2,10,10,20
10,1,2,10,10,20
14,13,35,239,182,421
1,13,35,17,13,30
24,2,5,46,48,94
8,2,5,15,16,31
15,2,5,29,30,59
3,2,5,6,6,12
15,1,2,10,15,25
8,11,29,142,88,230
24,2,5,46,48,94
12,2,5,23,24,47
19,2,5,53,38,91
20,2,5,56,40,96
22,2,5,64,44,108
12,2,5,35,24,59
3,2,5,9,6,15
11,2,5,24,22,46
22,2,5,48,44,92
23,13,35,474,299,773
27,13,35,556,351,907
18,13,35,295,234,529
2,13,35,33,26,59
30,1,4,88,30,118
14,12,33,192,168,360
18,8,21,166,144,310
28,8,21,258,224,482
13,8,21,164,104,268
28,8,21,352,224,576
21,8,21,264,168,432
18,12,33,301,216,517
1,12,33,17,12,29
1,755,1215,448,755,1203
1,1482,2384,735,1482,2217
1,1482,2384,807,1482,2289
1,1482,2384,807,1482,2289
7,45,120,508,315,823
6,59,159,466,354,820
21,2,5,61,42,103
13,2,5,38,26,64
29,2,5,84,58,142
26,4,10,109,104,213
17,2,5,49,34,83
5,2,5,15,10,25
21,2,5,61,42,103
23,2,5,67,46,113
20,4,10,116,80,196
25,4,10,145,100,245
26,2,5,51,52,103
14,2,5,39,28,67
17,2,5,48,34,82
18,2,5,50,36,86
20,7,9,38,140,178
16,3,8,75,48,123
19,3,8,62,57,119
22,8,22,192,176,368
12,8,22,165,96,261
18,8,22,244,144,388
24,8,22,325,192,517
15,8,22,137,120,257
26,8,22,353,208,561
16,8,22,220,128,348
25,8,22,345,200,545
18,9,24,166,162,328
22,9,24,309,198,507
7,9,24,70,63,133
4,13,35,82,52,134
9,13,35,192,117,309
17,13,35,368,221,589
7,13,35,144,91,235
20,13,35,426,260,686
13,13,35,277,169,446
29,13,35,618,377,995
23,13,35,450,299,749
7,13,35,100,91,191
29,13,35,618,377,995
15,13,35,325,195,520
6,13,35,130,78,208
26,13,35,536,338,874
15,13,35,262,195,457
15,13,35,320,195,515
18,13,35,371,234,605
18,13,35,383,234,617
7,13,35,103,91,194
26,13,35,408,338,746
13,13,35,213,169,382
18,38,50,207,684,891
7,38,50,21,266,287
10,38,50,110,380,490
2,38,50,11,76,87
11,42,54,126,462,588
1,1912,3400,1352,1912,3264
1,1898,3375,937,1898,2835
1,1252,2295,492,1252,1744
1,1252,2295,1020,1252,2272
1,420,769,334,420,754
1,1266,2320,567,1266,1833
1,420,769,318,420,738
1,1266,2320,544,1266,1810
1,1266,2320,1031,1266,2297
1,1266,2320,1031,1266,2297
1,295,540,234,295,529
1,1266,2320,1008,1266,2274
1,713,1120,385,713,1098
1,713,1120,261,713,974
1,713,1120,385,713,1098
1,713,1120,172,713,885
1,1083,1701,550,1083,1633
1,1555,2443,864,1555,2419
1,344,540,174,344,518
1,344,540,174,344,518
6,26,70,260,156,416
12,3,9,58,36,94
11,1,2,11,11,22
29,1,2,27,29,56
10,1,2,9,10,19
20,1,2,19,20,39
6,1,2,6,6,12
4,1,2,4,4,8
20,2,5,59,40,99
4,13,35,87,52,139
7,13,35,152,91,243
15,13,35,325,195,520
19,9,25,204,171,375
11,9,25,118,99,217
17,9,25,268,153,421
29,9,25,457,261,718
23,1,4,68,23,91
2,1,4,6,2,8
5,1,4,15,5,20
6,1,4,18,6,24
29,2,5,86,58,144
19,11,29,243,209,452
3,11,29,38,33,71
22,11,29,281,242,523
14,13,35,274,182,456
15,13,35,293,195,488
4,1,2,3,4,7
24,1,2,16,24,40
1,2,5,2,2,4
3,2,5,7,6,13
12,1,2,12,12,24
14,1,2,13,14,27
5,1,2,4,5,9
1,1,2,1,1,2
30,2,5,71,60,131
30,2,5,57,60,117
22,2,5,42,44,86
22,2,5,65,44,109
25,2,5,74,50,124
2,2,5,6,4,10
29,2,5,86,58,144
3,2,5,9,6,15
1,2,5,3,2,5
27,1,4,80,27,107
24,1,4,71,24,95
28,1,4,83,28,111
21,1,4,61,21,82
27,9,25,324,243,567
8,9,25,96,72,168
9,1,2,9,9,18
5,1,2,5,5,10
1,12,33,14,12,26
21,12,33,289,252,541
18,2,5,50,36,86
17,2,5,48,34,82
5,2,5,11,10,21
8,2,5,23,16,39
4,2,5,12,8,20
16,1,2,12,16,28
27,1,2,19,27,46
2,2,5,4,4,8
14,2,5,27,28,55
3,2,5,7,6,13
13,2,5,30,26,56
20,1,4,58,20,78
6,1,4,18,6,24
3,1,4,9,3,12
7,1,4,16,7,23
1,1,4,2,1,3
1,755,1215,266,755,1021
1,755,1215,302,755,1057
1,1482,2384,854,1482,2336
1,1482,2384,854,1482,2336
11,24,64,433,264,697
2,59,159,197,118,315
6,59,159,495,354,849
13,4,10,55,52,107
20,4,10,84,80,164
27,4,10,127,108,235
23,4,10,108,92,200
21,2,5,61,42,103
8,2,5,19,16,35
30,2,5,87,60,147
2,2,5,6,4,10
27,4,10,151,108,259
11,4,10,62,44,106
28,2,5,78,56,134
13,2,5,36,26,62
10,3,9,54,30,84
8,3,9,43,24,67
7,2,5,13,14,27
26,2,5,49,52,101
25,4,10,95,100,195
25,4,10,95,100,195
26,2,5,57,52,109
19,2,5,42,38,80
7,4,10,32,28,60
2,4,10,9,8,17
5,2,5,15,10,25
24,2,5,70,48,118
26,2,5,55,52,107
17,2,5,36,34,70
8,7,9,8,56,64
20,7,9,17,140,157
30,7,9,17,210,227
10,7,9,6,70,76
14,7,9,10,98,108
8,7,9,15,56,71
27,7,9,10,189,199
24,7,9,33,168,201
30,7,9,41,210,251
10,7,9,18,70,88
18,3,8,71,54,125
29,3,8,140,87,227
21,8,22,276,168,444
10,8,22,111,80,191
3,8,22,41,24,65
1,8,22,11,8,19
25,8,22,273,200,473
12,8,22,110,96,206
13,8,22,119,104,223
20,8,22,223,160,383
3,8,22,27,24,51
9,8,22,84,72,156
24,8,22,241,192,433
18,8,22,169,144,313
26,9,24,365,234,599
7,9,24,81,63,144
28,9,24,407,252,659
19,9,24,276,171,447
26,13,35,454,338,792
4,13,35,85,52,137
10,13,35,157,130,287
13,13,35,268,169,437
30,13,35,618,390,1008
13,13,35,277,169,446
29,13,35,496,377,873
10,13,35,206,130,336
10,13,35,143,130,273
17,13,35,297,221,518
4,13,35,85,52,137
6,13,35,94,78,172
15,13,35,257,195,452
3,13,35,52,39,91
30,13,35,639,390,1029
27,13,35,462,351,813
13,13,35,281,169,450
3,13,35,64,39,103
1,13,35,21,13,34
28,13,35,596,364,960
30,13,35,524,390,914
15,42,54,34,630,664
19,42,54,13,798,811
20,38,50,110,760,870
15,42,54,148,630,778
7,38,50,77,266,343
3,42,54,30,126,156
17,42,54,2,714,716
29,38,50,319,1102,1421
4,38,50,20,152,172
4,42,54,18,168,186
1,1912,3400,774,1912,2686
1,1266,2320,892,1266,2158
1,1252,2295,538,1252,1790
1,1252,2295,630,1252,1882
1,1252,2295,1020,1252,2272
1,1252,2295,951,1252,2203
1,1252,2295,745,1252,1997
1,1266,2320,1008,1266,2274
1,308,565,184,308,492
1,295,540,148,295,443
1,420,769,318,420,738
1,1266,2320,961,1266,2227
1,1252,2295,745,1252,1997
1,308,565,246,308,554
1,1252,2295,630,1252,1882
1,1555,2443,546,1555,2101
1,487,783,124,487,611
1,713,1120,329,713,1042
1,1519,2443,533,1519,2052
1,713,1120,385,713,1098
1,344,540,120,344,464
1,1555,2443,570,1555,2125
1,713,1120,205,713,918
21,26,70,601,546,1147
2,26,70,85,52,137
17,3,9,100,51,151
12,3,9,57,36,93
11,1,2,6,11,17
30,1,2,29,30,59
6,1,2,6,6,12
3,1,2,3,3,6
20,1,2,20,20,40
8,1,2,8,8,16
17,2,5,49,34,83
14,2,5,41,28,69
17,2,5,49,34,83
19,9,25,285,171,456
26,9,25,390,234,624
9,2,5,21,18,39
17,2,5,40,34,74
2,1,2,2,2,4
2,1,2,2,2,4
1,1,2,1,1,2
25,1,2,24,25,49
24,1,2,15,24,39
30,2,5,89,60,149
14,2,5,41,28,69
4,2,5,11,8,19
26,2,5,69,52,121
7,9,25,105,63,168
17,2,5,39,34,73
30,1,2,29,30,59
17,1,2,12,17,29
30,1,2,22,30,52
26,1,2,15,26,41
18,1,2,10,18,28
19,1,4,43,19,62
26,1,4,59,26,85
27,12,33,451,324,775
20,12,33,334,240,574
9,1,2,6,9,15
14,1,2,9,14,23
10,2,5,30,20,50
26,2,5,75,52,127
9,11,30,160,99,259
16,2,5,38,32,70
8,2,5,19,16,35
20,11,30,314,220,534
13,11,30,204,143,347
4,1,4,12,4,16
19,12,33,317,228,545
19,12,33,317,228,545
15,1,4,44,15,59
28,1,4,82,28,110
26,1,4,64,26,90
22,1,4,55,22,77
6,1,2,4,6,10
13,1,2,10,13,23
21,2,5,56,42,98
26,2,5,75,52,127
17,8,21,196,136,332
3,8,21,35,24,59
1,1482,2384,521,1482,2003
1,755,1215,436,755,1191
1,461,742,266,461,727
23,24,64,905,552,1457
29,24,64,900,696,1596
11,24,64,285,264,549
3,59,159,238,177,415
18,3,9,106,54,160
28,2,5,83,56,139
17,2,5,50,34,84
22,2,5,64,44,108
28,2,5,81,56,137
14,2,5,32,28,60
16,2,5,37,32,69
22,2,5,62,44,106
18,2,5,42,36,78
15,2,5,35,30,65
26,2,5,75,52,127
9,2,5,21,18,39
27,2,5,62,54,116
1,2,5,3,2,5
5,2,5,15,10,25
15,2,5,44,30,74
9,2,5,26,18,44
1,2,5,3,2,5
21,2,5,61,42,103
11,2,5,32,22,54
23,2,5,68,46,114
29,3,9,140,87,227
11,3,9,53,33,86
30,7,9,57,210,267
16,7,9,31,112,143
26,7,9,47,182,229
18,7,9,-3,126,123
6,3,8,24,18,42
27,3,8,107,81,188
12,8,22,142,96,238
26,9,24,378,234,612
4,9,24,56,36,92
27,9,24,314,243,557
20,13,35,293,260,553
12,13,35,256,156,412
10,13,35,217,130,347
26,13,35,563,338,901
29,13,35,537,377,914
12,13,35,256,156,412
30,13,35,618,390,1008
28,13,35,606,364,970
9,13,35,132,117,249
13,13,35,190,169,359
6,13,35,94,78,172
23,13,35,393,299,692
27,13,35,528,351,879
4,13,35,85,52,137
9,13,35,192,117,309
12,13,35,209,156,365
9,13,35,185,117,302
10,13,35,213,130,343
5,13,35,79,65,144
17,21,55,456,357,813
3,21,55,90,63,153
21,38,50,210,798,1008
2,42,54,22,84,106
12,42,54,131,504,635
12,38,50,132,456,588
18,42,54,90,756,846
7,42,54,69,294,363
17,42,54,-16,714,698
1,1266,2320,1008,1266,2274
1,1252,2295,997,1252,2249
1,1252,2295,561,1252,1813
1,1266,2320,1008,1266,2274
1,1252,2295,997,1252,2249
1,1252,2295,1020,1252,2272
1,1252,2295,630,1252,1882
1,2171,3578,1335,2171,3506
1,2171,3578,1157,2171,3328
1,487,783,186,487,673
1,1083,1701,380,1083,1463
1,487,783,155,487,642
1,487,783,265,487,752
1,713,1120,362,713,1075
1,487,783,194,487,681
1,487,783,194,487,681
1,487,783,194,487,681
16,26,70,682,416,1098
25,26,70,855,650,1505
18,26,70,779,468,1247
23,3,9,92,69,161
18,3,9,74,54,128
21,3,9,122,63,185
14,3,9,66,42,108
10,13,35,217,130,347
2,13,35,43,26,69
2,11,30,32,22,54
21,11,30,336,231,567
19,13,35,405,247,652
21,2,5,62,42,104
11,2,5,32,22,54
26,2,5,77,52,129
5,2,5,15,10,25
28,2,5,59,56,115
4,2,5,8,8,16
9,1,2,5,9,14
6,1,4,14,6,20
10,1,4,23,10,33
23,2,5,67,46,113
20,2,5,58,40,98
15,1,2,13,15,28
18,1,2,15,18,33
17,2,5,49,34,83
26,2,5,75,52,127
27,1,2,26,27,53
8,1,2,8,8,16
16,1,2,15,16,31
29,1,2,17,29,46
12,1,2,7,12,19
16,1,2,12,16,28
28,2,5,66,56,122
26,2,5,61,52,113
10,2,5,24,20,44
5,8,21,63,40,103
1,11,29,14,11,25
13,11,29,185,143,328
16,1,4,47,16,63
5,1,4,15,5,20
16,2,5,30,32,62
8,1,2,5,8,13
16,2,5,34,32,66
12,9,25,150,108,258
18,2,5,50,36,86
22,2,5,46,44,90
30,2,5,63,60,123
1,1482,2384,401,1482,1883
1,1482,2384,807,1482,2289
1,461,742,147,461,608
1,1482,2384,592,1482,2074
1,461,742,266,461,727
7,24,64,271,168,439
6,45,120,349,270,619
23,45,120,1615,1035,2650
20,3,9,113,60,173
18,4,10,79,72,151
6,4,10,26,24,50
1,3,9,5,3,8
11,2,5,26,22,48
7,2,5,16,14,30
11,4,10,58,44,102
13,4,10,69,52,121
22,2,5,58,44,102
11,2,5,29,22,51
18,2,5,37,36,73
29,2,5,55,58,113
15,2,5,29,30,59
10,2,5,19,20,39
10,2,5,21,20,41
12,3,9,53,36,89
27,2,5,78,54,132
24,2,5,70,48,118
12,3,9,68,36,104
27,2,5,63,54,117
28,2,5,66,56,122
15,2,5,44,30,74
8,2,5,23,16,39
4,3,9,23,12,35
21,3,9,118,63,181
23,7,9,19,161,180
5,7,9,4,35,39
5,7,9,9,35,44
13,7,9,10,91,101
19,7,9,14,133,147
5,7,9,0,35,35
26,3,8,86,78,164
14,3,8,55,42,97
4,8,22,37,32,69
1,8,22,11,8,19
8,8,22,105,64,169
27,8,22,336,216,552
12,8,22,157,96,253
14,8,22,193,112,305
22,8,22,298,176,474
30,9,24,421,270,691
24,9,24,320,216,536
11,9,24,154,99,253
17,9,24,247,153,400
8,9,24,78,72,150
17,13,35,362,221,583
19,13,35,332,247,579
7,13,35,137,91,228
2,13,35,43,26,69
3,13,35,64,39,103
10,13,35,175,130,305
24,13,35,343,312,655
23,13,35,490,299,789
10,13,35,217,130,347
24,13,35,377,312,689
25,13,35,436,325,761
15,13,35,267,195,462
29,13,35,415,377,792
7,13,35,149,91,240
19,13,35,411,247,658
9,13,35,185,117,302
28,13,35,596,364,960
20,13,35,433,260,693
26,38,50,260,988,1248
24,38,50,276,912,1188
4,38,50,4,152,156
21,38,50,242,798,1040
6,42,54,59,252,311
1,1266,2320,752,1266,2018
1,1252,2295,538,1252,1790
1,1252,2295,951,1252,2203
1,1266,2320,636,1266,1902
1,1266,2320,961,1266,2227
1,1252,2295,997,1252,2249
1,1266,2320,544,1266,1810
1,2171,3578,1157,2171,3328
1,2171,3578,1157,2171,3328
1,344,540,120,344,464
1,2171,3578,942,2171,3113
1,344,540,174,344,518
1,344,540,174,344,518
1,1519,2443,606,1519,2125
1,344,540,99,344,443
1,487,783,194,487,681
1,487,783,194,487,681
13,26,70,454,338,792
20,26,70,852,520,1372
3,3,9,17,9,26
5,3,9,30,15,45
30,3,9,175,90,265
26,2,5,49,52,101
26,2,5,49,52,101
15,1,2,15,15,30
18,1,2,18,18,36
28,1,2,20,28,48
6,1,2,4,6,10
19,1,2,14,19,33
22,2,5,52,44,96
22,2,5,52,44,96
18,11,30,337,198,535
23,11,30,430,253,683
27,11,30,505,297,802
11,2,5,32,22,54
9,12,33,136,108,244
22,12,33,331,264,595
20,1,2,20,20,40
4,1,2,4,4,8
10,1,4,21,10,31
6,1,4,13,6,19
11,2,5,26,22,48
16,2,5,38,32,70
7,2,5,20,14,34
25,2,5,73,50,123
3,1,2,2,3,5
15,1,2,11,15,26
18,1,4,53,18,71
19,1,2,11,19,30
1,1,2,1,1,2
4,8,21,49,32,81
5,8,21,61,40,101
20,2,5,59,40,99
28,2,5,83,56,139
11,9,25,140,99,239
3,9,25,38,27,65
16,1,2,16,16,32
2,1,2,2,2,4
23,1,2,23,23,46
17,11,29,242,187,429
14,11,29,199,154,353
15,2,5,44,30,74
4,1,2,3,4,7
22,1,2,17,22,39
28,8,21,352,224,576
8,8,21,101,64,165
7,1,4,20,7,27
29,1,4,82,29,111
1,461,742,185,461,646
1,1482,2384,878,1482,2360
1,1482,2384,378,1482,1860
1,1482,2384,854,1482,2336
1,461,742,162,461,623
10,24,64,355,240,595
23,24,64,891,552,1443
8,45,120,427,360,787
26,3,9,147,78,225
20,3,9,113,60,173
3,2,5,6,6,12
8,2,5,17,16,33
11,2,5,32,22,54
7,3,9,41,21,62
29,3,9,169,87,256
25,3,9,141,75,216
1,3,9,6,3,9
23,2,5,53,46,99
23,2,5,51,46,97
22,2,5,48,44,92
9,4,10,52,36,88
28,2,5,64,56,120
25,2,5,55,50,105
3,2,5,7,6,13
13,2,5,38,26,64
12,2,5,35,24,59
2,3,9,12,6,18
6,3,9,35,18,53
20,2,5,47,40,87
14,2,5,33,28,61
4,2,5,9,8,17
12,3,9,68,36,104
16,3,9,64,48,112
5,3,9,20,15,35
24,2,5,56,48,104
3,2,5,7,6,13
5,7,9,10,35,45
21,7,9,12,147,159
30,7,9,11,210,221
24,7,9,39,168,207
20,7,9,17,140,157
26,7,9,47,182,229
13,7,9,0,91,91
26,7,9,43,182,225
26,3,8,103,78,181
25,8,22,229,200,429
28,8,22,386,224,610
19,8,22,199,152,351
11,8,22,149,88,237
22,8,22,202,176,378
20,8,22,223,160,383
30,8,22,301,240,541
22,9,24,325,198,523
18,9,24,179,162,341
4,9,24,43,36,79
16,9,24,190,144,334
20,9,24,290,180,470
12,13,35,172,156,328
1,13,35,21,13,34
20,13,35,293,260,553
18,13,35,383,234,617
10,13,35,206,130,336
5,13,35,79,65,144
23,13,35,474,299,773
13,13,35,204,169,373
1,13,35,17,13,30
12,13,35,260,156,416
8,13,35,165,104,269
30,13,35,429,390,819
21,13,35,433,273,706
15,13,35,257,195,452
27,13,35,443,351,794
6,13,35,122,78,200
1,13,35,21,13,34
26,42,54,3,1092,1095
14,38,50,154,532,686
10,38,50,30,380,410
25,38,50,25,950,975
2,38,50,23,76,99
13,42,54,58,546,604
13,38,50,52,494,546
28,38,50,84,1064,1148
28,38,50,280,1064,1344
29,38,50,87,1102,1189
24,42,54,3,1008,1011
1,1252,2295,630,1252,1882
1,1266,2320,1008,1266,2274
1,420,769,318,420,738
1,308,565,155,308,463
1,1266,2320,961,1266,2227
1,1252,2295,997,1252,2249
1,1083,1701,346,1083,1429
1,344,540,185,344,529
1,713,1120,362,713,1075
1,1555,2443,351,1555,1906
1,1555,2443,546,1555,2101
1,1083,1701,261,1083,1344
1,713,1120,261,713,974
1,2171,3578,620,2171,2791
1,2171,3578,1335,2171,3506
1,344,540,174,344,518
10,26,70,433,260,693
5,26,70,143,130,273
2,3,9,8,6,14
24,3,9,96,72,168
28,3,9,113,84,197
16,8,21,201,128,329
29,8,21,365,232,597
22,1,2,21,22,43
4,1,2,4,4,8
28,1,4,59,28,87
16,1,4,34,16,50
10,1,4,21,10,31
6,2,5,11,12,23
2,2,5,4,4,8
28,13,35,596,364,960
11,11,29,185,121,306
11,11,29,185,121,306
1,2,5,3,2,5
26,2,5,73,52,125
20,2,5,56,40,96
30,1,2,17,30,47
19,1,2,11,19,30
17,1,2,10,17,27
5,1,2,3,5,8
5,1,2,3,5,8
2,1,2,1,2,3
15,1,2,10,15,25
23,1,2,15,23,38
30,1,2,26,30,56
15,1,2,11,15,26
22,1,2,16,22,38
10,2,5,30,20,50
22,1,2,14,22,36
11,1,2,7,11,18
26,2,5,75,52,127
14,12,33,234,168,402
30,12,33,501,360,861
23,2,5,68,46,114
11,2,5,32,22,54
19,1,2,12,19,31
20,1,2,13,20,33
9,1,2,6,9,15
9,1,2,9,9,18
17,1,2,17,17,34
15,1,2,15,15,30
1,1,2,1,1,2
27,11,30,497,297,794
1,11,30,18,11,29
16,1,4,38,16,54
9,1,2,8,9,17
6,9,25,90,54,144
17,9,25,255,153,408
20,9,25,300,180,480
21,8,21,180,168,348
29,8,21,249,232,481
25,1,2,16,25,41
16,1,2,15,16,31
25,1,2,23,25,48
10,1,2,9,10,19
30,8,21,277,240,517
28,1,4,68,28,96
3,1,4,7,3,10
1,461,742,125,461,586
1,1482,2384,807,1482,2289
1,1482,2384,473,1482,1955
1,1482,2384,878,1482,2360
1,1482,2384,807,1482,2289
1,1482,2384,473,1482,1955
1,1482,2384,807,1482,2289
1,1482,2384,473,1482,1955
1,1482,2384,473,1482,1955
16,24,64,497,384,881
8,24,64,310,192,502
3,59,159,214,177,391
22,4,10,130,88,218
17,4,10,100,68,168
15,3,9,66,45,111
28,3,9,123,84,207
1,2,5,2,2,4
6,4,10,28,24,52
1,4,10,5,4,9
4,2,5,11,8,19
25,2,5,70,50,120
23,2,5,53,46,99
26,2,5,60,52,112
24,2,5,71,48,119
28,3,9,123,84,207
3,3,9,13,9,22
28,2,5,53,56,109
15,3,9,85,45,130
2,3,9,11,6,17
10,3,9,56,30,86
6,3,9,34,18,52
3,2,5,6,6,12
2,2,5,4,4,8
28,2,5,81,56,137
20,2,5,58,40,98
27,2,5,57,54,111
17,2,5,36,34,70
21,2,5,59,42,101
11,2,5,31,22,53
12,3,9,57,36,93
3,3,9,14,9,23
12,2,5,35,24,59
30,2,5,87,60,147
15,3,9,89,45,134
4,3,9,24,12,36
30,3,9,161,90,251
28,3,9,150,84,234
9,2,5,21,18,39
9,2,5,21,18,39
13,3,9,76,39,115
22,3,9,128,66,194
19,2,5,55,38,93
5,2,5,11,10,21
8,2,5,17,16,33
20,2,5,56,40,96
19,2,5,53,38,91
21,7,9,40,147,187
21,7,9,38,147,185
2,7,9,1,14,15
30,7,9,49,210,259
7,7,9,11,49,60
4,3,8,16,12,28
21,3,8,103,63,166
23,8,22,251,184,435
16,8,22,217,128,345
9,8,22,122,72,194
11,8,22,149,88,237
6,8,22,81,48,129
16,8,22,210,128,338
6,8,22,55,48,103
3,8,22,39,24,63
19,8,22,174,152,326
17,8,22,189,136,325
20,9,24,295,180,475
12,9,24,160,108,268
27,9,24,262,243,505
10,9,24,140,90,230
27,9,24,392,243,635
10,9,24,145,90,235
13,9,24,189,117,306
2,13,35,29,26,55
12,13,35,239,156,395
27,13,35,556,351,907
15,13,35,262,195,457
21,13,35,433,273,706
14,13,35,288,182,470
17,13,35,350,221,571
3,13,35,47,39,86
7,13,35,149,91,240
23,13,35,474,299,773
24,13,35,520,312,832
18,13,35,371,234,605
12,13,35,256,156,412
24,13,35,511,312,823
26,13,35,408,338,746
1,13,35,21,13,34
12,13,35,235,156,391
9,21,55,197,189,386
17,21,55,541,357,898
18,38,50,198,684,882
13,42,54,107,546,653
9,38,50,90,342,432
1,38,50,3,38,41
17,42,54,2,714,716
7,42,54,16,294,310
5,42,54,25,210,235
11,42,54,126,462,588
20,42,54,164,840,1004
1,1266,2320,636,1266,1902
1,1252,2295,745,1252,1997
1,308,565,217,308,525
1,1266,2320,544,1266,1810
1,308,565,184,308,492
1,420,769,318,420,738
1,1266,2320,544,1266,1810
1,420,769,211,420,631
1,1266,2320,961,1266,2227
1,1266,2320,752,1266,2018
1,1266,2320,961,1266,2227
1,295,540,234,295,529
1,295,540,126,295,421
1,420,769,249,420,669
1,1266,2320,544,1266,1810
1,2171,3578,1335,2171,3506
1,2171,3578,1371,2171,3542
1,1555,2443,448,1555,2003
1,1555,2443,448,1555,2003
1,1519,2443,826,1519,2345
1,2171,3578,942,2171,3113
1,713,1120,385,713,1098
1,344,540,185,344,529
1,1555,2443,790,1555,2345
1,1083,1701,499,1083,1582
1,344,540,191,344,535
2,26,70,87,52,139
20,26,70,852,520,1372
2,26,70,57,52,109
2,26,70,57,52,109
2,26,70,70,52,122
21,3,9,84,63,147
22,2,5,46,44,90
21,1,2,15,21,36
15,1,2,8,15,23
7,1,2,4,7,11
22,13,35,438,286,724
27,13,35,537,351,888
13,1,2,10,13,23
10,1,2,7,10,17
2,12,33,39,24,63
19,12,33,374,228,602
4,1,2,4,4,8
25,1,2,24,25,49
28,2,5,66,56,122
17,2,5,40,34,74
6,2,5,18,12,30
6,2,5,17,12,29
20,2,5,56,40,96
16,11,30,294,176,470
16,1,2,15,16,31
8,1,2,5,8,13
30,1,2,19,30,49
13,2,5,27,26,53
3,2,5,6,6,12
14,2,5,29,28,57
6,2,5,18,12,30
6,2,5,18,12,30
16,1,4,45,16,61
22,1,4,62,22,84
29,9,25,450,261,711
17,9,25,264,153,417
12,11,30,214,132,346
26,2,5,75,52,127
6,2,5,17,12,29
9,2,5,26,18,44
14,1,2,8,14,22
17,1,2,10,17,27
12,1,2,7,12,19
28,1,2,27,28,55
7,1,2,7,7,14
27,1,2,26,27,53
19,1,2,19,19,38
26,1,2,25,26,51
13,2,5,27,26,53
10,2,5,21,20,41
11,1,2,10,11,21
8,1,2,4,8,12
9,1,2,5,9,14
1,2,5,3,2,5
10,2,5,29,20,49
5,2,5,15,10,25
11,2,5,31,22,53
14,2,5,39,28,67
11,2,5,26,22,48
19,2,5,45,38,83
19,8,21,239,152,391
28,8,21,352,224,576
10,8,21,126,80,206
5,9,25,78,45,123
1,9,25,16,9,25
28,9,25,322,252,574
25,9,25,288,225,513
1,1482,2384,473,1482,1955
1,1482,2384,759,1482,2241
1,461,742,251,461,712
1,1482,2384,807,1482,2289
1,1482,2384,473,1482,1955
1,755,1215,375,755,1130
1,461,742,199,461,660
1,461,742,147,461,608
9,24,64,279,216,495
2,24,64,52,48,100
7,24,64,271,168,439
4,45,120,281,180,461
2,45,120,148,90,238
3,59,159,238,177,415
27,4,10,159,108,267
27,4,10,159,108,267
6,2,5,12,12,24
4,2,5,8,8,16
15,2,5,44,30,74
13,2,5,38,26,64
16,3,9,73,48,121
9,3,9,41,27,68
25,2,5,66,50,116
25,2,5,66,50,116
10,3,9,41,30,71
29,3,9,119,87,206
18,3,9,105,54,159
22,3,9,128,66,194
26,3,9,151,78,229
2,3,9,12,6,18
24,4,10,91,96,187
21,4,10,80,84,164
13,2,5,31,26,57
25,2,5,59,50,109
26,2,5,61,52,113
17,2,5,40,34,74
20,2,5,53,40,93
13,2,5,34,26,60
19,2,5,56,38,94
24,3,9,99,72,171
2,3,9,8,6,14
20,2,5,59,40,99
15,7,9,29,105,134
7,7,9,13,49,62
4,7,9,7,28,35
23,7,9,32,161,193
24,7,9,3,168,171
4,3,8,20,12,32
8,3,8,37,24,61
7,8,22,95,56,151
16,8,22,217,128,345
24,8,22,299,192,491
17,9,24,169,153,322
27,9,24,269,243,512
26,9,24,253,234,487
11,9,24,147,99,246
27,9,24,392,243,635
2,13,35,33,26,59
18,13,35,390,234,624
8,13,35,140,104,244
11,13,35,227,143,370
11,13,35,238,143,381
13,13,35,186,169,355
12,13,35,209,156,365
3,13,35,59,39,98
10,13,35,147,130,277
19,13,35,298,247,545
16,13,35,341,208,549
2,13,35,31,26,57
25,13,35,515,325,840
11,13,35,161,143,304
2,13,35,29,26,55
30,13,35,492,390,882
5,13,35,107,65,172
17,13,35,249,221,470
9,21,55,301,189,490
3,21,55,99,63,162
21,38,50,210,798,1008
9,42,54,30,378,408
8,42,54,40,336,376
14,42,54,9,588,597
3,38,50,5,114,119
3,38,50,26,114,140
16,38,50,176,608,784
30,42,54,328,1260,1588
1,1252,2295,1020,1252,2272
1,1252,2295,1020,1252,2272
1,1266,2320,752,1266,2018
1,1252,2295,882,1252,2134
1,1252,2295,997,1252,2249
1,420,769,249,420,669
1,1266,2320,636,1266,1902
1,308,565,217,308,525
1,1252,2295,630,1252,1882
1,308,565,246,308,554
1,1555,2443,790,1555,2345
1,2171,3578,942,2171,3113
1,1555,2443,717,1555,2272
1,487,783,155,487,642
1,487,783,265,487,752
1,713,1120,161,713,874
1,344,540,185,344,529
1,344,540,174,344,518
1,1083,1701,397,1083,1480
1,487,783,171,487,658
1,2171,3578,1335,2171,3506
10,26,70,426,260,686
30,26,70,1278,780,2058
18,3,9,79,54,133
1,3,9,6,3,9
25,9,25,269,225,494
23,9,25,247,207,454
25,1,2,17,25,42
20,1,2,14,20,34
5,8,21,63,40,103
30,1,2,17,30,47
10,1,2,10,10,20
20,1,2,11,20,31
5,2,5,12,10,22
6,2,5,14,12,26
17,2,5,50,34,84
18,2,5,53,36,89
29,2,5,86,58,144
7,2,5,15,14,29
27,1,2,26,27,53
9,1,2,9,9,18
11,1,2,11,11,22
1,2,5,3,2,5
10,1,2,9,10,19
15,11,30,267,165,432
18,11,30,320,198,518
13,11,30,231,143,374
26,1,2,25,26,51
6,1,2,6,6,12
18,1,2,18,18,36
14,1,2,10,14,24
9,1,2,6,9,15
11,1,2,11,11,22
12,1,2,12,12,24
21,11,30,386,231,617
28,2,5,81,56,137
13,11,30,161,143,304
17,11,30,211,187,398
20,11,30,248,220,468
22,11,29,313,242,555
1,11,29,14,11,25
29,1,2,27,29,56
7,1,2,6,7,13
1,1,2,1,1,2
8,1,4,23,8,31
8,1,4,23,8,31
8,1,2,8,8,16
2,1,2,2,2,4
18,9,25,230,162,392
18,9,25,230,162,392
22,2,5,52,44,96
29,2,5,68,58,126
13,2,5,38,26,64
6,2,5,17,12,29
1,1482,2384,401,1482,1883
1,1482,2384,592,1482,2074
1,755,1215,205,755,960
1,1482,2384,878,1482,2360
1,1482,2384,401,1482,1883
1,755,1215,193,755,948
1,1482,2384,401,1482,1883
21,24,64,786,504,1290
9,59,159,871,531,1402
9,4,10,50,36,86
23,4,10,129,92,221
1,2,5,3,2,5
18,2,5,34,36,70
18,2,5,34,36,70
19,2,5,55,38,93
19,2,5,55,38,93
1,2,5,3,2,5
16,3,9,66,48,114
3,3,9,12,9,21
21,2,5,61,42,103
22,4,10,84,88,172
6,4,10,23,24,47
9,2,5,21,18,39
27,2,5,63,54,117
6,2,5,14,12,26
18,2,5,42,36,78
25,2,5,59,50,109
10,2,5,29,20,49
11,2,5,21,22,43
21,7,9,38,147,185
16,7,9,2,112,114
6,7,9,11,42,53
8,7,9,7,56,63
29,7,9,40,203,243
5,7,9,9,35,44
5,7,9,2,35,37
22,3,8,108,66,174
12,8,22,134,96,230
23,9,24,334,207,541
10,9,24,148,90,238
28,13,35,410,364,774
2,13,35,43,26,69
15,13,35,320,195,515
28,13,35,596,364,960
30,13,35,524,390,914
8,13,35,170,104,274
18,13,35,383,234,617
8,13,35,140,104,244
29,13,35,506,377,883
13,13,35,277,169,446
16,13,35,341,208,549
20,13,35,314,260,574
1,13,35,14,13,27
23,13,35,474,299,773
6,13,35,94,78,172
3,13,35,43,39,82
22,13,35,376,286,662
28,21,55,937,588,1525
14,38,50,161,532,693
12,38,50,12,456,468
20,38,50,220,760,980
10,42,54,109,420,529
1,1266,2320,1031,1266,2297
1,1252,2295,538,1252,1790
1,420,769,341,420,761
1,420,769,318,420,738
1,308,565,234,308,542
1,1555,2443,839,1555,2394
1,713,1120,205,713,918
1,1555,2443,570,1555,2125
1,713,1120,228,713,941
1,2171,3578,1335,2171,3506
3,26,70,105,78,183
28,26,70,1212,728,1940
28,26,70,1212,728,1940
12,2,5,35,24,59
22,1,2,12,22,34
15,1,2,8,15,23
29,8,21,249,232,481
29,1,2,28,29,57
1,1,2,1,1,2
1,1,2,1,1,2
29,13,35,628,377,1005
28,13,35,606,364,970
8,13,35,173,104,277
17,1,2,16,17,33
23,1,2,13,23,36
30,1,2,17,30,47
2,1,4,6,2,8
20,1,4,57,20,77
20,9,25,315,180,495
4,1,2,4,4,8
2,1,2,2,2,4
16,1,2,15,16,31
27,1,2,26,27,53
11,2,5,26,22,48
25,2,5,59,50,109
23,1,2,21,23,44
1,1,2,1,1,2
7,1,2,6,7,13
28,1,2,27,28,55
29,1,2,28,29,57
27,2,5,80,54,134
25,2,5,74,50,124
15,1,4,37,15,52
29,1,2,16,29,45
5,1,2,3,5,8
10,2,5,29,20,49
22,2,5,64,44,108
11,2,5,32,22,54
24,11,30,442,264,706
7,11,29,122,77,199
8,11,29,139,88,227
3,8,21,28,24,52
8,8,21,74,64,138
21,8,21,194,168,362
12,2,5,35,24,59
9,2,5,27,18,45
14,2,5,33,28,61
3,2,5,7,6,13
1,1482,2384,878,1482,2360
1,461,742,177,461,638
1,1482,2384,854,1482,2336
1,461,742,266,461,727
1,461,742,147,461,608
17,24,64,669,408,1077
4,24,64,155,96,251
7,45,120,349,315,664
7,2,5,15,14,29
15,2,5,32,30,62
29,2,5,86,58,144
21,2,5,49,42,91
3,2,5,7,6,13
29,4,10,168,116,284
10,4,10,58,40,98
6,4,10,35,24,59
14,4,10,81,56,137
2,2,5,6,4,10
22,2,5,52,44,96
28,2,5,66,56,122
23,2,5,68,46,114
17,3,9,78,51,129
21,3,9,96,63,159
2,2,5,5,4,9
14,3,9,66,42,108
8,3,9,38,24,62
13,2,5,38,26,64
1,2,5,3,2,5
13,2,5,36,26,62
8,2,5,22,16,38
14,2,5,33,28,61
26,2,5,61,52,113
29,7,9,24,203,227
18,7,9,25,126,151
13,7,9,0,91,91
8,7,9,15,56,71
24,7,9,44,168,212
8,7,9,6,56,62
6,7,9,11,42,53
25,3,8,99,75,174
26,8,22,244,208,452
17,8,22,231,136,367
13,8,22,176,104,280
19,8,22,237,152,389
1,8,22,14,8,22
19,9,24,276,171,447
19,9,24,226,171,397
15,9,24,178,135,313
11,9,24,160,99,259
1,9,24,15,9,24
22,13,35,469,286,755
25,13,35,366,325,691
19,13,35,411,247,658
18,13,35,371,234,605
19,13,35,405,247,652
21,13,35,330,273,603
24,13,35,343,312,655
27,13,35,528,351,879
21,13,35,455,273,728
22,13,35,453,286,739
23,13,35,401,299,700
5,13,35,107,65,172
4,13,35,78,52,130
20,13,35,349,260,609
3,13,35,64,39,103
22,13,35,453,286,739
11,13,35,238,143,381
23,13,35,409,299,708
1,13,35,17,13,30
27,13,35,471,351,822
29,13,35,618,377,995
24,13,35,419,312,731
1,21,55,25,21,46
13,21,55,435,273,708
2,21,55,53,42,95
6,42,54,66,252,318
4,38,50,44,152,196
2,38,50,6,76,82
7,38,50,81,266,347
8,38,50,80,304,384
27,42,54,266,1134,1400
2,42,54,7,84,91
17,38,50,51,646,697
18,38,50,27,684,711
1,1898,3375,937,1898,2835
1,1912,3400,944,1912,2856
1,1252,2295,561,1252,1813
1,1252,2295,951,1252,2203
1,420,769,295,420,715
1,1266,2320,961,1266,2227
1,1266,2320,1008,1266,2274
1,1266,2320,961,1266,2227
1,1555,2443,839,1555,2394
1,1083,1701,244,1083,1327
1,2171,3578,656,2171,2827
1,713,1120,161,713,874
1,344,540,191,344,535
1,344,540,131,344,475
1,1083,1701,312,1083,1395
1,487,783,132,487,619
1,344,540,110,344,454
11,26,70,315,286,601
15,26,70,639,390,1029
12,1,2,12,12,24
3,1,2,3,3,6
16,1,2,16,16,32
29,1,2,28,29,57
11,2,5,32,22,54
30,2,5,89,60,149
7,1,2,7,7,14
11,1,2,11,11,22
16,1,2,14,16,30
29,1,2,21,29,50
21,2,5,61,42,103
24,13,35,511,312,823
4,13,35,85,52,137
4,2,5,8,8,16
12,1,4,33,12,45
15,1,4,41,15,56
24,1,4,65,24,89
25,2,5,70,50,120
19,1,2,17,19,36
5,2,5,12,10,22
22,2,5,52,44,96
18,2,5,42,36,78
5,9,25,71,45,116
9,9,25,128,81,209
10,2,5,28,20,48
18,1,2,17,18,35
9,8,21,113,72,185
23,1,2,23,23,46
7,1,4,16,7,23
29,8,21,249,232,481
22,1,2,12,22,34
15,1,2,8,15,23
3,2,5,7,6,13
23,2,5,56,46,102
17,2,5,42,34,76
10,1,2,7,10,17
20,1,2,15,20,35
2,1,2,1,2,3
17,1,2,9,17,26
8,1,4,20,8,28
1,1,4,2,1,3
17,11,29,271,187,458
25,11,29,399,275,674
9,2,5,19,18,37
29,2,5,61,58,119
1,1482,2384,592,1482,2074
1,461,742,229,461,690
1,1482,2384,473,1482,1955
1,1482,2384,735,1482,2217
1,461,742,251,461,712
1,1482,2384,473,1482,1955
1,461,742,147,461,608
1,1482,2384,854,1482,2336
1,1482,2384,854,1482,2336
1,461,742,274,461,735
1,1482,2384,592,1482,2074
1,461,742,185,461,646
19,24,64,711,456,1167
20,24,64,595,480,1075
13,45,120,632,585,1217
10,59,159,968,590,1558
6,59,159,447,354,801
5,4,10,18,20,38
16,3,9,77,48,125
28,3,9,135,84,219
16,4,10,61,64,125
1,4,10,4,4,8
17,3,9,99,51,150
13,3,9,76,39,115
30,2,5,87,60,147
5,2,5,10,10,20
7,2,5,16,14,30
12,2,5,28,24,52
1,4,10,4,4,8
12,4,10,46,48,94
22,3,9,88,66,154
25,2,5,74,50,124
9,2,5,25,18,43
6,2,5,17,12,29
20,2,5,39,40,79
10,7,9,19,70,89
25,7,9,48,175,223
9,7,9,0,63,63
1,7,9,0,7,7
10,7,9,16,70,86
20,7,9,0,140,140
15,7,9,0,105,105
7,3,8,34,21,55
25,3,8,81,75,156
25,8,22,279,200,479
5,8,22,68,40,108
13,8,22,131,104,235
16,9,24,236,144,380
2,9,24,24,18,42
25,9,24,297,225,522
23,9,24,224,207,431
23,9,24,334,207,541
26,9,24,378,234,612
6,13,35,82,78,160
13,13,35,254,169,423
24,13,35,352,312,664
3,13,35,64,39,103
17,13,35,249,221,470
14,13,35,244,182,426
18,13,35,390,234,624
26,13,35,372,338,710
11,13,35,157,143,300
22,13,35,345,286,631
3,13,35,43,39,82
30,13,35,524,390,914
27,13,35,575,351,926
27,13,35,471,351,822
25,13,35,541,325,866
12,13,35,176,156,332
18,13,35,383,234,617
20,13,35,391,260,651
14,13,35,235,182,417
21,13,35,433,273,706
30,13,35,639,390,1029
14,13,35,274,182,456
23,13,35,498,299,797
24,13,35,494,312,806
11,21,55,295,231,526
28,21,55,921,588,1509
8,21,55,254,168,422
25,38,50,275,950,1225
28,38,50,322,1064,1386
1,38,50,6,38,44
4,38,50,6,152,158
26,42,54,298,1092,1390
27,38,50,149,1026,1175
29,38,50,319,1102,1421
9,38,50,90,342,432
28,42,54,64,1176,1240
1,1252,2295,630,1252,1882
1,1266,2320,497,1266,1763
1,1266,2320,961,1266,2227
1,1252,2295,745,1252,1997
1,1266,2320,567,1266,1833
1,1252,2295,997,1252,2249
1,1266,2320,1008,1266,2274
1,1266,2320,752,1266,2018
1,1252,2295,630,1252,1882
1,713,1120,205,713,918
1,2171,3578,1264,2171,3435
1,713,1120,385,713,1098
1,713,1120,261,713,974
1,487,783,265,487,752
1,1555,2443,497,1555,2052
1,1555,2443,570,1555,2125
1,344,540,174,344,518
1,344,540,158,344,502
1,344,540,164,344,508
1,344,540,83,344,427
1,487,783,132,487,619
1,344,540,126,344,470
1,344,540,174,344,518
1,2171,3578,620,2171,2791
21,26,70,909,546,1455
11,26,70,469,286,755
7,26,70,298,182,480
22,26,70,629,572,1201
12,26,70,343,312,655
28,3,9,135,84,219
11,3,9,65,33,98
4,3,9,15,12,27
11,1,2,6,11,17
11,11,29,147,121,268
27,11,29,361,297,658
4,11,29,53,44,97
22,1,2,16,22,38
8,1,2,6,8,14
9,2,5,25,18,43
21,2,5,59,42,101
7,9,25,75,63,138
29,9,25,312,261,573
6,9,25,65,54,119
16,1,2,15,16,31
16,12,33,331,192,523
16,2,5,30,32,62
13,2,5,31,26,57
25,2,5,59,50,109
11,2,5,26,22,48
8,9,25,126,72,198
25,9,25,394,225,619
12,1,2,11,12,23
7,2,5,19,14,33
4,2,5,11,8,19
9,2,5,21,18,39
5,8,21,59,40,99
15,8,21,176,120,296
9,8,21,106,72,178
15,1,4,41,15,56
14,1,4,38,14,52
3,1,4,7,3,10
27,1,4,65,27,92
14,1,2,13,14,27
3,1,2,3,3,6
14,11,29,199,154,353
7,1,4,16,7,23
9,1,4,21,9,30
9,2,5,18,18,36
30,2,5,59,60,119
10,2,5,19,20,39
26,2,5,49,52,101
12,9,25,153,108,261
13,9,25,166,117,283
19,1,2,18,19,37
9,1,2,9,9,18
23,1,4,65,23,88
15,1,4,43,15,58
6,2,5,14,12,26
18,2,5,42,36,78
10,9,25,155,90,245
15,9,25,233,135,368
19,1,4,55,19,74
1,1,4,3,1,4
1,1482,2384,401,1482,1883
1,461,742,274,461,735
1,1482,2384,330,1482,1812
1,461,742,229,461,690
1,1482,2384,378,1482,1860
1,461,742,118,461,579
19,24,64,711,456,1167
23,24,64,891,552,1443
11,24,64,313,264,577
3,45,120,149,135,284
2,59,159,178,118,296
9,2,5,19,18,37
1,2,5,2,2,4
3,4,10,11,12,23
22,4,10,79,88,167
1,2,5,3,2,5
25,2,5,70,50,120
11,4,10,52,44,96
18,4,10,85,72,157
18,2,5,52,36,88
16,2,5,46,32,78
8,2,5,24,16,40
2,2,5,6,4,10
19,2,5,56,38,94
21,2,5,62,42,104
23,2,5,44,46,90
27,2,5,51,54,105
11,2,5,21,22,43
27,2,5,51,54,105
25,3,9,114,75,189
26,3,9,119,78,197
24,2,5,70,48,118
6,2,5,17,12,29
7,2,5,20,14,34
2,2,5,6,4,10
10,2,5,28,20,48
7,2,5,20,14,34
8,2,5,23,16,39
26,2,5,75,52,127
7,7,9,3,49,52
29,3,8,143,87,230
27,3,8,126,81,207
5,8,22,52,40,92
26,8,22,284,208,492
1,8,22,11,8,19
13,9,24,126,117,243
1,9,24,11,9,20
3,9,24,33,27,60
4,9,24,40,36,76
8,9,24,93,72,165
13,9,24,126,117,243
6,9,24,84,54,138
16,9,24,171,144,315
9,9,24,107,81,188
29,13,35,597,377,974
18,13,35,371,234,605
9,13,35,195,117,312
9,13,35,195,117,312
22,13,35,453,286,739
1,13,35,17,13,30
12,13,35,256,156,412
22,13,35,361,286,647
10,13,35,143,130,273
18,13,35,257,234,491
30,13,35,618,390,1008
15,13,35,320,195,515
25,13,35,410,325,735
10,13,35,164,130,294
6,13,35,98,78,176
27,13,35,367,351,718
9,13,35,192,117,309
23,13,35,498,299,797
4,13,35,57,52,109
5,13,35,72,65,137
25,13,35,533,325,858
11,13,35,173,143,316
25,13,35,515,325,840
2,42,54,23,84,107
28,38,50,322,1064,1386
5,42,54,22,210,232
4,42,54,46,168,214
5,38,50,50,190,240
3,42,54,30,126,156
30,38,50,90,1140,1230
1,1912,3400,944,1912,2856
1,1252,2295,492,1252,1744
1,1252,2295,722,1252,1974
1,1252,2295,561,1252,1813
1,1252,2295,997,1252,2249
1,420,769,318,420,738
1,1252,2295,745,1252,1997
1,1266,2320,1008,1266,2274
1,1252,2295,676,1252,1928
1,1266,2320,544,1266,1810
1,1266,2320,1031,1266,2297
1,2171,3578,906,2171,3077
1,2171,3578,1264,2171,3435
1,1555,2443,864,1555,2419
1,1555,2443,717,1555,2272
1,1083,1701,550,1083,1633
1,344,540,174,344,518
1,487,783,194,487,681
1,487,783,171,487,658
1,2171,3578,1335,2171,3506
1,2171,3578,1335,2171,3506
1,2171,3578,1335,2171,3506
27,26,70,791,702,1493
11,3,9,65,33,98
27,3,9,157,81,238
24,1,2,13,24,37
18,1,2,17,18,35
6,9,25,65,54,119
29,9,25,312,261,573
12,1,2,9,12,21
8,1,2,8,8,16
17,13,35,362,221,583
29,13,35,618,377,995
16,1,4,44,16,60
7,1,4,19,7,26
17,1,4,50,17,67
3,9,25,38,27,65
5,9,25,63,45,108
6,2,5,18,12,30
4,2,5,12,8,20
29,2,5,81,58,139
17,2,5,48,34,82
19,1,2,11,19,30
25,1,2,24,25,49
6,1,2,6,6,12
8,13,35,126,104,230
12,13,35,188,156,344
24,1,2,13,24,37
8,1,2,4,8,12
28,1,2,19,28,47
7,1,2,5,7,12
6,11,29,101,66,167
5,11,29,84,55,139
26,9,25,390,234,624
23,9,25,345,207,552
11,1,4,25,11,36
2,1,4,5,2,7
2,12,33,31,24,55
3,1,2,2,3,5
18,1,2,12,18,30
20,2,5,44,40,84
27,2,5,59,54,113
16,1,4,38,16,54
17,1,4,40,17,57
6,1,4,14,6,20
8,1,2,5,8,13
19,1,2,11,19,30
3,2,5,8,6,14
30,2,5,84,60,144
6,2,5,17,12,29
22,2,5,64,44,108
22,2,5,64,44,108
11,1,2,6,11,17
13,1,2,7,13,20
25,11,30,310,275,585
25,12,33,344,300,644
19,12,33,261,228,489
27,1,4,79,27,106
5,1,4,15,5,20
24,12,33,330,288,618
30,2,5,87,60,147
5,2,5,15,10,25
5,2,5,11,10,21
7,2,5,15,14,29
16,2,5,34,32,66
1,1482,2384,473,1482,1955
1,1482,2384,807,1482,2289
1,1482,2384,807,1482,2289
6,59,159,476,354,830
6,2,5,14,12,26
29,2,5,59,58,117
16,2,5,33,32,65
17,2,5,50,34,84
23,2,5,67,46,113
13,4,10,60,52,112
19,4,10,87,76,163
25,3,9,134,75,209
1,3,9,5,3,8
29,2,5,81,58,139
5,2,5,14,10,24
9,4,10,48,36,84
18,4,10,101,72,173
17,2,5,40,34,74
30,2,5,71,60,131
17,3,9,99,51,150
4,3,9,23,12,35
2,2,5,4,4,8
12,2,5,35,24,59
28,2,5,83,56,139
13,2,5,38,26,64
19,2,5,50,38,88
21,2,5,56,42,98
29,2,5,68,58,126
1,2,5,2,2,4
25,2,5,73,50,123
18,2,5,52,36,88
28,3,9,158,84,242
12,2,5,23,24,47
14,2,5,27,28,55
2,2,5,6,4,10
14,2,5,41,28,69
1,2,5,2,2,4
1,2,5,2,2,4
23,7,9,44,161,205
13,7,9,24,91,115
3,7,9,5,21,26
5,7,9,9,35,44
22,7,9,40,154,194
21,7,9,17,147,164
11,7,9,15,77,92
3,3,8,15,9,24
30,3,8,145,90,235
8,3,8,28,24,52
24,3,8,112,72,184
15,3,8,73,45,118
9,8,22,90,72,162
2,8,22,18,16,34
3,8,22,37,24,61
2,8,22,19,16,35
8,9,24,118,72,190
21,9,24,209,189,398
2,9,24,19,18,37
15,9,24,221,135,356
2,9,24,24,18,42
2,9,24,24,18,42
6,9,24,70,54,124
23,9,24,334,207,541
12,13,35,256,156,412
13,13,35,277,169,446
1,13,35,17,13,30
21,13,35,322,273,595
14,13,35,205,182,387
25,13,35,366,325,691
24,13,35,368,312,680
1,13,35,22,13,35
23,13,35,329,299,628
6,13,35,105,78,183
6,13,35,109,78,187
24,13,35,520,312,832
21,13,35,300,273,573
15,13,35,262,195,457
21,13,35,433,273,706
17,13,35,332,221,553
12,13,35,209,156,365
24,13,35,469,312,781
5,13,35,87,65,152
8,13,35,114,104,218
8,13,35,131,104,235
14,13,35,200,182,382
28,13,35,577,364,941
15,21,55,477,315,792
6,21,55,197,126,323
15,21,55,378,315,693
11,38,50,55,418,473
16,42,54,11,672,683
20,38,50,230,760,990
2,42,54,10,84,94
5,38,50,33,190,223
22,38,50,22,836,858
22,42,54,110,924,1034
12,38,50,120,456,576
1,1266,2320,567,1266,1833
1,1266,2320,961,1266,2227
1,295,540,234,295,529
1,1266,2320,961,1266,2227
1,1912,3400,1420,1912,3332
1,1519,2443,387,1519,1906
1,1519,2443,533,1519,2052
1,1555,2443,717,1555,2272
1,487,783,210,487,697
1,713,1120,385,713,1098
1,713,1120,385,713,1098
1,713,1120,161,713,874
1,487,783,265,487,752
1,1555,2443,570,1555,2125
1,2171,3578,1335,2171,3506
1,713,1120,329,713,1042
1,1555,2443,570,1555,2125
1,1555,2443,570,1555,2125
1,713,1120,329,713,1042
1,713,1120,172,713,885
1,713,1120,261,713,974
1,2171,3578,1335,2171,3506
27,26,70,1150,702,1852
10,26,70,433,260,693
6,3,9,34,18,52
3,8,21,26,24,50
13,13,35,277,169,446
13,13,35,277,169,446
23,2,5,44,46,90
28,2,5,53,56,109
14,2,5,27,28,55
5,1,2,3,5,8
3,1,2,2,3,5
22,1,2,22,22,44
1,1,2,1,1,2
3,1,2,3,3,6
6,1,2,3,6,9
30,1,4,89,30,119
13,1,4,38,13,51
22,1,2,14,22,36
5,1,2,3,5,8
4,2,5,12,8,20
18,2,5,53,36,89
22,1,2,19,22,41
23,2,5,48,46,94
10,2,5,21,20,41
23,1,4,57,23,80
26,2,5,61,52,113
8,2,5,19,16,35
10,1,2,9,10,19
25,2,5,53,50,103
5,13,35,82,65,147
6,13,35,98,78,176
26,1,2,25,26,51
24,2,5,46,48,94
23,2,5,44,46,90
5,2,5,14,10,24
14,2,5,39,28,67
19,2,5,53,38,91
29,1,2,20,29,49
22,1,2,15,22,37
24,1,4,55,24,79
11,1,2,11,11,22
13,1,2,12,13,25
9,1,4,26,9,35
30,1,4,85,30,115
6,1,2,4,6,10
20,1,2,15,20,35
17,1,4,48,17,65
9,1,4,26,9,35
13,9,25,202,117,319
20,1,2,11,20,31
1,461,742,147,461,608
8,4,10,31,32,63
14,4,10,55,56,111
17,2,5,50,34,84
17,2,5,32,34,66
17,2,5,32,34,66
13,2,5,36,26,62
4,2,5,11,8,19
28,2,5,66,56,122
3,2,5,7,6,13
12,2,5,35,24,59
20,2,5,58,40,98
14,2,5,41,28,69
22,2,5,65,44,109
9,2,5,21,18,39
16,7,9,2,112,114
7,7,9,13,49,62
12,7,9,22,84,106
30,3,8,145,90,235
9,8,22,122,72,194
18,8,22,248,144,392
2,8,22,22,16,38
20,8,22,183,160,343
20,8,22,276,160,436
6,9,24,60,54,114
15,9,24,221,135,356
28,9,24,259,252,511
22,9,24,309,198,507
5,13,35,73,65,138
11,13,35,234,143,377
14,13,35,303,182,485
1,13,35,20,13,33
16,13,35,229,208,437
20,13,35,286,260,546
25,13,35,515,325,840
11,13,35,180,143,323
9,13,35,129,117,246
24,13,35,343,312,655
27,13,35,556,351,907
18,13,35,257,234,491
1,13,35,21,13,34
27,13,35,471,351,822
10,21,55,335,210,545
13,21,55,435,273,708
7,21,55,223,147,370
12,38,50,120,456,576
14,42,54,70,588,658
11,42,54,126,462,588
20,38,50,220,760,980
11,38,50,121,418,539
3,42,54,15,126,141
28,38,50,308,1064,1372
28,38,50,308,1064,1372
21,38,50,231,798,1029
1,1912,3400,1046,1912,2958
1,1912,3400,1046,1912,2958
1,1266,2320,1008,1266,2274
1,420,769,341,420,761
1,1266,2320,1031,1266,2297
1,1252,2295,745,1252,1997
1,1252,2295,630,1252,1882
1,1252,2295,997,1252,2249
1,308,565,155,308,463
1,1266,2320,497,1266,1763
1,1266,2320,1008,1266,2274
1,308,565,246,308,554
1,1252,2295,951,1252,2203
1,1555,2443,717,1555,2272
1,2171,3578,620,2171,2791
1,487,783,124,487,611
1,713,1120,385,713,1098
1,1555,2443,570,1555,2125
1,1555,2443,497,1555,2052
1,344,540,174,344,518
1,1083,1701,346,1083,1429
1,2171,3578,1371,2171,3542
1,487,783,171,487,658
1,487,783,194,487,681
1,713,1120,261,713,974
6,26,70,256,156,412
1,26,70,43,26,69
15,26,70,639,390,1029
5,26,70,217,130,347
25,2,5,49,50,99
2,2,5,4,4,8
10,2,5,20,20,40
7,8,21,88,56,144
9,1,2,9,9,18
15,1,2,14,15,29
14,1,2,13,14,27
26,1,2,25,26,51
28,1,2,24,28,52
21,1,2,18,21,39
27,2,5,76,54,130
2,2,5,6,4,10
17,2,5,48,34,82
9,2,5,27,18,45
23,2,5,68,46,114
29,1,2,21,29,50
24,1,2,17,24,41
6,1,2,4,6,10
23,13,35,401,299,700
17,11,30,318,187,505
7,11,30,131,77,208
29,2,5,86,58,144
4,11,29,71,44,115
18,11,29,319,198,517
15,1,4,34,15,49
13,2,5,25,26,51
25,12,33,517,300,817
27,1,2,19,27,46
13,1,2,9,13,22
8,1,2,6,8,14
2,11,30,25,22,47
19,1,2,10,19,29
24,2,5,67,48,115
25,1,4,53,25,78
2,8,21,24,16,40
7,8,21,85,56,141
24,8,21,221,192,413
3,8,21,28,24,52
6,1,2,6,6,12
9,11,30,112,99,211
8,11,30,99,88,187
15,2,5,40,30,70
13,1,4,27,13,40
26,1,2,15,26,41
26,1,2,15,26,41
9,1,2,6,9,15
4,1,2,3,4,7
25,2,5,59,50,109
25,2,5,59,50,109
2,2,5,6,4,10
18,2,5,52,36,88
1,461,742,125,461,586
1,461,742,118,461,579
1,1482,2384,807,1482,2289
1,461,742,229,461,690
1,1482,2384,378,1482,1860
1,1482,2384,854,1482,2336
1,461,742,125,461,586
1,461,742,266,461,727
19,24,64,736,456,1192
6,24,64,236,144,380
2,45,120,145,90,235
3,45,120,178,135,313
5,45,120,369,225,594
7,59,159,466,413,879
20,4,10,84,80,164
15,4,10,63,60,123
16,4,10,75,64,139
27,4,10,127,108,235
27,2,5,51,54,105
28,2,5,78,56,134
25,2,5,70,50,120
17,4,10,65,68,133
26,4,10,99,104,203
3,3,9,14,9,23
4,3,9,19,12,31
28,4,10,162,112,274
13,4,10,75,52,127
28,2,5,64,56,120
1,2,5,3,2,5
12,3,9,71,36,107
7,3,9,41,21,62
18,2,5,42,36,78
1,2,5,2,2,4
17,2,5,40,34,74
24,2,5,56,48,104
4,2,5,9,8,17
6,2,5,14,12,26
4,7,9,0,28,28
3,7,9,5,21,26
5,7,9,4,35,39
8,7,9,13,56,69
29,7,9,55,203,258
28,7,9,11,196,207
24,7,9,44,168,212
10,7,9,16,70,86
5,7,9,0,35,35
3,3,8,11,9,20
18,3,8,71,54,125
15,8,22,203,120,323
15,8,22,141,120,261
9,8,22,122,72,194
2,8,22,20,16,36
7,8,22,95,56,151
9,8,22,122,72,194
18,8,22,248,144,392
19,9,24,185,171,356
30,9,24,356,270,626
17,9,24,202,153,355
25,9,24,297,225,522
17,13,35,267,221,488
13,13,35,277,169,446
30,13,35,471,390,861
22,13,35,315,286,601
2,13,35,29,26,55
20,13,35,433,260,693
10,13,35,143,130,273
26,13,35,408,338,746
20,13,35,426,260,686
15,13,35,320,195,515
20,13,35,426,260,686
17,13,35,267,221,488
18,13,35,390,234,624
22,13,35,345,286,631
28,13,35,577,364,941
1,13,35,17,13,30
26,13,35,472,338,810
24,13,35,419,312,731
6,13,35,94,78,172
17,38,50,196,646,842
27,42,54,134,1134,1268
19,38,50,162,722,884
5,38,50,15,190,205
13,38,50,111,494,605
30,42,54,68,1260,1328
7,42,54,24,294,318
5,38,50,55,190,245
7,42,54,76,294,370
1,1252,2295,722,1252,1974
1,1266,2320,1008,1266,2274
1,1252,2295,630,1252,1882
1,1252,2295,630,1252,1882
1,1252,2295,1020,1252,2272
1,420,769,341,420,761
1,420,769,295,420,715
1,1266,2320,961,1266,2227
1,1266,2320,1031,1266,2297
1,1252,2295,630,1252,1882
1,1266,2320,1008,1266,2274
1,2171,3578,763,2171,2934
1,2171,3578,942,2171,3113
1,487,783,124,487,611
1,1083,1701,584,1083,1667
1,1083,1701,499,1083,1582
1,2171,3578,656,2171,2827
1,487,783,155,487,642
1,344,540,174,344,518
1,1083,1701,397,1083,1480
1,713,1120,261,713,974
1,344,540,126,344,470
14,26,70,606,364,970
26,3,9,154,78,232
18,3,9,79,54,133
6,3,9,32,18,50
16,3,9,93,48,141
30,1,2,22,30,52
21,1,2,16,21,37
1,1,2,1,1,2
1,13,35,22,13,35
23,13,35,498,299,797
4,13,35,87,52,139
5,9,25,54,45,99
26,9,25,280,234,514
11,9,25,118,99,217
18,2,5,35,36,71
28,2,5,55,56,111
11,1,4,25,11,36
28,1,4,64,28,92
17,1,4,39,17,56
10,1,2,7,10,17
5,1,2,4,5,9
9,1,2,5,9,14
16,1,2,9,16,25
4,2,5,12,8,20
11,1,2,11,11,22
7,1,2,7,7,14
10,1,2,10,10,20
10,1,2,10,10,20
5,1,2,4,5,9
1,1,2,1,1,2
17,2,5,49,34,83
22,2,5,64,44,108
8,11,30,150,88,238
25,1,4,71,25,96
11,1,4,31,11,42
11,2,5,32,22,54
19,11,30,236,209,445
10,11,30,124,110,234
12,1,2,9,12,21
5,1,2,4,5,9
12,2,5,28,24,52
19,2,5,44,38,82
16,1,4,45,16,61
1,1,4,3,1,4
30,9,25,450,270,720
24,11,29,307,264,571
8,2,5,23,16,39
8,2,5,23,16,39
13,1,2,8,13,21
5,1,2,3,5,8
1,461,742,162,461,623
1,1482,2384,807,1482,2289
1,755,1215,302,755,1057
1,461,742,185,461,646
1,1482,2384,378,1482,1860
1,1482,2384,378,1482,1860
1,1482,2384,378,1482,1860
13,24,64,512,312,824
3,24,64,93,72,165
8,59,159,787,472,1259
7,59,159,655,413,1068
9,59,159,843,531,1374
7,3,9,34,21,55
14,3,9,68,42,110
8,4,10,37,32,69
17,4,10,100,68,168
9,4,10,53,36,89
12,2,5,35,24,59
5,2,5,15,10,25
3,4,10,17,12,29
2,4,10,12,8,20
26,2,5,57,52,109
20,2,5,44,40,84
30,4,10,177,120,297
2,4,10,12,8,20
15,2,5,42,30,72
3,2,5,8,6,14
25,2,5,73,50,123
26,2,5,75,52,127
3,2,5,9,6,15
25,2,5,74,50,124
20,4,10,116,80,196
20,4,10,116,80,196
16,3,9,93,48,141
27,2,5,78,54,132
25,2,5,73,50,123
14,2,5,37,28,65
11,2,5,29,22,51
24,3,9,105,72,177
17,3,9,74,51,125
29,2,5,81,58,139
22,2,5,62,44,106
3,3,9,12,9,21
5,2,5,11,10,21
12,2,5,26,24,50
10,7,9,7,70,77
14,7,9,12,98,110
15,7,9,25,105,130
17,7,9,31,119,150
6,7,9,11,42,53
16,7,9,26,112,138
30,7,9,55,210,265
18,7,9,10,126,136
14,3,8,55,42,97
21,3,8,81,63,144
26,3,8,126,78,204
16,8,22,210,128,338
25,8,22,339,200,539
20,8,22,183,160,343
24,8,22,262,192,454
19,8,22,258,152,410
6,8,22,63,48,111
17,8,22,231,136,367
24,8,22,325,192,517
7,8,22,92,56,148
1,8,22,10,8,18
23,8,22,256,184,440
18,9,24,261,162,423
7,9,24,103,63,166
26,9,24,290,234,524
2,9,24,24,18,42
9,9,24,133,81,214
30,9,24,356,270,626
1,9,24,10,9,19
12,9,24,174,108,282
2,9,24,20,18,38
16,13,35,234,208,442
30,13,35,618,390,1008
16,13,35,313,208,521
3,13,35,52,39,91
7,13,35,152,91,243
12,13,35,256,156,412
9,13,35,192,117,309
9,13,35,192,117,309
24,13,35,520,312,832
6,13,35,130,78,208
2,13,35,43,26,69
7,13,35,115,91,206
8,13,35,173,104,277
3,13,35,62,39,101
10,13,35,217,130,347
26,13,35,454,338,792
4,13,35,82,52,134
23,13,35,474,299,773
30,13,35,650,390,1040
26,13,35,454,338,792
2,13,35,31,26,57
27,13,35,528,351,879
5,13,35,72,65,137
24,21,55,803,504,1307
19,21,55,500,399,899
29,21,55,635,609,1244
22,38,50,121,836,957
10,42,54,50,420,470
25,42,54,273,1050,1323
7,42,54,35,294,329
23,42,54,251,966,1217
12,42,54,1,504,505
4,42,54,33,168,201
1,1252,2295,951,1252,2203
1,1266,2320,1008,1266,2274
1,420,769,249,420,669
1,1252,2295,997,1252,2249
1,420,769,318,420,738
1,420,769,318,420,738
1,420,769,334,420,754
1,1252,2295,538,1252,1790
1,1266,2320,1008,1266,2274
1,1252,2295,1020,1252,2272
1,2171,3578,1264,2171,3435
1,1519,2443,900,1519,2419
1,2171,3578,942,2171,3113
1,1083,1701,584,1083,1667
1,713,1120,362,713,1075
1,713,1120,396,713,1109
1,1555,2443,864,1555,2419
1,2171,3578,1335,2171,3506
12,26,70,343,312,655
8,26,70,279,208,487
17,3,9,78,51,129
3,2,5,7,6,13
24,1,2,22,24,46
19,1,2,17,19,36
12,13,35,256,156,412
16,13,35,341,208,549
15,2,5,29,30,59
14,2,5,27,28,55
26,13,35,508,338,846
10,13,35,196,130,326
23,2,5,68,46,114
26,13,35,563,338,901
20,13,35,433,260,693
17,1,2,17,17,34
25,1,2,25,25,50
5,1,2,5,5,10
7,9,25,75,63,138
30,1,2,29,30,59
26,1,2,25,26,51
26,1,2,25,26,51
14,13,35,288,182,470
8,13,35,165,104,269
17,2,5,40,34,74
28,1,2,26,28,54
16,1,2,15,16,31
1,1,2,1,1,2
22,2,5,46,44,90
9,1,4,27,9,36
29,1,2,25,29,54
3,1,2,3,3,6
15,9,25,214,135,349
2,9,25,29,18,47
24,2,5,71,48,119
24,2,5,71,48,119
26,1,2,25,26,51
1,2,5,3,2,5
2,1,2,1,2,3
27,1,2,18,27,45
21,1,2,14,21,35
21,2,5,49,42,91
22,1,2,22,22,44
28,1,2,27,28,55
26,8,21,240,208,448
25,2,5,49,50,99
26,2,5,51,52,103
30,1,2,22,30,52
25,1,2,25,25,50
20,1,4,58,20,78
25,1,4,73,25,98
8,1,4,23,8,31
19,11,29,221,209,430
3,11,29,35,33,68
13,2,5,36,26,62
14,2,5,39,28,67
22,2,5,62,44,106
29,1,2,25,29,54
6,1,2,5,6,11
24,8,21,292,192,484
14,8,21,170,112,282
1,1482,2384,807,1482,2289
1,755,1215,266,755,1021
1,755,1215,436,755,1191
1,755,1215,436,755,1191
1,461,742,229,461,690
1,461,742,229,461,690
1,1482,2384,592,1482,2074
18,24,64,467,432,899
1,45,120,49,45,94
1,45,120,70,45,115
3,59,159,290,177,467
5,2,5,15,10,25
21,2,5,61,42,103
26,2,5,51,52,103
11,2,5,21,22,43
24,2,5,71,48,119
4,2,5,12,8,20
29,2,5,61,58,119
15,2,5,32,30,62
25,4,10,145,100,245
26,4,10,151,104,255
16,2,5,34,32,66
28,2,5,59,56,115
8,2,5,17,16,33
5,2,5,11,10,21
10,4,10,58,40,98
30,2,5,89,60,149
15,2,5,44,30,74
15,2,5,29,30,59
17,2,5,48,34,82
23,2,5,64,46,110
17,2,5,40,34,74
26,2,5,61,52,113
18,7,9,33,126,159
1,7,9,2,7,9
6,7,9,0,42,42
27,7,9,44,189,233
8,7,9,0,56,56
23,7,9,42,161,203
11,3,8,43,33,76
25,3,8,99,75,174
12,3,8,58,36,94
16,3,8,53,48,101
29,8,22,393,232,625
27,8,22,253,216,469
7,8,22,96,56,152
3,8,22,41,24,65
6,8,22,67,48,115
16,9,24,236,144,380
8,13,35,170,104,274
26,13,35,563,338,901
2,13,35,43,26,69
16,13,35,346,208,554
2,13,35,29,26,55
3,13,35,65,39,104
8,13,35,170,104,274
29,13,35,628,377,1005
20,13,35,433,260,693
5,13,35,107,65,172
19,13,35,278,247,525
17,13,35,267,221,488
19,13,35,411,247,658
27,13,35,424,351,775
7,13,35,122,91,213
9,13,35,157,117,274
24,13,35,494,312,806
9,13,35,185,117,302
12,13,35,256,156,412
30,13,35,639,390,1029
18,21,55,572,378,950
9,21,55,227,189,416
12,38,50,132,456,588
5,42,54,49,210,259
15,42,54,34,630,664
6,42,54,30,252,282
23,38,50,253,874,1127
4,42,54,44,168,212
3,42,54,33,126,159
23,42,54,251,966,1217
15,38,50,150,570,720
1,1912,3400,1352,1912,3264
1,1266,2320,1008,1266,2274
1,1266,2320,636,1266,1902
1,420,769,341,420,761
1,420,769,341,420,761
1,1266,2320,613,1266,1879
1,1252,2295,997,1252,2249
1,1266,2320,636,1266,1902
1,308,565,155,308,463
1,1266,2320,752,1266,2018
1,295,540,148,295,443
1,2171,3578,1335,2171,3506
1,487,783,108,487,595
1,713,1120,362,713,1075
1,1083,1701,397,1083,1480
1,344,540,174,344,518
1,1555,2443,570,1555,2125
1,1519,2443,900,1519,2419
1,344,540,174,344,518
12,26,70,520,312,832
7,26,70,244,182,426
18,26,70,767,468,1235
18,26,70,515,468,983
16,26,70,682,416,1098
7,26,70,298,182,480
25,3,9,121,75,196
6,3,9,35,18,53
12,3,9,58,36,94
25,1,4,71,25,96
20,1,4,57,20,77
27,2,5,80,54,134
9,2,5,27,18,45
2,2,5,4,4,8
22,2,5,48,44,92
1,11,30,19,11,30
4,1,2,2,4,6
27,1,2,16,27,43
17,2,5,40,34,74
7,2,5,16,14,30
9,2,5,21,18,39
10,2,5,24,20,44
14,2,5,33,28,61
10,2,5,24,20,44
14,2,5,33,28,61
26,2,5,61,52,113
5,8,21,50,40,90
29,1,2,15,29,44
21,1,2,11,21,32
19,13,35,391,247,638
14,13,35,288,182,470
25,9,25,319,225,544
8,9,25,102,72,174
3,1,2,3,3,6
11,1,2,10,11,21
6,1,2,5,6,11
12,1,2,9,12,21
14,1,4,35,14,49
2,1,4,5,2,7
30,2,5,71,60,131
6,2,5,14,12,26
1,2,5,2,2,4
3,2,5,9,6,15
27,2,5,78,54,132
12,1,2,9,12,21
3,1,2,3,3,6
22,1,2,12,22,34
27,11,29,470,297,767
3,11,29,52,33,85
25,1,2,25,25,50
4,1,2,4,4,8
14,1,4,30,14,44
8,2,5,23,16,39
29,9,25,450,261,711
13,2,5,38,26,64
4,2,5,12,8,20
1,1482,2384,878,1482,2360
6,45,120,443,270,713
22,3,9,100,66,166
15,3,9,68,45,113
16,3,9,77,48,125
12,3,9,58,36,94
28,2,5,81,56,137
8,2,5,24,16,40
30,2,5,89,60,149
8,2,5,23,16,39
10,2,5,29,20,49
26,4,10,151,104,255
30,4,10,174,120,294
25,2,5,58,50,108
3,2,5,7,6,13
18,2,5,52,36,88
9,2,5,26,18,44
3,3,9,12,9,21
8,2,5,23,16,39
26,3,9,126,78,204
17,3,9,82,51,133
23,4,10,106,92,198
30,2,5,71,60,131
11,2,5,31,22,53
29,3,9,140,87,227
23,2,5,67,46,113
5,2,5,14,10,24
19,2,5,53,38,91
5,7,9,9,35,44
7,7,9,6,49,55
18,7,9,30,126,156
23,7,9,38,161,199
16,7,9,31,112,143
2,7,9,1,14,15
9,7,9,15,63,78
20,7,9,33,140,173
10,3,8,49,30,79
30,3,8,140,90,230
4,3,8,18,12,30
14,3,8,69,42,111
16,8,22,217,128,345
20,8,22,223,160,383
15,8,22,137,120,257
28,8,22,306,224,530
2,8,22,19,16,35
9,8,22,118,72,190
9,8,22,94,72,166
5,8,22,66,40,106
5,8,22,56,40,96
15,9,24,218,135,353
2,9,24,30,18,48
23,13,35,474,299,773
9,13,35,141,117,258
30,13,35,429,390,819
12,13,35,172,156,328
16,13,35,346,208,554
25,13,35,515,325,840
8,13,35,170,104,274
5,13,35,87,65,152
17,13,35,350,221,571
25,13,35,436,325,761
6,13,35,130,78,208
9,13,35,129,117,246
28,13,35,489,364,853
29,13,35,597,377,974
14,13,35,239,182,421
10,13,35,164,130,294
7,13,35,100,91,191
15,13,35,262,195,457
24,21,55,526,504,1030
4,21,55,105,84,189
15,21,55,494,315,809
29,38,50,290,1102,1392
2,42,54,5,84,89
1,1252,2295,538,1252,1790
1,1266,2320,961,1266,2227
1,1252,2295,722,1252,1974
1,420,769,318,420,738
1,1252,2295,951,1252,2203
1,1266,2320,544,1266,1810
1,1252,2295,745,1252,1997
1,1252,2295,951,1252,2203
1,1266,2320,1008,1266,2274
1,1266,2320,1008,1266,2274
1,1252,2295,951,1252,2203
1,295,540,240,295,535
1,308,565,184,308,492
1,2171,3578,1264,2171,3435
1,2171,3578,1264,2171,3435
1,487,783,265,487,752
1,1555,2443,497,1555,2052
1,713,1120,385,713,1098
1,344,540,174,344,518
1,1083,1701,550,1083,1633
1,344,540,110,344,454
1,344,540,99,344,443
7,26,70,239,182,421
17,26,70,736,442,1178
13,26,70,445,338,783
20,3,9,82,60,142
30,8,21,258,240,498
7,8,21,60,56,116
22,2,5,42,44,86
7,2,5,13,14,27
23,2,5,44,46,90
8,13,35,131,104,235
2,13,35,33,26,59
9,1,2,9,9,18
7,1,2,7,7,14
16,11,30,299,176,475
9,11,30,168,99,267
30,11,30,561,330,891
5,2,5,15,10,25
23,2,5,68,46,114
11,2,5,31,22,53
8,1,2,5,8,13
17,1,2,11,17,28
21,1,2,12,21,33
10,1,2,6,10,16
4,1,2,2,4,6
20,1,2,11,20,31
16,1,2,9,16,25
26,2,5,73,52,125
27,2,5,76,54,130
7,1,4,20,7,27
7,1,4,20,7,27
19,9,25,271,171,442
2,1,2,2,2,4
1,1,2,1,1,2
27,9,25,425,243,668
23,9,25,362,207,569
29,2,5,86,58,144
13,2,5,38,26,64
26,11,30,439,286,725
19,11,30,321,209,530
3,1,4,7,3,10
13,1,4,30,13,43
4,1,4,9,4,13
23,1,2,13,23,36
7,2,5,15,14,29
22,1,4,47,22,69
7,11,30,125,77,202
28,11,30,498,308,806
3,11,30,53,33,86
18,1,4,45,18,63
24,12,33,488,288,776
1,2,5,2,2,4
20,2,5,38,40,78
8,2,5,19,16,35
6,2,5,14,12,26
19,1,2,19,19,38
4,2,5,12,8,20
13,2,5,38,26,64
1,755,1215,436,755,1191
8,24,64,300,192,492
26,24,64,824,624,1448
9,24,64,279,216,495
17,24,64,539,408,947
26,24,64,1007,624,1631
4,59,159,260,236,496
5,59,159,325,295,620
7,2,5,21,14,35
27,3,9,123,81,204
13,3,9,59,39,98
25,2,5,73,50,123
25,2,5,73,50,123
13,2,5,38,26,64
23,3,9,124,69,193
26,3,9,140,78,218
9,2,5,16,18,34
3,2,5,5,6,11
29,2,5,71,58,129
29,2,5,86,58,144
23,2,5,68,46,114
30,4,10,177,120,297
29,4,10,171,116,287
28,2,5,74,56,130
17,2,5,45,34,79
12,4,10,70,48,118
10,2,5,29,20,49
14,2,5,33,28,61
2,2,5,6,4,10
10,2,5,29,20,49
16,2,5,37,32,69
11,2,5,23,22,45
23,2,5,48,46,94
28,2,5,78,56,134
21,2,5,59,42,101
16,4,10,93,64,157
19,2,5,45,38,83
12,2,5,28,24,52
23,2,5,64,46,110
14,2,5,29,28,57
18,2,5,38,36,74
17,2,5,50,34,84
15,2,5,44,30,74
22,2,5,46,44,90
9,2,5,19,18,37
25,3,9,121,75,196
3,3,9,14,9,23
15,7,9,25,105,130
7,7,9,13,49,62
8,7,9,13,56,69
1,7,9,1,7,8
27,7,9,22,189,211
20,7,9,33,140,173
5,7,9,8,35,43
26,7,9,22,182,204
6,7,9,2,42,44
30,3,8,119,90,209
28,3,8,109,84,193
4,3,8,15,12,27
12,3,8,58,36,94
30,8,22,275,240,515
4,8,22,37,32,69
22,8,22,202,176,378
8,8,22,87,64,151
7,8,22,70,56,126
10,8,22,136,80,216
2,8,22,27,16,43
1,9,24,12,9,21
29,9,24,345,261,606
1,9,24,12,9,21
30,9,24,320,270,590
7,9,24,102,63,165
15,13,35,309,195,504
5,13,35,87,65,152
13,13,35,281,169,450
24,13,35,520,312,832
15,13,35,309,195,504
26,13,35,381,338,719
6,13,35,103,78,181
10,13,35,143,130,273
23,13,35,329,299,628
8,13,35,126,104,230
15,13,35,262,195,457
7,13,35,144,91,235
27,13,35,471,351,822
12,13,35,209,156,365
5,13,35,87,65,152
26,13,35,408,338,746
23,13,35,450,299,749
25,13,35,541,325,866
15,13,35,262,195,457
26,13,35,408,338,746
21,13,35,366,273,639
21,13,35,366,273,639
7,13,35,149,91,240
15,13,35,320,195,515
5,13,35,87,65,152
14,13,35,190,182,372
8,13,35,140,104,244
15,21,55,502,315,817
1,21,55,33,21,54
21,21,55,691,441,1132
24,21,55,724,504,1228
2,21,55,66,42,108
1,42,54,11,42,53
6,42,54,30,252,282
19,42,54,43,798,841
12,38,50,132,456,588
22,42,54,110,924,1034
17,38,50,170,646,816
12,42,54,27,504,531
17,42,54,85,714,799
1,1266,2320,799,1266,2065
1,1266,2320,497,1266,1763
1,1266,2320,752,1266,2018
1,1266,2320,1008,1266,2274
1,1266,2320,544,1266,1810
1,1266,2320,1031,1266,2297
1,420,769,211,420,631
1,295,540,175,295,470
1,1252,2295,997,1252,2249
1,420,769,249,420,669
1,1266,2320,1008,1266,2274
1,295,540,234,295,529
1,1252,2295,882,1252,2134
1,420,769,211,420,631
1,1252,2295,997,1252,2249
1,1252,2295,997,1252,2249
1,713,1120,362,713,1075
1,1555,2443,717,1555,2272
1,2171,3578,1157,2171,3328
1,713,1120,205,713,918
1,2171,3578,656,2171,2827
1,1519,2443,606,1519,2125
1,2171,3578,942,2171,3113
1,713,1120,205,713,918
1,2171,3578,763,2171,2934
1,713,1120,205,713,918
1,487,783,155,487,642
1,1555,2443,839,1555,2394
1,713,1120,205,713,918
1,344,540,158,344,502
1,713,1120,362,713,1075
1,344,540,174,344,518
1,344,540,174,344,518
1,713,1120,261,713,974
1,487,783,194,487,681
1,344,540,126,344,470
1,344,540,99,344,443
29,26,70,1012,754,1766
6,1,4,18,6,24
17,1,4,50,17,67
4,1,2,3,4,7
6,1,2,4,6,10
26,2,5,55,52,107
1,2,5,3,2,5
25,2,5,70,50,120
8,2,5,22,16,38
18,2,5,50,36,86
1,1,2,1,1,2
2,2,5,5,4,9
7,2,5,21,14,35
16,2,5,47,32,79
11,1,2,11,11,22
4,1,2,4,4,8
20,2,5,58,40,98
4,2,5,8,8,16
16,2,5,30,32,62
28,2,5,53,56,109
16,12,33,331,192,523
17,2,5,45,34,79
30,1,2,29,30,59
24,1,2,24,24,48
20,9,25,285,180,465
2,1,2,2,2,4
1,1,2,1,1,2
2,1,2,2,2,4
30,1,2,29,30,59
10,1,2,10,10,20
19,1,2,18,19,37
7,2,5,13,14,27
20,2,5,38,40,78
12,2,5,23,24,47
3,13,35,43,39,82
1,13,35,14,13,27
13,1,2,9,13,22
15,1,2,10,15,25
4,1,2,3,4,7
1,2,5,2,2,4
25,2,5,59,50,109
24,2,5,53,48,101
20,8,21,184,160,344
11,1,2,7,11,18
27,11,30,497,297,794
19,9,25,200,171,371
1,9,25,11,9,20
19,1,2,19,19,38
12,2,5,35,24,59
30,12,33,501,360,861
21,12,33,351,252,603
16,8,21,164,128,292
22,2,5,43,44,87
12,2,5,23,24,47
4,1,4,8,4,12
6,1,4,13,6,19
13,1,2,7,13,20
1,755,1215,411,755,1166
1,461,742,162,461,623
1,1482,2384,878,1482,2360
1,1482,2384,592,1482,2074
1,461,742,185,461,646
1,1482,2384,854,1482,2336
1,1482,2384,854,1482,2336
1,1482,2384,854,1482,2336
1,461,742,185,461,646
10,24,64,387,240,627
29,24,64,919,696,1615
9,45,120,502,405,907
10,45,120,738,450,1188
20,2,5,44,40,84
7,4,10,41,28,69
14,4,10,81,56,137
29,2,5,84,58,142
2,2,5,6,4,10
4,2,5,12,8,20
29,2,5,84,58,142
25,3,9,146,75,221
6,3,9,35,18,53
17,2,5,49,34,83
16,2,5,46,32,78
13,2,5,38,26,64
23,2,5,67,46,113
12,2,5,35,24,59
5,2,5,15,10,25
26,7,9,43,182,225
14,7,9,25,98,123
29,7,9,21,203,224
30,7,9,11,210,221
1,7,9,0,7,7
6,3,8,30,18,48
9,3,8,44,27,71
12,3,8,53,36,89
9,3,8,30,27,57
2,3,8,10,6,16
18,8,22,248,144,392
29,8,22,393,232,625
30,8,22,413,240,653
8,8,22,89,64,153
14,8,22,193,112,305
21,9,24,310,189,499
28,9,24,413,252,665
16,9,24,232,144,376
17,9,24,247,153,400
18,9,24,261,162,423
13,9,24,192,117,309
19,13,35,332,247,579
4,13,35,66,52,118
10,13,35,175,130,305
16,13,35,229,208,437
26,13,35,508,338,846
17,13,35,297,221,518
20,13,35,426,260,686
1,13,35,22,13,35
4,13,35,87,52,139
8,13,35,170,104,274
13,13,35,268,169,437
7,13,35,152,91,243
27,13,35,443,351,794
13,21,55,292,273,565
22,21,55,591,462,1053
21,38,50,231,798,1029
26,38,50,143,988,1131
6,42,54,66,252,318
9,42,54,21,378,399
1,1252,2295,1020,1252,2272
1,1266,2320,567,1266,1833
1,420,769,295,420,715
1,420,769,226,420,646
1,1252,2295,997,1252,2249
1,1555,2443,717,1555,2272
1,713,1120,205,713,918
1,487,783,265,487,752
1,344,540,185,344,529
1,713,1120,228,713,941
1,344,540,185,344,529
1,2171,3578,1335,2171,3506
1,2171,3578,1335,2171,3506
30,26,70,1026,780,1806
22,26,70,629,572,1201
28,26,70,1212,728,1940
14,3,9,81,42,123
5,1,2,5,5,10
23,1,2,23,23,46
26,13,35,554,338,892
10,12,33,197,120,317
11,9,25,173,99,272
11,9,25,173,99,272
28,2,5,83,56,139
26,1,2,22,26,48
13,1,2,11,13,24
27,1,2,23,27,50
5,13,35,87,65,152
7,1,2,5,7,12
18,1,2,17,18,35
12,1,2,11,12,23
19,2,5,55,38,93
30,2,5,87,60,147
17,12,33,284,204,488
26,12,33,434,312,746
17,12,33,284,204,488
2,1,2,2,2,4
7,1,2,5,7,12
10,1,2,7,10,17
8,1,2,6,8,14
27,2,5,80,54,134
13,2,5,38,26,64
30,2,5,63,60,123
14,2,5,29,28,57
12,2,5,25,24,49
13,1,2,9,13,22
23,2,5,67,46,113
26,2,5,75,52,127
27,8,21,340,216,556
27,2,5,78,54,132
12,2,5,35,24,59
1,1,2,1,1,2
28,1,4,82,28,110
18,1,4,53,18,71
4,1,2,3,4,7
13,1,2,7,13,20
5,11,29,87,55,142
19,11,29,331,209,540
25,8,21,304,200,504
26,8,21,316,208,524
6,8,21,73,48,121
18,8,21,155,144,299
30,8,21,258,240,498
28,2,5,81,56,137
22,2,5,64,44,108
16,2,5,46,32,78
12,8,21,151,96,247
9,2,5,26,18,44
22,2,5,64,44,108
12,2,5,35,24,59
7,2,5,20,14,34
28,8,21,352,224,576
11,1,2,6,11,17
30,1,2,17,30,47
1,461,742,185,461,646
26,24,64,1007,624,1631
12,45,120,871,540,1411
19,45,120,1015,855,1870
2,45,120,145,90,235
2,59,159,143,118,261
23,3,9,111,69,180
15,3,9,72,45,117
11,2,5,21,22,43
20,2,5,38,40,78
8,4,10,45,32,77
26,4,10,146,104,250
7,2,5,20,14,34
14,2,5,39,28,67
6,2,5,14,12,26
6,2,5,14,12,26
18,2,5,52,36,88
25,2,5,73,50,123
25,2,5,61,50,111
4,2,5,10,8,18
17,2,5,32,34,66
4,2,5,8,8,16
19,2,5,44,38,82
6,2,5,14,12,26
24,2,5,67,48,115
19,2,5,53,38,91
29,2,5,68,58,126
7,2,5,16,14,30
11,2,5,26,22,48
1,2,5,2,2,4
27,2,5,76,54,130
18,2,5,42,36,78
16,7,9,29,112,141
9,7,9,16,63,79
22,7,9,30,154,184
17,7,9,0,119,119
12,7,9,16,84,100
28,7,9,3,196,199
13,7,9,24,91,115
10,7,9,6,70,76
13,7,9,24,91,115
12,3,8,48,36,84
29,8,22,393,232,625
8,8,22,73,64,137
9,8,22,98,72,170
5,8,22,66,40,106
4,8,22,45,32,77
1,8,22,10,8,18
9,8,22,124,72,196
30,8,22,413,240,653
28,9,24,279,252,531
11,9,24,154,99,253
27,13,35,471,351,822
6,13,35,105,78,183
1,13,35,17,13,30
20,13,35,426,260,686
5,13,35,107,65,172
27,13,35,585,351,936
27,13,35,556,351,907
5,13,35,108,65,173
3,13,35,47,39,86
19,13,35,391,247,638
12,13,35,205,156,361
3,13,35,59,39,98
16,13,35,330,208,538
28,13,35,489,364,853
7,21,55,234,147,381
12,21,55,395,252,647
15,21,55,403,315,718
16,38,50,136,608,744
7,42,54,69,294,363
10,38,50,115,380,495
1,38,50,12,38,50
26,42,54,284,1092,1376
1,38,50,5,38,43
13,38,50,52,494,546
11,38,50,121,418,539
1,1252,2295,997,1252,2249
1,1252,2295,997,1252,2249
1,1266,2320,1008,1266,2274
1,1266,2320,961,1266,2227
1,1252,2295,745,1252,1997
1,1266,2320,544,1266,1810
1,1266,2320,1008,1266,2274
1,1252,2295,997,1252,2249
1,420,769,334,420,754
1,295,540,240,295,535
1,1266,2320,961,1266,2227
1,1266,2320,799,1266,2065
1,420,769,211,420,631
1,420,769,211,420,631
1,2171,3578,1335,2171,3506
1,1555,2443,790,1555,2345
1,1555,2443,790,1555,2345
1,1555,2443,375,1555,1930
1,1519,2443,411,1519,1930
1,2171,3578,620,2171,2791
1,1555,2443,497,1555,2052
1,1555,2443,570,1555,2125
1,344,540,174,344,518
1,344,540,99,344,443
1,2171,3578,1335,2171,3506
22,26,70,937,572,1509
12,26,70,511,312,823
28,26,70,1193,728,1921
5,26,70,213,130,343
9,26,70,383,234,617
2,26,70,59,52,111
25,26,70,785,650,1435
15,3,9,85,45,130
9,3,9,53,27,80
26,3,9,154,78,232
21,1,2,20,21,41
16,2,5,34,32,66
15,2,5,32,30,62
6,1,4,17,6,23
23,1,4,65,23,88
23,1,4,65,23,88
6,2,5,13,12,25
7,1,2,5,7,12
18,1,2,13,18,31
20,13,35,433,260,693
23,13,35,498,299,797
17,1,2,16,17,33
8,1,2,8,8,16
11,1,4,33,11,44
20,1,4,59,20,79
29,1,2,21,29,50
18,1,2,17,18,35
29,1,2,28,29,57
15,1,2,14,15,29
29,2,5,55,58,113
10,2,5,19,20,39
30,2,5,57,60,117
26,2,5,55,52,107
23,2,5,48,46,94
6,1,2,6,6,12
1,1,4,2,1,3
16,1,4,36,16,52
13,2,5,38,26,64
27,1,2,16,27,43
7,1,2,4,7,11
19,1,2,12,19,31
10,9,25,150,90,240
6,1,4,16,6,22
14,1,4,38,14,52
6,2,5,14,12,26
1,1,4,2,1,3
30,1,4,68,30,98
14,8,21,176,112,288
4,9,25,62,36,98
10,2,5,29,20,49
26,2,5,75,52,127
5,2,5,15,10,25
1,1482,2384,592,1482,2074
1,461,742,251,461,712
1,461,742,251,461,712
1,1482,2384,807,1482,2289
1,1482,2384,807,1482,2289
1,755,1215,448,755,1203
1,461,742,229,461,690
1,1482,2384,854,1482,2336
1,1482,2384,592,1482,2074
3,24,64,112,72,184
17,45,120,1234,765,1999
16,45,120,950,720,1670
10,45,120,666,450,1116
4,59,159,317,236,553
4,59,159,394,236,630
16,2,5,31,32,63
1,3,9,4,3,7
6,3,9,26,18,44
14,2,5,41,28,69
4,2,5,12,8,20
22,4,10,130,88,218
16,4,10,94,64,158
21,2,5,59,42,101
5,2,5,14,10,24
4,2,5,11,8,19
15,2,5,42,30,72
19,2,5,55,38,93
25,2,5,73,50,123
18,3,9,105,54,159
24,3,9,140,72,212
14,2,5,41,28,69
8,2,5,23,16,39
27,2,5,78,54,132
11,2,5,32,22,54
30,2,5,57,60,117
21,2,5,40,42,82
23,2,5,54,46,100
17,2,5,40,34,74
11,2,5,32,22,54
22,2,5,65,44,109
16,3,9,90,48,138
16,3,9,90,48,138
5,2,5,14,10,24
4,2,5,11,8,19
14,3,9,64,42,106
24,3,9,109,72,181
9,7,9,17,63,80
7,7,9,11,49,60
21,7,9,40,147,187
21,7,9,40,147,187
13,7,9,21,91,112
6,7,9,11,42,53
18,7,9,33,126,159
28,7,9,3,196,199
10,7,9,19,70,89
18,7,9,18,126,144
17,3,8,66,51,117
6,8,22,83,48,131
2,8,22,27,16,43
3,9,24,44,27,71
7,9,24,78,63,141
21,9,24,204,189,393
28,9,24,407,252,659
26,9,24,309,234,543
15,13,35,246,195,441
10,13,35,213,130,343
12,13,35,209,156,365
15,13,35,257,195,452
26,13,35,563,338,901
14,13,35,288,182,470
12,13,35,172,156,328
16,13,35,279,208,487
17,13,35,362,221,583
30,13,35,639,390,1029
9,13,35,192,117,309
20,13,35,286,260,546
4,13,35,70,52,122
12,13,35,256,156,412
27,13,35,575,351,926
7,13,35,149,91,240
24,13,35,511,312,823
26,13,35,536,338,874
16,13,35,251,208,459
20,13,35,391,260,651
27,13,35,490,351,841
3,13,35,62,39,101
4,13,35,82,52,134
19,21,55,625,399,1024
10,38,50,100,380,480
30,38,50,345,1140,1485
22,38,50,220,836,1056
29,38,50,87,1102,1189
6,42,54,69,252,321
5,42,54,3,210,213
10,38,50,110,380,490
7,38,50,77,266,343
11,38,50,110,418,528
12,38,50,132,456,588
1,1252,2295,951,1252,2203
1,1252,2295,561,1252,1813
1,1266,2320,1031,1266,2297
1,1266,2320,961,1266,2227
1,1266,2320,1031,1266,2297
1,308,565,184,308,492
1,295,540,126,295,421
1,1252,2295,882,1252,2134
1,1252,2295,997,1252,2249
1,487,783,280,487,767
1,344,540,185,344,529
1,1555,2443,790,1555,2345
1,1083,1701,584,1083,1667
1,344,540,120,344,464
1,2171,3578,763,2171,2934
1,713,1120,385,713,1098
1,1555,2443,375,1555,1930
1,344,540,126,344,470
1,713,1120,172,713,885
1,713,1120,396,713,1109
1,713,1120,362,713,1075
1,713,1120,362,713,1075
30,26,70,1299,780,2079
18,26,70,779,468,1247
21,26,70,895,546,1441
30,26,70,858,780,1638
9,3,9,52,27,79
17,8,21,214,136,350
15,8,21,189,120,309
13,1,2,7,13,20
5,1,2,3,5,8
6,1,2,4,6,10
16,13,35,341,208,549
10,13,35,213,130,343
30,13,35,639,390,1029
28,2,5,66,56,122
7,2,5,16,14,30
19,2,5,37,38,75
6,13,35,128,78,206
7,13,35,149,91,240
23,13,35,401,299,700
23,13,35,401,299,700
25,11,29,356,275,631
2,1,2,2,2,4
3,2,5,6,6,12
21,2,5,48,42,90
6,1,2,4,6,10
1,1,2,1,1,2
27,1,2,17,27,44
14,1,2,13,14,27
28,1,2,26,28,54
17,1,2,10,17,27
24,1,2,14,24,38
5,11,30,76,55,131
10,11,30,151,110,261
15,11,30,227,165,392
15,11,30,276,165,441
12,11,30,221,132,353
23,1,2,23,23,46
16,1,2,16,16,32
11,1,4,31,11,42
10,1,4,28,10,38
28,2,5,83,56,139
19,2,5,56,38,94
22,8,21,203,176,379
15,8,21,138,120,258
9,2,5,24,18,42
29,1,4,66,29,95
1,2,5,2,2,4
1,2,5,2,2,4
15,2,5,35,30,65
14,1,2,10,14,24
1,1,2,1,1,2
11,1,4,32,11,43
20,1,4,58,20,78
10,1,4,29,10,39
20,1,2,14,20,34
17,1,2,12,17,29
29,1,2,21,29,50
27,2,5,78,54,132
19,1,2,19,19,38
27,1,2,26,27,53
24,1,4,68,24,92
18,1,4,51,18,69
1,1482,2384,401,1482,1883
1,461,742,147,461,608
1,1482,2384,521,1482,2003
1,461,742,251,461,712
1,1482,2384,473,1482,1955
1,1482,2384,854,1482,2336
1,1482,2384,854,1482,2336
1,1482,2384,640,1482,2122
1,1482,2384,854,1482,2336
1,1482,2384,592,1482,2074
1,755,1215,411,755,1166
2,24,64,77,48,125
16,24,64,630,384,1014
5,45,120,369,225,594
4,45,120,290,180,470
10,3,9,56,30,86
29,3,9,164,87,251
24,4,10,127,96,223
18,4,10,95,72,167
20,3,9,88,60,148
10,3,9,44,30,74
8,4,10,30,32,62
13,2,5,38,26,64
1,2,5,3,2,5
4,2,5,12,8,20
23,4,10,106,92,198
30,4,10,138,120,258
16,2,5,46,32,78
14,2,5,41,28,69
21,2,5,62,42,104
21,2,5,62,42,104
21,4,10,80,84,164
14,4,10,53,56,109
5,4,10,27,20,47
16,4,10,85,64,149
1,4,10,4,4,8
2,4,10,9,8,17
30,2,5,87,60,147
11,2,5,32,22,54
28,2,5,83,56,139
14,2,5,41,28,69
23,4,10,108,92,200
10,2,5,28,20,48
13,2,5,36,26,62
9,2,5,27,18,45
7,2,5,21,14,35
25,2,5,73,50,123
26,2,5,75,52,127
25,7,9,46,175,221
16,7,9,29,112,141
28,7,9,23,196,219
15,7,9,21,105,126
27,7,9,8,189,197
16,7,9,13,112,125
23,7,9,0,161,161
19,7,9,26,133,159
2,7,9,4,14,18
12,7,9,0,84,84
15,8,22,203,120,323
10,8,22,136,80,216
26,8,22,238,208,446
9,8,22,124,72,196
14,8,22,131,112,243
5,8,22,56,40,96
8,9,24,93,72,165
27,9,24,360,243,603
7,9,24,98,63,161
9,9,24,131,81,212
27,9,24,321,243,564
7,9,24,103,63,166
9,13,35,157,117,274
24,13,35,469,312,781
19,13,35,298,247,545
1,13,35,22,13,35
12,13,35,260,156,416
13,13,35,204,169,373
20,13,35,293,260,553
23,13,35,401,299,700
2,13,35,43,26,69
30,13,35,639,390,1029
18,13,35,390,234,624
18,13,35,383,234,617
10,13,35,213,130,343
8,13,35,140,104,244
1,13,35,20,13,33
22,13,35,453,286,739
24,13,35,494,312,806
24,13,35,520,312,832
14,13,35,298,182,480
4,13,35,85,52,137
22,13,35,315,286,601
15,13,35,236,195,431
30,13,35,587,390,977
13,13,35,222,169,391
15,21,55,337,315,652
17,21,55,428,357,785
8,38,50,80,304,384
5,42,54,25,210,235
17,42,54,195,714,909
30,42,54,344,1260,1604
6,38,50,69,228,297
1,1252,2295,882,1252,2134
1,1252,2295,561,1252,1813
1,1266,2320,752,1266,2018
1,1252,2295,997,1252,2249
1,420,769,334,420,754
1,1266,2320,636,1266,1902
1,420,769,318,420,738
1,308,565,251,308,559
1,1266,2320,752,1266,2018
1,1252,2295,630,1252,1882
1,295,540,234,295,529
1,1266,2320,892,1266,2158
1,1898,3375,735,1898,2633
1,1252,2295,997,1252,2249
1,2171,3578,1157,2171,3328
1,2171,3578,1264,2171,3435
1,487,783,124,487,611
1,2171,3578,1264,2171,3435
1,1555,2443,839,1555,2394
1,2171,3578,942,2171,3113
1,487,783,155,487,642
1,2171,3578,835,2171,3006
1,487,783,265,487,752
1,713,1120,261,713,974
1,487,783,194,487,681
1,487,783,194,487,681
1,344,540,110,344,454
1,2171,3578,906,2171,3077
25,26,70,1065,650,1715
29,26,70,1256,754,2010
11,3,9,59,33,92
27,3,9,157,81,238
23,3,9,101,69,170
4,2,5,9,8,17
12,2,5,28,24,52
21,9,25,268,189,457
7,9,25,89,63,152
11,9,25,140,99,239
29,1,2,16,29,45
3,1,2,2,3,5
16,2,5,42,32,74
1,1,2,1,1,2
19,1,2,14,19,33
15,1,2,11,15,26
11,2,5,32,22,54
13,2,5,38,26,64
11,1,2,11,11,22
5,1,2,5,5,10
1,2,5,3,2,5
4,2,5,12,8,20
9,2,5,26,18,44
9,2,5,21,18,39
4,2,5,9,8,17
9,9,25,142,81,223
20,1,2,12,20,32
17,1,2,10,17,27
29,1,2,21,29,50
13,2,5,38,26,64
20,11,30,368,220,588
24,11,30,442,264,706
25,1,4,71,25,96
22,1,4,62,22,84
23,1,2,20,23,43
4,1,2,3,4,7
6,1,4,16,6,22
24,1,4,65,24,89
4,1,4,11,4,15
18,1,2,17,18,35
21,1,2,19,21,40
21,2,5,44,42,86
23,11,29,367,253,620
5,1,2,3,5,8
27,1,2,15,27,42
14,1,2,8,14,22
24,1,2,13,24,37
7,1,2,4,7,11
4,11,30,50,44,94
12,11,30,149,132,281
4,1,2,3,4,7
15,1,2,10,15,25
27,1,2,18,27,45
15,1,2,11,15,26
3,1,2,2,3,5
19,2,5,55,38,93
14,2,5,41,28,69
16,2,5,46,32,78
22,1,4,64,22,86
2,1,4,6,2,8
30,2,5,57,60,117
30,2,5,57,60,117
4,2,5,12,8,20
20,2,5,59,40,99
11,1,4,32,11,43
1,1482,2384,592,1482,2074
1,755,1215,411,755,1166
1,755,1215,411,755,1166
1,1482,2384,807,1482,2289
1,1482,2384,473,1482,1955
1,1482,2384,878,1482,2360
1,755,1215,193,755,948
1,755,1215,436,755,1191
1,755,1215,241,755,996
1,755,1215,436,755,1191
25,24,64,936,600,1536
16,24,64,620,384,1004
12,24,64,380,288,668
2,45,120,140,90,230
13,45,120,944,585,1529
16,4,10,74,64,138
22,2,5,43,44,87
13,2,5,38,26,64
19,2,5,56,38,94
18,4,10,106,72,178
11,2,5,32,22,54
7,2,5,20,14,34
7,2,5,20,14,34
15,2,5,44,30,74
14,2,5,41,28,69
14,2,5,33,28,61
14,2,5,39,28,67
17,2,5,48,34,82
15,2,5,42,30,72
18,2,5,50,36,86
7,2,5,20,14,34
3,2,5,9,6,15
3,2,5,9,6,15
3,2,5,9,6,15
24,2,5,70,48,118
4,7,9,8,28,36
24,7,9,39,168,207
27,7,9,52,189,241
11,8,22,101,88,189
16,8,22,178,128,306
10,8,22,138,80,218
3,8,22,41,24,65
1,8,22,13,8,21
27,9,24,399,243,642
18,9,24,261,162,423
7,9,24,103,63,166
23,9,24,334,207,541
17,9,24,198,153,351
14,9,24,163,126,289
4,13,35,85,52,137
11,13,35,157,143,300
1,13,35,21,13,34
20,13,35,328,260,588
24,13,35,343,312,655
17,13,35,243,221,464
18,13,35,390,234,624
21,13,35,455,273,728
13,13,35,222,169,391
17,13,35,368,221,589
30,13,35,618,390,1008
6,13,35,88,78,166
25,13,35,428,325,753
29,13,35,455,377,832
7,13,35,122,91,213
22,13,35,469,286,755
4,13,35,85,52,137
20,13,35,412,260,672
1,13,35,21,13,34
14,13,35,244,182,426
12,13,35,188,156,344
20,13,35,314,260,574
2,13,35,34,26,60
23,13,35,490,299,789
21,13,35,300,273,573
8,42,54,87,336,423
8,42,54,87,336,423
4,38,50,4,152,156
18,38,50,198,684,882
27,42,54,62,1134,1196
17,38,50,170,646,816
1,1912,3400,1046,1912,2958
1,1266,2320,497,1266,1763
1,1252,2295,951,1252,2203
1,1266,2320,544,1266,1810
1,1266,2320,729,1266,1995
1,1252,2295,561,1252,1813
1,420,769,334,420,754
1,420,769,334,420,754
1,1266,2320,1031,1266,2297
1,295,540,240,295,535
1,308,565,234,308,542
1,1083,1701,550,1083,1633
1,2171,3578,1371,2171,3542
1,487,783,124,487,611
1,1083,1701,244,1083,1327
1,713,1120,250,713,963
1,713,1120,205,713,918
1,1083,1701,312,1083,1395
1,344,540,174,344,518
1,344,540,174,344,518
1,713,1120,329,713,1042
1,344,540,174,344,518
1,487,783,171,487,658
1,1555,2443,864,1555,2419
1,344,540,174,344,518
16,26,70,682,416,1098
28,3,9,135,84,219
26,1,2,25,26,51
13,1,2,12,13,25
6,1,2,6,6,12
25,1,2,25,25,50
22,1,2,16,22,38
7,1,2,5,7,12
27,1,2,19,27,46
29,1,2,21,29,50
30,1,2,22,30,52
9,1,2,5,9,14
22,1,2,11,22,33
15,1,2,8,15,23
22,1,2,16,22,38
15,1,2,11,15,26
24,2,5,71,48,119
17,2,5,50,34,84
4,2,5,12,8,20
18,11,29,256,198,454
11,11,29,157,121,278
1,2,5,2,2,4
1,2,5,2,2,4
8,2,5,19,16,35
7,1,2,5,7,12
8,2,5,23,16,39
14,2,5,41,28,69
28,2,5,83,56,139
20,1,4,50,20,70
21,1,2,14,21,35
30,12,33,620,360,980
19,2,5,55,38,93
3,2,5,9,6,15
10,8,21,101,80,181
22,1,2,16,22,38
25,1,2,23,25,48
4,1,2,4,4,8
4,13,35,59,52,111
24,1,2,18,24,42
16,1,2,12,16,28
21,2,5,44,42,86
19,2,5,40,38,78
17,1,2,12,17,29
13,1,2,9,13,22
8,1,2,5,8,13
18,2,5,52,36,88
8,2,5,23,16,39
30,1,4,68,30,98
5,1,4,12,5,17
16,12,33,299,192,491
26,12,33,486,312,798
14,1,2,13,14,27
27,1,2,25,27,52
27,1,2,25,27,52
9,2,5,17,18,35
15,2,5,44,30,74
9,1,2,5,9,14
13,1,2,8,13,21
20,2,5,44,40,84
4,1,2,2,4,6
1,1482,2384,592,1482,2074
1,461,742,147,461,608
1,1482,2384,807,1482,2289
1,1482,2384,854,1482,2336
1,755,1215,436,755,1191
1,1482,2384,378,1482,1860
1,461,742,266,461,727
1,461,742,266,461,727
28,24,64,1102,672,1774
6,45,120,436,270,706
17,3,9,100,51,151
27,2,5,49,54,103
1,2,5,2,2,4
29,3,9,169,87,256
11,2,5,26,22,48
13,2,5,31,26,57
29,2,5,68,58,126
2,2,5,5,4,9
15,2,5,44,30,74
12,2,5,35,24,59
8,2,5,22,16,38
30,2,5,84,60,144
29,2,5,55,58,113
23,2,5,44,46,90
24,3,9,135,72,207
12,3,9,57,36,93
15,3,9,71,45,116
25,2,5,59,50,109
15,2,5,35,30,65
12,2,5,35,24,59
6,2,5,17,12,29
13,2,5,31,26,57
13,2,5,31,26,57
7,3,9,28,21,49
12,3,9,58,36,94
20,3,9,97,60,157
6,3,9,29,18,47
28,3,9,135,84,219
27,7,9,20,189,209
16,7,9,22,112,134
28,7,9,1,196,197
15,7,9,25,105,130
19,7,9,16,133,149
20,7,9,38,140,178
28,7,9,46,196,242
28,3,8,93,84,177
14,3,8,50,42,92
4,3,8,15,12,27
3,3,8,15,9,24
26,3,8,103,78,181
29,3,8,94,87,181
16,3,8,52,48,100
22,8,22,298,176,474
26,8,22,353,208,561
9,8,22,78,72,150
8,8,22,105,64,169
16,8,22,168,128,296
18,8,22,169,144,313
24,9,24,348,216,564
8,9,24,112,72,184
3,9,24,36,27,63
12,9,24,174,108,282
25,9,24,363,225,588
21,13,35,366,273,639
22,13,35,453,286,739
14,13,35,274,182,456
24,13,35,520,312,832
23,13,35,474,299,773
10,13,35,175,130,305
14,13,35,244,182,426
27,13,35,471,351,822
27,13,35,528,351,879
20,13,35,391,260,651
14,13,35,274,182,456
14,13,35,244,182,426
20,13,35,412,260,672
24,13,35,520,312,832
11,13,35,227,143,370
11,13,35,234,143,377
17,13,35,267,221,488
5,13,35,108,65,173
9,13,35,148,117,265
24,13,35,511,312,823
29,13,35,415,377,792
21,21,55,668,441,1109
8,21,55,180,168,348
27,21,55,591,567,1158
23,38,50,265,874,1139
21,38,50,210,798,1008
5,38,50,55,190,245
6,38,50,51,228,279
11,38,50,127,418,545
7,38,50,39,266,305
10,42,54,1,420,421
16,38,50,88,608,696
25,42,54,57,1050,1107
1,1898,3375,937,1898,2835
1,1252,2295,538,1252,1790
1,1266,2320,961,1266,2227
1,1266,2320,636,1266,1902
1,1266,2320,683,1266,1949
1,420,769,318,420,738
1,420,769,318,420,738
1,1252,2295,882,1252,2134
1,420,769,249,420,669
1,1252,2295,997,1252,2249
1,1266,2320,961,1266,2227
1,713,1120,161,713,874
1,2171,3578,1371,2171,3542
1,1555,2443,790,1555,2345
1,2171,3578,656,2171,2827
1,1555,2443,570,1555,2125
1,344,540,158,344,502
1,1083,1701,601,1083,1684
1,1083,1701,499,1083,1582
1,713,1120,138,713,851
1,713,1120,261,713,974
1,487,783,194,487,681
1,1555,2443,864,1555,2419
13,26,70,536,338,874
7,26,70,200,182,382
18,26,70,565,468,1033
22,3,9,124,66,190
17,3,9,99,51,150
14,11,29,179,154,333
21,11,29,268,231,499
29,11,29,371,319,690
18,12,33,271,216,487
12,12,33,181,144,325
24,12,33,361,288,649
20,1,2,13,20,33
12,11,29,213,132,345
29,11,29,514,319,833
17,2,5,49,34,83
17,2,5,50,34,84
20,2,5,59,40,99
9,2,5,18,18,36
19,2,5,37,38,75
12,2,5,34,24,58
9,2,5,25,18,43
17,2,5,36,34,70
6,2,5,14,12,26
20,2,5,47,40,87
9,9,25,142,81,223
11,9,25,173,99,272
20,1,4,50,20,70
7,1,4,17,7,24
22,1,2,15,22,37
18,1,2,12,18,30
16,8,21,164,128,292
22,8,21,226,176,402
28,8,21,288,224,512
21,8,21,216,168,384
11,8,21,113,88,201
22,1,4,64,22,86
28,1,4,82,28,110
4,2,5,8,8,16
23,2,5,44,46,90
1,2,5,2,2,4
12,11,30,149,132,281
4,11,30,50,44,94
18,11,30,331,198,529
3,11,30,55,33,88
13,2,5,38,26,64
7,12,33,96,84,180
6,1,2,6,6,12
30,1,2,29,30,59
26,1,2,14,26,40
14,1,2,7,14,21
11,1,2,6,11,17
5,1,2,3,5,8
3,1,2,2,3,5
1,1482,2384,592,1482,2074
1,1482,2384,592,1482,2074
1,1482,2384,592,1482,2074
1,755,1215,375,755,1130
1,461,742,147,461,608
1,755,1215,205,755,960
1,461,742,229,461,690
15,24,64,475,360,835
18,45,120,1307,810,2117
1,59,159,97,59,156
25,2,5,74,50,124
20,2,5,58,40,98
3,2,5,9,6,15
19,2,5,55,38,93
5,2,5,10,10,20
23,2,5,44,46,90
23,2,5,44,46,90
9,2,5,17,18,35
9,2,5,27,18,45
30,2,5,89,60,149
23,3,9,92,69,161
26,3,9,105,78,183
28,4,10,162,112,274
15,2,5,44,30,74
22,2,5,52,44,96
18,2,5,42,36,78
25,2,5,59,50,109
15,2,5,35,30,65
28,2,5,81,56,137
10,7,9,8,70,78
18,7,9,10,126,136
5,7,9,8,35,43
3,7,9,0,21,21
23,7,9,42,161,203
11,7,9,0,77,77
11,7,9,18,77,95
7,3,8,34,21,55
4,3,8,15,12,27
19,3,8,92,57,149
13,3,8,42,39,81
3,3,8,11,9,20
4,3,8,13,12,25
5,3,8,20,15,35
5,3,8,24,15,39
6,8,22,81,48,129
20,8,22,188,160,348
19,8,22,249,152,401
8,8,22,110,64,174
18,8,22,248,144,392
13,9,24,189,117,306
6,9,24,60,54,114
15,9,24,146,135,281
10,9,24,145,90,235
15,9,24,200,135,335
4,13,35,85,52,137
2,13,35,43,26,69
1,13,35,21,13,34
7,13,35,100,91,191
3,13,35,65,39,104
28,13,35,547,364,911
29,13,35,425,377,802
3,13,35,43,39,82
24,13,35,419,312,731
6,13,35,128,78,206
15,13,35,320,195,515
18,13,35,383,234,617
27,13,35,443,351,794
11,13,35,150,143,293
24,13,35,511,312,823
29,13,35,425,377,802
26,13,35,372,338,710
1,13,35,17,13,30
12,13,35,205,156,361
6,21,55,201,126,327
25,21,55,836,525,1361
21,21,55,529,441,970
7,38,50,77,266,343
8,38,50,80,304,384
6,38,50,18,228,246
5,38,50,58,190,248
22,38,50,88,836,924
1,42,54,11,42,53
27,42,54,62,1134,1196
1,1266,2320,1008,1266,2274
1,1266,2320,1031,1266,2297
1,420,769,334,420,754
1,1252,2295,1020,1252,2272
1,1252,2295,676,1252,1928
1,295,540,240,295,535
1,1252,2295,997,1252,2249
1,1266,2320,544,1266,1810
1,295,540,126,295,421
1,295,540,126,295,421
1,1266,2320,961,1266,2227
1,295,540,234,295,529
1,295,540,240,295,535
1,1252,2295,538,1252,1790
1,487,783,280,487,767
1,1083,1701,397,1083,1480
1,2171,3578,942,2171,3113
1,713,1120,261,713,974
1,344,540,77,344,421
1,1555,2443,497,1555,2052
1,344,540,77,344,421
1,713,1120,362,713,1075
1,487,783,132,487,619
1,2171,3578,1335,2171,3506
27,26,70,1112,702,1814
27,26,70,1150,702,1852
18,26,70,767,468,1235
2,26,70,63,52,115
12,1,2,7,12,19
10,1,2,6,10,16
28,9,25,441,252,693
22,9,25,347,198,545
25,1,2,24,25,49
4,1,2,4,4,8
14,1,2,13,14,27
7,13,35,149,91,240
15,13,35,320,195,515
7,1,4,21,7,28
12,1,4,36,12,48
7,1,4,21,7,28
5,1,2,4,5,9
21,1,2,18,21,39
23,2,5,54,46,100
28,2,5,83,56,139
7,2,5,21,14,35
26,1,2,25,26,51
24,1,2,23,24,47
1,2,5,3,2,5
1,2,5,3,2,5
13,1,2,13,13,26
18,1,2,18,18,36
30,2,5,57,60,117
21,2,5,56,42,98
12,2,5,32,24,56
6,1,2,3,6,9
15,1,2,9,15,24
11,13,35,157,143,300
16,13,35,229,208,437
6,1,2,3,6,9
24,1,2,14,24,38
4,13,35,82,52,134
20,1,4,47,20,67
18,1,4,42,18,60
15,1,2,8,15,23
26,1,2,14,26,40
4,1,2,4,4,8
22,1,2,20,22,42
15,2,5,44,30,74
3,2,5,9,6,15
13,2,5,38,26,64
14,2,5,41,28,69
5,2,5,15,10,25
9,11,30,133,99,232
8,11,30,118,88,206
30,12,33,412,360,772
9,12,33,124,108,232
14,2,5,39,28,67
3,2,5,8,6,14
21,2,5,59,42,101
29,1,4,71,29,100
1,1,4,2,1,3
15,2,5,35,30,65
24,1,2,13,24,37
23,1,2,13,23,36
4,1,4,12,4,16
18,1,4,53,18,71
9,1,4,26,9,35
18,1,2,17,18,35
18,1,2,17,18,35
2,1,2,2,2,4
8,11,29,128,88,216
27,11,29,431,297,728
23,11,29,367,253,620
21,2,5,48,42,90
14,2,5,32,28,60
21,1,4,61,21,82
7,1,4,20,7,27
1,461,742,185,461,646
1,461,742,251,461,712
1,461,742,229,461,690
1,755,1215,241,755,996
1,24,64,26,24,50
5,45,120,363,225,588
14,2,5,34,28,62
25,2,5,73,50,123
15,2,5,44,30,74
30,2,5,57,60,117
1,2,5,3,2,5
6,2,5,18,12,30
28,2,5,64,56,120
28,2,5,81,56,137
24,2,5,70,48,118
13,2,5,38,26,64
24,2,5,70,48,118
13,4,10,75,52,127
28,4,10,162,112,274
28,2,5,74,56,130
19,4,10,80,76,156
15,2,5,29,30,59
12,2,5,23,24,47
23,4,10,122,92,214
19,4,10,101,76,177
13,4,10,49,52,101
24,4,10,91,96,187
1,2,5,3,2,5
21,2,5,61,42,103
26,2,5,53,52,105
2,2,5,4,4,8
15,2,5,42,30,72
12,2,5,34,24,58
11,2,5,31,22,53
3,2,5,8,6,14
11,3,9,65,33,98
18,2,5,42,36,78
1,7,9,2,7,9
22,7,9,2,154,156
12,7,9,0,84,84
3,7,9,4,21,25
24,7,9,46,168,214
29,7,9,40,203,243
23,7,9,42,161,203
30,7,9,55,210,265
17,7,9,32,119,151
7,3,8,23,21,44
22,3,8,106,66,172
16,3,8,71,48,119
27,3,8,87,81,168
9,8,22,98,72,170
5,8,22,68,40,108
19,8,22,262,152,414
10,8,22,136,80,216
26,8,22,238,208,446
21,8,22,192,168,360
14,8,22,193,112,305
2,8,22,26,16,42
1,9,24,12,9,21
26,9,24,365,234,599
24,9,24,348,216,564
12,13,35,172,156,328
28,13,35,596,364,960
26,13,35,536,338,874
4,13,35,87,52,139
7,13,35,110,91,201
23,13,35,490,299,789
20,13,35,349,260,609
9,13,35,141,117,258
3,13,35,64,39,103
10,13,35,217,130,347
2,13,35,39,26,65
4,13,35,78,52,130
15,13,35,309,195,504
4,13,35,70,52,122
9,13,35,192,117,309
15,13,35,257,195,452
16,13,35,274,208,482
12,38,50,132,456,588
22,42,54,240,924,1164
26,38,50,286,988,1274
6,38,50,66,228,294
1,38,50,12,38,50
20,38,50,230,760,990
17,42,54,75,714,789
20,42,54,2,840,842
22,42,54,240,924,1164
1,1252,2295,538,1252,1790
1,420,769,341,420,761
1,1252,2295,722,1252,1974
1,1252,2295,607,1252,1859
1,1266,2320,776,1266,2042
1,1266,2320,636,1266,1902
1,1252,2295,1020,1252,2272
1,420,769,334,420,754
1,1266,2320,636,1266,1902
1,1252,2295,997,1252,2249
1,1266,2320,544,1266,1810
1,295,540,234,295,529
1,1266,2320,636,1266,1902
1,1266,2320,892,1266,2158
1,1252,2295,722,1252,1974
1,1266,2320,1008,1266,2274
1,1252,2295,538,1252,1790
1,2171,3578,620,2171,2791
1,2171,3578,1335,2171,3506
1,487,783,194,487,681
1,487,783,280,487,767
1,487,783,265,487,752
1,487,783,265,487,752
1,344,540,185,344,529
1,487,783,194,487,681
1,26,70,29,26,55
18,26,70,779,468,1247
9,26,70,257,234,491
16,3,9,90,48,138
9,1,2,9,9,18
15,1,2,15,15,30
13,1,2,13,13,26
4,1,2,4,4,8
20,13,35,328,260,588
14,1,2,9,14,23
22,1,2,16,22,38
4,1,2,3,4,7
14,1,2,10,14,24
26,2,5,77,52,129
2,2,5,6,4,10
9,11,30,168,99,267
6,13,35,103,78,181
22,13,35,376,286,662
8,13,35,137,104,241
9,1,4,27,9,36
15,2,5,35,30,65
26,2,5,61,52,113
25,2,5,53,50,103
4,2,5,8,8,16
7,2,5,21,14,35
28,2,5,83,56,139
16,2,5,30,32,62
15,1,2,10,15,25
8,1,2,5,8,13
2,1,2,1,2,3
24,1,2,21,24,45
15,1,2,9,15,24
11,1,4,33,11,44
6,2,5,13,12,25
19,2,5,40,38,78
1,2,5,2,2,4
6,9,25,86,54,140
9,9,25,128,81,209
19,9,25,271,171,442
26,1,2,25,26,51
3,2,5,6,6,12
29,2,5,81,58,139
9,1,2,6,9,15
26,1,2,25,26,51
21,1,2,20,21,41
30,1,2,22,30,52
17,1,2,12,17,29
5,8,21,63,40,103
5,2,5,15,10,25
4,2,5,12,8,20
21,2,5,61,42,103
26,2,5,75,52,127
6,2,5,17,12,29
13,2,5,31,26,57
6,1,4,13,6,19
1,1,4,2,1,3
8,9,25,124,72,196
13,9,25,202,117,319
1,461,742,266,461,727
1,461,742,251,461,712
1,755,1215,448,755,1203
1,1482,2384,854,1482,2336
1,461,742,266,461,727
1,1482,2384,568,1482,2050
1,1482,2384,568,1482,2050
1,461,742,251,461,712
1,461,742,266,461,727
6,24,64,156,144,300
1,45,120,73,45,118
9,59,159,871,531,1402
1,59,159,65,59,124
11,2,5,32,22,54
4,2,5,12,8,20
14,2,5,39,28,67
7,4,10,41,28,69
10,4,10,58,40,98
18,4,10,101,72,173
11,4,10,62,44,106
13,2,5,30,26,56
23,2,5,68,46,114
11,2,5,32,22,54
17,2,5,46,34,80
13,4,10,73,52,125
10,4,10,56,40,96
25,2,5,73,50,123
23,2,5,67,46,113
22,2,5,64,44,108
13,2,5,38,26,64
30,4,10,114,120,234
5,4,10,19,20,39
10,2,5,29,20,49
14,2,5,41,28,69
21,2,5,61,42,103
2,2,5,4,4,8
19,2,5,34,38,72
16,7,9,12,112,124
22,7,9,40,154,194
11,7,9,21,77,98
14,3,8,68,42,110
20,3,8,94,60,154
11,3,8,54,33,87
17,8,22,231,136,367
30,8,22,407,240,647
15,8,22,203,120,323
23,8,22,302,184,486
18,8,22,165,144,309
24,8,22,325,192,517
5,8,22,69,40,109
5,8,22,46,40,86
21,9,24,310,189,499
10,9,24,148,90,238
23,9,24,268,207,475
28,13,35,606,364,970
26,13,35,408,338,746
28,13,35,381,364,745
8,13,35,170,104,274
8,13,35,126,104,230
4,13,35,71,52,123
6,13,35,105,78,183
6,13,35,128,78,206
10,13,35,157,130,287
21,21,55,691,441,1132
12,21,55,401,252,653
6,38,50,69,228,297
2,38,50,10,76,86
2,38,50,11,76,87
20,38,50,220,760,980
21,42,54,241,882,1123
5,42,54,57,210,267
11,38,50,55,418,473
1,1266,2320,1008,1266,2274
1,1252,2295,951,1252,2203
1,420,769,334,420,754
1,420,769,334,420,754
1,420,769,341,420,761
1,295,540,223,295,518
1,1266,2320,961,1266,2227
1,1252,2295,997,1252,2249
1,295,540,240,295,535
1,1266,2320,961,1266,2227
1,1266,2320,1031,1266,2297
1,1912,3400,740,1912,2652
1,713,1120,362,713,1075
1,487,783,124,487,611
1,2171,3578,763,2171,2934
1,2171,3578,942,2171,3113
1,713,1120,250,713,963
1,713,1120,205,713,918
1,487,783,132,487,619
1,344,540,174,344,518
1,2171,3578,1335,2171,3506
7,26,70,303,182,485
1,26,70,34,26,60
14,26,70,606,364,970
26,3,9,147,78,225
18,2,5,40,36,76
17,2,5,37,34,71
2,2,5,4,4,8
2,1,2,2,2,4
9,1,2,8,9,17
29,2,5,86,58,144
30,2,5,89,60,149
12,1,2,12,12,24
19,1,2,17,19,36
9,1,2,8,9,17
14,11,30,262,154,416
16,11,30,299,176,475
8,11,30,150,88,238
8,11,30,150,88,238
19,2,5,55,38,93
19,2,5,55,38,93
21,9,25,326,189,515
29,1,2,28,29,57
27,1,2,26,27,53
9,11,30,114,99,213
16,2,5,34,32,66
12,2,5,25,24,49
14,1,4,35,14,49
15,1,4,38,15,53
22,9,25,253,198,451
12,9,25,138,108,246
15,2,5,44,30,74
16,1,2,15,16,31
19,2,5,44,38,82
28,2,5,64,56,120
15,1,2,15,15,30
2,1,2,2,2,4
14,1,4,41,14,55
6,1,4,18,6,24
3,1,2,2,3,5
26,1,2,15,26,41
1,1,4,2,1,3
20,1,4,43,20,63
15,2,5,29,30,59
29,2,5,55,58,113
3,1,2,3,3,6
17,2,5,32,34,66
14,2,5,27,28,55
25,2,5,48,50,98
5,1,2,3,5,8
14,1,2,8,14,22
2,8,21,25,16,41
4,8,21,50,32,82
27,2,5,57,54,111
5,1,4,14,5,19
14,1,4,40,14,54
16,2,5,34,32,66
5,2,5,11,10,21
1,1482,2384,854,1482,2336
1,1482,2384,854,1482,2336
26,45,120,1888,1170,3058
6,45,120,421,270,691
8,59,159,520,472,992
3,3,9,14,9,23
29,3,9,140,87,227
15,2,5,44,30,74
3,2,5,9,6,15
25,2,5,74,50,124
23,2,5,68,46,114
8,2,5,15,16,31
20,2,5,58,40,98
2,2,5,6,4,10
14,4,10,74,56,130
26,4,10,138,104,242
24,4,10,106,96,202
26,4,10,114,104,218
22,2,5,48,44,92
10,2,5,22,20,42
8,2,5,22,16,38
30,2,5,84,60,144
19,3,9,78,57,135
10,3,9,41,30,71
9,2,5,25,18,43
24,7,9,3,168,171
1,7,9,2,7,9
3,7,9,2,21,23
30,7,9,49,210,259
29,7,9,1,203,204
9,7,9,17,63,80
18,7,9,0,126,126
5,7,9,7,35,42
9,3,8,44,27,71
9,3,8,44,27,71
13,3,8,58,39,97
21,3,8,83,63,146
4,8,22,38,32,70
8,8,22,89,64,153
19,8,22,191,152,343
24,8,22,325,192,517
8,8,22,110,64,174
16,8,22,220,128,348
29,8,22,291,232,523
25,9,24,369,225,594
8,9,24,85,72,157
26,13,35,554,338,892
10,13,35,175,130,305
27,13,35,585,351,936
21,13,35,455,273,728
20,13,35,412,260,672
13,13,35,190,169,359
26,13,35,454,338,792
16,13,35,251,208,459
15,13,35,320,195,515
1,13,35,22,13,35
27,13,35,386,351,737
16,13,35,346,208,554
3,13,35,65,39,104
1,13,35,22,13,35
4,13,35,82,52,134
14,13,35,288,182,470
10,13,35,206,130,336
9,21,55,296,189,485
29,38,50,87,1102,1189
27,38,50,270,1026,1296
29,42,54,97,1218,1315
11,38,50,127,418,545
22,38,50,22,836,858
20,38,50,220,760,980
26,38,50,299,988,1287
8,42,54,1,336,337
1,1266,2320,1008,1266,2274
1,1266,2320,961,1266,2227
1,1252,2295,561,1252,1813
1,1252,2295,951,1252,2203
1,420,769,334,420,754
1,1252,2295,561,1252,1813
1,420,769,318,420,738
1,420,769,318,420,738
1,1252,2295,997,1252,2249
1,1898,3375,1443,1898,3341
1,1252,2295,882,1252,2134
1,420,769,211,420,631
1,1898,3375,735,1898,2633
1,1252,2295,722,1252,1974
1,1252,2295,630,1252,1882
1,713,1120,396,713,1109
1,2171,3578,942,2171,3113
1,1555,2443,864,1555,2419
1,1519,2443,484,1519,2003
1,1519,2443,826,1519,2345
1,2171,3578,835,2171,3006
1,344,540,174,344,518
1,713,1120,329,713,1042
1,713,1120,205,713,918
1,344,540,99,344,443
14,26,70,596,364,960
24,3,9,135,72,207
19,1,2,18,19,37
6,1,2,6,6,12
29,1,2,19,29,48
20,12,33,334,240,574
13,12,33,217,156,373
11,11,29,195,121,316
5,11,29,89,55,144
5,12,33,98,60,158
21,12,33,413,252,665
17,2,5,49,34,83
27,2,5,78,54,132
29,2,5,84,58,142
27,2,5,80,54,134
28,12,33,551,336,887
28,12,33,579,336,915
14,1,2,10,14,24
10,2,5,30,20,50
1,2,5,3,2,5
10,2,5,29,20,49
27,2,5,78,54,132
23,1,4,57,23,80
13,1,2,13,13,26
23,1,2,23,23,46
3,1,2,3,3,6
15,13,35,309,195,504
14,13,35,288,182,470
23,2,5,64,46,110
1,2,5,3,2,5
20,11,30,356,220,576
21,11,30,374,231,605
14,11,30,249,154,403
10,1,2,7,10,17
6,1,2,4,6,10
5,1,2,4,5,9
8,1,2,7,8,15
21,1,2,12,21,33
13,1,2,8,13,21
6,1,2,4,6,10
25,1,2,16,25,41
14,1,2,9,14,23
16,2,5,38,32,70
3,2,5,7,6,13
18,1,4,51,18,69
3,1,4,9,3,12
2,2,5,4,4,8
30,2,5,57,60,117
9,9,25,115,81,196
7,9,25,89,63,152
16,9,25,204,144,348
19,9,25,242,171,413
9,1,2,6,9,15
10,1,2,6,10,16
4,1,4,8,4,12
1,461,742,125,461,586
1,461,742,162,461,623
1,1482,2384,854,1482,2336
1,1482,2384,854,1482,2336
1,461,742,118,461,579
24,2,5,50,48,98
8,2,5,17,16,33
13,2,5,36,26,62
21,4,10,80,84,164
16,4,10,61,64,125
28,4,10,106,112,218
17,2,5,50,34,84
11,2,5,32,22,54
28,2,5,66,56,122
25,2,5,59,50,109
6,2,5,17,12,29
2,2,5,5,4,9
18,2,5,48,36,84
11,3,9,64,33,97
7,3,9,41,21,62
26,2,5,75,52,127
5,2,5,12,10,22
17,2,5,40,34,74
23,3,9,136,69,205
16,3,9,64,48,112
17,3,9,68,51,119
10,2,5,24,20,44
21,2,5,49,42,91
28,2,5,78,56,134
28,2,5,78,56,134
26,7,9,10,182,192
29,7,9,48,203,251
9,7,9,16,63,79
21,7,9,8,147,155
28,7,9,11,196,207
16,7,9,31,112,143
4,7,9,0,28,28
17,7,9,31,119,150
29,7,9,21,203,224
14,3,8,52,42,94
5,3,8,17,15,32
12,3,8,48,36,84
29,3,8,94,87,181
30,3,8,140,90,230
4,8,22,54,32,86
20,8,22,271,160,431
7,8,22,76,56,132
12,8,22,157,96,253
11,8,22,103,88,191
12,8,22,110,96,206
7,8,22,76,56,132
24,9,24,233,216,449
28,9,24,393,252,645
6,9,24,87,54,141
28,13,35,547,364,911
4,13,35,85,52,137
1,13,35,17,13,30
3,13,35,62,39,101
18,13,35,383,234,617
15,13,35,325,195,520
8,13,35,126,104,230
5,13,35,73,65,138
2,13,35,43,26,69
6,13,35,94,78,172
9,13,35,195,117,312
6,13,35,128,78,206
3,13,35,62,39,101
29,13,35,597,377,974
9,13,35,185,117,302
25,13,35,533,325,858
1,13,35,21,13,34
7,13,35,110,91,201
9,13,35,132,117,249
20,13,35,286,260,546
18,13,35,257,234,491
14,13,35,200,182,382
5,21,55,134,105,239
2,21,55,50,42,92
7,21,55,188,147,335
26,21,55,569,546,1115
12,21,55,401,252,653
2,42,54,22,84,106
23,38,50,230,874,1104
18,42,54,90,756,846
1,42,54,1,42,43
1,1266,2320,1008,1266,2274
1,1252,2295,561,1252,1813
1,420,769,341,420,761
1,308,565,155,308,463
1,1266,2320,636,1266,1902
1,420,769,203,420,623
1,1266,2320,544,1266,1810
1,420,769,318,420,738
1,1252,2295,997,1252,2249
1,1252,2295,997,1252,2249
1,1252,2295,538,1252,1790
1,420,769,249,420,669
1,1252,2295,538,1252,1790
1,713,1120,362,713,1075
1,1555,2443,717,1555,2272
1,1555,2443,790,1555,2345
1,2171,3578,656,2171,2827
1,487,783,265,487,752
1,344,540,77,344,421
1,713,1120,261,713,974
1,1519,2443,900,1519,2419
1,344,540,83,344,427
26,26,70,744,676,1420
29,26,70,1235,754,1989
12,26,70,511,312,823
16,13,35,341,208,549
24,13,35,511,312,823
3,8,21,25,24,49
7,8,21,59,56,115
4,1,2,2,4,6
5,1,2,3,5,8
10,13,35,213,130,343
2,13,35,43,26,69
5,12,33,84,60,144
7,12,33,117,84,201
1,1,2,1,1,2
4,1,2,2,4,6
16,1,2,10,16,26
14,2,5,41,28,69
22,2,5,64,44,108
3,2,5,9,6,15
14,1,2,14,14,28
2,1,2,2,2,4
5,2,5,10,10,20
4,2,5,8,8,16
29,9,25,457,261,718
11,1,2,10,11,21
16,1,2,16,16,32
8,1,2,7,8,15
5,9,25,75,45,120
8,9,25,120,72,192
16,9,25,240,144,384
13,2,5,38,26,64
11,2,5,32,22,54
9,1,2,9,9,18
5,1,2,5,5,10
4,11,29,71,44,115
28,2,5,81,56,137
3,2,5,9,6,15
24,12,33,330,288,618
12,12,33,165,144,309
9,1,4,22,9,31
15,1,4,37,15,52
11,1,2,11,11,22
8,1,2,8,8,16
16,1,4,35,16,51
10,1,4,22,10,32
15,1,4,32,15,47
9,1,4,21,9,30
27,1,4,62,27,89
13,1,2,8,13,21
5,2,5,14,10,24
12,2,5,34,24,58
10,2,5,28,20,48
26,9,25,390,234,624
10,9,25,150,90,240
6,9,25,90,54,144
6,8,21,62,48,110
24,8,21,246,192,438
19,1,2,11,19,30
6,9,25,77,54,131
4,2,5,12,8,20
26,2,5,75,52,127
1,461,742,147,461,608
1,1482,2384,735,1482,2217
1,1482,2384,592,1482,2074
1,461,742,185,461,646
1,1482,2384,473,1482,1955
1,1482,2384,854,1482,2336
1,1482,2384,568,1482,2050
22,24,64,697,528,1225
19,24,64,748,456,1204
25,24,64,648,600,1248
15,24,64,475,360,835
5,24,64,158,120,278
8,45,120,590,360,950
7,59,159,522,413,935
7,59,159,555,413,968
13,2,5,25,26,51
15,2,5,29,30,59
21,3,9,124,63,187
26,3,9,154,78,232
13,2,5,36,26,62
30,2,5,84,60,144
25,4,10,133,100,233
4,4,10,21,16,37
4,2,5,8,8,16
16,2,5,34,32,66
22,2,5,42,44,86
9,2,5,25,18,43
11,2,5,32,22,54
19,4,10,89,76,165
14,4,10,66,56,122
20,2,5,58,40,98
19,2,5,55,38,93
20,4,10,106,80,186
24,4,10,127,96,223
18,4,10,79,72,151
2,4,10,9,8,17
19,2,5,55,38,93
9,2,5,26,18,44
11,2,5,26,22,48
19,2,5,45,38,83
7,2,5,13,14,27
30,2,5,57,60,117
21,2,5,40,42,82
10,7,9,19,70,89
2,7,9,4,14,18
18,7,9,7,126,133
2,7,9,2,14,16
2,7,9,1,14,15
3,3,8,15,9,24
5,3,8,23,15,38
9,3,8,36,27,63
25,8,22,328,200,528
25,8,22,262,200,462
4,8,22,44,32,76
27,8,22,366,216,582
3,8,22,41,24,65
21,8,22,289,168,457
21,8,22,262,168,430
19,8,22,199,152,351
15,9,24,211,135,346
9,9,24,87,81,168
17,9,24,202,153,355
25,9,24,333,225,558
17,9,24,165,153,318
13,9,24,129,117,246
13,13,35,281,169,450
3,13,35,59,39,98
4,13,35,82,52,134
12,13,35,197,156,353
21,13,35,366,273,639
13,13,35,186,169,355
10,13,35,157,130,287
24,13,35,343,312,655
16,13,35,279,208,487
1,13,35,17,13,30
20,13,35,349,260,609
4,13,35,63,52,115
17,13,35,332,221,553
15,13,35,262,195,457
20,13,35,286,260,546
9,13,35,176,117,293
30,13,35,429,390,819
6,13,35,103,78,181
13,21,55,435,273,708
1,21,55,32,21,53
20,21,55,438,420,858
8,21,55,202,168,370
21,38,50,21,798,819
11,38,50,61,418,479
19,38,50,190,722,912
21,38,50,210,798,1008
25,38,50,250,950,1200
26,42,54,129,1092,1221
9,38,50,50,342,392
20,42,54,100,840,940
13,38,50,143,494,637
1,42,54,3,42,45
16,42,54,54,672,726
23,38,50,115,874,989
1,1266,2320,1008,1266,2274
1,1252,2295,882,1252,2134
1,420,769,341,420,761
1,1266,2320,961,1266,2227
1,420,769,318,420,738
1,295,540,240,295,535
1,1266,2320,752,1266,2018
1,295,540,240,295,535
1,2171,3578,1157,2171,3328
1,1519,2443,484,1519,2003
1,2171,3578,942,2171,3113
1,1555,2443,839,1555,2394
1,1083,1701,312,1083,1395
1,487,783,265,487,752
1,1519,2443,606,1519,2125
1,344,540,185,344,529
1,344,540,158,344,502
1,1083,1701,499,1083,1582
1,487,783,171,487,658
1,2171,3578,1335,2171,3506
1,26,70,29,26,55
13,3,9,52,39,91
27,3,9,123,81,204
26,1,4,77,26,103
12,1,4,36,12,48
6,1,2,6,6,12
24,1,2,24,24,48
29,1,2,16,29,45
8,2,5,22,16,38
18,2,5,50,36,86
24,13,35,394,312,706
20,1,2,15,20,35
14,1,2,13,14,27
8,12,33,157,96,253
24,13,35,410,312,722
20,2,5,56,40,96
30,2,5,84,60,144
2,2,5,5,4,9
9,2,5,24,18,42
16,1,2,15,16,31
1,1,2,1,1,2
9,9,25,128,81,209
6,11,30,112,66,178
3,11,30,56,33,89
24,11,30,449,264,713
23,2,5,68,46,114
26,2,5,77,52,129
29,2,5,68,58,126
28,2,5,66,56,122
17,11,30,318,187,505
10,2,5,30,20,50
5,1,2,3,5,8
7,1,2,6,7,13
1,1,2,1,1,2
24,2,5,55,48,103
25,2,5,58,50,108
7,1,4,17,7,24
27,1,4,66,27,93
27,2,5,62,54,116
18,2,5,41,36,77
29,2,5,67,58,125
28,2,5,64,56,120
15,1,4,37,15,52
14,1,4,35,14,49
29,9,25,450,261,711
1,461,742,185,461,646
1,1482,2384,592,1482,2074
1,1482,2384,592,1482,2074
3,24,64,116,72,188
4,45,120,295,180,475
6,59,159,590,354,944
1,59,159,71,59,130
5,2,5,14,10,24
5,2,5,14,10,24
17,2,5,50,34,84
28,4,10,129,112,241
11,4,10,51,44,95
2,4,10,9,8,17
30,2,5,87,60,147
16,2,5,46,32,78
19,2,5,40,38,78
19,2,5,40,38,78
27,3,9,123,81,204
21,3,9,96,63,159
10,4,10,39,40,79
3,4,10,12,12,24
21,2,5,61,42,103
16,2,5,34,32,66
14,3,9,61,42,103
10,2,5,30,20,50
10,2,5,30,20,50
4,3,9,16,12,28
25,3,9,103,75,178
11,3,9,44,33,77
19,4,10,74,76,150
28,4,10,109,112,221
10,7,9,1,70,71
14,7,9,12,98,110
6,7,9,5,42,47
26,7,9,10,182,192
29,7,9,53,203,256
12,7,9,22,84,106
11,7,9,9,77,86
3,7,9,0,21,21
22,3,8,87,66,153
29,3,8,94,87,181
22,8,22,298,176,474
19,8,22,262,152,414
16,8,22,161,128,289
5,8,22,68,40,108
30,8,22,328,240,568
24,8,22,325,192,517
24,8,22,331,192,523
29,9,24,421,261,682
22,9,24,319,198,517
10,13,35,143,130,273
4,13,35,87,52,139
6,13,35,128,78,206
1,13,35,21,13,34
30,13,35,587,390,977
7,13,35,122,91,213
12,13,35,188,156,344
13,13,35,281,169,450
29,13,35,425,377,802
7,13,35,137,91,228
13,13,35,277,169,446
7,13,35,144,91,235
3,13,35,65,39,104
26,13,35,563,338,901
1,13,35,21,13,34
27,13,35,585,351,936
17,13,35,368,221,589
21,13,35,330,273,603
21,13,35,447,273,720
13,13,35,277,169,446
15,21,55,494,315,809
23,38,50,265,874,1139
19,38,50,219,722,941
26,38,50,78,988,1066
4,42,54,9,168,177
26,38,50,26,988,1014
9,38,50,77,342,419
11,38,50,33,418,451
5,38,50,28,190,218
2,42,54,9,84,93
14,42,54,115,588,703
16,38,50,176,608,784
17,38,50,187,646,833
28,38,50,252,1064,1316
18,38,50,198,684,882
17,42,54,11,714,725
1,1252,2295,1020,1252,2272
1,420,769,334,420,754
1,1252,2295,997,1252,2249
1,1266,2320,1008,1266,2274
1,1252,2295,630,1252,1882
1,1555,2443,546,1555,2101
1,2171,3578,1264,2171,3435
1,344,540,185,344,529
1,1555,2443,864,1555,2419
1,1555,2443,790,1555,2345
1,1083,1701,244,1083,1327
1,487,783,155,487,642
1,487,783,241,487,728
1,344,540,158,344,502
1,344,540,158,344,502
1,344,540,99,344,443
1,713,1120,205,713,918
1,487,783,155,487,642
1,487,783,132,487,619
1,487,783,194,487,681
1,344,540,174,344,518
2,26,70,85,52,137
4,26,70,114,104,218
3,26,70,128,78,206
12,26,70,478,312,790
27,13,35,386,351,737
19,13,35,272,247,519
12,13,35,172,156,328
15,9,25,236,135,371
30,8,21,258,240,498
19,2,5,55,38,93
11,2,5,32,22,54
18,1,4,53,18,71
7,1,4,21,7,28
24,2,5,56,48,104
10,2,5,24,20,44
17,2,5,50,34,84
12,1,4,36,12,48
7,2,5,16,14,30
18,13,35,314,234,548
14,13,35,244,182,426
3,13,35,52,39,91
29,1,2,28,29,57
28,13,35,596,364,960
8,13,35,170,104,274
9,2,5,27,18,45
21,2,5,62,42,104
30,1,2,29,30,59
24,1,2,18,24,42
1,1,2,1,1,2
21,8,21,211,168,379
23,2,5,48,46,94
21,2,5,44,42,86
6,2,5,13,12,25
18,2,5,42,36,78
2,2,5,5,4,9
17,2,5,50,34,84
21,2,5,62,42,104
8,1,2,8,8,16
22,1,2,22,22,44
19,1,2,14,19,33
26,12,33,357,312,669
5,12,33,69,60,129
20,12,33,407,240,647
17,12,33,346,204,550
24,12,33,488,288,776
19,11,29,331,209,540
15,1,4,34,15,49
7,1,2,7,7,14
5,1,2,5,5,10
27,1,2,26,27,53
8,1,2,8,8,16
3,1,2,3,3,6
1,2,5,3,2,5
21,1,4,61,21,82
5,1,4,15,5,20
22,1,4,62,22,84
19,1,4,54,19,73
18,1,4,51,18,69
6,2,5,15,12,27
18,2,5,44,36,80
1,1482,2384,807,1482,2289
1,755,1215,411,755,1166
1,461,742,125,461,586
1,1482,2384,473,1482,1955
1,1482,2384,854,1482,2336
1,1482,2384,854,1482,2336
1,1482,2384,378,1482,1860
1,1482,2384,378,1482,1860
1,461,742,229,461,690
1,755,1215,205,755,960
1,755,1215,302,755,1057
1,461,742,125,461,586
28,24,64,1084,672,1756
7,24,64,217,168,385
4,45,120,238,180,418
4,45,120,281,180,461
7,3,9,41,21,62
27,4,10,113,108,221
26,4,10,109,104,213
13,4,10,75,52,127
4,3,9,21,12,33
18,2,5,52,36,88
3,2,5,9,6,15
6,2,5,11,12,23
5,2,5,10,10,20
2,2,5,6,4,10
13,2,5,38,26,64
4,2,5,12,8,20
5,2,5,15,10,25
6,2,5,17,12,29
11,4,10,64,44,108
2,2,5,5,4,9
15,2,5,35,30,65
19,2,5,40,38,78
20,2,5,58,40,98
14,2,5,41,28,69
29,2,5,68,58,126
28,3,9,113,84,197
20,3,9,80,60,140
16,2,5,30,32,62
13,7,9,1,91,92
1,7,9,2,7,9
23,7,9,44,161,205
16,7,9,29,112,141
30,7,9,57,210,267
18,7,9,0,126,126
6,7,9,0,42,42
17,7,9,6,119,125
11,7,9,9,77,86
2,7,9,4,14,18
29,7,9,55,203,258
27,3,8,107,81,188
7,8,22,64,56,120
14,8,22,184,112,296
28,8,22,263,224,487
8,8,22,80,64,144
15,8,22,207,120,327
23,8,22,211,184,395
26,9,24,384,234,618
1,9,24,12,9,21
5,9,24,49,45,94
25,13,35,533,325,858
12,13,35,260,156,416
16,13,35,251,208,459
22,13,35,361,286,647
14,13,35,303,182,485
5,13,35,108,65,173
7,13,35,144,91,235
24,13,35,520,312,832
5,13,35,107,65,172
17,13,35,297,221,518
13,13,35,186,169,355
6,13,35,94,78,172
30,13,35,524,390,914
4,13,35,85,52,137
16,13,35,341,208,549
9,13,35,132,117,249
20,13,35,314,260,574
16,13,35,341,208,549
26,21,55,827,546,1373
5,21,55,134,105,239
21,42,54,48,882,930
14,38,50,42,532,574
3,38,50,35,114,149
22,38,50,253,836,1089
13,42,54,44,546,590
7,42,54,69,294,363
12,38,50,132,456,588
6,38,50,6,228,234
9,38,50,90,342,432
20,42,54,2,840,842
21,38,50,63,798,861
12,42,54,60,504,564
22,42,54,252,924,1176
20,42,54,218,840,1058
1,1266,2320,752,1266,2018
1,1266,2320,636,1266,1902
1,1252,2295,745,1252,1997
1,1252,2295,1020,1252,2272
1,1266,2320,729,1266,1995
1,420,769,318,420,738
1,1266,2320,567,1266,1833
1,1252,2295,997,1252,2249
1,1252,2295,676,1252,1928
1,308,565,155,308,463
1,420,769,334,420,754
1,1266,2320,544,1266,1810
1,1252,2295,997,1252,2249
1,1252,2295,538,1252,1790
1,2171,3578,620,2171,2791
1,2171,3578,1264,2171,3435
1,1519,2443,826,1519,2345
1,1083,1701,244,1083,1327
1,1083,1701,550,1083,1633
1,344,540,77,344,421
1,344,540,99,344,443
1,713,1120,261,713,974
1,344,540,191,344,535
1,713,1120,261,713,974
1,487,783,194,487,681
1,2171,3578,620,2171,2791
1,713,1120,205,713,918
9,26,70,295,234,529
23,26,70,980,598,1578
17,26,70,736,442,1178
19,26,70,823,494,1317
16,3,9,86,48,134
9,8,21,77,72,149
1,8,21,9,8,17
25,13,35,533,325,858
22,13,35,469,286,755
24,2,5,71,48,119
15,2,5,35,30,65
7,2,5,21,14,35
9,2,5,27,18,45
15,2,5,44,30,74
30,2,5,89,60,149
18,2,5,53,36,89
11,2,5,32,22,54
8,1,4,19,8,27
5,2,5,15,10,25
3,2,5,9,6,15
25,2,5,48,50,98
18,2,5,34,36,70
24,2,5,46,48,94
20,1,4,50,20,70
30,1,4,74,30,104
25,1,2,25,25,50
20,1,2,20,20,40
12,1,2,12,12,24
4,2,5,12,8,20
13,2,5,38,26,64
18,11,30,299,198,497
13,11,30,216,143,359
16,8,21,164,128,292
10,11,29,160,110,270
11,11,29,195,121,316
21,11,29,372,231,603
22,1,2,12,22,34
28,12,33,385,336,721
22,12,33,302,264,566
13,12,33,264,156,420
18,11,29,314,198,512
30,1,2,17,30,47
11,1,2,6,11,17
29,8,21,353,232,585
23,8,21,280,184,464
14,1,2,8,14,22
18,8,21,166,144,310
6,1,2,6,6,12
1,1,2,1,1,2
25,8,21,315,200,515
18,8,21,226,144,370
21,8,21,264,168,432
1,461,742,185,461,646
1,1482,2384,521,1482,2003
1,1482,2384,878,1482,2360
1,1482,2384,592,1482,2074
1,1482,2384,854,1482,2336
1,755,1215,436,755,1191
1,1482,2384,854,1482,2336
1,1482,2384,854,1482,2336
6,24,64,190,144,334
28,24,64,1084,672,1756
15,45,120,1107,675,1782
10,45,120,534,450,984
4,45,120,233,180,413
25,2,5,59,50,109
15,2,5,35,30,65
12,2,5,23,24,47
25,4,10,145,100,245
1,4,10,6,4,10
29,4,10,122,116,238
2,4,10,8,8,16
23,2,5,67,46,113
9,2,5,17,18,35
4,2,5,8,8,16
12,2,5,26,24,50
11,2,5,24,22,46
5,2,5,14,10,24
2,2,5,6,4,10
8,2,5,15,16,31
13,2,5,25,26,51
25,4,10,115,100,215
3,2,5,6,6,12
16,2,5,30,32,62
9,2,5,21,18,39
26,2,5,60,52,112
11,4,10,65,44,109
5,4,10,30,20,50
5,2,5,10,10,20
19,7,9,7,133,140
30,7,9,1,210,211
12,7,9,10,84,94
17,7,9,23,119,142
26,3,8,128,78,206
24,3,8,93,72,165
22,8,22,202,176,378
18,8,22,244,144,388
9,8,22,84,72,156
6,8,22,60,48,108
27,8,22,247,216,463
24,8,22,220,192,412
15,8,22,167,120,287
6,9,24,84,54,138
12,9,24,143,108,251
4,9,24,56,36,92
14,9,24,197,126,323
17,13,35,350,221,571
10,13,35,213,130,343
15,13,35,257,195,452
30,13,35,492,390,882
2,13,35,43,26,69
15,13,35,320,195,515
27,13,35,575,351,926
19,13,35,391,247,638
26,13,35,372,338,710
3,13,35,43,39,82
24,13,35,511,312,823
21,13,35,366,273,639
8,13,35,114,104,218
11,13,35,227,143,370
27,13,35,424,351,775
15,13,35,325,195,520
22,13,35,469,286,755
14,13,35,205,182,387
9,13,35,129,117,246
4,13,35,70,52,122
8,13,35,114,104,218
2,13,35,34,26,60
22,13,35,384,286,670
17,13,35,231,221,452
12,13,35,209,156,365
16,13,35,251,208,459
10,21,55,263,210,473
24,21,55,644,504,1148
2,21,55,42,42,84
27,42,54,134,1134,1268
2,38,50,17,76,93
15,38,50,165,570,735
1,38,50,11,38,49
12,42,54,40,504,544
12,42,54,53,504,557
28,38,50,154,1064,1218
12,42,54,99,504,603
20,38,50,200,760,960
1,1252,2295,722,1252,1974
1,1266,2320,544,1266,1810
1,1252,2295,538,1252,1790
1,1252,2295,997,1252,2249
1,1266,2320,567,1266,1833
1,308,565,133,308,441
1,420,769,318,420,738
1,308,565,184,308,492
1,1266,2320,544,1266,1810
1,1252,2295,722,1252,1974
1,308,565,184,308,492
1,1912,3400,1420,1912,3332
1,1898,3375,1410,1898,3308
1,1912,3400,740,1912,2652
1,2171,3578,620,2171,2791
1,2171,3578,942,2171,3113
1,2171,3578,1371,2171,3542
1,1083,1701,584,1083,1667
1,487,783,194,487,681
1,344,540,185,344,529
1,344,540,185,344,529
1,713,1120,329,713,1042
1,487,783,194,487,681
1,344,540,126,344,470
1,713,1120,362,713,1075
1,344,540,99,344,443
25,26,70,1065,650,1715
12,26,70,419,312,731
12,26,70,419,312,731
11,3,9,64,33,97
25,3,9,110,75,185
10,1,2,7,10,17
10,1,4,30,10,40
8,1,2,4,8,12
6,13,35,128,78,206
17,2,5,48,34,82
2,1,2,1,2,3
7,1,2,4,7,11
19,2,5,44,38,82
13,2,5,38,26,64
10,2,5,30,20,50
30,2,5,89,60,149
5,1,4,15,5,20
22,1,4,65,22,87
25,2,5,74,50,124
5,2,5,15,10,25
24,13,35,511,312,823
25,13,35,533,325,858
2,1,2,1,2,3
7,13,35,110,91,201
5,1,2,3,5,8
24,1,2,13,24,37
2,1,2,1,2,3
15,2,5,44,30,74
26,1,2,24,26,50
6,9,25,95,54,149
10,9,25,158,90,248
7,9,25,110,63,173
19,2,5,45,38,83
21,2,5,49,42,91
16,1,2,15,16,31
17,1,2,16,17,33
15,11,30,204,165,369
8,11,30,109,88,197
18,1,2,10,18,28
27,1,2,15,27,42
7,1,2,4,7,11
29,1,2,16,29,45
14,1,4,38,14,52
26,11,30,478,286,764
4,11,30,74,44,118
8,8,21,97,64,161
16,1,4,38,16,54
1,1,4,2,1,3
13,9,25,150,117,267
19,9,25,219,171,390
29,2,5,55,58,113
12,2,5,23,24,47
10,1,4,21,10,31
11,1,4,23,11,34
6,1,2,3,6,9
1,1,2,1,1,2
11,1,2,9,11,20
7,1,2,6,7,13
26,2,5,75,52,127
16,2,5,46,32,78
1,461,742,185,461,646
1,1482,2384,807,1482,2289
1,755,1215,411,755,1166
1,755,1215,241,755,996
1,1482,2384,878,1482,2360
1,755,1215,193,755,948
1,1482,2384,378,1482,1860
1,461,742,103,461,564
1,1482,2384,854,1482,2336
1,1482,2384,592,1482,2074
6,45,120,443,270,713
5,45,120,363,225,588
3,45,120,200,135,335
17,45,120,1132,765,1897
10,59,159,936,590,1526
8,2,5,21,16,37
22,2,5,58,44,102
22,2,5,46,44,90
22,2,5,46,44,90
4,2,5,11,8,19
14,2,5,39,28,67
10,2,5,29,20,49
7,2,5,20,14,34
12,2,5,29,24,53
15,2,5,36,30,66
23,2,5,53,46,99
4,2,5,9,8,17
29,4,10,110,116,226
27,4,10,103,108,211
17,2,5,50,34,84
6,2,5,18,12,30
24,2,5,71,48,119
11,2,5,32,22,54
12,2,5,35,24,59
18,3,9,105,54,159
7,3,9,41,21,62
16,2,5,47,32,79
15,2,5,44,30,74
28,2,5,66,56,122
29,2,5,68,58,126
19,7,9,36,133,169
17,7,9,28,119,147
16,3,8,53,48,101
15,3,8,74,45,119
7,3,8,31,21,52
13,3,8,64,39,103
17,8,22,212,136,348
24,8,22,267,192,459
19,8,22,207,152,359
13,8,22,176,104,280
6,8,22,81,48,129
30,8,22,374,240,614
16,8,22,178,128,306
26,8,22,290,208,498
17,8,22,234,136,370
22,9,24,325,198,523
6,13,35,86,78,164
15,13,35,236,195,431
18,13,35,371,234,605
18,13,35,314,234,548
1,13,35,21,13,34
1,13,35,21,13,34
13,13,35,190,169,359
30,13,35,429,390,819
21,13,35,447,273,720
19,13,35,278,247,525
28,13,35,577,364,941
28,13,35,400,364,764
5,13,35,89,65,154
16,13,35,330,208,538
14,13,35,303,182,485
26,13,35,445,338,783
3,13,35,44,39,83
21,13,35,455,273,728
6,13,35,128,78,206
24,13,35,494,312,806
28,13,35,489,364,853
19,13,35,405,247,652
13,13,35,227,169,396
6,13,35,94,78,172
22,13,35,384,286,670
21,13,35,366,273,639
1,38,50,6,38,44
27,38,50,311,1026,1337
15,38,50,173,570,743
10,38,50,30,380,410
8,38,50,88,304,392
1,1252,2295,882,1252,2134
1,1266,2320,752,1266,2018
1,1252,2295,997,1252,2249
1,1252,2295,561,1252,1813
1,308,565,217,308,525
1,420,769,188,420,608
1,1266,2320,892,1266,2158
1,420,769,249,420,669
1,295,540,234,295,529
1,1252,2295,768,1252,2020
1,1266,2320,636,1266,1902
1,1519,2443,826,1519,2345
1,487,783,155,487,642
1,1555,2443,864,1555,2419
1,1555,2443,448,1555,2003
1,2171,3578,620,2171,2791
1,1083,1701,584,1083,1667
1,1555,2443,570,1555,2125
1,2171,3578,1335,2171,3506
1,344,540,126,344,470
4,3,9,24,12,36
19,3,9,92,57,149
14,3,9,66,42,108
21,2,5,61,42,103
25,2,5,73,50,123
6,2,5,18,12,30
2,1,2,2,2,4
17,1,2,15,17,32
25,2,5,70,50,120
29,2,5,81,58,139
4,1,4,12,4,16
29,12,33,485,348,833
27,2,5,62,54,116
2,2,5,5,4,9
6,2,5,17,12,29
4,2,5,12,8,20
6,2,5,17,12,29
7,2,5,20,14,34
11,1,4,24,11,35
11,11,30,166,121,287
2,1,2,1,2,3
19,1,2,14,19,33
23,2,5,48,46,94
2,2,5,4,4,8
18,1,2,12,18,30
5,1,2,3,5,8
8,1,2,7,8,15
5,1,4,14,5,19
23,1,4,65,23,88
2,1,2,2,2,4
4,1,2,4,4,8
9,1,2,6,9,15
9,1,2,6,9,15
11,1,2,7,11,18
18,1,4,45,18,63
16,1,4,40,16,56
7,1,2,5,7,12
24,1,2,16,24,40
29,2,5,84,58,142
6,11,30,91,66,157
24,11,30,362,264,626
14,11,30,211,154,365
11,1,4,32,11,43
6,1,2,6,6,12
19,1,2,18,19,37
2,1,2,2,2,4
1,11,30,18,11,29
4,11,30,74,44,118
29,11,30,534,319,853
18,1,2,15,18,33
18,1,2,15,18,33
24,2,5,67,48,115
25,2,5,70,50,120
8,2,5,22,16,38
5,1,2,3,5,8
22,1,2,13,22,35
5,2,5,14,10,24
18,2,5,50,36,86
2,2,5,4,4,8
1,1482,2384,735,1482,2217
1,1482,2384,592,1482,2074
1,1482,2384,807,1482,2289
1,461,742,185,461,646
1,461,742,125,461,586
29,2,5,57,58,115
9,2,5,18,18,36
19,3,9,92,57,149
15,3,9,68,45,113
5,3,9,23,15,38
26,2,5,75,52,127
10,2,5,29,20,49
14,2,5,29,28,57
1,2,5,2,2,4
15,2,5,35,30,65
16,2,5,38,32,70
19,2,5,55,38,93
15,2,5,29,30,59
17,2,5,32,34,66
20,2,5,53,40,93
26,2,5,69,52,121
21,2,5,61,42,103
15,2,5,44,30,74
22,2,5,62,44,106
3,7,9,5,21,26
30,3,8,145,90,235
9,3,8,44,27,71
16,3,8,63,48,111
6,8,22,81,48,129
25,8,22,339,200,539
4,8,22,54,32,86
3,8,22,41,24,65
13,8,22,162,104,266
1,9,24,12,9,21
30,9,24,320,270,590
3,9,24,36,27,63
16,13,35,313,208,521
28,13,35,577,364,941
30,13,35,618,390,1008
26,13,35,454,338,792
10,13,35,217,130,347
25,13,35,515,325,840
10,13,35,206,130,336
19,13,35,391,247,638
2,13,35,31,26,57
5,13,35,107,65,172
18,13,35,302,234,536
25,13,35,533,325,858
4,13,35,80,52,132
11,13,35,173,143,316
17,13,35,231,221,452
20,13,35,342,260,602
12,21,55,395,252,647
10,42,54,109,420,529
19,42,54,2,798,800
19,42,54,187,798,985
4,42,54,46,168,214
10,38,50,115,380,495
10,38,50,50,380,430
29,38,50,145,1102,1247
12,38,50,60,456,516
1,420,769,334,420,754
1,1266,2320,752,1266,2018
1,1266,2320,1008,1266,2274
1,308,565,155,308,463
1,1266,2320,1008,1266,2274
1,420,769,334,420,754
1,1252,2295,882,1252,2134
1,2171,3578,620,2171,2791
1,487,783,155,487,642
1,487,783,155,487,642
1,713,1120,250,713,963
1,344,540,174,344,518
1,1555,2443,570,1555,2125
1,487,783,194,487,681
1,1555,2443,864,1555,2419
1,1083,1701,516,1083,1599
1,713,1120,205,713,918
1,344,540,174,344,518
1,713,1120,329,713,1042
30,26,70,858,780,1638
13,3,9,63,39,102
29,1,2,27,29,56
16,8,21,137,128,265
17,8,21,146,136,282
17,8,21,146,136,282
9,9,25,115,81,196
6,9,25,77,54,131
5,2,5,15,10,25
21,2,5,62,42,104
7,12,33,105,84,189
9,1,2,8,9,17
25,1,4,57,25,82
14,1,4,32,14,46
23,1,4,52,23,75
12,8,21,151,96,247
16,1,4,36,16,52
7,1,4,16,7,23
8,1,4,18,8,26
28,1,4,67,28,95
12,1,4,29,12,41
10,1,2,6,10,16
22,1,4,64,22,86
15,12,33,246,180,426
16,12,33,262,192,454
24,2,5,47,48,95
3,2,5,6,6,12
1,2,5,3,2,5
29,2,5,81,58,139
24,1,2,18,24,42
23,1,2,17,23,40
29,2,5,78,58,136
17,2,5,46,34,80
1,2,5,3,2,5
12,2,5,35,24,59
28,2,5,83,56,139
9,9,25,115,81,196
2,9,25,26,18,44
20,1,2,10,20,30
15,1,2,13,15,28
19,1,2,16,19,35
1,461,742,125,461,586
1,461,742,162,461,623
1,1482,2384,854,1482,2336
1,755,1215,375,755,1130
1,1482,2384,473,1482,1955
8,24,64,300,192,492
2,2,5,5,4,9
12,2,5,32,24,56
4,2,5,12,8,20
26,2,5,77,52,129
12,2,5,35,24,59
16,2,5,47,32,79
25,2,5,74,50,124
23,3,9,111,69,180
26,3,9,126,78,204
1,4,10,5,4,9
23,2,5,64,46,110
13,2,5,36,26,62
9,2,5,25,18,43
28,2,5,78,56,134
2,2,5,6,4,10
24,2,5,67,48,115
2,4,10,11,8,19
21,2,5,61,42,103
16,4,10,93,64,157
17,4,10,99,68,167
23,2,5,51,46,97
20,2,5,44,40,84
20,2,5,53,40,93
24,3,9,140,72,212
5,3,9,29,15,44
26,2,5,75,52,127
19,3,9,107,57,164
3,3,9,17,9,26
18,7,9,33,126,159
10,7,9,14,70,84
20,7,9,38,140,178
25,7,9,48,175,223
1,7,9,2,7,9
18,7,9,33,126,159
6,7,9,3,42,45
24,3,8,112,72,184
30,3,8,148,90,238
26,3,8,128,78,206
2,8,22,25,16,41
13,8,22,176,104,280
6,8,22,81,48,129
30,8,22,413,240,653
30,8,22,407,240,647
21,8,22,234,168,402
21,8,22,289,168,457
14,8,22,184,112,296
13,9,24,192,117,309
16,9,24,232,144,376
10,9,24,145,90,235
13,9,24,189,117,306
15,9,24,218,135,353
17,9,24,202,153,355
17,9,24,239,153,392
24,9,24,268,216,484
29,9,24,407,261,668
5,13,35,87,65,152
2,13,35,43,26,69
16,13,35,313,208,521
8,13,35,126,104,230
19,13,35,391,247,638
2,13,35,41,26,67
15,13,35,320,195,515
6,13,35,128,78,206
25,13,35,533,325,858
18,13,35,352,234,586
8,13,35,173,104,277
10,13,35,213,130,343
19,13,35,405,247,652
6,13,35,128,78,206
27,13,35,575,351,926
18,13,35,314,234,548
9,38,50,90,342,432
10,38,50,100,380,480
10,42,54,50,420,470
30,38,50,300,1140,1440
10,42,54,109,420,529
10,42,54,109,420,529
6,38,50,66,228,294
25,42,54,246,1050,1296
14,42,54,70,588,658
10,38,50,115,380,495
9,42,54,30,378,408
23,38,50,253,874,1127
1,1266,2320,892,1266,2158
1,1252,2295,1020,1252,2272
1,1252,2295,745,1252,1997
1,1252,2295,951,1252,2203
1,420,769,318,420,738
1,295,540,240,295,535
1,308,565,234,308,542
1,1266,2320,961,1266,2227
1,1266,2320,1008,1266,2274
1,1266,2320,1008,1266,2274
1,2171,3578,763,2171,2934
1,487,783,280,487,767
1,487,783,280,487,767
1,1555,2443,864,1555,2419
1,1555,2443,790,1555,2345
1,1555,2443,790,1555,2345
1,487,783,155,487,642
1,487,783,194,487,681
1,344,540,185,344,529
1,1083,1701,550,1083,1633
1,1519,2443,533,1519,2052
1,1555,2443,497,1555,2052
1,2171,3578,1335,2171,3506
1,344,540,174,344,518
1,713,1120,362,713,1075
16,26,70,682,416,1098
3,26,70,130,78,208
28,26,70,1212,728,1940
16,26,70,682,416,1098
25,26,70,1083,650,1733
19,1,2,13,19,32
21,1,2,15,21,36
27,1,2,19,27,46
29,1,2,21,29,50
5,2,5,14,10,24
23,12,33,453,276,729
21,12,33,413,252,665
8,2,5,22,16,38
11,2,5,31,22,53
12,2,5,34,24,58
6,2,5,13,12,25
1,2,5,2,2,4
3,12,33,50,36,86
13,12,33,217,156,373
17,1,2,16,17,33
23,1,2,21,23,44
2,1,2,1,2,3
5,1,2,3,5,8
5,8,21,63,40,103
28,8,21,352,224,576
4,11,30,74,44,118
3,11,30,55,33,88
20,1,2,11,20,31
23,1,2,13,23,36
10,1,4,24,10,34
19,1,4,46,19,65
24,1,2,23,24,47
22,1,2,21,22,43
10,2,5,30,20,50
5,2,5,15,10,25
20,2,5,59,40,99
26,2,5,75,52,127
10,1,2,8,10,18
1,1,2,1,1,2
1,1,2,1,1,2
7,1,4,20,7,27
5,1,4,11,5,16
6,1,4,13,6,19
23,9,25,293,207,500
5,2,5,12,10,22
8,2,5,19,16,35
1,1482,2384,592,1482,2074
1,1482,2384,592,1482,2074
1,1482,2384,807,1482,2289
1,755,1215,436,755,1191
1,461,742,266,461,727
11,24,64,433,264,697
6,24,64,190,144,334
1,45,120,53,45,98
3,45,120,218,135,353
28,2,5,59,56,115
17,2,5,36,34,70
29,2,5,67,58,125
21,2,5,48,42,90
17,2,5,48,34,82
23,2,5,64,46,110
3,4,10,16,12,28
23,2,5,68,46,114
6,2,5,18,12,30
12,3,9,58,36,94
6,3,9,29,18,47
23,3,9,130,69,199
26,3,9,147,78,225
20,2,5,38,40,78
3,2,5,6,6,12
29,2,5,55,58,113
12,2,5,23,24,47
18,2,5,52,36,88
14,3,9,83,42,125
7,3,9,41,21,62
27,3,9,157,81,238
22,2,5,51,44,95
28,2,5,64,56,120
5,3,9,27,15,42
28,3,9,150,84,234
9,2,5,21,18,39
5,2,5,12,10,22
9,2,5,26,18,44
7,2,5,20,14,34
18,7,9,13,126,139
19,7,9,31,133,164
9,7,9,16,63,79
26,3,8,101,78,179
18,8,22,244,144,388
25,8,22,339,200,539
14,8,22,174,112,286
15,8,22,167,120,287
30,8,22,275,240,515
5,8,22,55,40,95
1,8,22,14,8,22
14,8,22,193,112,305
15,9,24,149,135,284
20,9,24,290,180,470
27,9,24,379,243,622
9,9,24,133,81,214
3,9,24,36,27,63
16,9,24,225,144,369
3,13,35,64,39,103
27,13,35,528,351,879
1,13,35,17,13,30
20,13,35,391,260,651
1,13,35,14,13,27
7,13,35,100,91,191
25,13,35,541,325,866
14,13,35,220,182,402
15,13,35,236,195,431
3,13,35,65,39,104
7,13,35,103,91,194
6,13,35,124,78,202
27,13,35,396,351,747
29,13,35,455,377,832
12,13,35,256,156,412
27,13,35,556,351,907
2,13,35,43,26,69
22,13,35,469,286,755
17,13,35,231,221,452
26,13,35,554,338,892
23,13,35,329,299,628
8,13,35,117,104,221
6,21,55,191,126,317
12,21,55,302,252,554
9,21,55,242,189,431
2,38,50,6,76,82
20,42,54,218,840,1058
29,38,50,290,1102,1392
27,38,50,230,1026,1256
15,42,54,2,630,632
27,38,50,297,1026,1323
15,42,54,164,630,794
15,38,50,128,570,698
28,42,54,276,1176,1452
19,38,50,219,722,941
1,1266,2320,1008,1266,2274
1,420,769,295,420,715
1,420,769,334,420,754
1,1252,2295,951,1252,2203
1,1266,2320,1008,1266,2274
1,1252,2295,676,1252,1928
1,1252,2295,538,1252,1790
1,1266,2320,544,1266,1810
1,1252,2295,722,1252,1974
1,308,565,251,308,559
1,1266,2320,752,1266,2018
1,1252,2295,722,1252,1974
1,1555,2443,448,1555,2003
1,487,783,280,487,767
1,1083,1701,244,1083,1327
1,2171,3578,942,2171,3113
1,487,783,155,487,642
1,487,783,155,487,642
1,713,1120,161,713,874
1,713,1120,385,713,1098
1,713,1120,385,713,1098
1,344,540,158,344,502
1,2171,3578,620,2171,2791
1,344,540,174,344,518
1,1083,1701,550,1083,1633
1,344,540,158,344,502
1,487,783,194,487,681
2,26,70,82,52,134
14,26,70,596,364,960
7,26,70,298,182,480
22,3,9,106,66,172
27,3,9,123,81,204
24,3,9,142,72,214
14,2,5,27,28,55
6,2,5,12,12,24
15,1,2,14,15,29
19,2,5,50,38,88
5,2,5,13,10,23
30,1,2,29,30,59
27,1,4,77,27,104
20,1,4,57,20,77
17,1,2,10,17,27
19,1,2,11,19,30
12,1,2,7,12,19
30,1,2,17,30,47
16,1,2,15,16,31
1,1,2,1,1,2
17,2,5,45,34,79
23,2,5,61,46,107
15,1,2,14,15,29
6,13,35,105,78,183
21,13,35,366,273,639
20,9,25,300,180,480
28,2,5,59,56,115
5,2,5,12,10,22
19,2,5,45,38,83
26,13,35,454,338,792
5,1,4,12,5,17
2,1,4,5,2,7
30,1,2,17,30,47
15,1,2,9,15,24
7,11,30,99,77,176
8,1,2,6,8,14
25,1,2,19,25,44
19,1,2,11,19,30
27,1,2,26,27,53
2,1,2,1,2,3
7,1,4,15,7,22
14,1,4,30,14,44
11,9,25,165,99,264
16,9,25,240,144,384
30,2,5,69,60,129
25,2,5,58,50,108
19,8,21,239,152,391
11,8,21,138,88,226
3,2,5,6,6,12
30,2,5,57,60,117
1,1482,2384,521,1482,2003
1,1482,2384,735,1482,2217
1,1482,2384,401,1482,1883
1,755,1215,302,755,1057
1,1482,2384,807,1482,2289
1,461,742,274,461,735
1,1482,2384,330,1482,1812
1,461,742,266,461,727
1,1482,2384,854,1482,2336
1,461,742,118,461,579
14,24,64,435,336,771
26,24,64,1007,624,1631
17,24,64,528,408,936
2,24,64,63,48,111
6,59,159,428,354,782
4,3,9,15,12,27
10,3,9,38,30,68
9,2,5,19,18,37
3,2,5,6,6,12
10,4,10,59,40,99
9,4,10,53,36,89
14,2,5,41,28,69
18,2,5,52,36,88
29,2,5,81,58,139
13,2,5,36,26,62
30,2,5,87,60,147
17,3,9,96,51,147
12,2,5,35,24,59
12,2,5,35,24,59
5,2,5,15,10,25
25,2,5,73,50,123
23,2,5,54,46,100
8,2,5,19,16,35
9,2,5,27,18,45
24,3,9,140,72,212
7,4,10,41,28,69
6,2,5,14,12,26
10,2,5,23,20,43
15,2,5,35,30,65
19,2,5,45,38,83
26,7,9,43,182,225
2,7,9,2,14,16
5,7,9,7,35,42
24,7,9,18,168,186
22,7,9,40,154,194
27,7,9,52,189,241
23,7,9,32,161,193
20,3,8,97,60,157
7,3,8,33,21,54
25,3,8,93,75,168
17,8,22,231,136,367
3,8,22,28,24,52
3,8,22,41,24,65
9,8,22,94,72,166
27,8,22,366,216,582
8,8,22,108,64,172
5,8,22,50,40,90
11,8,22,120,88,208
4,8,22,44,32,76
20,8,22,271,160,431
6,8,22,60,48,108
9,8,22,112,72,184
27,9,24,249,243,492
16,9,24,186,144,330
10,9,24,148,90,238
3,9,24,44,27,71
21,13,35,359,273,632
15,13,35,246,195,441
16,13,35,346,208,554
24,13,35,494,312,806
5,13,35,79,65,144
5,13,35,107,65,172
30,13,35,618,390,1008
25,13,35,533,325,858
30,13,35,618,390,1008
9,13,35,192,117,309
27,13,35,585,351,936
14,13,35,200,182,382
2,13,35,43,26,69
20,13,35,342,260,602
25,13,35,541,325,866
16,13,35,330,208,538
18,13,35,390,234,624
27,13,35,575,351,926
3,13,35,64,39,103
23,13,35,490,299,789
9,13,35,157,117,274
30,13,35,471,390,861
16,13,35,251,208,459
29,13,35,597,377,974
4,13,35,87,52,139
25,13,35,533,325,858
9,13,35,192,117,309
1,13,35,16,13,29
9,13,35,176,117,293
17,21,55,382,357,739
13,21,55,428,273,701
26,42,54,129,1092,1221
28,38,50,84,1064,1148
10,42,54,44,420,464
24,42,54,16,1008,1024
9,38,50,99,342,441
4,38,50,34,152,186
1,1252,2295,951,1252,2203
1,1252,2295,951,1252,2203
1,1266,2320,752,1266,2018
1,1252,2295,722,1252,1974
1,420,769,341,420,761
1,1252,2295,997,1252,2249
1,420,769,241,420,661
1,1266,2320,567,1266,1833
1,420,769,249,420,669
1,1252,2295,538,1252,1790
1,1266,2320,961,1266,2227
1,295,540,207,295,502
1,1912,3400,1012,1912,2924
1,1252,2295,538,1252,1790
1,2171,3578,1371,2171,3542
1,1555,2443,864,1555,2419
1,344,540,174,344,518
1,344,540,126,344,470
1,1083,1701,550,1083,1633
1,344,540,99,344,443
1,487,783,132,487,619
1,344,540,191,344,535
1,344,540,99,344,443
1,713,1120,329,713,1042
16,3,9,93,48,141
8,3,9,47,24,71
17,3,9,99,51,150
30,2,5,87,60,147
14,2,5,41,28,69
18,2,5,52,36,88
3,2,5,9,6,15
26,1,4,61,26,87
12,12,33,248,144,392
30,12,33,620,360,980
13,13,35,222,169,391
3,1,4,9,3,12
13,11,30,239,143,382
8,11,30,147,88,235
3,9,25,45,27,72
1,9,25,15,9,24
30,1,4,74,30,104
27,2,5,80,54,134
10,1,4,28,10,38
25,1,4,71,25,96
27,1,4,77,27,104
25,1,2,16,25,41
28,13,35,459,364,823
23,13,35,377,299,676
13,2,5,38,26,64
25,1,2,24,25,49
8,2,5,19,16,35
16,2,5,38,32,70
27,1,4,79,27,106
11,1,4,32,11,43
2,1,4,6,2,8
3,1,4,9,3,12
2,1,4,5,2,7
4,1,2,2,4,6
30,2,5,87,60,147
2,1,2,1,2,3
9,1,2,5,9,14
23,1,4,65,23,88
6,1,4,15,6,21
24,2,5,46,48,94
24,8,21,277,192,469
7,8,21,81,56,137
15,11,29,240,165,405
24,11,29,383,264,647
20,1,4,58,20,78
22,1,4,64,22,86
1,1482,2384,330,1482,1812
1,1482,2384,807,1482,2289
1,1482,2384,807,1482,2289
1,755,1215,411,755,1166
1,1482,2384,521,1482,2003
1,1482,2384,473,1482,1955
1,1482,2384,878,1482,2360
1,755,1215,436,755,1191
1,755,1215,290,755,1045
1,461,742,266,461,727
3,24,64,80,72,152
4,45,120,199,180,379
8,45,120,581,360,941
4,45,120,185,180,365
19,45,120,1106,855,1961
3,59,159,238,177,415
16,2,5,47,32,79
19,2,5,53,38,91
1,2,5,3,2,5
21,2,5,61,42,103
8,2,5,23,16,39
24,2,5,64,48,112
6,2,5,16,12,28
8,2,5,22,16,38
2,2,5,6,4,10
23,4,10,129,92,221
25,4,10,140,100,240
12,2,5,28,24,52
21,3,9,113,63,176
12,2,5,35,24,59
25,3,9,103,75,178
4,3,9,16,12,28
22,7,9,8,154,162
19,7,9,17,133,150
8,7,9,13,56,69
15,3,8,73,45,118
9,8,22,84,72,156
5,8,22,68,40,108
25,8,22,339,200,539
24,8,22,331,192,523
26,9,24,309,234,543
20,9,24,281,180,461
26,9,24,378,234,612
16,9,24,232,144,376
4,13,35,59,52,111
27,13,35,396,351,747
1,13,35,21,13,34
26,13,35,445,338,783
16,13,35,341,208,549
4,13,35,82,52,134
13,13,35,277,169,446
24,13,35,368,312,680
20,13,35,349,260,609
13,13,35,277,169,446
11,13,35,234,143,377
6,13,35,124,78,202
14,13,35,249,182,431
27,13,35,575,351,926
10,13,35,143,130,273
9,13,35,157,117,274
22,13,35,430,286,716
3,13,35,65,39,104
17,21,55,559,357,916
23,21,55,757,483,1240
13,38,50,130,494,624
28,38,50,308,1064,1372
17,42,54,11,714,725
12,38,50,132,456,588
24,38,50,240,912,1152
25,42,54,17,1050,1067
1,1912,3400,774,1912,2686
1,1252,2295,882,1252,2134
1,1266,2320,961,1266,2227
1,1266,2320,636,1266,1902
1,1266,2320,752,1266,2018
1,308,565,251,308,559
1,295,540,234,295,529
1,1266,2320,497,1266,1763
1,420,769,295,420,715
1,2171,3578,1264,2171,3435
1,1519,2443,753,1519,2272
1,713,1120,329,713,1042
1,344,540,158,344,502
1,487,783,265,487,752
1,344,540,174,344,518
1,2171,3578,1371,2171,3542
1,344,540,77,344,421
1,344,540,174,344,518
1,487,783,132,487,619
14,26,70,440,364,804
11,3,9,45,33,78
10,1,2,10,10,20
14,1,2,9,14,23
21,1,2,13,21,34
9,1,2,9,9,18
1,1,2,1,1,2
6,1,2,6,6,12
27,1,2,20,27,47
5,1,2,4,5,9
17,1,2,10,17,27
15,1,2,9,15,24
4,1,2,2,4,6
20,2,5,46,40,86
26,2,5,73,52,125
24,2,5,67,48,115
30,2,5,84,60,144
26,1,2,19,26,45
24,1,2,17,24,41
13,2,5,31,26,57
14,2,5,33,28,61
15,1,2,11,15,26
15,1,2,11,15,26
20,2,5,58,40,98
27,2,5,78,54,132
5,9,25,71,45,116
18,2,5,53,36,89
30,9,25,345,270,615
23,9,25,265,207,472
20,2,5,58,40,98
28,11,30,347,308,655
24,11,30,298,264,562
8,1,2,5,8,13
15,1,2,9,15,24
10,1,2,10,10,20
8,8,21,77,64,141
6,8,21,58,48,106
24,8,21,231,192,423
15,2,5,29,30,59
27,1,2,26,27,53
16,1,2,15,16,31
8,1,4,20,8,28
24,8,21,302,192,494
12,8,21,151,96,247
21,1,2,16,21,37
11,1,2,8,11,19
1,1482,2384,401,1482,1883
1,461,742,140,461,601
1,1482,2384,807,1482,2289
1,1482,2384,616,1482,2098
1,1482,2384,401,1482,1883
1,1482,2384,854,1482,2336
1,1482,2384,568,1482,2050
1,1482,2384,854,1482,2336
1,1482,2384,854,1482,2336
1,461,742,266,461,727
18,24,64,639,432,1071
24,45,120,1771,1080,2851
1,45,120,73,45,118
17,3,9,100,51,151
28,3,9,165,84,249
7,4,10,27,28,55
13,2,5,25,26,51
26,2,5,49,52,101
24,2,5,56,48,104
16,2,5,38,32,70
3,2,5,7,6,13
1,2,5,2,2,4
16,2,5,30,32,62
24,2,5,46,48,94
22,4,10,128,88,216
12,4,10,70,48,118
15,2,5,29,30,59
23,2,5,45,46,91
23,2,5,64,46,110
30,3,9,123,90,213
9,3,9,37,27,64
7,2,5,21,14,35
25,3,9,141,75,216
14,7,9,23,98,121
21,7,9,40,147,187
8,7,9,15,56,71
13,7,9,11,91,102
8,7,9,0,56,56
21,3,8,75,63,138
3,8,22,27,24,51
10,8,22,92,80,172
23,8,22,251,184,435
20,8,22,276,160,436
24,9,24,268,216,484
27,9,24,314,243,557
9,9,24,90,81,171
5,13,35,103,65,168
24,13,35,394,312,706
29,13,35,597,377,974
19,13,35,298,247,545
22,13,35,322,286,608
27,13,35,528,351,879
5,13,35,72,65,137
18,13,35,352,234,586
17,13,35,291,221,512
17,13,35,297,221,518
5,13,35,108,65,173
9,13,35,132,117,249
4,13,35,57,52,109
23,13,35,377,299,676
26,13,35,554,338,892
8,13,35,170,104,274
14,13,35,230,182,412
22,13,35,384,286,670
28,13,35,606,364,970
16,13,35,341,208,549
13,13,35,190,169,359
4,13,35,82,52,134
14,21,55,445,294,739
16,38,50,160,608,768
5,38,50,58,190,248
6,42,54,4,252,256
5,42,54,25,210,235
4,42,54,39,168,207
25,42,54,3,1050,1053
13,42,54,142,546,688
2,38,50,20,76,96
1,1252,2295,538,1252,1790
1,1266,2320,1031,1266,2297
1,295,540,126,295,421
1,1266,2320,567,1266,1833
1,1252,2295,722,1252,1974
1,2171,3578,1264,2171,3435
1,2171,3578,1335,2171,3506
1,1519,2443,753,1519,2272
1,2171,3578,942,2171,3113
1,1083,1701,244,1083,1327
1,2171,3578,835,2171,3006
1,2171,3578,656,2171,2827
1,713,1120,329,713,1042
1,1555,2443,497,1555,2052
1,1555,2443,497,1555,2052
1,1519,2443,533,1519,2052
1,1519,2443,411,1519,1930
1,1083,1701,397,1083,1480
1,344,540,77,344,421
1,344,540,185,344,529
1,1083,1701,261,1083,1344
1,487,783,132,487,619
1,344,540,174,344,518
27,26,70,1112,702,1814
15,26,70,650,390,1040
27,26,70,923,702,1625
29,3,9,171,87,258
22,3,9,128,66,194
27,3,9,130,81,211
19,3,9,90,57,147
23,2,5,67,46,113
23,2,5,67,46,113
6,2,5,17,12,29
11,1,2,6,11,17
7,1,2,4,7,11
7,13,35,149,91,240
6,11,29,80,66,146
21,11,29,281,231,512
16,13,35,330,208,538
5,13,35,103,65,168
11,9,25,132,99,231
22,1,2,22,22,44
19,1,4,52,19,71
16,2,5,30,32,62
19,2,5,36,38,74
4,2,5,8,8,16
16,2,5,34,32,66
13,1,4,32,13,45
24,2,5,71,48,119
24,2,5,71,48,119
1,1,4,3,1,4
21,1,4,57,21,78
1,1,4,3,1,4
3,2,5,9,6,15
15,2,5,44,30,74
23,1,2,22,23,45
27,1,2,26,27,53
11,1,4,26,11,37
19,8,21,195,152,347
3,8,21,36,24,60
12,2,5,23,24,47
1,2,5,2,2,4
5,11,29,58,55,113
20,2,5,42,40,82
1,2,5,2,2,4
5,8,21,61,40,101
1,755,1215,448,755,1203
1,1482,2384,473,1482,1955
1,461,742,125,461,586
1,1482,2384,854,1482,2336
1,1482,2384,854,1482,2336
1,755,1215,436,755,1191
1,1482,2384,854,1482,2336
1,461,742,125,461,586
1,461,742,185,461,646
1,1482,2384,568,1482,2050
1,1482,2384,854,1482,2336
1,461,742,251,461,712
4,24,64,106,96,202
14,24,64,524,336,860
9,45,120,502,405,907
17,2,5,48,34,82
17,2,5,48,34,82
6,2,5,16,12,28
4,2,5,11,8,19
18,3,9,106,54,160
22,3,9,130,66,196
17,2,5,49,34,83
2,2,5,6,4,10
13,2,5,36,26,62
1,4,10,6,4,10
9,4,10,53,36,89
24,4,10,113,96,209
14,2,5,29,28,57
20,2,5,42,40,82
30,4,10,174,120,294
29,4,10,168,116,284
6,2,5,14,12,26
13,2,5,30,26,56
4,3,9,21,12,33
20,3,9,107,60,167
30,2,5,87,60,147
26,2,5,75,52,127
26,3,9,107,78,185
22,3,9,90,66,156
21,2,5,61,42,103
8,2,5,23,16,39
15,7,9,29,105,134
16,7,9,13,112,125
20,7,9,17,140,157
13,7,9,24,91,115
7,7,9,6,49,55
18,7,9,33,126,159
11,7,9,0,77,77
18,7,9,33,126,159
28,3,8,124,84,208
24,8,22,220,192,412
14,8,22,147,112,259
1,8,22,14,8,22
10,8,22,136,80,216
7,8,22,73,56,129
27,8,22,372,216,588
14,8,22,190,112,302
25,8,22,251,200,451
9,8,22,82,72,154
19,8,22,262,152,414
4,8,22,55,32,87
4,8,22,55,32,87
18,8,22,248,144,392
1,9,24,12,9,21
6,9,24,80,54,134
3,9,24,40,27,67
29,9,24,282,261,543
2,9,24,29,18,47
5,13,35,73,65,138
10,13,35,171,130,301
13,13,35,227,169,396
16,13,35,234,208,442
21,13,35,455,273,728
18,13,35,390,234,624
6,13,35,94,78,172
5,13,35,87,65,152
6,13,35,128,78,206
4,13,35,78,52,130
5,13,35,72,65,137
29,13,35,496,377,873
23,13,35,377,299,676
1,13,35,16,13,29
7,13,35,137,91,228
24,13,35,494,312,806
15,21,55,502,315,817
1,21,55,33,21,54
6,21,55,135,126,261
24,38,50,264,912,1176
18,38,50,99,684,783
15,38,50,165,570,735
29,42,54,238,1218,1456
20,42,54,2,840,842
26,38,50,286,988,1274
11,42,54,126,462,588
26,42,54,115,1092,1207
23,42,54,52,966,1018
27,42,54,18,1134,1152
1,1252,2295,997,1252,2249
1,1252,2295,882,1252,2134
1,1252,2295,882,1252,2134
1,1252,2295,676,1252,1928
1,1252,2295,997,1252,2249
1,1266,2320,1008,1266,2274
1,1252,2295,676,1252,1928
1,1266,2320,1031,1266,2297
1,1252,2295,561,1252,1813
1,1266,2320,752,1266,2018
1,1266,2320,892,1266,2158
1,1266,2320,544,1266,1810
1,1252,2295,997,1252,2249
1,1252,2295,538,1252,1790
1,1898,3375,1038,1898,2936
1,2171,3578,1335,2171,3506
1,487,783,194,487,681
1,1555,2443,839,1555,2394
1,2171,3578,1335,2171,3506
1,1555,2443,375,1555,1930
1,1519,2443,533,1519,2052
1,344,540,120,344,464
1,713,1120,172,713,885
1,2171,3578,1335,2171,3506
1,26,70,41,26,67
26,26,70,1108,676,1784
18,3,9,106,54,160
29,3,9,140,87,227
12,3,9,68,36,104
8,3,9,32,24,56
7,13,35,152,91,243
13,13,35,281,169,450
24,9,25,258,216,474
14,11,30,262,154,416
27,11,30,505,297,802
22,9,25,347,198,545
27,9,25,425,243,668
16,1,2,15,16,31
19,1,2,14,19,33
25,2,5,59,50,109
7,13,35,100,91,191
6,1,4,16,6,22
8,1,4,22,8,30
15,1,2,10,15,25
20,1,2,14,20,34
26,2,5,77,52,129
10,2,5,30,20,50
2,1,2,1,2,3
26,1,2,15,26,41
22,12,33,302,264,566
9,1,4,26,9,35
25,1,4,62,25,87
22,1,4,55,22,77
17,1,4,42,17,59
6,1,2,6,6,12
1,461,742,177,461,638
1,1482,2384,807,1482,2289
1,1482,2384,592,1482,2074
1,755,1215,302,755,1057
1,1482,2384,807,1482,2289
1,1482,2384,854,1482,2336
1,755,1215,436,755,1191
1,1482,2384,592,1482,2074
1,1482,2384,473,1482,1955
1,461,742,251,461,712
8,24,64,315,192,507
5,59,159,468,295,763
18,4,10,85,72,157
1,4,10,5,4,9
12,2,5,25,24,49
6,2,5,13,12,25
23,2,5,64,46,110
30,2,5,84,60,144
28,2,5,81,56,137
7,4,10,32,28,60
2,4,10,9,8,17
3,4,10,17,12,29
12,4,10,67,48,115
26,2,5,57,52,109
10,2,5,22,20,42
7,2,5,15,14,29
16,2,5,38,32,70
30,2,5,71,60,131
7,2,5,20,14,34
13,2,5,38,26,64
9,4,10,34,36,70
6,2,5,11,12,23
4,2,5,8,8,16
15,2,5,44,30,74
21,2,5,61,42,103
23,2,5,51,46,97
10,2,5,22,20,42
20,2,5,47,40,87
21,2,5,49,42,91
4,2,5,8,8,16
27,2,5,51,54,105
14,2,5,31,28,59
15,2,5,33,30,63
21,2,5,49,42,91
15,2,5,35,30,65
10,2,5,28,20,48
23,2,5,64,46,110
26,7,9,24,182,206
26,7,9,10,182,192
21,7,9,40,147,187
4,7,9,7,28,35
14,7,9,5,98,103
18,7,9,33,126,159
16,7,9,9,112,121
19,7,9,26,133,159
21,3,8,102,63,165
14,3,8,68,42,110
11,3,8,43,33,76
16,3,8,79,48,127
26,3,8,103,78,181
28,3,8,111,84,195
19,8,22,258,152,410
9,8,22,124,72,196
8,9,24,95,72,167
19,9,24,221,171,392
5,9,24,49,45,94
15,9,24,160,135,295
8,9,24,78,72,150
14,9,24,163,126,289
26,9,24,303,234,537
16,13,35,229,208,437
17,13,35,350,221,571
23,13,35,393,299,692
19,13,35,298,247,545
6,13,35,86,78,164
1,13,35,22,13,35
24,13,35,469,312,781
11,13,35,157,143,300
16,13,35,330,208,538
5,13,35,108,65,173
7,13,35,152,91,243
26,13,35,554,338,892
25,13,35,393,325,718
25,13,35,428,325,753
21,13,35,447,273,720
12,13,35,256,156,412
7,13,35,152,91,243
6,13,35,103,78,181
27,13,35,528,351,879
8,13,35,156,104,260
25,13,35,436,325,761
14,21,55,445,294,739
12,21,55,322,252,574
29,42,54,332,1218,1550
1,42,54,4,42,46
27,42,54,309,1134,1443
13,42,54,23,546,569
23,42,54,15,966,981
1,1252,2295,997,1252,2249
1,420,769,241,420,661
1,308,565,155,308,463
1,1266,2320,729,1266,1995
1,295,540,234,295,529
1,295,540,240,295,535
1,308,565,251,308,559
1,1252,2295,997,1252,2249
1,2171,3578,978,2171,3149
1,1555,2443,351,1555,1906
1,1555,2443,717,1555,2272
1,713,1120,385,713,1098
1,487,783,288,487,775
1,1555,2443,570,1555,2125
1,713,1120,385,713,1098
1,2171,3578,620,2171,2791
1,344,540,185,344,529
1,1083,1701,584,1083,1667
1,487,783,132,487,619
1,713,1120,205,713,918
1,344,540,174,344,518
23,26,70,658,598,1256
29,3,9,127,87,214
5,3,9,21,15,36
27,3,9,157,81,238
16,8,21,205,128,333
20,8,21,256,160,416
26,9,25,410,234,644
16,1,2,15,16,31
4,1,2,4,4,8
4,1,2,4,4,8
14,1,2,14,14,28
12,1,2,12,12,24
1,1,2,1,1,2
2,13,35,43,26,69
26,13,35,554,338,892
23,2,5,55,46,101
24,2,5,50,48,98
9,2,5,19,18,37
30,1,2,22,30,52
27,1,2,19,27,46
7,1,2,5,7,12
24,1,2,18,24,42
8,1,2,5,8,13
5,1,2,5,5,10
15,1,2,15,15,30
11,11,30,196,121,317
17,11,30,303,187,490
28,9,25,399,252,651
9,9,25,128,81,209
24,1,2,16,24,40
5,11,30,76,55,131
7,12,33,103,84,187
9,2,5,26,18,44
25,2,5,73,50,123
16,1,2,16,16,32
5,9,25,75,45,120
10,9,25,150,90,240
28,1,2,27,28,55
12,1,2,12,12,24
10,1,2,10,10,20
15,1,2,15,15,30
6,1,2,6,6,12
24,1,4,59,24,83
2,1,4,5,2,7
22,1,2,19,22,41
23,8,21,265,184,449
23,8,21,265,184,449
15,8,21,173,120,293
21,2,5,61,42,103
20,2,5,53,40,93
20,2,5,53,40,93
22,2,5,51,44,95
24,2,5,55,48,103
29,1,2,21,29,50
29,11,29,320,319,639
1,1482,2384,521,1482,2003
1,1482,2384,807,1482,2289
1,1482,2384,807,1482,2289
1,1482,2384,807,1482,2289
1,755,1215,436,755,1191
9,59,159,714,531,1245
21,2,5,40,42,82
15,2,5,29,30,59
4,2,5,8,8,16
19,2,5,37,38,75
22,2,5,52,44,96
28,2,5,66,56,122
22,2,5,58,44,102
3,2,5,8,6,14
9,4,10,53,36,89
25,4,10,95,100,195
14,2,5,27,28,55
30,2,5,89,60,149
16,2,5,38,32,70
12,2,5,28,24,52
6,2,5,18,12,30
7,2,5,21,14,35
18,2,5,50,36,86
9,2,5,25,18,43
24,2,5,70,48,118
14,2,5,41,28,69
4,2,5,8,8,16
1,2,5,2,2,4
4,2,5,12,8,20
25,2,5,73,50,123
23,2,5,67,46,113
5,2,5,15,10,25
13,4,10,49,52,101
21,2,5,41,42,83
26,2,5,61,52,113
10,2,5,24,20,44
1,2,5,3,2,5
19,2,5,55,38,93
1,2,5,3,2,5
7,3,9,32,21,53
3,3,9,14,9,23
16,7,9,29,112,141
17,7,9,0,119,119
13,7,9,1,91,92
2,7,9,0,14,14
29,7,9,1,203,204
28,3,8,138,84,222
9,3,8,40,27,67
27,3,8,90,81,171
7,3,8,34,21,55
1,3,8,3,3,6
29,3,8,115,87,202
6,3,8,24,18,42
4,8,22,44,32,76
15,8,22,203,120,323
20,8,22,276,160,436
10,8,22,109,80,189
15,8,22,203,120,323
21,8,22,192,168,360
6,8,22,56,48,104
19,9,24,280,171,451
21,9,24,295,189,484
26,9,24,278,234,512
18,13,35,314,234,548
29,13,35,425,377,802
8,13,35,165,104,269
8,13,35,173,104,277
30,13,35,618,390,1008
7,13,35,144,91,235
4,13,35,82,52,134
30,13,35,440,390,830
26,13,35,554,338,892
5,13,35,107,65,172
2,13,35,43,26,69
16,13,35,274,208,482
26,13,35,563,338,901
18,13,35,308,234,542
16,21,55,535,336,871
10,21,55,269,210,479
4,21,55,88,84,172
14,42,54,70,588,658
18,42,54,177,756,933
10,38,50,110,380,490
14,38,50,119,532,651
25,42,54,17,1050,1067
29,42,54,66,1218,1284
28,42,54,276,1176,1452
17,38,50,170,646,816
15,38,50,165,570,735
28,38,50,84,1064,1148
30,42,54,101,1260,1361
11,38,50,121,418,539
1,1266,2320,1008,1266,2274
1,1252,2295,882,1252,2134
1,420,769,334,420,754
1,1252,2295,607,1252,1859
1,295,540,240,295,535
1,295,540,207,295,502
1,1252,2295,951,1252,2203
1,420,769,249,420,669
1,295,540,234,295,529
1,295,540,234,295,529
1,713,1120,362,713,1075
1,344,540,99,344,443
1,1519,2443,533,1519,2052
1,487,783,288,487,775
6,1,2,6,6,12
21,13,35,447,273,720
5,13,35,107,65,172
10,2,5,28,20,48
18,2,5,50,36,86
21,2,5,40,42,82
4,2,5,8,8,16
22,2,5,51,44,95
22,2,5,42,44,86
18,2,5,34,36,70
2,9,25,31,18,49
30,9,25,465,270,735
20,9,25,310,180,490
28,2,5,53,56,109
25,2,5,48,50,98
26,1,2,15,26,41
22,1,2,13,22,35
4,1,4,11,4,15
26,1,4,74,26,100
12,13,35,247,156,403
16,13,35,330,208,538
28,13,35,577,364,941
21,2,5,62,42,104
20,2,5,59,40,99
10,2,5,29,20,49
20,2,5,58,40,98
26,9,25,410,234,644
14,9,25,221,126,347
4,1,2,2,4,6
6,1,2,3,6,9
9,11,30,160,99,259
16,1,4,47,16,63
9,1,4,27,9,36
8,8,21,74,64,138
25,1,2,19,25,44
22,11,29,383,242,625
19,1,4,45,19,64
22,8,21,268,176,444
13,8,21,158,104,262
24,2,5,67,48,115
16,1,2,9,16,25
23,9,25,293,207,500
15,9,25,191,135,326
9,1,2,6,9,15
21,1,2,21,21,42
15,1,2,13,15,28
10,1,2,9,10,19
30,2,5,84,60,144
14,1,4,35,14,49
28,2,5,59,56,115
2,2,5,4,4,8
3,1,4,9,3,12
6,1,4,17,6,23
26,1,4,63,26,89
17,1,4,41,17,58
28,1,2,21,28,49
1,1482,2384,401,1482,1883
1,1482,2384,401,1482,1883
1,1482,2384,807,1482,2289
1,1482,2384,401,1482,1883
1,461,742,185,461,646
2,24,64,52,48,100
9,24,64,354,216,570
3,24,64,89,72,161
7,59,159,689,413,1102
6,2,5,18,12,30
28,2,5,81,56,137
23,2,5,67,46,113
29,2,5,84,58,142
20,3,9,80,60,140
12,3,9,48,36,84
10,2,5,24,20,44
20,2,5,47,40,87
15,7,9,8,105,113
2,7,9,2,14,16
20,7,9,2,140,142
16,7,9,6,112,118
4,7,9,7,28,35
23,7,9,42,161,203
7,7,9,6,49,55
12,3,8,58,36,94
3,8,22,41,24,65
15,8,22,203,120,323
15,8,22,203,120,323
25,8,22,328,200,528
29,8,22,291,232,523
1,8,22,9,8,17
23,8,22,317,184,501
18,9,24,240,162,402
14,9,24,139,126,265
26,9,24,253,234,487
23,9,24,306,207,513
17,9,24,239,153,392
10,13,35,175,130,305
11,13,35,238,143,381
20,13,35,426,260,686
19,13,35,272,247,519
11,13,35,192,143,335
16,13,35,341,208,549
12,13,35,256,156,412
23,13,35,490,299,789
10,13,35,175,130,305
23,13,35,401,299,700
2,13,35,41,26,67
29,13,35,567,377,944
14,13,35,200,182,382
27,13,35,575,351,926
20,13,35,349,260,609
6,13,35,86,78,164
20,13,35,293,260,553
20,21,55,449,420,869
9,21,55,296,189,485
29,21,55,954,609,1563
29,21,55,699,609,1308
3,42,54,34,126,160
14,38,50,119,532,651
9,42,54,1,378,379
28,42,54,276,1176,1452
9,38,50,99,342,441
26,38,50,78,988,1066
12,38,50,132,456,588
1,1252,2295,538,1252,1790
1,1252,2295,997,1252,2249
1,1252,2295,745,1252,1997
1,420,769,334,420,754
1,1252,2295,561,1252,1813
1,1266,2320,1008,1266,2274
1,1266,2320,892,1266,2158
1,420,769,211,420,631
1,2171,3578,1157,2171,3328
1,487,783,280,487,767
1,1555,2443,570,1555,2125
1,713,1120,261,713,974
1,2171,3578,656,2171,2827
1,713,1120,385,713,1098
1,344,540,174,344,518
1,2171,3578,620,2171,2791
23,26,70,980,598,1578
20,1,4,59,20,79
24,1,4,71,24,95
17,1,2,10,17,27
30,1,2,17,30,47
5,1,2,3,5,8
10,2,5,30,20,50
10,2,5,30,20,50
19,1,2,18,19,37
16,1,2,15,16,31
1,1,2,1,1,2
4,1,2,3,4,7
24,1,2,18,24,42
8,1,2,7,8,15
7,2,5,13,14,27
16,2,5,30,32,62
19,2,5,36,38,74
19,2,5,36,38,74
12,13,35,256,156,412
30,13,35,639,390,1029
23,2,5,68,46,114
3,2,5,9,6,15
5,1,4,12,5,17
18,1,2,17,18,35
7,1,2,6,7,13
14,11,30,190,154,344
23,1,2,17,23,40
15,1,2,11,15,26
21,11,30,286,231,517
4,11,30,54,44,98
14,11,30,220,154,374
5,1,4,12,5,17
27,1,2,16,27,43
23,12,33,346,276,622
7,1,4,20,7,27
10,12,33,137,120,257
10,12,33,137,120,257
27,2,5,72,54,126
24,2,5,64,48,112
27,1,2,20,27,47
7,1,4,15,7,22
29,1,2,16,29,45
9,9,25,115,81,196
15,9,25,191,135,326
28,11,29,358,308,666
24,11,29,307,264,571
11,11,29,141,121,262
15,9,25,233,135,368
24,1,2,18,24,42
21,1,2,16,21,37
1,1482,2384,521,1482,2003
1,461,742,185,461,646
1,1482,2384,592,1482,2074
1,1482,2384,473,1482,1955
4,45,120,238,180,418
23,4,10,108,92,200
24,4,10,113,96,209
1,2,5,2,2,4
23,2,5,54,46,100
2,4,10,9,8,17
20,2,5,58,40,98
20,2,5,58,40,98
11,2,5,32,22,54
2,4,10,12,8,20
24,4,10,139,96,235
9,2,5,27,18,45
26,2,5,77,52,129
22,2,5,62,44,106
4,2,5,11,8,19
20,2,5,44,40,84
30,2,5,66,60,126
22,2,5,62,44,106
3,2,5,8,6,14
1,7,9,2,7,9
22,7,9,42,154,196
27,7,9,22,189,211
25,7,9,-4,175,171
3,7,9,5,21,26
9,7,9,0,63,63
29,7,9,55,203,258
23,7,9,44,161,205
8,3,8,26,24,50
26,3,8,84,78,162
5,3,8,23,15,38
24,8,22,262,192,454
19,8,22,174,152,326
26,8,22,358,208,566
9,8,22,118,72,190
18,8,22,248,144,392
1,9,24,12,9,21
24,9,24,285,216,501
1,9,24,12,9,21
27,9,24,301,243,544
5,13,35,68,65,133
6,13,35,86,78,164
3,13,35,49,39,88
21,13,35,366,273,639
25,13,35,436,325,761
3,13,35,59,39,98
7,13,35,152,91,243
9,13,35,157,117,274
12,13,35,209,156,365
8,13,35,165,104,269
30,13,35,513,390,903
7,13,35,110,91,201
21,13,35,433,273,706
15,13,35,309,195,504
9,13,35,192,117,309
12,13,35,188,156,344
14,13,35,303,182,485
8,13,35,170,104,274
3,13,35,47,39,86
13,13,35,227,169,396
30,13,35,492,390,882
15,13,35,262,195,457
14,13,35,288,182,470
17,13,35,297,221,518
19,13,35,332,247,579
19,21,55,416,399,815
20,21,55,482,420,902
23,38,50,127,874,1001
16,38,50,48,608,656
15,38,50,173,570,743
24,38,50,132,912,1044
3,38,50,30,114,144
16,42,54,175,672,847
29,38,50,160,1102,1262
1,1252,2295,951,1252,2203
1,1266,2320,497,1266,1763
1,1266,2320,544,1266,1810
1,1252,2295,538,1252,1790
1,1266,2320,729,1266,1995
1,420,769,334,420,754
1,1266,2320,752,1266,2018
1,420,769,211,420,631
1,1266,2320,961,1266,2227
1,1252,2295,882,1252,2134
1,1266,2320,636,1266,1902
1,1252,2295,630,1252,1882
1,2171,3578,942,2171,3113
1,2171,3578,1264,2171,3435
1,1519,2443,606,1519,2125
1,487,783,155,487,642
1,713,1120,362,713,1075
1,487,783,265,487,752
1,2171,3578,835,2171,3006
1,344,540,185,344,529
1,344,540,185,344,529
1,1519,2443,533,1519,2052
1,713,1120,396,713,1109
1,344,540,126,344,470
1,487,783,171,487,658
1,344,540,174,344,518
24,26,70,1039,624,1663
9,3,9,43,27,70
13,3,9,52,39,91
25,3,9,148,75,223
26,3,9,126,78,204
23,13,35,490,299,789
23,13,35,490,299,789
14,2,5,27,28,55
20,2,5,59,40,99
5,2,5,11,10,21
12,2,5,25,24,49
25,9,25,394,225,619
29,11,30,438,319,757
28,11,30,423,308,731
12,11,29,153,132,285
7,9,25,81,63,144
20,9,25,230,180,410
4,2,5,11,8,19
26,2,5,69,52,121
20,12,33,301,240,541
19,1,2,14,19,33
21,1,2,16,21,37
5,1,4,10,5,15
24,1,2,18,24,42
12,1,2,9,12,21
5,2,5,15,10,25
13,1,2,12,13,25
25,1,2,17,25,42
14,1,2,10,14,24
8,1,2,5,8,13
8,2,5,17,16,33
29,2,5,61,58,119
30,1,4,82,30,112
1,1,4,3,1,4
13,1,2,12,13,25
17,2,5,39,34,73
2,2,5,5,4,9
10,2,5,21,20,41
23,2,5,48,46,94
11,8,21,134,88,222
7,8,21,85,56,141
8,8,21,97,64,161
27,12,33,371,324,695
30,8,21,289,240,529
24,2,5,71,48,119
29,2,5,86,58,144
16,2,5,46,32,78
7,2,5,20,14,34
11,1,2,8,11,19
23,1,2,17,23,40
17,1,4,48,17,65
30,1,4,85,30,115
3,1,4,9,3,12
7,1,2,4,7,11
28,2,5,81,56,137
1,1482,2384,592,1482,2074
1,461,742,185,461,646
1,1482,2384,735,1482,2217
1,1482,2384,878,1482,2360
1,1482,2384,592,1482,2074
5,59,159,468,295,763
8,59,159,749,472,1221
30,4,10,117,120,237
27,3,9,123,81,204
28,3,9,128,84,212
13,2,5,31,26,57
12,2,5,34,24,58
5,2,5,14,10,24
10,4,10,38,40,78
28,2,5,78,56,134
18,2,5,50,36,86
21,2,5,49,42,91
8,2,5,19,16,35
28,2,5,78,56,134
16,2,5,45,32,77
13,2,5,30,26,56
2,2,5,5,4,9
25,2,5,55,50,105
22,2,5,48,44,92
18,2,5,53,36,89
8,2,5,24,16,40
19,2,5,55,38,93
14,2,5,41,28,69
23,3,9,92,69,161
29,3,9,117,87,204
13,7,9,18,91,109
12,7,9,10,84,94
16,7,9,6,112,118
14,8,22,156,112,268
5,8,22,50,40,90
11,8,22,149,88,237
1,8,22,13,8,21
24,8,22,267,192,459
10,8,22,94,80,174
18,8,22,165,144,309
4,8,22,42,32,74
4,8,22,40,32,72
11,9,24,110,99,209
3,9,24,42,27,69
16,9,24,225,144,369
10,13,35,196,130,326
26,13,35,372,338,710
5,13,35,72,65,137
21,13,35,381,273,654
26,13,35,563,338,901
21,13,35,330,273,603
8,13,35,114,104,218
26,13,35,536,338,874
17,13,35,249,221,470
17,13,35,267,221,488
7,13,35,122,91,213
10,13,35,175,130,305
25,13,35,358,325,683
12,13,35,188,156,344
10,13,35,213,130,343
25,13,35,541,325,866
22,13,35,376,286,662
18,21,55,454,378,832
26,42,54,129,1092,1221
7,38,50,39,266,305
8,42,54,40,336,376
28,42,54,139,1176,1315
4,42,54,39,168,207
1,42,54,2,42,44
13,42,54,65,546,611
17,38,50,85,646,731
1,1252,2295,538,1252,1790
1,1266,2320,544,1266,1810
1,1266,2320,752,1266,2018
1,1266,2320,636,1266,1902
1,1252,2295,951,1252,2203
1,1266,2320,961,1266,2227
1,1252,2295,722,1252,1974
1,308,565,234,308,542
1,1266,2320,1031,1266,2297
1,713,1120,362,713,1075
1,2171,3578,942,2171,3113
1,2171,3578,763,2171,2934
1,487,783,155,487,642
1,487,783,265,487,752
1,713,1120,250,713,963
1,344,540,120,344,464
1,713,1120,261,713,974
1,344,540,174,344,518
1,487,783,155,487,642
1,1555,2443,864,1555,2419
1,487,783,132,487,619
1,2171,3578,1335,2171,3506
1,2171,3578,1335,2171,3506
1,26,70,34,26,60
9,8,21,113,72,185
2,13,35,29,26,55
18,1,2,17,18,35
25,1,2,24,25,49
4,1,2,4,4,8
16,1,2,16,16,32
10,1,2,10,10,20
9,11,30,168,99,267
16,11,30,299,176,475
30,11,30,444,330,774
11,2,5,31,22,53
11,2,5,31,22,53
19,2,5,47,38,85
17,2,5,42,34,76
5,1,2,3,5,8
18,1,2,10,18,28
15,1,4,37,15,52
2,1,2,1,2,3
3,1,2,2,3,5
28,9,25,420,252,672
9,9,25,135,81,216
16,1,2,12,16,28
24,1,4,65,24,89
17,1,2,11,17,28
5,1,2,3,5,8
15,1,2,14,15,29
29,1,2,21,29,50
22,2,5,65,44,109
7,11,30,129,77,206
12,1,4,27,12,39
25,1,4,57,25,82
5,1,4,12,5,17
10,1,4,29,10,39
17,1,4,50,17,67
8,11,29,93,88,181
22,11,29,256,242,498
4,11,29,46,44,90
28,2,5,53,56,109
10,2,5,19,20,39
25,2,5,73,50,123
10,2,5,29,20,49
21,12,33,351,252,603
1,1482,2384,735,1482,2217
1,1482,2384,378,1482,1860
1,1482,2384,592,1482,2074
2,24,64,52,48,100
24,24,64,622,576,1198
2,45,120,145,90,235
17,4,10,90,68,158
28,2,5,81,56,137
11,2,5,32,22,54
17,2,5,49,34,83
24,2,5,70,48,118
19,2,5,55,38,93
26,2,5,61,52,113
1,2,5,2,2,4
22,2,5,58,44,102
13,2,5,34,26,60
30,2,5,57,60,117
5,2,5,10,10,20
21,2,5,61,42,103
6,2,5,17,12,29
25,2,5,66,50,116
24,2,5,71,48,119
30,2,5,89,60,149
4,3,9,23,12,35
7,3,9,39,21,60
4,2,5,12,8,20
28,2,5,83,56,139
18,2,5,53,36,89
3,2,5,9,6,15
11,7,9,9,77,86
29,7,9,24,203,227
20,7,9,0,140,140
10,7,9,18,70,88
11,7,9,15,77,92
20,7,9,8,140,148
12,3,8,53,36,89
17,3,8,82,51,133
18,8,22,244,144,388
2,8,22,27,16,43
23,8,22,211,184,395
5,8,22,56,40,96
7,8,22,95,56,151
15,8,22,197,120,317
27,8,22,301,216,517
20,9,24,194,180,374
9,9,24,131,81,212
12,9,24,174,108,282
22,9,24,293,198,491
2,13,35,43,26,69
30,13,35,618,390,1008
5,13,35,89,65,154
23,13,35,361,299,660
19,13,35,371,247,618
24,13,35,343,312,655
22,13,35,469,286,755
19,13,35,371,247,618
22,13,35,315,286,601
6,13,35,88,78,166
12,13,35,172,156,328
27,13,35,575,351,926
26,13,35,536,338,874
4,13,35,63,52,115
19,13,35,278,247,525
16,13,35,313,208,521
10,21,55,329,210,539
6,21,55,191,126,317
10,21,55,269,210,479
15,21,55,403,315,718
22,21,55,736,462,1198
15,38,50,165,570,735
1,1266,2320,1008,1266,2274
1,1266,2320,1008,1266,2274
1,1252,2295,951,1252,2203
1,1252,2295,745,1252,1997
1,420,769,334,420,754
1,420,769,295,420,715
1,1252,2295,951,1252,2203
1,1252,2295,997,1252,2249
1,420,769,226,420,646
1,1252,2295,882,1252,2134
1,1252,2295,882,1252,2134
1,1252,2295,1020,1252,2272
1,295,540,148,295,443
1,1252,2295,538,1252,1790
1,2171,3578,942,2171,3113
1,2171,3578,656,2171,2827
1,1519,2443,411,1519,1930
1,2171,3578,1371,2171,3542
1,344,540,77,344,421
1,344,540,185,344,529
1,713,1120,362,713,1075
1,2171,3578,1335,2171,3506
1,344,540,158,344,502
11,26,70,453,286,739
30,26,70,1278,780,2058
22,1,2,13,22,35
17,1,2,16,17,33
8,1,2,8,8,16
25,1,2,24,25,49
30,1,2,17,30,47
20,1,2,12,20,32
7,1,2,7,7,14
18,13,35,371,234,605
18,13,35,371,234,605
13,13,35,281,169,450
14,13,35,303,182,485
21,12,33,392,252,644
16,12,33,299,192,491
9,2,5,17,18,35
8,2,5,15,16,31
28,2,5,55,56,111
28,2,5,55,56,111
24,9,25,342,216,558
3,9,25,43,27,70
7,1,4,17,7,24
7,1,4,17,7,24
15,1,2,13,15,28
5,1,2,4,5,9
28,1,2,27,28,55
25,2,5,73,50,123
11,2,5,32,22,54
5,1,2,5,5,10
8,1,2,8,8,16
3,1,2,3,3,6
16,1,2,9,16,25
8,1,4,23,8,31
26,1,4,76,26,102
22,1,4,64,22,86
28,1,2,26,28,54
12,1,2,11,12,23
2,1,2,2,2,4
12,12,33,165,144,309
11,12,33,151,132,283
21,1,2,12,21,33
7,1,2,4,7,11
30,1,4,68,30,98
28,1,4,64,28,92
1,8,21,9,8,17
15,8,21,138,120,258
24,2,5,46,48,94
21,2,5,40,42,82
3,1,2,2,3,5
17,2,5,50,34,84
24,2,5,71,48,119
3,1,2,2,3,5
18,1,2,13,18,31
3,9,25,38,27,65
8,2,5,23,16,39
29,2,5,84,58,142
24,9,25,372,216,588
1,461,742,118,461,579
1,1482,2384,401,1482,1883
1,461,742,251,461,712
1,1482,2384,854,1482,2336
9,24,64,233,216,449
1,59,159,79,59,138
29,4,10,171,116,287
8,4,10,47,32,79
15,2,5,29,30,59
8,3,9,36,24,60
12,2,5,34,24,58
1,2,5,3,2,5
3,2,5,9,6,15
5,2,5,15,10,25
1,2,5,3,2,5
1,2,5,3,2,5
30,2,5,87,60,147
15,2,5,35,30,65
16,4,10,61,64,125
20,4,10,76,80,156
21,2,5,61,42,103
3,2,5,9,6,15
1,3,9,6,3,9
20,3,9,116,60,176
15,3,9,60,45,105
7,3,9,28,21,49
23,3,9,136,69,205
5,3,9,30,15,45
27,3,9,160,81,241
13,3,9,73,39,112
20,3,9,82,60,142
9,3,9,37,27,64
16,3,9,86,48,134
26,3,9,140,78,218
15,7,9,29,105,134
6,7,9,1,42,43
16,7,9,31,112,143
24,7,9,44,168,212
6,7,9,5,42,47
15,7,9,12,105,117
22,7,9,36,154,190
11,7,9,21,77,98
6,7,9,5,42,47
11,7,9,21,77,98
20,7,9,17,140,157
15,3,8,58,45,103
13,3,8,51,39,90
14,3,8,62,42,104
2,3,8,6,6,12
27,8,22,271,216,487
2,8,22,22,16,38
16,8,22,220,128,348
1,9,24,15,9,24
26,9,24,378,234,612
10,9,24,145,90,235
22,9,24,288,198,486
26,13,35,563,338,901
14,13,35,303,182,485
19,13,35,278,247,525
16,13,35,229,208,437
10,13,35,206,130,336
20,13,35,412,260,672
2,13,35,41,26,67
7,13,35,149,91,240
22,13,35,322,286,608
12,13,35,247,156,403
26,13,35,454,338,792
12,13,35,205,156,361
9,13,35,129,117,246
9,13,35,157,117,274
30,13,35,524,390,914
26,13,35,554,338,892
8,13,35,170,104,274
16,13,35,346,208,554
23,13,35,498,299,797
8,13,35,170,104,274
23,13,35,498,299,797
1,13,35,22,13,35
21,13,35,366,273,639
2,13,35,43,26,69
2,13,35,43,26,69
4,13,35,77,52,129
7,13,35,120,91,211
11,13,35,234,143,377
18,21,55,394,378,772
10,21,55,335,210,545
7,38,50,39,266,305
14,38,50,56,532,588
9,38,50,104,342,446
15,38,50,45,570,615
16,42,54,80,672,752
12,42,54,131,504,635
17,38,50,145,646,791
1,1252,2295,997,1252,2249
1,420,769,249,420,669
1,1252,2295,630,1252,1882
1,420,769,249,420,669
1,1266,2320,729,1266,1995
1,1266,2320,544,1266,1810
1,1266,2320,1008,1266,2274
1,1266,2320,636,1266,1902
1,1555,2443,351,1555,1906
1,713,1120,261,713,974
1,2171,3578,1264,2171,3435
1,1083,1701,397,1083,1480
1,487,783,280,487,767
1,2171,3578,656,2171,2827
1,487,783,241,487,728
1,1555,2443,570,1555,2125
1,2171,3578,1371,2171,3542
1,344,540,77,344,421
1,2171,3578,1335,2171,3506
25,3,9,101,75,176
16,3,9,70,48,118
25,3,9,119,75,194
8,8,21,102,64,166
27,1,2,26,27,53
18,13,35,308,234,542
2,13,35,34,26,60
6,1,2,4,6,10
28,2,5,81,56,137
16,2,5,47,32,79
16,2,5,35,32,67
18,2,5,40,36,76
8,1,2,8,8,16
16,1,2,15,16,31
3,2,5,7,6,13
7,1,2,4,7,11
13,1,2,8,13,21
29,12,33,571,348,919
6,2,5,13,12,25
25,2,5,70,50,120
10,1,2,6,10,16
1,2,5,2,2,4
25,2,5,59,50,109
7,13,35,100,91,191
30,13,35,429,390,819
18,9,25,284,162,446
19,9,25,299,171,470
30,1,2,29,30,59
17,1,2,16,17,33
12,13,35,188,156,344
16,13,35,251,208,459
27,1,2,26,27,53
2,1,2,2,2,4
4,2,5,12,8,20
5,2,5,15,10,25
29,8,21,365,232,597
2,8,21,25,16,41
15,2,5,44,30,74
25,2,5,73,50,123
3,1,2,3,3,6
30,1,2,29,30,59
5,1,2,4,5,9
25,1,4,73,25,98
24,1,4,70,24,94
30,8,21,377,240,617
3,8,21,38,24,62
11,8,21,125,88,213
25,8,21,283,200,483
26,2,5,61,52,113
18,2,5,52,36,88
24,1,4,60,24,84
1,461,742,162,461,623
1,461,742,185,461,646
1,461,742,185,461,646
1,1482,2384,854,1482,2336
1,1482,2384,378,1482,1860
1,1482,2384,854,1482,2336
1,461,742,229,461,690
1,1482,2384,854,1482,2336
1,1482,2384,568,1482,2050
15,24,64,389,360,749
8,59,159,533,472,1005
17,3,9,74,51,125
13,3,9,57,39,96
18,2,5,42,36,78
27,2,5,63,54,117
13,2,5,36,26,62
24,2,5,67,48,115
2,2,5,5,4,9
26,2,5,61,52,113
14,2,5,39,28,67
2,2,5,6,4,10
18,2,5,53,36,89
11,2,5,32,22,54
18,4,10,68,72,140
23,4,10,87,92,179
13,4,10,69,52,121
5,4,10,27,20,47
26,3,9,154,78,232
3,3,9,12,9,21
18,7,9,10,126,136
9,7,9,16,63,79
4,7,9,3,28,31
25,7,9,34,175,209
26,7,9,19,182,201
14,7,9,27,98,125
23,7,9,44,161,205
29,7,9,3,203,206
25,3,8,121,75,196
1,3,8,4,3,7
20,3,8,94,60,154
5,3,8,20,15,35
1,8,22,11,8,19
24,8,22,220,192,412
19,8,22,262,152,414
11,9,24,162,99,261
13,9,24,126,117,243
4,9,24,59,36,95
6,13,35,130,78,208
7,13,35,152,91,243
11,13,35,192,143,335
24,13,35,419,312,731
20,13,35,349,260,609
15,13,35,309,195,504
1,13,35,20,13,33
13,13,35,186,169,355
5,13,35,98,65,163
24,13,35,419,312,731
24,13,35,511,312,823
18,13,35,257,234,491
25,13,35,541,325,866
21,13,35,447,273,720
7,13,35,144,91,235
23,13,35,329,299,628
23,13,35,337,299,636
21,42,54,105,882,987
23,42,54,251,966,1217
1,42,54,1,42,43
14,42,54,62,588,650
20,42,54,229,840,1069
7,38,50,81,266,347
19,38,50,162,722,884
18,42,54,2,756,758
19,42,54,2,798,800
28,38,50,322,1064,1386
13,38,50,13,494,507
30,38,50,330,1140,1470
19,42,54,13,798,811
1,1252,2295,722,1252,1974
1,1252,2295,745,1252,1997
1,1266,2320,544,1266,1810
1,1252,2295,951,1252,2203
1,1252,2295,882,1252,2134
1,1266,2320,544,1266,1810
1,1266,2320,1008,1266,2274
1,1083,1701,312,1083,1395
1,2171,3578,1264,2171,3435
1,2171,3578,620,2171,2791
1,1555,2443,839,1555,2394
1,2171,3578,942,2171,3113
1,2171,3578,1157,2171,3328
1,2171,3578,656,2171,2827
1,2171,3578,942,2171,3113
1,1555,2443,864,1555,2419
1,487,783,265,487,752
1,2171,3578,1335,2171,3506
1,713,1120,205,713,918
1,1555,2443,864,1555,2419
10,26,70,433,260,693
8,3,9,47,24,71
13,1,2,7,13,20
10,1,2,6,10,16
30,1,2,29,30,59
13,1,2,13,13,26
23,13,35,490,299,789
2,13,35,43,26,69
25,1,2,15,25,40
2,1,2,1,2,3
17,12,33,284,204,488
8,12,33,134,96,230
7,2,5,13,14,27
20,1,2,20,20,40
3,2,5,9,6,15
13,2,5,38,26,64
14,2,5,41,28,69
3,2,5,8,6,14
6,2,5,14,12,26
20,2,5,47,40,87
10,1,2,9,10,19
30,1,2,28,30,58
20,1,2,11,20,31
14,9,25,217,126,343
9,9,25,140,81,221
25,1,4,62,25,87
29,1,4,72,29,101
23,1,2,13,23,36
6,1,2,3,6,9
11,1,2,6,11,17
1,1482,2384,592,1482,2074
1,1482,2384,592,1482,2074
1,1482,2384,878,1482,2360
14,4,10,69,56,125
29,2,5,61,58,119
18,2,5,53,36,89
1,2,5,3,2,5
11,2,5,25,22,47
17,2,5,39,34,73
3,4,10,11,12,23
12,2,5,23,24,47
29,2,5,55,58,113
19,2,5,56,38,94
20,2,5,59,40,99
2,3,9,12,6,18
1,3,9,6,3,9
25,2,5,55,50,105
29,2,5,64,58,122
28,2,5,74,56,130
12,2,5,32,24,56
4,7,9,0,28,28
23,7,9,42,161,203
29,7,9,53,203,256
20,7,9,11,140,151
4,7,9,3,28,31
24,3,8,78,72,150
17,3,8,84,51,135
18,8,22,165,144,309
30,8,22,407,240,647
23,8,22,312,184,496
9,8,22,90,72,162
14,8,22,174,112,286
11,8,22,110,88,198
15,8,22,207,120,327
4,9,24,59,36,95
19,9,24,253,171,424
12,13,35,260,156,416
26,13,35,472,338,810
10,13,35,143,130,273
14,13,35,244,182,426
17,13,35,297,221,518
16,13,35,251,208,459
13,13,35,227,169,396
7,13,35,120,91,211
21,13,35,330,273,603
20,13,35,426,260,686
7,13,35,100,91,191
6,13,35,128,78,206
1,13,35,17,13,30
2,21,55,48,42,90
4,42,54,46,168,214
7,42,54,31,294,325
23,38,50,115,874,989
23,38,50,253,874,1127
28,42,54,124,1176,1300
8,42,54,40,336,376
12,42,54,131,504,635
19,38,50,19,722,741
12,42,54,60,504,564
9,38,50,9,342,351
4,42,54,44,168,212
5,42,54,49,210,259
1,420,769,295,420,715
1,420,769,241,420,661
1,295,540,126,295,421
1,420,769,211,420,631
1,1266,2320,961,1266,2227
1,1266,2320,544,1266,1810
1,295,540,223,295,518
1,308,565,234,308,542
1,295,540,148,295,443
1,1083,1701,380,1083,1463
1,1555,2443,790,1555,2345
1,2171,3578,942,2171,3113
1,1555,2443,570,1555,2125
1,344,540,185,344,529
1,344,540,110,344,454
1,344,540,126,344,470
1,344,540,126,344,470
15,26,70,513,390,903
23,26,70,787,598,1385
2,26,70,85,52,137
21,26,70,733,546,1279
13,3,9,52,39,91
24,1,4,71,24,95
2,1,4,6,2,8
28,9,25,441,252,693
19,1,2,14,19,33
29,1,2,21,29,50
1,2,5,3,2,5
23,1,2,23,23,46
18,1,2,18,18,36
22,1,4,55,22,77
21,1,4,52,21,73
19,2,5,36,38,74
19,1,2,18,19,37
19,1,2,18,19,37
27,11,30,408,297,705
5,11,30,76,55,131
28,2,5,83,56,139
14,1,2,12,14,26
12,2,5,34,24,58
11,1,2,8,11,19
17,1,2,13,17,30
9,1,4,27,9,36
30,1,4,89,30,119
8,1,4,18,8,26
15,11,30,281,165,446
10,11,30,187,110,297
15,11,30,281,165,446
12,1,2,12,12,24
30,1,2,29,30,59
8,1,2,4,8,12
5,1,2,3,5,8
19,1,4,43,19,62
23,1,4,52,23,75
26,1,4,59,26,85
25,1,2,24,25,49
12,1,2,12,12,24
20,2,5,42,40,82
18,1,2,17,18,35
9,1,2,8,9,17
4,1,2,3,4,7
27,1,2,20,27,47
3,2,5,8,6,14
12,2,5,34,24,58
19,2,5,53,38,91
28,1,2,16,28,44
10,1,2,6,10,16
1,461,742,118,461,579
1,1482,2384,807,1482,2289
1,1482,2384,378,1482,1860
26,24,64,674,624,1298
20,24,64,710,480,1190
5,45,120,363,225,588
8,59,159,787,472,1259
27,2,5,72,54,126
30,2,5,80,60,140
19,4,10,74,76,150
12,4,10,47,48,95
30,3,9,169,90,259
30,3,9,169,90,259
27,3,9,123,81,204
8,3,9,36,24,60
23,4,10,133,92,225
20,4,10,116,80,196
21,4,10,122,84,206
22,2,5,64,44,108
21,2,5,59,42,101
20,2,5,56,40,96
19,2,5,55,38,93
20,2,5,58,40,98
28,2,5,66,56,122
22,2,5,64,44,108
30,2,5,54,60,114
20,2,5,36,40,76
26,2,5,61,52,113
14,2,5,33,28,61
25,3,9,148,75,223
16,2,5,35,32,67
12,2,5,26,24,50
16,3,9,90,48,138
16,3,9,77,48,125
2,3,9,8,6,14
27,3,9,111,81,192
20,7,9,38,140,178
14,7,9,12,98,110
3,7,9,5,21,26
14,7,9,5,98,103
9,7,9,16,63,79
22,7,9,12,154,166
10,7,9,8,70,78
29,3,8,143,87,230
20,3,8,97,60,157
16,3,8,63,48,111
3,3,8,10,9,19
15,8,22,167,120,287
20,8,22,188,160,348
14,8,22,190,112,302
1,9,24,11,9,20
19,9,24,226,171,397
4,9,24,56,36,92
18,9,24,175,162,337
7,9,24,83,63,146
28,9,24,279,252,531
18,13,35,352,234,586
8,13,35,114,104,218
5,13,35,103,65,168
8,13,35,140,104,244
27,13,35,556,351,907
17,13,35,291,221,512
1,13,35,17,13,30
27,13,35,556,351,907
10,13,35,143,130,273
13,13,35,281,169,450
18,13,35,314,234,548
17,13,35,368,221,589
10,13,35,143,130,273
17,13,35,243,221,464
21,13,35,366,273,639
5,13,35,79,65,144
21,21,55,529,441,970
16,21,55,509,336,845
6,21,55,161,126,287
12,21,55,269,252,521
12,42,54,40,504,544
10,38,50,40,380,420
29,42,54,285,1218,1503
15,42,54,10,630,640
16,42,54,11,672,683
20,38,50,230,760,990
23,42,54,264,966,1230
15,42,54,148,630,778
13,38,50,13,494,507
8,42,54,40,336,376
27,42,54,295,1134,1429
11,38,50,121,418,539
25,38,50,275,950,1225
16,42,54,80,672,752
1,1252,2295,951,1252,2203
1,1266,2320,961,1266,2227
1,1252,2295,561,1252,1813
1,1252,2295,676,1252,1928
1,1252,2295,676,1252,1928
1,1266,2320,752,1266,2018
1,420,769,334,420,754
1,1266,2320,567,1266,1833
1,420,769,318,420,738
1,1252,2295,745,1252,1997
1,420,769,318,420,738
1,295,540,223,295,518
1,1266,2320,636,1266,1902
1,295,540,234,295,529
1,1252,2295,561,1252,1813
1,1266,2320,1008,1266,2274
1,2171,3578,1335,2171,3506
1,1083,1701,499,1083,1582
1,2171,3578,1335,2171,3506
1,2171,3578,656,2171,2827
1,2171,3578,942,2171,3113
1,344,540,174,344,518
1,713,1120,261,713,974
1,344,540,99,344,443
1,344,540,66,344,410
1,713,1120,329,713,1042
1,1083,1701,397,1083,1480
1,487,783,132,487,619
1,487,783,194,487,681
1,344,540,126,344,470
1,2171,3578,1335,2171,3506
1,2171,3578,1335,2171,3506
1,1555,2443,864,1555,2419
30,26,70,1278,780,2058
25,26,70,715,650,1365
4,3,9,15,12,27
11,1,4,33,11,44
27,1,4,80,27,107
29,1,2,28,29,57
16,1,2,16,16,32
14,1,2,14,14,28
16,1,2,12,16,28
24,1,2,22,24,46
13,2,5,38,26,64
30,2,5,87,60,147
23,2,5,67,46,113
23,2,5,68,46,114
25,1,2,19,25,44
21,1,2,16,21,37
26,1,2,19,26,45
26,11,30,354,286,640
10,11,30,136,110,246
5,2,5,12,10,22
1,2,5,2,2,4
4,1,2,3,4,7
20,1,2,14,20,34
3,2,5,7,6,13
6,2,5,14,12,26
7,1,4,17,7,24
3,1,4,7,3,10
13,9,25,205,117,322
8,9,25,126,72,198
17,9,25,268,153,421
11,1,2,9,11,20
10,1,2,9,10,19
6,12,33,122,72,194
28,12,33,570,336,906
9,2,5,26,18,44
5,2,5,12,10,22
22,1,2,12,22,34
18,1,2,10,18,28
13,1,2,13,13,26
13,8,21,158,104,262
12,8,21,146,96,242
29,1,2,21,29,50
17,1,2,13,17,30
8,1,2,6,8,14
1,1482,2384,807,1482,2289
1,461,742,162,461,623
1,461,742,185,461,646
1,1482,2384,878,1482,2360
1,755,1215,411,755,1166
11,24,64,391,264,655
18,4,10,106,72,178
13,4,10,77,52,129
24,2,5,64,48,112
29,2,5,77,58,135
6,3,9,27,18,45
8,3,9,36,24,60
4,2,5,8,8,16
22,2,5,64,44,108
13,2,5,38,26,64
3,2,5,8,6,14
27,2,5,72,54,126
11,4,10,46,44,90
14,4,10,59,56,115
16,4,10,61,64,125
23,4,10,87,92,179
9,3,9,36,27,63
10,3,9,40,30,70
11,2,5,32,22,54
13,2,5,38,26,64
15,3,9,81,45,126
24,3,9,129,72,201
30,2,5,71,60,131
29,2,5,68,58,126
17,7,9,6,119,125
8,7,9,0,56,56
14,7,9,12,98,110
16,7,9,0,112,112
7,7,9,6,49,55
8,3,8,36,24,60
24,3,8,89,72,161
1,3,8,4,3,7
11,8,22,149,88,237
16,8,22,147,128,275
17,8,22,156,136,292
5,8,22,69,40,109
16,9,24,236,144,380
25,9,24,291,225,516
9,9,24,87,81,168
25,9,24,267,225,492
3,13,35,43,39,82
26,13,35,563,338,901
16,13,35,341,208,549
9,13,35,157,117,274
4,13,35,87,52,139
1,13,35,22,13,35
12,13,35,235,156,391
28,13,35,606,364,970
14,13,35,303,182,485
25,13,35,489,325,814
9,13,35,141,117,258
10,13,35,206,130,336
6,13,35,86,78,164
15,13,35,246,195,441
27,21,55,680,567,1247
4,21,55,88,84,172
5,38,50,28,190,218
24,38,50,72,912,984
27,38,50,311,1026,1337
13,38,50,39,494,533
9,42,54,103,378,481
22,38,50,253,836,1089
23,38,50,23,874,897
25,42,54,125,1050,1175
17,42,54,39,714,753
6,38,50,6,228,234
14,42,54,70,588,658
25,38,50,38,950,988
1,1912,3400,1046,1912,2958
1,1252,2295,630,1252,1882
1,1252,2295,538,1252,1790
1,308,565,217,308,525
1,1266,2320,961,1266,2227
1,1266,2320,892,1266,2158
1,1266,2320,1031,1266,2297
1,420,769,249,420,669
1,1912,3400,1012,1912,2924
1,1266,2320,892,1266,2158
1,713,1120,385,713,1098
1,1519,2443,484,1519,2003
1,2171,3578,942,2171,3113
1,1083,1701,244,1083,1327
1,2171,3578,942,2171,3113
1,713,1120,396,713,1109
1,1555,2443,448,1555,2003
1,2171,3578,1371,2171,3542
1,1519,2443,411,1519,1930
1,2171,3578,620,2171,2791
17,26,70,593,442,1035
2,26,70,85,52,137
18,26,70,779,468,1247
14,26,70,489,364,853
23,26,70,996,598,1594
18,26,70,779,468,1247
3,3,9,14,9,23
26,13,35,372,338,710
29,13,35,415,377,792
17,1,2,17,17,34
20,2,5,58,40,98
19,9,25,242,171,413
25,1,2,25,25,50
21,1,2,21,21,42
6,1,2,6,6,12
13,1,4,38,13,51
17,2,5,49,34,83
15,2,5,44,30,74
23,2,5,45,46,91
26,2,5,51,52,103
1,11,30,12,11,23
13,11,30,161,143,304
9,9,25,115,81,196
28,9,25,357,252,609
29,1,2,20,29,49
24,2,5,46,48,94
27,9,25,344,243,587
10,9,25,128,90,218
27,9,25,344,243,587
13,9,25,166,117,283
5,1,4,12,5,17
4,1,2,4,4,8
13,1,2,12,13,25
20,1,2,18,20,38
16,2,5,34,32,66
4,2,5,8,8,16
4,2,5,9,8,17
15,2,5,35,30,65
6,2,5,14,12,26
16,8,21,195,128,323
30,2,5,84,60,144
16,2,5,45,32,77
18,2,5,50,36,86
26,2,5,61,52,113
1,1482,2384,473,1482,1955
1,1482,2384,878,1482,2360
1,1482,2384,473,1482,1955
1,461,742,118,461,579
1,461,742,147,461,608
1,461,742,229,461,690
16,24,64,620,384,1004
15,45,120,873,675,1548
5,45,120,267,225,492
6,45,120,436,270,706
9,59,159,843,531,1374
18,2,5,53,36,89
5,2,5,15,10,25
4,2,5,8,8,16
14,2,5,29,28,57
18,4,10,106,72,178
25,4,10,148,100,248
11,2,5,31,22,53
16,2,5,45,32,77
7,4,10,39,28,67
11,2,5,29,22,51
1,2,5,3,2,5
19,2,5,56,38,94
10,2,5,22,20,42
13,2,5,29,26,55
19,2,5,44,38,82
30,2,5,69,60,129
12,2,5,26,24,50
2,2,5,4,4,8
22,4,10,128,88,216
24,2,5,70,48,118
11,2,5,32,22,54
28,3,9,128,84,212
11,3,9,50,33,83
24,2,5,67,48,115
4,2,5,11,8,19
21,2,5,59,42,101
12,2,5,28,24,52
24,2,5,56,48,104
17,2,5,36,34,70
12,2,5,25,24,49
29,2,5,68,58,126
25,2,5,59,50,109
26,7,9,50,182,232
2,7,9,4,14,18
19,7,9,36,133,169
5,7,9,4,35,39
26,7,9,50,182,232
28,7,9,46,196,242
20,7,9,8,140,148
6,7,9,-1,42,41
30,7,9,11,210,221
16,7,9,9,112,121
20,7,9,0,140,140
15,7,9,6,105,111
29,3,8,94,87,181
23,3,8,113,69,182
21,8,22,285,168,453
19,8,22,207,152,359
11,8,22,101,88,189
13,8,22,171,104,275
20,8,22,276,160,436
3,8,22,33,24,57
2,9,24,18,18,36
10,9,24,148,90,238
29,9,24,338,261,599
7,9,24,98,63,161
16,13,35,262,208,470
3,13,35,43,39,82
24,13,35,377,312,689
21,13,35,455,273,728
22,13,35,315,286,601
30,13,35,650,390,1040
16,13,35,313,208,521
11,13,35,227,143,370
19,13,35,411,247,658
17,13,35,350,221,571
12,13,35,188,156,344
20,13,35,391,260,651
30,13,35,408,390,798
22,13,35,476,286,762
7,13,35,110,91,201
4,13,35,57,52,109
29,13,35,476,377,853
29,13,35,506,377,883
3,13,35,43,39,82
22,13,35,345,286,631
25,13,35,393,325,718
10,13,35,157,130,287
9,21,55,296,189,485
22,21,55,591,462,1053
2,38,50,23,76,99
9,42,54,89,378,467
13,42,54,142,546,688
5,42,54,25,210,235
7,38,50,81,266,347
25,42,54,111,1050,1161
7,42,54,76,294,370
1,38,50,1,38,39
24,42,54,262,1008,1270
2,38,50,2,76,78
23,42,54,226,966,1192
1,1912,3400,1352,1912,3264
1,1266,2320,961,1266,2227
1,1252,2295,1020,1252,2272
1,1266,2320,892,1266,2158
1,1266,2320,544,1266,1810
1,295,540,240,295,535
1,1252,2295,676,1252,1928
1,295,540,234,295,529
1,295,540,234,295,529
1,420,769,211,420,631
1,1252,2295,538,1252,1790
1,2171,3578,1371,2171,3542
1,1083,1701,397,1083,1480
1,487,783,108,487,595
1,1083,1701,380,1083,1463
1,2171,3578,835,2171,3006
1,2171,3578,835,2171,3006
1,713,1120,161,713,874
1,487,783,155,487,642
1,1555,2443,570,1555,2125
1,713,1120,261,713,974
1,487,783,132,487,619
1,713,1120,205,713,918
15,26,70,513,390,903
18,3,9,72,54,126
23,2,5,51,46,97
11,1,2,6,11,17
19,13,35,298,247,545
12,13,35,188,156,344
19,2,5,36,38,74
6,2,5,18,12,30
26,1,2,24,26,50
8,1,2,7,8,15
15,1,2,14,15,29
9,11,29,159,99,258
1,11,29,18,11,29
30,2,5,84,60,144
8,2,5,22,16,38
16,1,2,12,16,28
3,1,2,2,3,5
19,2,5,56,38,94
30,2,5,89,60,149
27,2,5,80,54,134
6,1,2,6,6,12
12,1,4,24,12,36
15,1,4,31,15,46
7,1,2,5,7,12
20,9,25,285,180,465
26,9,25,371,234,605
28,2,5,59,56,115
3,2,5,6,6,12
11,1,4,25,11,36
25,1,2,25,25,50
10,2,5,21,20,41
8,2,5,24,16,40
12,2,5,35,24,59
16,2,5,46,32,78
9,2,5,18,18,36
5,1,4,15,5,20
6,1,4,15,6,21
9,9,25,104,81,185
17,1,4,50,17,67
13,12,33,264,156,420
16,12,33,325,192,517
12,9,25,144,108,252
21,8,21,255,168,423
12,1,2,7,12,19
24,1,4,60,24,84
30,1,4,74,30,104
14,1,2,14,14,28
16,1,4,45,16,61
11,1,2,7,11,18
3,1,4,7,3,10
4,1,4,9,4,13
8,1,2,4,8,12
19,1,2,14,19,33
7,1,2,5,7,12
19,1,2,14,19,33
1,461,742,118,461,579
1,755,1215,411,755,1166
1,1482,2384,807,1482,2289
1,1482,2384,473,1482,1955
1,755,1215,241,755,996
1,461,742,147,461,608
1,1482,2384,854,1482,2336
1,461,742,266,461,727
5,45,120,309,225,534
8,45,120,475,360,835
2,45,120,140,90,230
1,2,5,3,2,5
12,2,5,34,24,58
19,2,5,40,38,78
3,2,5,6,6,12
22,4,10,92,88,180
16,4,10,67,64,131
30,2,5,87,60,147
21,2,5,61,42,103
7,2,5,21,14,35
21,2,5,62,42,104
24,4,10,139,96,235
30,4,10,174,120,294
5,2,5,12,10,22
10,2,5,29,20,49
3,2,5,9,6,15
15,2,5,35,30,65
18,2,5,42,36,78
23,2,5,67,46,113
2,2,5,6,4,10
29,2,5,84,58,142
11,2,5,32,22,54
13,2,5,38,26,64
26,2,5,60,52,112
5,2,5,12,10,22
25,2,5,73,50,123
9,2,5,26,18,44
10,2,5,29,20,49
30,2,5,87,60,147
6,2,5,18,12,30
15,2,5,42,30,72
15,3,9,72,45,117
11,2,5,21,22,43
16,2,5,31,32,63
29,2,5,68,58,126
10,2,5,24,20,44
8,7,9,11,56,67
23,7,9,19,161,180
14,7,9,5,98,103
15,7,9,27,105,132
25,7,9,46,175,221
27,7,9,49,189,238
20,7,9,36,140,176
9,7,9,0,63,63
21,7,9,40,147,187
24,7,9,20,168,188
17,7,9,28,119,147
27,3,8,100,81,181
12,3,8,48,36,84
12,8,22,163,96,259
2,8,22,27,16,43
23,8,22,211,184,395
30,8,22,407,240,647
21,8,22,192,168,360
28,8,22,386,224,610
22,8,22,245,176,421
22,9,24,325,198,523
26,9,24,378,234,612
6,9,24,64,54,118
9,9,24,131,81,212
21,9,24,204,189,393
24,9,24,256,216,472
3,9,24,29,27,56
12,9,24,168,108,276
9,9,24,105,81,186
16,13,35,218,208,426
19,13,35,405,247,652
19,13,35,312,247,559
26,13,35,508,338,846
12,13,35,188,156,344
3,13,35,64,39,103
20,13,35,412,260,672
28,13,35,489,364,853
6,13,35,124,78,202
7,13,35,122,91,213
26,13,35,563,338,901
24,13,35,343,312,655
10,13,35,175,130,305
10,13,35,171,130,301
6,13,35,94,78,172
26,13,35,554,338,892
14,13,35,244,182,426
3,13,35,64,39,103
2,13,35,29,26,55
24,13,35,419,312,731
11,13,35,234,143,377
13,13,35,277,169,446
19,21,55,458,399,857
4,42,54,0,168,168
12,42,54,99,504,603
10,38,50,55,380,435
6,38,50,6,228,234
9,38,50,27,342,369
23,42,54,77,966,1043
11,42,54,126,462,588
25,38,50,25,950,975
17,42,54,85,714,799
29,42,54,3,1218,1221
4,38,50,46,152,198
13,38,50,72,494,566
3,42,54,33,126,159
3,42,54,-3,126,123
25,38,50,250,950,1200
1,1912,3400,1046,1912,2958
1,1266,2320,961,1266,2227
1,1266,2320,799,1266,2065
1,1252,2295,745,1252,1997
1,1266,2320,1031,1266,2297
1,1266,2320,729,1266,1995
1,1266,2320,1008,1266,2274
1,1252,2295,882,1252,2134
1,1266,2320,636,1266,1902
1,420,769,334,420,754
1,295,540,223,295,518
1,1252,2295,745,1252,1997
1,308,565,246,308,554
1,1252,2295,745,1252,1997
1,1252,2295,951,1252,2203
1,1083,1701,499,1083,1582
1,2171,3578,763,2171,2934
1,2171,3578,1335,2171,3506
1,487,783,124,487,611
1,487,783,124,487,611
1,1083,1701,346,1083,1429
1,2171,3578,656,2171,2827
1,1555,2443,864,1555,2419
1,1555,2443,790,1555,2345
1,2171,3578,835,2171,3006
1,2171,3578,942,2171,3113
1,1555,2443,839,1555,2394
1,487,783,265,487,752
1,1555,2443,570,1555,2125
1,1555,2443,448,1555,2003
1,344,540,185,344,529
1,713,1120,261,713,974
1,344,540,66,344,410
1,344,540,83,344,427
1,2171,3578,1335,2171,3506
1,2171,3578,620,2171,2791
1,344,540,174,344,518
28,26,70,1212,728,1940
17,26,70,724,442,1166
10,26,70,286,260,546
1,26,70,43,26,69
5,2,5,11,10,21
30,2,5,63,60,123
30,13,35,639,390,1029
5,1,2,5,5,10
25,2,5,48,50,98
1,2,5,2,2,4
30,2,5,71,60,131
1,1,2,1,1,2
14,1,2,10,14,24
20,1,2,11,20,31
28,1,4,83,28,111
18,1,4,53,18,71
13,2,5,38,26,64
12,2,5,35,24,59
19,2,5,53,38,91
24,1,2,18,24,42
29,1,2,21,29,50
25,1,4,62,25,87
8,1,4,20,8,28
28,1,4,69,28,97
20,1,4,50,20,70
4,2,5,11,8,19
28,2,5,78,56,134
5,2,5,14,10,24
2,2,5,5,4,9
21,2,5,49,42,91
17,12,33,267,204,471
20,12,33,314,240,554
5,1,2,3,5,8
11,2,5,23,22,45
19,2,5,40,38,78
22,2,5,64,44,108
26,2,5,75,52,127
27,1,2,26,27,53
12,1,2,12,12,24
29,2,5,81,58,139
29,9,25,435,261,696
25,9,25,375,225,600
24,9,25,360,216,576
8,1,2,6,8,14
2,1,2,1,2,3
9,2,5,27,18,45
7,2,5,20,14,34
25,1,2,15,25,40
15,2,5,42,30,72
24,2,5,67,48,115
26,2,5,61,52,113
20,2,5,47,40,87
3,8,21,36,24,60
27,8,21,328,216,544
12,2,5,35,24,59
1,1482,2384,330,1482,1812
1,461,742,185,461,646
1,1482,2384,878,1482,2360
1,461,742,185,461,646
1,1482,2384,854,1482,2336
1,755,1215,302,755,1057
1,1482,2384,854,1482,2336
22,2,5,65,44,109
24,2,5,71,48,119
17,4,10,65,68,133
16,4,10,61,64,125
25,2,5,74,50,124
15,2,5,44,30,74
13,4,10,77,52,129
2,4,10,12,8,20
27,4,10,157,108,265
6,4,10,35,24,59
11,2,5,32,22,54
23,2,5,67,46,113
21,2,5,48,42,90
8,2,5,18,16,34
1,4,10,6,4,10
13,4,10,75,52,127
20,2,5,58,40,98
14,2,5,41,28,69
6,2,5,17,12,29
18,2,5,50,36,86
2,4,10,12,8,20
3,4,10,17,12,29
29,2,5,68,58,126
4,2,5,9,8,17
7,4,10,27,28,55
3,2,5,6,6,12
11,3,9,64,33,97
1,3,9,6,3,9
8,2,5,15,16,31
2,2,5,6,4,10
24,2,5,70,48,118
28,2,5,81,56,137
19,2,5,55,38,93
5,3,9,23,15,38
23,2,5,45,46,91
5,3,9,24,15,39
15,3,9,72,45,117
22,2,5,52,44,96
17,2,5,40,34,74
8,2,5,23,16,39
2,2,5,6,4,10
18,2,5,34,36,70
30,2,5,57,60,117
10,2,5,21,20,41
5,2,5,11,10,21
17,7,9,32,119,151
12,7,9,22,84,106
4,7,9,7,28,35
17,7,9,28,119,147
16,3,8,79,48,127
5,8,22,55,40,95
8,8,22,108,64,172
1,8,22,9,8,17
3,8,22,27,24,51
24,8,22,325,192,517
8,8,22,73,64,137
9,8,22,122,72,194
13,8,22,176,104,280
4,8,22,54,32,86
28,8,22,386,224,610
22,9,24,214,198,412
25,9,24,243,225,468
28,9,24,407,252,659
3,9,24,36,27,63
14,9,24,166,126,292
17,9,24,239,153,392
26,9,24,378,234,612
1,9,24,12,9,21
19,13,35,405,247,652
27,13,35,556,351,907
26,13,35,372,338,710
24,13,35,520,312,832
17,13,35,249,221,470
12,13,35,256,156,412
1,13,35,14,13,27
11,13,35,173,143,316
6,13,35,130,78,208
4,13,35,85,52,137
27,13,35,462,351,813
1,13,35,22,13,35
26,13,35,554,338,892
11,13,35,234,143,377
4,13,35,57,52,109
9,13,35,132,117,249
2,13,35,43,26,69
30,13,35,524,390,914
20,13,35,433,260,693
27,13,35,575,351,926
13,13,35,268,169,437
8,13,35,126,104,230
22,13,35,469,286,755
12,13,35,256,156,412
11,13,35,192,143,335
15,13,35,220,195,415
4,13,35,57,52,109
15,13,35,220,195,415
18,13,35,283,234,517
2,21,55,44,42,86
6,21,55,201,126,327
9,38,50,77,342,419
22,42,54,74,924,998
21,38,50,242,798,1040
5,42,54,17,210,227
18,38,50,198,684,882
9,42,54,21,378,399
14,38,50,161,532,693
24,38,50,240,912,1152
24,42,54,16,1008,1024
1,1252,2295,951,1252,2203
1,1266,2320,961,1266,2227
1,1252,2295,745,1252,1997
1,1252,2295,722,1252,1974
1,1252,2295,538,1252,1790
1,1266,2320,1008,1266,2274
1,420,769,341,420,761
1,1266,2320,544,1266,1810
1,420,769,334,420,754
1,420,769,180,420,600
1,1252,2295,538,1252,1790
1,1266,2320,1008,1266,2274
1,1266,2320,567,1266,1833
1,1266,2320,1008,1266,2274
1,308,565,251,308,559
1,1252,2295,745,1252,1997
1,1252,2295,997,1252,2249
1,1266,2320,1008,1266,2274
1,2171,3578,1335,2171,3506
1,2171,3578,942,2171,3113
1,713,1120,362,713,1075
1,487,783,241,487,728
1,2171,3578,835,2171,3006
1,2171,3578,1371,2171,3542
1,344,540,185,344,529
1,713,1120,228,713,941
1,487,783,194,487,681
1,1555,2443,864,1555,2419
1,2171,3578,1335,2171,3506
5,26,70,206,130,336
2,26,70,63,52,115
26,3,9,105,78,183
7,1,2,4,7,11
14,1,2,8,14,22
29,8,21,249,232,481
4,8,21,34,32,66
20,2,5,38,40,78
9,2,5,17,18,35
10,2,5,19,20,39
16,1,2,15,16,31
24,1,2,22,24,46
4,2,5,12,8,20
1,2,5,3,2,5
5,2,5,15,10,25
20,2,5,39,40,79
10,2,5,20,20,40
12,11,29,213,132,345
20,1,2,19,20,39
21,2,5,59,42,101
30,2,5,84,60,144
28,2,5,53,56,109
19,9,25,204,171,375
3,9,25,32,27,59
25,2,5,53,50,103
26,2,5,55,52,107
25,2,5,53,50,103
4,1,4,10,4,14
12,2,5,34,24,58
8,2,5,22,16,38
15,1,2,10,15,25
11,1,2,7,11,18
22,1,4,66,22,88
10,1,4,30,10,40
21,2,5,49,42,91
17,2,5,32,34,66
30,2,5,57,60,117
12,11,30,221,132,353
23,11,30,430,253,683
2,11,30,37,22,59
30,12,33,610,360,970
19,12,33,386,228,614
24,8,21,292,192,484
27,8,21,328,216,544
20,8,21,243,160,403
1,2,5,3,2,5
5,2,5,14,10,24
23,2,5,64,46,110
12,1,2,10,12,22
28,2,5,81,56,137
16,2,5,46,32,78
5,2,5,15,10,25
24,2,5,70,48,118
18,2,5,52,36,88
26,2,5,75,52,127
22,2,5,46,44,90
27,2,5,57,54,111
1,1482,2384,878,1482,2360
1,1482,2384,401,1482,1883
1,1482,2384,807,1482,2289
1,1482,2384,878,1482,2360
1,755,1215,302,755,1057
1,755,1215,448,755,1203
1,1482,2384,854,1482,2336
1,461,742,147,461,608
1,1482,2384,378,1482,1860
1,1482,2384,807,1482,2289
14,24,64,444,336,780
15,24,64,581,360,941
9,45,120,437,405,842
27,4,10,157,108,265
10,4,10,58,40,98
14,4,10,83,56,139
20,4,10,118,80,198
15,2,5,29,30,59
17,2,5,32,34,66
16,2,5,46,32,78
1,2,5,3,2,5
9,2,5,24,18,42
22,2,5,58,44,102
15,2,5,29,30,59
28,3,9,163,84,247
10,2,5,24,20,44
17,2,5,40,34,74
15,3,9,72,45,117
18,3,9,87,54,141
23,7,9,38,161,199
25,7,9,48,175,223
7,7,9,11,49,60
3,7,9,2,21,23
7,7,9,6,49,55
7,7,9,5,49,54
22,7,9,40,154,194
14,7,9,19,98,117
20,3,8,98,60,158
17,3,8,82,51,133
22,8,22,206,176,382
12,8,22,134,96,230
26,8,22,353,208,561
27,8,22,247,216,463
30,8,22,407,240,647
13,8,22,145,104,249
11,8,22,110,88,198
21,8,22,234,168,402
1,8,22,11,8,19
9,8,22,100,72,172
3,8,22,37,24,61
6,9,24,58,54,112
18,9,24,214,162,376
3,9,24,44,27,71
1,9,24,15,9,24
11,13,35,234,143,377
14,13,35,288,182,470
22,13,35,476,286,762
14,13,35,288,182,470
23,13,35,401,299,700
18,13,35,371,234,605
17,13,35,297,221,518
9,13,35,192,117,309
12,13,35,172,156,328
15,13,35,309,195,504
24,13,35,511,312,823
16,13,35,346,208,554
22,13,35,430,286,716
15,13,35,320,195,515
22,13,35,476,286,762
21,13,35,308,273,581
11,13,35,192,143,335
1,13,35,17,13,30
13,13,35,277,169,446
22,13,35,361,286,647
11,13,35,161,143,304
9,21,55,197,189,386
15,21,55,395,315,710
26,21,55,855,546,1401
12,21,55,316,252,568
1,38,50,5,38,43
17,42,54,85,714,799
23,42,54,52,966,1018
19,38,50,95,722,817
10,42,54,50,420,470
11,42,54,55,462,517
19,38,50,19,722,741
9,42,54,45,378,423
26,42,54,129,1092,1221
13,42,54,142,546,688
1,1898,3375,1038,1898,2936
1,1898,3375,1038,1898,2936
1,1252,2295,997,1252,2249
1,420,769,341,420,761
1,1252,2295,745,1252,1997
1,1252,2295,951,1252,2203
1,420,769,226,420,646
1,420,769,188,420,608
1,1252,2295,722,1252,1974
1,1252,2295,538,1252,1790
1,420,769,295,420,715
1,1252,2295,997,1252,2249
1,1266,2320,1008,1266,2274
1,2171,3578,620,2171,2791
1,1083,1701,397,1083,1480
1,344,540,126,344,470
1,2171,3578,942,2171,3113
1,1083,1701,244,1083,1327
1,1083,1701,244,1083,1327
1,1083,1701,380,1083,1463
1,713,1120,362,713,1075
1,2171,3578,1371,2171,3542
1,344,540,174,344,518
1,1519,2443,606,1519,2125
1,1519,2443,606,1519,2125
1,344,540,126,344,470
1,487,783,171,487,658
1,2171,3578,906,2171,3077
1,344,540,174,344,518
1,2171,3578,1335,2171,3506
30,26,70,1026,780,1806
9,3,9,52,27,79
30,3,9,145,90,235
4,3,9,23,12,35
3,3,9,12,9,21
24,3,9,135,72,207
29,2,5,68,58,126
12,2,5,28,24,52
30,13,35,513,390,903
13,13,35,222,169,391
7,13,35,144,91,235
19,1,2,14,19,33
8,8,21,69,64,133
19,1,4,54,19,73
21,1,4,60,21,81
8,1,2,6,8,14
25,1,2,23,25,48
7,1,2,6,7,13
24,2,5,67,48,115
6,12,33,124,72,196
12,12,33,248,144,392
4,12,33,83,48,131
19,1,4,47,19,66
1,1,4,2,1,3
24,2,5,67,48,115
22,1,2,12,22,34
4,1,2,2,4,6
21,2,5,61,42,103
7,1,2,6,7,13
13,12,33,183,156,339
15,12,33,211,180,391
3,2,5,9,6,15
10,2,5,29,20,49
4,2,5,12,8,20
10,2,5,29,20,49
28,2,5,81,56,137
21,2,5,62,42,104
9,2,5,27,18,45
15,1,2,15,15,30
2,1,2,2,2,4
25,1,2,17,25,42
20,1,2,14,20,34
22,1,4,60,22,82
1,8,21,12,8,20
8,8,21,97,64,161
17,9,25,179,153,332
23,9,25,242,207,449
29,9,25,305,261,566
12,1,4,35,12,47
20,1,4,58,20,78
2,2,5,4,4,8
13,2,5,25,26,51
19,2,5,50,38,88
13,2,5,34,26,60
9,8,21,109,72,181
24,8,21,292,192,484
19,2,5,37,38,75
1,1482,2384,878,1482,2360
1,461,742,185,461,646
1,1482,2384,878,1482,2360
1,461,742,266,461,727
1,1482,2384,568,1482,2050
3,24,64,89,72,161
2,45,120,145,90,235
25,2,5,73,50,123
26,2,5,75,52,127
7,4,10,41,28,69
20,2,5,42,40,82
25,2,5,70,50,120
22,2,5,42,44,86
14,2,5,27,28,55
10,4,10,38,40,78
8,2,5,23,16,39
23,2,5,44,46,90
1,2,5,2,2,4
6,2,5,17,12,29
7,2,5,20,14,34
11,2,5,32,22,54
9,3,9,36,27,63
28,2,5,78,56,134
4,2,5,9,8,17
25,2,5,53,50,103
7,2,5,15,14,29
19,2,5,45,38,83
5,2,5,12,10,22
1,7,9,2,7,9
30,7,9,49,210,259
4,7,9,7,28,35
23,7,9,19,161,180
24,7,9,46,168,214
19,7,9,36,133,169
12,7,9,22,84,106
7,7,9,11,49,60
12,7,9,10,84,94
20,3,8,79,60,139
4,3,8,13,12,25
5,8,22,46,40,86
6,8,22,81,48,129
24,8,22,325,192,517
22,8,22,289,176,465
28,8,22,293,224,517
24,8,22,325,192,517
26,8,22,238,208,446
10,8,22,138,80,218
23,9,24,339,207,546
6,9,24,71,54,125
19,9,24,280,171,451
25,9,24,297,225,522
6,9,24,84,54,138
26,13,35,454,338,792
14,13,35,303,182,485
16,13,35,279,208,487
22,13,35,469,286,755
27,13,35,424,351,775
28,13,35,400,364,764
23,13,35,474,299,773
9,13,35,185,117,302
24,13,35,494,312,806
18,13,35,314,234,548
15,13,35,320,195,515
12,13,35,256,156,412
26,13,35,472,338,810
1,13,35,14,13,27
15,13,35,325,195,520
2,13,35,31,26,57
21,13,35,300,273,573
26,21,55,870,546,1416
9,21,55,296,189,485
12,42,54,131,504,635
8,42,54,40,336,376
25,42,54,246,1050,1296
29,38,50,334,1102,1436
3,38,50,30,114,144
8,38,50,88,304,392
3,42,54,0,126,126
1,1912,3400,774,1912,2686
1,1252,2295,997,1252,2249
1,1252,2295,951,1252,2203
1,1252,2295,997,1252,2249
1,295,540,126,295,421
1,1252,2295,997,1252,2249
1,1266,2320,1008,1266,2274
1,1252,2295,538,1252,1790
1,1266,2320,915,1266,2181
1,308,565,246,308,554
1,295,540,240,295,535
1,2171,3578,906,2171,3077
1,2171,3578,1157,2171,3328
1,487,783,280,487,767
1,1519,2443,900,1519,2419
1,1555,2443,351,1555,1906
1,2171,3578,942,2171,3113
1,2171,3578,942,2171,3113
1,487,783,202,487,689
1,487,783,265,487,752
1,1519,2443,606,1519,2125
1,1555,2443,497,1555,2052
1,344,540,137,344,481
1,713,1120,261,713,974
1,1083,1701,601,1083,1684
1,713,1120,228,713,941
11,3,9,48,33,81
14,3,9,81,42,123
20,11,29,267,220,487
19,11,29,254,209,463
6,1,2,6,6,12
27,1,2,26,27,53
9,1,2,9,9,18
25,2,5,70,50,120
7,2,5,20,14,34
12,8,21,146,96,242
3,8,21,36,24,60
16,13,35,313,208,521
15,12,33,280,180,460
7,12,33,131,84,215
13,1,2,7,13,20
13,2,5,38,26,64
13,2,5,38,26,64
6,2,5,17,12,29
28,2,5,81,56,137
24,1,2,14,24,38
15,1,2,9,15,24
5,13,35,107,65,172
20,2,5,38,40,78
17,2,5,32,34,66
26,2,5,49,52,101
2,2,5,4,4,8
11,2,5,21,22,43
16,1,2,11,16,27
19,1,2,12,19,31
22,1,2,14,22,36
28,9,25,357,252,609
13,12,33,217,156,373
7,12,33,117,84,201
19,9,25,299,171,470
20,9,25,315,180,495
4,2,5,12,8,20
6,2,5,17,12,29
23,9,25,334,207,541
24,9,25,348,216,564
17,9,25,247,153,400
20,1,2,20,20,40
24,1,2,24,24,48
12,9,25,138,108,246
5,9,25,58,45,103
14,1,2,13,14,27
13,1,2,12,13,25
21,1,4,61,21,82
5,1,4,15,5,20
4,1,4,12,4,16
26,2,5,49,52,101
2,2,5,4,4,8
22,2,5,51,44,95
25,2,5,58,50,108
7,1,4,20,7,27
13,2,5,30,26,56
7,2,5,16,14,30
27,11,29,478,297,775
1,11,29,18,11,29
2,2,5,6,4,10
1,1,4,2,1,3
17,1,4,42,17,59
1,1482,2384,807,1482,2289
1,755,1215,302,755,1057
1,1482,2384,878,1482,2360
1,461,742,274,461,735
3,24,64,95,72,167
11,24,64,426,264,690
2,45,120,133,90,223
30,2,5,87,60,147
24,2,5,70,48,118
11,4,10,65,44,109
3,4,10,18,12,30
15,2,5,35,30,65
21,2,5,48,42,90
29,4,10,113,116,229
21,4,10,82,84,166
15,2,5,35,30,65
2,2,5,5,4,9
14,4,10,83,56,139
25,4,10,148,100,248
1,2,5,3,2,5
13,2,5,25,26,51
6,2,5,11,12,23
16,2,5,46,32,78
8,2,5,23,16,39
11,3,9,44,33,77
5,3,9,20,15,35
28,2,5,55,56,111
2,2,5,4,4,8
25,7,9,19,175,194
4,7,9,5,28,33
19,7,9,7,133,140
1,7,9,2,7,9
16,7,9,29,112,141
8,7,9,15,56,71
17,7,9,6,119,125
7,7,9,0,49,49
9,3,8,42,27,69
3,3,8,12,9,21
27,8,22,372,216,588
4,8,22,54,32,86
21,8,22,211,168,379
21,8,22,211,168,379
27,9,24,392,243,635
3,9,24,33,27,60
20,9,24,295,180,475
28,9,24,407,252,659
20,9,24,199,180,379
6,13,35,86,78,164
10,13,35,164,130,294
13,13,35,268,169,437
2,13,35,35,26,61
24,13,35,520,312,832
27,13,35,585,351,936
20,13,35,349,260,609
24,13,35,511,312,823
26,13,35,426,338,764
10,13,35,213,130,343
13,13,35,204,169,373
2,13,35,31,26,57
12,13,35,247,156,403
7,13,35,103,91,194
8,13,35,140,104,244
25,13,35,533,325,858
7,38,50,77,266,343
10,38,50,110,380,490
15,42,54,75,630,705
18,38,50,54,684,738
5,42,54,55,210,265
11,42,54,120,462,582
13,38,50,65,494,559
1,1266,2320,1008,1266,2274
1,1266,2320,729,1266,1995
1,1252,2295,676,1252,1928
1,1266,2320,567,1266,1833
1,1252,2295,997,1252,2249
1,295,540,175,295,470
1,308,565,155,308,463
1,1252,2295,997,1252,2249
1,1252,2295,630,1252,1882
1,420,769,211,420,631
1,1252,2295,630,1252,1882
1,295,540,207,295,502
1,1252,2295,561,1252,1813
1,1266,2320,892,1266,2158
1,1555,2443,546,1555,2101
1,344,540,185,344,529
1,1555,2443,497,1555,2052
1,344,540,185,344,529
1,713,1120,362,713,1075
1,713,1120,172,713,885
1,344,540,126,344,470
1,2171,3578,906,2171,3077
1,2171,3578,1335,2171,3506
6,26,70,256,156,412
20,26,70,852,520,1372
27,3,9,160,81,241
8,3,9,45,24,69
18,2,5,52,36,88
9,1,2,7,9,16
12,1,2,9,12,21
28,1,2,27,28,55
23,2,5,68,46,114
21,12,33,351,252,603
11,12,33,184,132,316
6,12,33,100,72,172
24,1,2,24,24,48
5,1,2,5,5,10
9,1,2,9,9,18
20,1,2,19,20,39
24,1,2,23,24,47
11,1,2,7,11,18
20,1,2,13,20,33
7,1,4,15,7,22
24,1,4,51,24,75
19,1,2,17,19,36
7,1,2,6,7,13
19,2,5,55,38,93
26,11,30,439,286,725
19,11,30,321,209,530
23,13,35,377,299,676
17,2,5,40,34,74
2,2,5,5,4,9
28,1,2,16,28,44
10,1,2,6,10,16
20,2,5,47,40,87
15,2,5,35,30,65
8,2,5,18,16,34
25,1,2,19,25,44
25,1,2,19,25,44
27,8,21,249,216,465
1,8,21,9,8,17
29,2,5,67,58,125
4,1,2,4,4,8
26,1,4,74,26,100
10,1,4,28,10,38
15,1,4,43,15,58
5,1,4,14,5,19
11,2,5,23,22,45
18,2,5,38,36,74
23,9,25,288,207,495
21,9,25,263,189,452
1,1482,2384,521,1482,2003
1,1482,2384,878,1482,2360
1,1482,2384,854,1482,2336
1,755,1215,448,755,1203
1,1482,2384,807,1482,2289
19,45,120,1402,855,2257
26,45,120,1919,1170,3089
1,4,10,6,4,10
10,4,10,59,40,99
30,2,5,87,60,147
29,2,5,84,58,142
24,2,5,47,48,95
17,2,5,33,34,67
21,2,5,59,42,101
1,2,5,3,2,5
8,2,5,19,16,35
21,2,5,50,42,92
27,2,5,76,54,130
5,2,5,14,10,24
2,4,10,11,8,19
7,4,10,39,28,67
6,2,5,18,12,30
28,2,5,83,56,139
25,4,10,105,100,205
20,4,10,84,80,164
6,2,5,14,12,26
7,2,5,16,14,30
23,2,5,67,46,113
29,2,5,84,58,142
28,2,5,81,56,137
21,2,5,61,42,103
19,2,5,37,38,75
6,4,10,35,24,59
18,4,10,104,72,176
21,2,5,62,42,104
28,2,5,83,56,139
9,3,9,52,27,79
9,2,5,26,18,44
30,2,5,59,60,119
25,2,5,49,50,99
16,2,5,46,32,78
1,2,5,3,2,5
20,2,5,47,40,87
18,2,5,42,36,78
23,4,10,136,92,228
5,4,10,30,20,50
21,2,5,49,42,91
23,2,5,51,46,97
29,2,5,64,58,122
13,2,5,36,26,62
14,2,5,39,28,67
7,2,5,14,14,28
30,7,9,57,210,267
7,7,9,13,49,62
21,7,9,40,147,187
19,7,9,35,133,168
7,7,9,11,49,60
18,7,9,34,126,160
9,7,9,3,63,66
11,7,9,18,77,95
29,7,9,48,203,251
20,7,9,8,140,148
13,7,9,21,91,112
25,7,9,3,175,178
15,3,8,56,45,101
11,3,8,37,33,70
14,3,8,57,42,99
11,3,8,53,33,86
3,8,22,27,24,51
27,8,22,283,216,499
18,8,22,181,144,325
10,8,22,111,80,191
7,8,22,92,56,148
12,8,22,165,96,261
29,8,22,291,232,523
20,8,22,262,160,422
21,8,22,192,168,360
9,8,22,94,72,166
21,8,22,276,168,444
11,8,22,144,88,232
21,8,22,276,168,444
15,8,22,207,120,327
11,8,22,110,88,198
22,9,24,319,198,517
18,9,24,240,162,402
1,9,24,15,9,24
22,9,24,319,198,517
14,9,24,207,126,333
25,9,24,363,225,588
26,13,35,563,338,901
5,13,35,107,65,172
20,13,35,433,260,693
1,13,35,21,13,34
20,13,35,433,260,693
10,13,35,206,130,336
13,13,35,268,169,437
30,13,35,618,390,1008
1,13,35,21,13,34
17,13,35,297,221,518
12,13,35,247,156,403
18,13,35,390,234,624
10,13,35,157,130,287
24,13,35,377,312,689
26,13,35,426,338,764
9,13,35,192,117,309
6,13,35,105,78,183
10,13,35,147,130,277
29,13,35,425,377,802
3,13,35,64,39,103
17,13,35,297,221,518
10,21,55,318,210,528
1,21,55,25,21,46
12,21,55,289,252,541
22,21,55,591,462,1053
7,21,55,157,147,304
12,21,55,322,252,574
13,21,55,306,273,579
3,38,50,9,114,123
26,38,50,286,988,1274
29,38,50,87,1102,1189
1,42,54,8,42,50
18,38,50,207,684,891
30,38,50,300,1140,1440
25,38,50,250,950,1200
3,42,54,0,126,126
4,38,50,16,152,168
24,38,50,96,912,1008
14,42,54,115,588,703
1,1266,2320,1008,1266,2274
1,1266,2320,961,1266,2227
1,1252,2295,676,1252,1928
1,1252,2295,676,1252,1928
1,1252,2295,997,1252,2249
1,1266,2320,636,1266,1902
1,1266,2320,636,1266,1902
1,1266,2320,961,1266,2227
1,1252,2295,882,1252,2134
1,1266,2320,961,1266,2227
1,1266,2320,567,1266,1833
1,420,769,249,420,669
1,1266,2320,752,1266,2018
1,420,769,249,420,669
1,1252,2295,630,1252,1882
1,420,769,318,420,738
1,1252,2295,630,1252,1882
1,1266,2320,961,1266,2227
1,1252,2295,538,1252,1790
1,295,540,175,295,470
1,295,540,234,295,529
1,308,565,246,308,554
1,420,769,295,420,715
1,295,540,207,295,502
1,1252,2295,630,1252,1882
1,1266,2320,752,1266,2018
1,2171,3578,1335,2171,3506
1,1555,2443,717,1555,2272
1,1519,2443,631,1519,2150
1,1519,2443,826,1519,2345
1,487,783,124,487,611
1,2171,3578,942,2171,3113
1,713,1120,261,713,974
1,713,1120,340,713,1053
1,1555,2443,375,1555,1930
1,713,1120,329,713,1042
1,1555,2443,497,1555,2052
1,2171,3578,656,2171,2827
30,26,70,1278,780,2058
21,3,9,84,63,147
11,3,9,62,33,95
7,1,2,7,7,14
7,1,2,7,7,14
30,1,2,23,30,53
23,1,2,17,23,40
22,1,2,21,22,43
10,1,2,10,10,20
3,1,2,3,3,6
17,1,2,17,17,34
1,1,2,1,1,2
15,2,5,29,30,59
3,2,5,6,6,12
4,2,5,8,8,16
18,1,4,53,18,71
9,1,4,27,9,36
18,13,35,383,234,617
9,2,5,27,18,45
24,2,5,71,48,119
10,2,5,20,20,40
1,1,2,1,1,2
25,1,2,23,25,48
29,1,2,27,29,56
16,1,2,15,16,31
15,9,25,214,135,349
28,1,4,69,28,97
19,1,4,47,19,66
20,1,4,57,20,77
2,1,4,6,2,8
26,2,5,55,52,107
24,2,5,50,48,98
26,1,2,19,26,45
5,1,2,4,5,9
24,1,2,18,24,42
12,9,25,153,108,261
4,9,25,51,36,87
1,2,5,3,2,5
4,2,5,12,8,20
12,1,4,27,12,39
7,1,4,16,7,23
15,8,21,154,120,274
14,2,5,41,28,69
28,2,5,81,56,137
15,2,5,44,30,74
16,12,33,220,192,412
13,9,25,146,117,263
28,9,25,315,252,567
8,9,25,96,72,168
9,9,25,108,81,189
6,2,5,14,12,26
20,2,5,46,40,86
1,461,742,274,461,735
1,1482,2384,807,1482,2289
1,461,742,125,461,586
30,24,64,950,720,1670
7,45,120,416,315,731
5,4,10,28,20,48
8,4,10,45,32,77
20,2,5,46,40,86
8,2,5,18,16,34
14,2,5,41,28,69
17,2,5,39,34,73
1,2,5,2,2,4
4,2,5,12,8,20
10,2,5,30,20,50
5,2,5,15,10,25
12,2,5,28,24,52
10,2,5,24,20,44
21,2,5,62,42,104
8,2,5,24,16,40
4,2,5,8,8,16
4,2,5,8,8,16
15,4,10,57,60,117
24,2,5,46,48,94
11,2,5,21,22,43
18,2,5,52,36,88
26,3,9,151,78,229
14,2,5,27,28,55
11,2,5,31,22,53
6,3,9,25,18,43
25,3,9,103,75,178
10,3,9,47,30,77
19,2,5,55,38,93
4,2,5,12,8,20
27,7,9,49,189,238
15,7,9,25,105,130
6,7,9,1,42,43
21,7,9,17,147,164
6,7,9,11,42,53
8,7,9,15,56,71
16,7,9,12,112,124
16,3,8,57,48,105
4,3,8,20,12,32
29,3,8,140,87,227
30,3,8,119,90,209
15,8,22,167,120,287
5,8,22,68,40,108
7,8,22,76,56,132
26,8,22,353,208,561
26,8,22,353,208,561
25,8,22,339,200,539
3,8,22,37,24,61
30,8,22,394,240,634
6,8,22,79,48,127
9,9,24,90,81,171
7,9,24,70,63,133
4,9,24,59,36,95
17,9,24,165,153,318
18,9,24,261,162,423
5,9,24,70,45,115
14,9,24,136,126,262
29,13,35,425,377,802
17,13,35,362,221,583
2,13,35,35,26,61
2,13,35,35,26,61
11,13,35,173,143,316
2,13,35,35,26,61
18,13,35,314,234,548
29,13,35,425,377,802
18,13,35,383,234,617
21,13,35,308,273,581
23,13,35,474,299,773
20,13,35,328,260,588
5,13,35,72,65,137
30,13,35,650,390,1040
3,13,35,64,39,103
2,13,35,29,26,55
13,13,35,222,169,391
3,21,55,100,63,163
29,21,55,922,609,1531
17,21,55,541,357,898
27,42,54,120,1134,1254
5,42,54,55,210,265
2,42,54,20,84,104
28,42,54,18,1176,1194
1,1252,2295,745,1252,1997
1,1266,2320,1008,1266,2274
1,1266,2320,892,1266,2158
1,420,769,318,420,738
1,308,565,184,308,492
1,1266,2320,1008,1266,2274
1,308,565,234,308,542
1,295,540,234,295,529
1,487,783,124,487,611
1,2171,3578,942,2171,3113
1,713,1120,362,713,1075
1,487,783,265,487,752
1,1083,1701,550,1083,1633
1,1519,2443,900,1519,2419
1,487,783,132,487,619
11,3,9,52,33,85
10,3,9,54,30,84
4,3,9,23,12,35
20,1,2,19,20,39
23,1,2,23,23,46
12,1,2,8,12,20
23,1,2,15,23,38
22,1,2,12,22,34
25,1,2,14,25,39
4,2,5,12,8,20
9,2,5,27,18,45
2,2,5,6,4,10
24,1,2,23,24,47
18,2,5,48,36,84
13,2,5,34,26,60
24,1,2,22,24,46
28,13,35,577,364,941
15,13,35,309,195,504
4,13,35,70,52,122
28,9,25,357,252,609
20,9,25,255,180,435
27,2,5,57,54,111
8,2,5,17,16,33
11,11,30,196,121,317
11,11,30,196,121,317
10,8,21,122,80,202
26,8,21,316,208,524
10,2,5,24,20,44
6,9,25,60,54,114
6,9,25,60,54,114
5,9,25,50,45,95
26,2,5,75,52,127
14,2,5,41,28,69
1,1,4,3,1,4
21,2,5,49,42,91
12,2,5,28,24,52
5,1,4,11,5,16
1,1482,2384,401,1482,1883
1,461,742,118,461,579
1,1482,2384,401,1482,1883
1,461,742,125,461,586
1,1482,2384,592,1482,2074
1,755,1215,168,755,923
6,3,9,32,18,50
5,2,5,15,10,25
7,2,5,20,14,34
18,2,5,50,36,86
22,4,10,130,88,218
29,4,10,171,116,287
12,3,9,71,36,107
30,3,9,169,90,259
15,2,5,44,30,74
19,2,5,55,38,93
2,2,5,5,4,9
25,2,5,53,50,103
6,2,5,13,12,25
12,4,10,55,48,103
14,4,10,64,56,120
16,3,9,90,48,138
23,3,9,130,69,199
26,7,9,3,182,185
4,7,9,0,28,28
28,7,9,16,196,212
8,7,9,15,56,71
4,7,9,3,28,31
1,7,9,2,7,9
10,7,9,4,70,74
19,7,9,26,133,159
16,3,8,77,48,125
26,3,8,128,78,206
23,8,22,211,184,395
2,8,22,20,16,36
13,8,22,171,104,275
10,9,24,116,90,206
27,9,24,321,243,564
28,9,24,393,252,645
15,9,24,211,135,346
23,13,35,329,299,628
27,13,35,556,351,907
21,13,35,455,273,728
12,13,35,209,156,365
11,13,35,238,143,381
7,13,35,115,91,206
29,13,35,597,377,974
11,13,35,192,143,335
20,13,35,342,260,602
28,13,35,606,364,970
24,13,35,377,312,689
24,13,35,377,312,689
9,13,35,141,117,258
2,13,35,35,26,61
1,13,35,14,13,27
8,21,55,254,168,422
19,21,55,625,399,1024
21,42,54,241,882,1123
2,38,50,6,76,82
17,38,50,170,646,816
13,38,50,111,494,605
15,38,50,165,570,735
6,42,54,30,252,282
28,42,54,139,1176,1315
22,42,54,3,924,927
1,1252,2295,951,1252,2203
1,1252,2295,722,1252,1974
1,420,769,211,420,631
1,308,565,155,308,463
1,1266,2320,1008,1266,2274
1,1252,2295,1020,1252,2272
1,1266,2320,752,1266,2018
1,1266,2320,1008,1266,2274
1,344,540,158,344,502
1,2171,3578,1264,2171,3435
1,2171,3578,1264,2171,3435
1,1555,2443,790,1555,2345
1,487,783,241,487,728
1,713,1120,385,713,1098
1,2171,3578,656,2171,2827
1,1083,1701,312,1083,1395
1,1519,2443,533,1519,2052
1,1519,2443,484,1519,2003
1,344,540,83,344,427
1,713,1120,228,713,941
1,26,70,31,26,57
4,26,70,170,104,274
30,3,9,131,90,221
29,3,9,164,87,251
5,1,2,5,5,10
22,8,21,184,176,360
2,8,21,17,16,33
21,9,25,252,189,441
15,9,25,180,135,315
1,13,35,15,13,28
14,2,5,33,28,61
12,2,5,28,24,52
6,1,2,6,6,12
10,1,2,10,10,20
13,1,2,13,13,26
27,1,2,26,27,53
11,1,2,10,11,21
24,13,35,419,312,731
14,13,35,244,182,426
8,1,2,5,8,13
29,1,2,20,29,49
7,1,4,17,7,24
14,1,4,35,14,49
14,1,2,10,14,24
23,1,2,15,23,38
26,1,2,17,26,43
11,1,2,7,11,18
30,1,2,29,30,59
25,1,2,24,25,49
2,2,5,4,4,8
14,2,5,27,28,55
1,2,5,3,2,5
20,2,5,58,40,98
18,2,5,52,36,88
25,2,5,74,50,124
20,9,25,240,180,420
7,9,25,84,63,147
18,1,2,18,18,36
10,1,2,10,10,20
2,2,5,4,4,8
10,2,5,19,20,39
19,1,2,18,19,37
30,8,21,308,240,548
23,8,21,236,184,420
16,1,4,45,16,61
16,1,4,45,16,61
15,2,5,44,30,74
30,2,5,87,60,147
4,2,5,12,8,20
3,1,4,9,3,12
9,1,4,26,9,35
1,1482,2384,807,1482,2289
1,1482,2384,521,1482,2003
1,1482,2384,473,1482,1955
1,755,1215,266,755,1021
1,755,1215,302,755,1057
1,1482,2384,807,1482,2289
1,1482,2384,878,1482,2360
1,1482,2384,878,1482,2360
1,1482,2384,378,1482,1860
1,1482,2384,807,1482,2289
14,24,64,551,336,887
26,24,64,674,624,1298
11,24,64,433,264,697
1,24,64,37,24,61
2,45,120,107,90,197
5,59,159,484,295,779
10,2,5,21,20,41
20,4,10,84,80,164
22,4,10,92,88,180
2,2,5,6,4,10
26,2,5,73,52,125
12,3,9,68,36,104
29,3,9,164,87,251
24,2,5,71,48,119
29,2,5,86,58,144
21,2,5,62,42,104
15,2,5,42,30,72
10,2,5,28,20,48
28,2,5,55,56,111
12,2,5,23,24,47
6,2,5,11,12,23
7,2,5,15,14,29
29,2,5,61,58,119
18,2,5,38,36,74
21,3,9,122,63,185
26,3,9,151,78,229
10,4,10,56,40,96
1,4,10,6,4,10
25,4,10,145,100,245
1,4,10,6,4,10
8,4,10,30,32,62
29,4,10,110,116,226
18,2,5,53,36,89
20,2,5,59,40,99
22,3,9,88,66,154
27,3,9,109,81,190
19,2,5,45,38,83
5,2,5,12,10,22
12,2,5,35,24,59
30,7,9,49,210,259
5,7,9,4,35,39
15,7,9,6,105,111
13,7,9,21,91,112
14,7,9,5,98,103
3,7,9,3,21,24
24,3,8,116,72,188
16,3,8,57,48,105
27,8,22,354,216,570
20,8,22,183,160,343
23,8,22,312,184,496
12,8,22,110,96,206
17,8,22,156,136,292
16,8,22,161,128,289
30,8,22,281,240,521
9,8,22,122,72,194
22,8,22,289,176,465
28,8,22,281,224,505
18,8,22,224,144,368
29,9,24,428,261,689
1,9,24,15,9,24
2,9,24,19,18,37
18,9,24,175,162,337
4,9,24,43,36,79
15,9,24,178,135,313
5,9,24,59,45,104
9,9,24,126,81,207
11,13,35,157,143,300
15,13,35,262,195,457
4,13,35,70,52,122
30,13,35,471,390,861
7,13,35,149,91,240
23,13,35,401,299,700
18,13,35,257,234,491
5,13,35,103,65,168
21,13,35,455,273,728
22,13,35,476,286,762
10,13,35,175,130,305
18,13,35,257,234,491
29,13,35,618,377,995
20,13,35,314,260,574
6,13,35,92,78,170
27,13,35,585,351,936
12,13,35,209,156,365
30,13,35,524,390,914
13,13,35,190,169,359
22,13,35,469,286,755
15,13,35,236,195,431
8,13,35,173,104,277
20,13,35,426,260,686
14,13,35,288,182,470
23,13,35,498,299,797
18,13,35,371,234,605
24,13,35,377,312,689
23,13,35,474,299,773
27,13,35,556,351,907
16,13,35,330,208,538
18,13,35,257,234,491
5,13,35,82,65,147
17,13,35,350,221,571
14,13,35,288,182,470
14,13,35,298,182,480
1,13,35,16,13,29
1,21,55,25,21,46
13,21,55,313,273,586
22,21,55,724,462,1186
2,42,54,20,84,104
5,42,54,3,210,213
14,38,50,161,532,693
23,38,50,23,874,897
6,38,50,69,228,297
30,42,54,68,1260,1328
20,38,50,200,760,960
5,42,54,3,210,213
11,42,54,55,462,517
24,42,54,236,1008,1244
3,38,50,5,114,119
20,38,50,100,760,860
28,42,54,64,1176,1240
12,42,54,118,504,622
15,38,50,45,570,615
5,38,50,25,190,215
15,42,54,123,630,753
19,42,54,95,798,893
13,42,54,107,546,653
14,42,54,153,588,741
18,42,54,2,756,758
23,38,50,23,874,897
1,1898,3375,1038,1898,2936
1,1252,2295,630,1252,1882
1,1252,2295,1020,1252,2272
1,1252,2295,951,1252,2203
1,1266,2320,752,1266,2018
1,1266,2320,752,1266,2018
1,420,769,249,420,669
1,1252,2295,997,1252,2249
1,1266,2320,1008,1266,2274
1,1266,2320,961,1266,2227
1,420,769,334,420,754
1,420,769,211,420,631
1,308,565,155,308,463
1,1266,2320,961,1266,2227
1,1266,2320,961,1266,2227
1,420,769,295,420,715
1,1252,2295,882,1252,2134
1,1252,2295,997,1252,2249
1,2171,3578,1264,2171,3435
1,2171,3578,1371,2171,3542
1,487,783,280,487,767
1,487,783,124,487,611
1,487,783,124,487,611
1,1555,2443,790,1555,2345
1,1519,2443,484,1519,2003
1,344,540,185,344,529
1,2171,3578,656,2171,2827
1,1083,1701,380,1083,1463
1,487,783,155,487,642
1,713,1120,385,713,1098
1,1083,1701,414,1083,1497
1,344,540,174,344,518
1,344,540,174,344,518
1,344,540,99,344,443
1,344,540,174,344,518
1,713,1120,362,713,1075
1,1555,2443,570,1555,2125
1,344,540,185,344,529
1,713,1120,261,713,974
1,487,783,132,487,619
1,487,783,171,487,658
26,26,70,1126,676,1802
14,26,70,596,364,960
6,26,70,197,156,353
5,26,70,175,130,305
8,26,70,346,208,554
8,3,9,32,24,56
16,3,9,70,48,118
24,3,9,114,72,186
24,1,2,24,24,48
30,2,5,87,60,147
25,2,5,59,50,109
3,2,5,7,6,13
2,2,5,5,4,9
4,2,5,9,8,17
24,1,2,22,24,46
10,11,30,187,110,297
25,11,30,468,275,743
6,13,35,128,78,206
2,13,35,43,26,69
2,1,2,1,2,3
27,1,2,17,27,44
5,13,35,87,65,152
21,1,4,45,21,66
14,1,2,8,14,22
22,1,2,12,22,34
24,12,33,496,288,784
4,2,5,9,8,17
22,2,5,51,44,95
21,2,5,61,42,103
5,2,5,15,10,25
15,1,2,11,15,26
1,1,4,2,1,3
26,1,4,59,26,85
1,9,25,13,9,22
27,9,25,344,243,587
9,1,2,8,9,17
13,1,2,12,13,25
10,1,2,9,10,19
21,9,25,268,189,457
29,9,25,370,261,631
14,1,2,13,14,27
6,1,4,14,6,20
15,1,4,34,15,49
21,2,5,49,42,91
5,2,5,12,10,22
20,11,30,248,220,468
22,11,30,273,242,515
2,1,2,1,2,3
2,1,2,1,2,3
26,11,29,370,286,656
3,11,29,43,33,76
7,2,5,13,14,27
2,2,5,4,4,8
17,11,29,247,187,434
14,11,29,163,154,317
23,8,21,212,184,396
18,8,21,166,144,310
1,1,2,1,1,2
20,1,2,17,20,37
23,12,33,384,276,660
26,12,33,434,312,746
2,2,5,5,4,9
6,2,5,17,12,29
1,461,742,251,461,712
1,461,742,251,461,712
1,755,1215,241,755,996
1,755,1215,290,755,1045
1,1482,2384,854,1482,2336
1,755,1215,302,755,1057
1,1482,2384,854,1482,2336
1,461,742,266,461,727
1,24,64,39,24,63
17,45,120,1234,765,1999
10,59,159,714,590,1304
10,59,159,968,590,1558
11,3,9,59,33,92
4,3,9,21,12,33
22,2,5,46,44,90
22,2,5,46,44,90
1,4,10,4,4,8
26,4,10,101,104,205
27,2,5,80,54,134
26,2,5,75,52,127
7,2,5,20,14,34
26,2,5,60,52,112
6,2,5,18,12,30
4,2,5,12,8,20
16,4,10,90,64,154
25,2,5,59,50,109
24,2,5,56,48,104
12,2,5,35,24,59
5,3,9,29,15,44
15,3,9,87,45,132
30,2,5,87,60,147
16,2,5,46,32,78
28,2,5,78,56,134
29,2,5,81,58,139
29,3,9,156,87,243
25,3,9,134,75,209
19,2,5,40,38,78
30,2,5,63,60,123
14,3,9,54,42,96
22,2,5,62,44,106
17,2,5,48,34,82
20,2,5,58,40,98
21,2,5,61,42,103
25,7,9,19,175,194
4,7,9,7,28,35
16,7,9,22,112,134
17,7,9,6,119,125
18,7,9,15,126,141
14,7,9,2,98,100
3,7,9,1,21,22
14,7,9,12,98,110
30,7,9,49,210,259
27,7,9,22,189,211
29,7,9,48,203,251
14,3,8,68,42,110
4,3,8,16,12,28
21,3,8,102,63,165
17,3,8,56,51,107
4,3,8,16,12,28
10,8,22,136,80,216
24,8,22,241,192,433
7,8,22,87,56,143
20,8,22,271,160,431
19,8,22,258,152,410
3,8,22,39,24,63
25,8,22,279,200,479
23,8,22,302,184,486
23,8,22,256,184,440
19,8,22,191,152,343
9,8,22,112,72,184
14,9,24,207,126,333
6,9,24,84,54,138
19,13,35,411,247,658
17,13,35,332,221,553
13,13,35,254,169,423
17,13,35,249,221,470
14,13,35,274,182,456
6,13,35,105,78,183
17,13,35,368,221,589
8,13,35,170,104,274
27,13,35,396,351,747
21,13,35,411,273,684
28,13,35,596,364,960
6,13,35,130,78,208
12,13,35,247,156,403
25,13,35,515,325,840
28,13,35,410,364,774
15,13,35,325,195,520
14,13,35,244,182,426
26,13,35,563,338,901
11,13,35,173,143,316
10,13,35,143,130,273
24,38,50,264,912,1176
27,38,50,311,1026,1337
14,38,50,21,532,553
4,42,54,3,168,171
7,38,50,77,266,343
17,38,50,170,646,816
5,38,50,25,190,215
27,42,54,134,1134,1268
20,38,50,220,760,980
1,1252,2295,997,1252,2249
1,1898,3375,870,1898,2768
1,1266,2320,961,1266,2227
1,1266,2320,892,1266,2158
1,1266,2320,892,1266,2158
1,1266,2320,1008,1266,2274
1,420,769,249,420,669
1,1266,2320,567,1266,1833
1,295,540,240,295,535
1,1266,2320,1008,1266,2274
1,1266,2320,961,1266,2227
1,295,540,234,295,529
1,308,565,246,308,554
1,1266,2320,961,1266,2227
1,1266,2320,636,1266,1902
1,1555,2443,717,1555,2272
1,1555,2443,448,1555,2003
1,344,540,185,344,529
1,2171,3578,942,2171,3113
1,1519,2443,753,1519,2272
1,1519,2443,826,1519,2345
1,487,783,194,487,681
1,2171,3578,763,2171,2934
1,713,1120,172,713,885
1,487,783,132,487,619
3,26,70,130,78,208
13,26,70,381,338,719
11,26,70,315,286,601
30,26,70,942,780,1722
28,3,9,158,84,242
18,3,9,87,54,141
20,1,4,59,20,79
19,1,4,56,19,75
10,8,21,86,80,166
23,8,21,198,184,382
16,2,5,47,32,79
27,12,33,451,324,775
25,1,2,24,25,49
17,13,35,362,221,583
24,9,25,258,216,474
18,9,25,194,162,356
10,1,4,25,10,35
10,1,4,25,10,35
26,13,35,508,338,846
1,1,4,2,1,3
24,1,4,60,24,84
12,1,2,11,12,23
12,1,2,11,12,23
28,1,4,80,28,108
20,1,4,57,20,77
5,8,21,46,40,86
21,1,4,43,21,64
26,1,4,53,26,79
9,2,5,26,18,44
30,2,5,87,60,147
20,2,5,58,40,98
7,1,2,7,7,14
7,1,2,7,7,14
11,1,2,11,11,22
11,1,2,11,11,22
18,1,2,17,18,35
28,1,4,60,28,88
30,1,4,65,30,95
12,1,4,26,12,38
12,8,21,146,96,242
10,2,5,23,20,43
24,2,5,55,48,103
24,2,5,70,48,118
24,2,5,70,48,118
12,1,2,8,12,20
20,1,2,13,20,33
14,1,2,9,14,23
5,1,4,15,5,20
14,11,29,163,154,317
16,11,29,186,176,362
5,2,5,9,10,19
13,2,5,23,26,49
8,2,5,14,16,30
17,2,5,48,34,82
11,2,5,26,22,48
22,2,5,52,44,96
13,2,5,25,26,51
17,1,2,13,17,30
16,1,2,9,16,25
1,1482,2384,807,1482,2289
1,461,742,125,461,586
1,461,742,125,461,586
1,1482,2384,592,1482,2074
1,1482,2384,807,1482,2289
1,1482,2384,878,1482,2360
1,1482,2384,878,1482,2360
1,461,742,147,461,608
1,461,742,103,461,564
1,1482,2384,854,1482,2336
1,461,742,251,461,712
15,24,64,562,360,922
15,24,64,562,360,922
20,24,64,634,480,1114
22,45,120,1624,990,2614
22,3,9,100,66,166
12,2,5,25,24,49
23,2,5,64,46,110
9,2,5,25,18,43
16,4,10,62,64,126
7,4,10,27,28,55
8,2,5,22,16,38
8,2,5,22,16,38
1,2,5,3,2,5
10,2,5,29,20,49
27,2,5,62,54,116
13,2,5,25,26,51
12,2,5,23,24,47
10,2,5,30,20,50
26,2,5,61,52,113
29,2,5,68,58,126
30,2,5,84,60,144
4,2,5,8,8,16
28,2,5,59,56,115
28,7,9,23,196,219
5,7,9,4,35,39
24,7,9,18,168,186
9,7,9,16,63,79
14,3,8,46,42,88
26,3,8,128,78,206
13,3,8,63,39,102
18,3,8,84,54,138
19,8,22,258,152,410
3,8,22,33,24,57
19,8,22,212,152,364
28,9,24,407,252,659
5,9,24,73,45,118
24,9,24,337,216,553
11,9,24,107,99,206
6,9,24,89,54,143
9,13,35,129,117,246
6,13,35,128,78,206
29,13,35,628,377,1005
24,13,35,352,312,664
28,13,35,596,364,960
5,13,35,108,65,173
3,13,35,62,39,101
13,13,35,277,169,446
7,13,35,95,91,186
1,13,35,17,13,30
24,13,35,520,312,832
20,13,35,412,260,672
11,13,35,157,143,300
13,13,35,277,169,446
21,21,55,460,441,901
15,21,55,337,315,652
8,38,50,80,304,384
23,42,54,-22,966,944
1,42,54,3,42,45
9,38,50,27,342,369
19,42,54,95,798,893
29,38,50,319,1102,1421
9,38,50,9,342,351
7,42,54,35,294,329
9,42,54,40,378,418
19,38,50,105,722,827
13,42,54,65,546,611
24,42,54,262,1008,1270
1,42,54,2,42,44
1,1266,2320,961,1266,2227
1,1252,2295,630,1252,1882
1,420,769,341,420,761
1,1266,2320,567,1266,1833
1,420,769,249,420,669
1,1266,2320,1031,1266,2297
1,1252,2295,951,1252,2203
1,420,769,249,420,669
1,1266,2320,752,1266,2018
1,1266,2320,636,1266,1902
1,1083,1701,584,1083,1667
1,487,783,288,487,775
1,713,1120,385,713,1098
1,487,783,265,487,752
1,1083,1701,397,1083,1480
1,344,540,126,344,470
1,344,540,120,344,464
1,344,540,120,344,464
1,2171,3578,1371,2171,3542
1,1083,1701,550,1083,1633
7,26,70,303,182,485
20,26,70,698,520,1218
17,26,70,593,442,1035
3,3,9,18,9,27
20,3,9,95,60,155
26,3,9,154,78,232
30,1,2,29,30,59
10,1,2,10,10,20
18,13,35,383,234,617
8,13,35,170,104,274
18,8,21,155,144,299
15,8,21,129,120,249
27,2,5,62,54,116
3,2,5,7,6,13
10,12,33,197,120,317
9,2,5,27,18,45
29,2,5,55,58,113
3,9,25,30,27,57
19,9,25,190,171,361
14,1,2,10,14,24
30,13,35,429,390,819
19,13,35,272,247,519
12,9,25,189,108,297
1,1,4,2,1,3
21,1,2,15,21,36
12,1,2,9,12,21
26,1,2,24,26,50
5,1,2,5,5,10
20,1,2,20,20,40
5,1,2,3,5,8
16,1,4,39,16,55
4,1,4,10,4,14
5,2,5,14,10,24
17,2,5,48,34,82
16,2,5,45,32,77
1,461,742,266,461,727
1,1482,2384,735,1482,2217
1,755,1215,241,755,996
1,755,1215,448,755,1203
1,1482,2384,378,1482,1860
1,755,1215,436,755,1191
1,755,1215,436,755,1191
1,755,1215,241,755,996
1,1482,2384,378,1482,1860
27,2,5,63,54,117
6,2,5,14,12,26
18,2,5,50,36,86
26,2,5,73,52,125
2,3,9,9,6,15
28,3,9,123,84,207
20,2,5,38,40,78
30,2,5,87,60,147
17,2,5,50,34,84
10,2,5,30,20,50
9,4,10,34,36,70
23,4,10,87,92,179
9,2,5,22,18,40
27,2,5,51,54,105
12,2,5,23,24,47
6,2,5,17,12,29
2,2,5,4,4,8
7,2,5,13,14,27
3,2,5,9,6,15
11,2,5,26,22,48
8,2,5,19,16,35
2,4,10,11,8,19
17,2,5,39,34,73
22,2,5,51,44,95
12,2,5,35,24,59
6,2,5,17,12,29
5,3,9,21,15,36
9,3,9,37,27,64
12,3,9,49,36,85
27,2,5,78,54,132
23,2,5,67,46,113
18,2,5,50,36,86
28,2,5,78,56,134
16,2,5,46,32,78
6,2,5,17,12,29
22,2,5,52,44,96
8,2,5,19,16,35
13,7,9,0,91,91
18,7,9,25,126,151
19,7,9,36,133,169
2,7,9,4,14,18
13,7,9,11,91,102
15,7,9,25,105,130
15,7,9,6,105,111
11,3,8,37,33,70
24,3,8,112,72,184
16,8,22,178,128,306
6,8,22,75,48,123
22,8,22,206,176,382
28,8,22,380,224,604
26,8,22,284,208,492
16,8,22,220,128,348
2,8,22,26,16,42
29,9,24,282,261,543
25,9,24,267,225,492
13,9,24,129,117,246
22,9,24,309,198,507
14,9,24,166,126,292
11,9,24,123,99,222
1,9,24,10,9,19
30,9,24,436,270,706
8,9,24,116,72,188
9,13,35,192,117,309
24,13,35,494,312,806
17,13,35,267,221,488
12,13,35,247,156,403
11,13,35,157,143,300
24,13,35,343,312,655
12,13,35,188,156,344
28,13,35,489,364,853
17,13,35,350,221,571
29,13,35,425,377,802
24,13,35,494,312,806
26,13,35,454,338,792
14,13,35,220,182,402
5,13,35,108,65,173
18,13,35,371,234,605
17,13,35,297,221,518
7,13,35,122,91,213
21,13,35,447,273,720
26,13,35,554,338,892
2,13,35,31,26,57
12,13,35,260,156,416
8,13,35,165,104,269
15,13,35,293,195,488
1,13,35,16,13,29
11,13,35,157,143,300
21,13,35,447,273,720
10,13,35,175,130,305
5,13,35,87,65,152
25,13,35,410,325,735
30,21,55,954,630,1584
27,21,55,888,567,1455
2,21,55,64,42,106
29,21,55,635,609,1244
25,42,54,125,1050,1175
11,38,50,127,418,545
5,38,50,58,190,248
1,42,54,5,42,47
30,38,50,45,1140,1185
17,38,50,187,646,833
3,38,50,33,114,147
14,38,50,140,532,672
1,42,54,10,42,52
2,38,50,17,76,93
1,1252,2295,997,1252,2249
1,1252,2295,538,1252,1790
1,1252,2295,951,1252,2203
1,1266,2320,961,1266,2227
1,295,540,126,295,421
1,295,540,207,295,502
1,1266,2320,636,1266,1902
1,1252,2295,951,1252,2203
1,1266,2320,799,1266,2065
1,308,565,234,308,542
1,1266,2320,729,1266,1995
1,1266,2320,961,1266,2227
1,308,565,246,308,554
1,1252,2295,951,1252,2203
1,420,769,318,420,738
1,1252,2295,997,1252,2249
1,2171,3578,620,2171,2791
1,2171,3578,620,2171,2791
1,487,783,124,487,611
1,1519,2443,606,1519,2125
1,2171,3578,656,2171,2827
1,2171,3578,942,2171,3113
1,1519,2443,606,1519,2125
1,1555,2443,570,1555,2125
1,2171,3578,1371,2171,3542
1,1519,2443,411,1519,1930
1,1519,2443,411,1519,1930
1,344,540,174,344,518
1,487,783,194,487,681
1,344,540,174,344,518
1,487,783,171,487,658
1,487,783,194,487,681
2,26,70,85,52,137
29,26,70,992,754,1746
12,26,70,511,312,823
17,3,9,78,51,129
3,3,9,14,9,23
28,1,2,27,28,55
16,1,2,15,16,31
29,1,2,28,29,57
14,13,35,298,182,480
2,1,2,1,2,3
10,2,5,30,20,50
25,1,2,23,25,48
30,13,35,524,390,914
16,13,35,279,208,487
7,1,2,7,7,14
9,1,2,9,9,18
2,1,2,2,2,4
16,2,5,45,32,77
10,2,5,28,20,48
10,2,5,19,20,39
21,2,5,40,42,82
22,1,2,14,22,36
18,1,2,12,18,30
9,1,2,6,9,15
13,1,2,10,13,23
23,9,25,247,207,454
14,9,25,151,126,277
23,1,2,16,23,39
23,1,2,16,23,39
1,1,2,1,1,2
28,1,2,19,28,47
22,1,2,15,22,37
3,1,2,2,3,5
30,1,2,29,30,59
8,1,4,18,8,26
16,1,4,36,16,52
25,1,2,16,25,41
11,1,2,7,11,18
10,2,5,29,20,49
13,2,5,38,26,64
3,1,2,2,3,5
22,1,2,21,22,43
9,1,2,9,9,18
11,1,2,11,11,22
4,1,2,2,4,6
12,1,2,7,12,19
27,1,2,19,27,46
19,1,2,14,19,33
15,9,25,214,135,349
6,2,5,17,12,29
22,2,5,42,44,86
17,2,5,32,34,66
25,1,2,18,25,43
9,1,2,6,9,15
9,1,2,5,9,14
3,1,4,6,3,9
19,2,5,53,38,91
1,2,5,3,2,5
13,2,5,38,26,64
5,2,5,14,10,24
1,461,742,147,461,608
1,1482,2384,401,1482,1883
1,1482,2384,473,1482,1955
1,755,1215,436,755,1191
1,755,1215,241,755,996
1,1482,2384,568,1482,2050
1,45,120,70,45,115
3,59,159,290,177,467
24,2,5,71,48,119
23,2,5,54,46,100
6,4,10,35,24,59
25,4,10,148,100,248
28,2,5,59,56,115
9,2,5,21,18,39
2,2,5,5,4,9
19,2,5,55,38,93
24,2,5,53,48,101
2,2,5,4,4,8
17,7,9,32,119,151
6,7,9,8,42,50
18,7,9,30,126,156
17,7,9,23,119,142
2,7,9,4,14,18
27,7,9,52,189,241
29,7,9,53,203,256
21,7,9,8,147,155
15,7,9,27,105,132
4,7,9,3,28,31
3,3,8,15,9,24
2,3,8,10,6,16
21,3,8,83,63,146
4,3,8,13,12,25
9,3,8,44,27,71
13,3,8,42,39,81
18,3,8,84,54,138
22,3,8,71,66,137
28,8,22,244,224,468
13,8,22,176,104,280
17,8,22,231,136,367
18,8,22,244,144,388
12,8,22,163,96,259
30,8,22,413,240,653
15,9,24,221,135,356
18,9,24,261,162,423
3,9,24,44,27,71
2,13,35,41,26,67
6,13,35,94,78,172
15,13,35,293,195,488
28,13,35,479,364,843
26,13,35,426,338,764
13,13,35,277,169,446
29,13,35,597,377,974
5,13,35,108,65,173
5,13,35,79,65,144
2,13,35,34,26,60
23,13,35,490,299,789
5,13,35,72,65,137
20,13,35,426,260,686
18,13,35,264,234,498
26,13,35,454,338,792
20,13,35,426,260,686
1,13,35,21,13,34
4,13,35,63,52,115
6,21,55,181,126,307
17,21,55,569,357,926
10,21,55,225,210,435
13,38,50,143,494,637
30,38,50,300,1140,1440
4,38,50,34,152,186
22,42,54,50,924,974
1,38,50,12,38,50
22,38,50,242,836,1078
3,42,54,33,126,159
23,38,50,253,874,1127
1,1252,2295,745,1252,1997
1,1252,2295,882,1252,2134
1,1252,2295,492,1252,1744
1,420,769,341,420,761
1,1266,2320,544,1266,1810
1,1266,2320,1008,1266,2274
1,1266,2320,1008,1266,2274
1,420,769,341,420,761
1,1266,2320,1031,1266,2297
1,1252,2295,951,1252,2203
1,1266,2320,567,1266,1833
1,1266,2320,544,1266,1810
1,308,565,246,308,554
1,2171,3578,1264,2171,3435
1,1519,2443,582,1519,2101
1,2171,3578,763,2171,2934
1,1555,2443,717,1555,2272
1,2171,3578,1157,2171,3328
1,2171,3578,835,2171,3006
1,713,1120,205,713,918
1,1519,2443,606,1519,2125
1,1519,2443,411,1519,1930
1,2171,3578,620,2171,2791
5,26,70,217,130,347
5,1,2,5,5,10
14,1,2,13,14,27
27,1,2,25,27,52
4,13,35,87,52,139
14,13,35,303,182,485
1,2,5,3,2,5
5,2,5,15,10,25
21,2,5,59,42,101
17,2,5,48,34,82
23,12,33,475,276,751
1,13,35,22,13,35
16,13,35,346,208,554
12,2,5,22,24,46
3,11,30,56,33,89
29,11,30,542,319,861
26,2,5,75,52,127
5,2,5,15,10,25
16,2,5,46,32,78
14,2,5,41,28,69
13,2,5,38,26,64
27,2,5,80,54,134
30,2,5,89,60,149
30,2,5,89,60,149
25,2,5,74,50,124
8,13,35,165,104,269
25,2,5,70,50,120
16,2,5,38,32,70
4,13,35,57,52,109
15,13,35,215,195,410
19,13,35,272,247,519
11,1,2,6,11,17
7,1,2,4,7,11
28,1,2,16,28,44
17,11,30,313,187,500
14,11,30,258,154,412
22,11,30,405,242,647
13,1,4,32,13,45
30,1,4,74,30,104
13,2,5,38,26,64
26,11,30,463,286,749
25,11,30,445,275,720
22,1,2,16,22,38
9,1,4,26,9,35
10,1,4,29,10,39
7,1,4,20,7,27
24,11,29,418,264,682
1,11,29,17,11,28
21,12,33,427,252,679
4,1,2,4,4,8
8,2,5,23,16,39
27,2,5,78,54,132
29,2,5,84,58,142
27,9,25,419,243,662
6,1,4,18,6,24
1,461,742,185,461,646
1,1482,2384,807,1482,2289
1,755,1215,436,755,1191
1,1482,2384,568,1482,2050
1,1482,2384,473,1482,1955
10,45,120,738,450,1188
27,45,120,1312,1215,2527
8,2,5,19,16,35
19,2,5,45,38,83
15,2,5,42,30,72
9,2,5,25,18,43
5,2,5,12,10,22
11,2,5,26,22,48
18,2,5,52,36,88
27,2,5,78,54,132
18,2,5,34,36,70
6,2,5,11,12,23
9,2,5,17,18,35
15,2,5,35,30,65
15,2,5,35,30,65
26,2,5,73,52,125
10,2,5,28,20,48
9,4,10,41,36,77
6,4,10,28,24,52
22,2,5,42,44,86
6,2,5,11,12,23
25,2,5,73,50,123
2,2,5,6,4,10
9,2,5,21,18,39
10,2,5,21,20,41
7,2,5,15,14,29
7,2,5,20,14,34
7,2,5,20,14,34
3,2,5,9,6,15
16,3,9,70,48,118
21,3,9,92,63,155
1,2,5,2,2,4
19,2,5,45,38,83
27,2,5,57,54,111
2,2,5,4,4,8
14,7,9,25,98,123
10,7,9,16,70,86
21,7,9,34,147,181
15,7,9,29,105,134
12,7,9,5,84,89
27,7,9,22,189,211
23,7,9,0,161,161
1,7,9,0,7,7
11,7,9,9,77,86
29,7,9,24,203,227
24,7,9,13,168,181
7,3,8,34,21,55
16,3,8,77,48,125
15,3,8,73,45,118
30,3,8,107,90,197
1,8,22,14,8,22
24,8,22,225,192,417
8,8,22,108,64,172
14,8,22,156,112,268
7,8,22,95,56,151
27,8,22,366,216,582
23,8,22,317,184,501
29,8,22,361,232,593
8,9,24,112,72,184
12,9,24,143,108,251
20,13,35,349,260,609
19,13,35,278,247,525
25,13,35,533,325,858
23,13,35,498,299,797
25,13,35,533,325,858
2,13,35,41,26,67
25,13,35,515,325,840
9,13,35,163,117,280
20,13,35,342,260,602
6,13,35,105,78,183
7,13,35,144,91,235
25,13,35,533,325,858
14,13,35,230,182,412
9,13,35,141,117,258
4,13,35,59,52,111
14,13,35,303,182,485
13,13,35,281,169,450
11,13,35,227,143,370
17,13,35,368,221,589
18,13,35,283,234,517
1,13,35,15,13,28
3,21,55,95,63,158
19,21,55,625,399,1024
24,21,55,790,504,1294
11,38,50,121,418,539
3,38,50,30,114,144
12,38,50,78,456,534
9,38,50,90,342,432
18,38,50,99,684,783
8,38,50,88,304,392
1,42,54,11,42,53
12,42,54,40,504,544
22,38,50,253,836,1089
3,42,54,30,126,156
18,38,50,18,684,702
1,1898,3375,1038,1898,2936
1,1266,2320,961,1266,2227
1,1252,2295,997,1252,2249
1,1252,2295,722,1252,1974
1,1252,2295,997,1252,2249
1,420,769,318,420,738
1,308,565,234,308,542
1,295,540,234,295,529
1,308,565,246,308,554
1,295,540,207,295,502
1,420,769,211,420,631
1,1252,2295,561,1252,1813
1,1266,2320,752,1266,2018
1,2171,3578,763,2171,2934
1,2171,3578,1264,2171,3435
1,2171,3578,1264,2171,3435
1,2171,3578,942,2171,3113
1,2171,3578,942,2171,3113
1,487,783,288,487,775
1,487,783,155,487,642
1,2171,3578,835,2171,3006
1,487,783,108,487,595
1,713,1120,385,713,1098
1,344,540,120,344,464
1,344,540,174,344,518
1,344,540,185,344,529
1,2171,3578,1335,2171,3506
1,344,540,99,344,443
1,1083,1701,550,1083,1633
26,26,70,1126,676,1802
24,26,70,1022,624,1646
24,26,70,1039,624,1663
22,26,70,937,572,1509
27,26,70,923,702,1625
3,26,70,130,78,208
25,3,9,146,75,221
29,3,9,137,87,224
15,1,2,8,15,23
24,8,21,246,192,438
3,8,21,25,24,49
1,8,21,8,8,16
14,1,2,13,14,27
28,1,2,27,28,55
11,1,2,11,11,22
20,13,35,433,260,693
16,13,35,346,208,554
4,1,2,3,4,7
18,1,4,51,18,69
23,9,25,362,207,569
1,2,5,3,2,5
3,13,35,51,39,90
9,2,5,26,18,44
1,2,5,3,2,5
10,11,30,151,110,261
3,9,25,40,27,67
24,9,25,318,216,534
4,1,2,3,4,7
6,1,2,4,6,10
1,2,5,3,2,5
21,11,30,267,231,498
8,1,2,7,8,15
22,1,2,20,22,42
7,1,4,15,7,22
2,8,21,24,16,40
29,11,30,490,319,809
20,2,5,58,40,98
10,2,5,29,20,49
9,2,5,26,18,44
25,2,5,70,50,120
5,2,5,14,10,24
28,9,25,420,252,672
28,2,5,83,56,139
5,1,2,5,5,10
11,1,2,11,11,22
1,2,5,3,2,5
6,2,5,17,12,29
8,2,5,17,16,33
26,2,5,55,52,107
30,1,4,68,30,98
1,1482,2384,807,1482,2289
1,1482,2384,401,1482,1883
1,1482,2384,807,1482,2289
1,1482,2384,592,1482,2074
1,461,742,185,461,646
1,461,742,125,461,586
1,1482,2384,807,1482,2289
1,1482,2384,854,1482,2336
1,1482,2384,378,1482,1860
2,24,64,79,48,127
24,4,10,86,96,182
28,4,10,101,112,213
20,2,5,56,40,96
22,4,10,128,88,216
14,4,10,81,56,137
19,2,5,44,38,82
30,2,5,87,60,147
9,2,5,26,18,44
12,2,5,34,24,58
9,2,5,25,18,43
20,3,9,116,60,176
9,3,9,52,27,79
2,2,5,6,4,10
27,2,5,78,54,132
11,2,5,29,22,51
29,2,5,84,58,142
25,2,5,73,50,123
28,4,10,118,112,230
18,4,10,76,72,148
10,2,5,27,20,47
12,2,5,32,24,56
4,3,9,18,12,30
13,3,9,59,39,98
19,3,9,78,57,135
18,3,9,74,54,128
25,3,9,119,75,194
2,3,9,9,6,15
7,7,9,11,49,60
15,7,9,25,105,130
17,7,9,31,119,150
19,7,9,14,133,147
18,7,9,25,126,151
24,7,9,33,168,201
16,7,9,12,112,124
27,3,8,133,81,214
12,3,8,59,36,95
5,3,8,23,15,38
22,3,8,106,66,172
3,3,8,15,9,24
12,3,8,48,36,84
30,3,8,140,90,230
27,8,22,295,216,511
9,8,22,82,72,154
21,8,22,229,168,397
9,8,22,82,72,154
15,8,22,167,120,287
14,8,22,184,112,296
26,8,22,290,208,498
6,8,22,56,48,104
3,9,24,30,27,57
16,9,24,190,144,334
15,9,24,178,135,313
14,13,35,288,182,470
17,13,35,231,221,452
8,13,35,114,104,218
2,13,35,35,26,61
21,13,35,330,273,603
23,13,35,490,299,789
16,13,35,234,208,442
19,13,35,411,247,658
8,13,35,173,104,277
5,13,35,72,65,137
6,13,35,103,78,181
18,13,35,314,234,548
14,13,35,274,182,456
29,13,35,618,377,995
14,13,35,220,182,402
24,13,35,520,312,832
18,13,35,295,234,529
9,13,35,157,117,274
18,13,35,371,234,605
8,13,35,140,104,244
7,13,35,122,91,213
18,13,35,308,234,542
21,13,35,433,273,706
25,13,35,393,325,718
27,13,35,462,351,813
19,21,55,604,399,1003
4,21,55,132,84,216
14,42,54,62,588,650
13,42,54,128,546,674
22,42,54,15,924,939
9,38,50,50,342,392
1,38,50,11,38,49
23,42,54,115,966,1081
11,42,54,1,462,463
10,42,54,82,420,502
18,38,50,198,684,882
1,38,50,5,38,43
1,1912,3400,774,1912,2686
1,1266,2320,961,1266,2227
1,1252,2295,492,1252,1744
1,1252,2295,607,1252,1859
1,1252,2295,745,1252,1997
1,1252,2295,561,1252,1813
1,1266,2320,1008,1266,2274
1,1266,2320,961,1266,2227
1,1252,2295,630,1252,1882
1,295,540,207,295,502
1,1519,2443,875,1519,2394
1,2171,3578,656,2171,2827
1,1555,2443,546,1555,2101
1,713,1120,385,713,1098
1,2171,3578,656,2171,2827
1,1555,2443,546,1555,2101
1,1519,2443,606,1519,2125
1,344,540,185,344,529
1,344,540,185,344,529
1,1555,2443,570,1555,2125
1,713,1120,228,713,941
1,344,540,126,344,470
10,26,70,286,260,546
22,26,70,752,572,1324
27,26,70,1169,702,1871
23,1,2,13,23,36
25,1,2,14,25,39
10,1,2,6,10,16
2,2,5,5,4,9
1,2,5,2,2,4
28,1,2,27,28,55
24,1,2,23,24,47
29,1,2,28,29,57
24,12,33,361,288,649
4,13,35,70,52,122
5,2,5,15,10,25
2,2,5,6,4,10
19,2,5,44,38,82
4,2,5,12,8,20
16,2,5,47,32,79
27,13,35,575,351,926
4,13,35,85,52,137
25,11,30,318,275,593
5,11,30,64,55,119
3,2,5,8,6,14
14,2,5,39,28,67
25,12,33,517,300,817
30,1,2,20,30,50
25,2,5,59,50,109
17,1,2,13,17,30
23,1,2,17,23,40
10,11,30,178,110,288
28,11,30,498,308,806
27,11,30,481,297,778
29,2,5,68,58,126
15,12,33,206,180,386
7,12,33,96,84,180
29,8,21,249,232,481
16,8,21,137,128,265
11,8,21,94,88,182
28,1,2,20,28,48
24,8,21,216,192,408
24,2,5,67,48,115
13,2,5,36,26,62
1,2,5,2,2,4
13,2,5,31,26,57
24,2,5,56,48,104
30,2,5,71,60,131
12,2,5,28,24,52
8,2,5,19,16,35
19,1,4,54,19,73
12,2,5,25,24,49
1,461,742,266,461,727
1,1482,2384,878,1482,2360
1,1482,2384,878,1482,2360
1,1482,2384,807,1482,2289
1,1482,2384,807,1482,2289
1,1482,2384,807,1482,2289
1,1482,2384,568,1482,2050
1,755,1215,205,755,960
1,1482,2384,568,1482,2050
1,1482,2384,568,1482,2050
1,1482,2384,592,1482,2074
21,24,64,827,504,1331
23,45,120,1615,1035,2650
3,2,5,9,6,15
17,2,5,50,34,84
30,4,10,138,120,258
19,3,9,92,57,149
16,3,9,77,48,125
21,2,5,59,42,101
22,2,5,62,44,106
1,2,5,3,2,5
16,2,5,45,32,77
28,3,9,150,84,234
3,3,9,16,9,25
7,2,5,14,14,28
28,2,5,81,56,137
5,2,5,15,10,25
7,4,10,29,28,57
19,2,5,53,38,91
24,2,5,67,48,115
4,4,10,23,16,39
26,4,10,151,104,255
28,4,10,162,112,274
12,2,5,28,24,52
1,2,5,2,2,4
18,3,9,85,54,139
26,3,9,123,78,201
20,2,5,59,40,99
16,2,5,47,32,79
3,2,5,6,6,12
13,2,5,25,26,51
29,7,9,24,203,227
1,7,9,0,7,7
26,3,8,126,78,204
27,3,8,126,81,207
16,8,22,220,128,348
15,8,22,207,120,327
6,9,24,67,54,121
2,9,24,28,18,46
10,9,24,100,90,190
6,9,24,64,54,118
27,9,24,321,243,564
25,9,24,363,225,588
8,9,24,116,72,188
24,13,35,520,312,832
2,13,35,43,26,69
14,13,35,244,182,426
13,13,35,227,169,396
19,13,35,345,247,592
11,13,35,192,143,335
30,13,35,471,390,861
17,13,35,362,221,583
24,13,35,352,312,664
19,13,35,391,247,638
1,13,35,16,13,29
22,13,35,469,286,755
25,13,35,533,325,858
3,13,35,64,39,103
13,13,35,204,169,373
17,13,35,332,221,553
20,13,35,349,260,609
18,13,35,283,234,517
28,13,35,400,364,764
5,13,35,107,65,172
15,13,35,320,195,515
4,13,35,57,52,109
18,13,35,245,234,479
20,13,35,433,260,693
14,21,55,376,294,670
16,21,55,386,336,722
11,21,55,368,231,599
1,21,55,33,21,54
27,42,54,222,1134,1356
10,42,54,50,420,470
9,38,50,99,342,441
2,38,50,11,76,87
8,38,50,92,304,396
11,42,54,1,462,463
25,38,50,250,950,1200
29,38,50,87,1102,1189
6,42,54,30,252,282
30,38,50,330,1140,1470
30,42,54,328,1260,1588
16,38,50,184,608,792
21,38,50,116,798,914
4,42,54,0,168,168
1,1266,2320,892,1266,2158
1,1266,2320,752,1266,2018
1,1252,2295,951,1252,2203
1,1252,2295,951,1252,2203
1,1266,2320,636,1266,1902
1,420,769,318,420,738
1,1266,2320,544,1266,1810
1,1252,2295,630,1252,1882
1,295,540,223,295,518
1,295,540,234,295,529
1,1266,2320,961,1266,2227
1,420,769,295,420,715
1,1252,2295,997,1252,2249
1,1266,2320,1008,1266,2274
1,713,1120,385,713,1098
1,2171,3578,1264,2171,3435
1,2171,3578,656,2171,2827
1,2171,3578,942,2171,3113
1,1083,1701,244,1083,1327
1,1083,1701,244,1083,1327
1,487,783,155,487,642
1,713,1120,396,713,1109
1,713,1120,329,713,1042
1,1555,2443,497,1555,2052
1,1519,2443,606,1519,2125
1,344,540,185,344,529
1,1555,2443,570,1555,2125
1,344,540,126,344,470
1,487,783,132,487,619
1,487,783,288,487,775
1,2171,3578,1335,2171,3506
1,2171,3578,906,2171,3077
1,713,1120,329,713,1042
1,2171,3578,620,2171,2791
8,26,70,229,208,437
21,26,70,718,546,1264
22,3,9,106,66,172
6,3,9,35,18,53
10,3,9,58,30,88
27,1,2,26,27,53
11,1,2,11,11,22
18,11,29,240,198,438
8,13,35,170,104,274
13,13,35,277,169,446
24,2,5,70,48,118
29,2,5,84,58,142
8,13,35,173,104,277
21,13,35,455,273,728
25,1,4,71,25,96
29,1,4,82,29,111
18,9,25,194,162,356
24,9,25,258,216,474
29,9,25,312,261,573
23,11,30,430,253,683
13,11,30,243,143,386
24,2,5,56,48,104
19,2,5,36,38,74
23,12,33,346,276,622
20,9,25,265,180,445
12,9,25,159,108,267
21,1,2,14,21,35
7,1,2,5,7,12
30,9,25,428,270,698
27,9,25,385,243,628
6,9,25,86,54,140
11,1,2,10,11,21
2,11,30,27,22,49
2,11,30,27,22,49
21,13,35,366,273,639
13,1,4,35,13,48
24,9,25,378,216,594
7,9,25,110,63,173
18,1,2,17,18,35
24,1,4,71,24,95
14,1,4,41,14,55
10,1,4,30,10,40
16,1,4,47,16,63
4,2,5,12,8,20
20,1,2,19,20,39
26,1,4,59,26,85
17,1,4,39,17,56
27,2,5,78,54,132
15,2,5,44,30,74
14,2,5,41,28,69
12,2,5,35,24,59
19,2,5,45,38,83
4,11,30,74,44,118
5,11,30,92,55,147
12,11,30,221,132,353
26,1,4,63,26,89
20,1,2,17,20,37
23,1,2,20,23,43
20,1,2,17,20,37
25,2,5,53,50,103
24,1,4,70,24,94
4,1,4,12,4,16
23,1,2,13,23,36
11,9,25,110,99,209
30,9,25,300,270,570
18,2,5,34,36,70
22,2,5,42,44,86
30,8,21,377,240,617
16,1,4,40,16,56
18,1,2,17,18,35
28,1,2,27,28,55
4,2,5,11,8,19
7,2,5,20,14,34
1,1482,2384,592,1482,2074
1,1482,2384,401,1482,1883
1,461,742,185,461,646
1,1482,2384,878,1482,2360
1,1482,2384,807,1482,2289
1,755,1215,436,755,1191
1,1482,2384,854,1482,2336
1,755,1215,168,755,923
1,1482,2384,854,1482,2336
12,24,64,472,288,760
1,59,159,97,59,156
2,2,5,6,4,10
16,4,10,94,64,158
20,3,9,113,60,173
28,2,5,53,56,109
17,2,5,32,34,66
12,2,5,35,24,59
5,2,5,15,10,25
10,2,5,29,20,49
14,4,10,81,56,137
6,2,5,17,12,29
2,2,5,6,4,10
22,3,9,88,66,154
13,3,9,52,39,91
27,2,5,57,54,111
7,2,5,15,14,29
15,4,10,87,60,147
15,4,10,87,60,147
13,2,5,38,26,64
28,2,5,81,56,137
6,2,5,18,12,30
16,2,5,47,32,79
20,2,5,47,40,87
30,2,5,66,60,126
27,2,5,59,54,113
12,2,5,28,24,52
14,2,5,33,28,61
20,7,9,36,140,176
10,7,9,19,70,89
28,7,9,53,196,249
1,7,9,2,7,9
23,7,9,38,161,199
25,7,9,1,175,176
2,7,9,2,14,16
7,7,9,13,49,62
14,3,8,62,42,104
4,3,8,16,12,28
25,3,8,99,75,174
21,3,8,78,63,141
22,3,8,82,66,148
30,8,22,328,240,568
7,8,22,70,56,126
4,8,22,54,32,86
10,8,22,136,80,216
22,8,22,231,176,407
26,8,22,353,208,561
5,8,22,68,40,108
27,8,22,247,216,463
28,9,24,326,252,578
9,9,24,131,81,212
19,9,24,185,171,356
20,13,35,426,260,686
25,13,35,428,325,753
19,13,35,332,247,579
27,13,35,585,351,936
5,13,35,86,65,151
6,13,35,124,78,202
2,13,35,41,26,67
23,13,35,474,299,773
20,13,35,349,260,609
23,13,35,490,299,789
11,13,35,234,143,377
23,13,35,490,299,789
14,13,35,200,182,382
6,13,35,86,78,164
5,13,35,100,65,165
9,13,35,141,117,258
26,13,35,454,338,792
1,13,35,22,13,35
29,13,35,516,377,893
17,13,35,267,221,488
30,13,35,587,390,977
25,13,35,358,325,683
19,13,35,312,247,559
24,13,35,377,312,689
9,21,55,197,189,386
7,21,55,234,147,381
14,21,55,461,294,755
20,21,55,526,420,946
16,42,54,175,672,847
4,42,54,46,168,214
16,38,50,80,608,688
17,42,54,39,714,753
12,38,50,12,456,468
17,42,54,2,714,716
19,38,50,105,722,827
22,38,50,33,836,869
16,42,54,88,672,760
1,1912,3400,774,1912,2686
1,1266,2320,752,1266,2018
1,1252,2295,676,1252,1928
1,1252,2295,997,1252,2249
1,1266,2320,1008,1266,2274
1,1266,2320,1008,1266,2274
1,1252,2295,997,1252,2249
1,420,769,318,420,738
1,420,769,180,420,600
1,1252,2295,951,1252,2203
1,308,565,234,308,542
1,420,769,249,420,669
1,295,540,234,295,529
1,1266,2320,636,1266,1902
1,308,565,251,308,559
1,308,565,189,308,497
1,1083,1701,499,1083,1582
1,1555,2443,546,1555,2101
1,1083,1701,244,1083,1327
1,1555,2443,570,1555,2125
1,1519,2443,606,1519,2125
1,344,540,185,344,529
1,344,540,110,344,454
17,26,70,486,442,928
4,26,70,137,104,241
25,3,9,146,75,221
4,2,5,8,8,16
2,2,5,4,4,8
12,1,2,12,12,24
5,1,2,5,5,10
9,1,2,9,9,18
25,1,2,24,25,49
23,1,2,17,23,40
11,1,2,8,11,19
18,1,2,18,18,36
24,1,2,17,24,41
21,2,5,59,42,101
30,2,5,84,60,144
22,2,5,62,44,106
17,13,35,362,221,583
19,13,35,405,247,652
5,2,5,11,10,21
5,2,5,11,10,21
10,2,5,19,20,39
15,2,5,29,30,59
22,2,5,62,44,106
25,2,5,70,50,120
22,2,5,65,44,109
28,1,4,64,28,92
13,1,4,30,13,43
8,1,2,5,8,13
8,1,2,5,8,13
18,1,2,12,18,30
21,9,25,268,189,457
22,9,25,281,198,479
28,9,25,357,252,609
5,11,30,86,55,141
13,2,5,38,26,64
17,2,5,49,34,83
17,2,5,32,34,66
16,2,5,30,32,62
30,1,4,68,30,98
5,1,4,11,5,16
6,2,5,14,12,26
26,9,25,312,234,546
29,9,25,348,261,609
6,2,5,18,12,30
13,2,5,38,26,64
21,1,4,57,21,78
5,1,2,3,5,8
28,8,21,241,224,465
19,8,21,163,152,315
2,1,4,5,2,7
12,1,4,29,12,41
24,2,5,46,48,94
21,2,5,40,42,82
28,2,5,81,56,137
27,2,5,78,54,132
4,2,5,12,8,20
1,1,4,3,1,4
8,1,4,22,8,30
6,2,5,11,12,23
6,9,25,93,54,147
7,9,25,109,63,172
1,1482,2384,521,1482,2003
1,461,742,177,461,638
1,1482,2384,568,1482,2050
1,461,742,185,461,646
1,461,742,266,461,727
1,24,64,31,24,55
13,24,64,404,312,716
28,24,64,869,672,1541
20,4,10,88,80,168
16,4,10,70,64,134
24,2,5,71,48,119
17,2,5,50,34,84
6,2,5,11,12,23
1,2,5,3,2,5
28,2,5,81,56,137
24,2,5,67,48,115
9,2,5,25,18,43
6,2,5,14,12,26
20,2,5,47,40,87
13,2,5,30,26,56
3,2,5,7,6,13
25,3,9,148,75,223
13,3,9,77,39,116
5,2,5,11,10,21
16,3,9,70,48,118
28,3,9,123,84,207
23,2,5,54,46,100
10,2,5,24,20,44
15,7,9,27,105,132
21,7,9,34,147,181
30,7,9,11,210,221
25,7,9,14,175,189
20,7,9,36,140,176
24,7,9,20,168,188
11,7,9,8,77,85
14,7,9,25,98,123
22,7,9,40,154,194
17,7,9,28,119,147
29,7,9,48,203,251
17,7,9,28,119,147
18,3,8,60,54,114
21,9,24,255,189,444
11,9,24,160,99,259
27,9,24,314,243,557
13,13,35,277,169,446
24,13,35,326,312,638
2,13,35,29,26,55
8,13,35,165,104,269
3,13,35,62,39,101
24,13,35,419,312,731
1,13,35,14,13,27
29,13,35,618,377,995
10,13,35,217,130,347
16,13,35,234,208,442
6,13,35,124,78,202
25,13,35,428,325,753
1,13,35,18,13,31
19,13,35,405,247,652
5,13,35,103,65,168
1,13,35,22,13,35
17,13,35,267,221,488
7,38,50,21,266,287
25,42,54,17,1050,1067
16,42,54,80,672,752
16,42,54,157,672,829
2,38,50,11,76,87
8,42,54,87,336,423
1,1266,2320,497,1266,1763
1,1252,2295,882,1252,2134
1,420,769,318,420,738
1,1266,2320,752,1266,2018
1,295,540,234,295,529
1,1252,2295,997,1252,2249
1,2171,3578,942,2171,3113
1,487,783,202,487,689
1,344,540,77,344,421
1,487,783,265,487,752
1,344,540,174,344,518
1,487,783,194,487,681
1,344,540,191,344,535
1,2171,3578,906,2171,3077
1,713,1120,205,713,918
1,1519,2443,900,1519,2419
24,26,70,989,624,1613
3,26,70,128,78,206
16,26,70,458,416,874
30,26,70,1278,780,2058
15,26,70,639,390,1029
29,26,70,1235,754,1989
2,3,9,12,6,18
3,3,9,18,9,27
7,1,2,7,7,14
7,1,2,7,7,14
9,2,5,26,18,44
8,2,5,23,16,39
21,1,2,11,21,32
18,1,2,9,18,27
6,1,2,5,6,11
2,1,2,2,2,4
11,1,2,7,11,18
7,1,2,4,7,11
6,12,33,100,72,172
26,11,30,486,286,772
4,11,30,75,44,119
27,1,4,80,27,107
22,1,4,65,22,87
26,2,5,73,52,125
14,2,5,27,28,55
3,2,5,6,6,12
5,2,5,10,10,20
14,1,4,35,14,49
13,1,4,32,13,45
23,1,2,23,23,46
17,1,2,13,17,30
14,1,2,10,14,24
24,2,5,64,48,112
15,2,5,29,30,59
11,2,5,21,22,43
25,2,5,70,50,120
26,2,5,73,52,125
6,1,4,15,6,21
26,13,35,563,338,901
13,13,35,281,169,450
22,1,4,65,22,87
4,9,25,63,36,99
18,9,25,284,162,446
29,9,25,457,261,718
11,1,2,8,11,19
27,1,2,16,27,43
14,1,2,13,14,27
26,1,2,24,26,50
15,1,2,14,15,29
30,1,2,28,30,58
18,1,4,53,18,71
30,2,5,59,60,119
2,2,5,4,4,8
27,2,5,53,54,107
1,2,5,2,2,4
9,1,4,26,9,35
5,1,4,14,5,19
2,1,2,1,2,3
28,1,2,16,28,44
2,1,2,2,2,4
22,1,4,54,22,76
10,1,4,24,10,34
6,1,2,4,6,10
22,1,2,14,22,36
29,1,2,19,29,48
1,1482,2384,521,1482,2003
1,1482,2384,616,1482,2098
1,1482,2384,807,1482,2289
1,1482,2384,735,1482,2217
1,1482,2384,854,1482,2336
1,755,1215,290,755,1045
1,1482,2384,854,1482,2336
26,24,64,774,624,1398
8,24,64,315,192,507
3,45,120,218,135,353
25,2,5,53,50,103
13,2,5,27,26,53
20,3,9,97,60,157
21,3,9,101,63,164
18,2,5,34,36,70
27,2,5,51,54,105
7,2,5,13,14,27
9,2,5,17,18,35
24,3,9,109,72,181
14,3,9,64,42,106
13,2,5,25,26,51
15,2,5,29,30,59
2,2,5,5,4,9
18,2,5,42,36,78
28,2,5,64,56,120
22,2,5,51,44,95
11,2,5,32,22,54
5,2,5,15,10,25
10,2,5,28,20,48
9,2,5,25,18,43
21,2,5,40,42,82
18,2,5,34,36,70
4,2,5,12,8,20
29,2,5,81,58,139
12,2,5,34,24,58
29,4,10,122,116,238
21,3,9,122,63,185
5,3,9,29,15,44
28,4,10,157,112,269
19,4,10,106,76,182
20,2,5,59,40,99
2,2,5,6,4,10
20,2,5,42,40,82
17,2,5,36,34,70
28,2,5,66,56,122
2,2,5,5,4,9
14,2,5,29,28,57
28,2,5,59,56,115
4,3,9,23,12,35
30,3,9,169,90,259
28,3,9,115,84,199
25,3,9,103,75,178
22,2,5,64,44,108
12,2,5,35,24,59
25,7,9,3,175,178
21,7,9,0,147,147
21,7,9,34,147,181
9,7,9,5,63,68
10,7,9,8,70,78
13,7,9,10,91,101
17,7,9,31,119,150
27,7,9,3,189,192
1,7,9,2,7,9
30,3,8,119,90,209
14,3,8,45,42,87
7,3,8,28,21,49
24,3,8,93,72,165
13,8,22,176,104,280
20,8,22,201,160,361
9,8,22,82,72,154
6,9,24,74,54,128
29,9,24,428,261,689
13,9,24,183,117,300
30,9,24,421,270,691
1,13,35,14,13,27
27,13,35,575,351,926
8,13,35,131,104,235
22,13,35,384,286,670
9,13,35,129,117,246
7,13,35,152,91,243
16,13,35,262,208,470
20,13,35,426,260,686
18,13,35,283,234,517
23,13,35,329,299,628
7,13,35,144,91,235
18,13,35,390,234,624
27,13,35,575,351,926
3,13,35,64,39,103
24,13,35,394,312,706
13,13,35,268,169,437
7,21,55,153,147,300
28,21,55,736,588,1324
17,21,55,559,357,916
30,42,54,4,1260,1264
27,38,50,270,1026,1296
12,38,50,36,456,492
17,38,50,170,646,816
2,38,50,8,76,84
27,38,50,41,1026,1067
30,42,54,182,1260,1442
16,42,54,36,672,708
4,42,54,44,168,212
6,38,50,60,228,288
15,42,54,10,630,640
1,1252,2295,538,1252,1790
1,1266,2320,636,1266,1902
1,1266,2320,636,1266,1902
1,420,769,180,420,600
1,308,565,184,308,492
1,420,769,249,420,669
1,420,769,318,420,738
1,1266,2320,961,1266,2227
1,1266,2320,961,1266,2227
1,1266,2320,961,1266,2227
1,1266,2320,636,1266,1902
1,1252,2295,745,1252,1997
1,1555,2443,839,1555,2394
1,2171,3578,763,2171,2934
1,2171,3578,656,2171,2827
1,2171,3578,656,2171,2827
1,2171,3578,656,2171,2827
1,713,1120,205,713,918
1,344,540,137,344,481
1,2171,3578,1335,2171,3506
1,1555,2443,790,1555,2345
1,487,783,171,487,658
1,2171,3578,1335,2171,3506
5,26,70,164,130,294
2,26,70,63,52,115
15,3,9,60,45,105
13,3,9,57,39,96
10,3,9,46,30,76
18,1,2,10,18,28
29,13,35,476,377,853
16,1,2,12,16,28
21,1,2,16,21,37
25,11,30,468,275,743
25,11,30,468,275,743
7,2,5,20,14,34
1,9,25,11,9,20
29,9,25,312,261,573
30,1,2,29,30,59
14,1,2,13,14,27
17,9,25,196,153,349
13,9,25,150,117,267
8,12,33,118,96,214
19,12,33,280,228,508
2,1,2,1,2,3
24,1,2,15,24,39
4,1,2,2,4,6
8,1,2,4,8,12
30,1,2,19,30,49
9,1,2,6,9,15
13,1,2,10,13,23
16,1,2,12,16,28
2,1,2,1,2,3
22,1,2,20,22,42
14,1,2,13,14,27
23,2,5,67,46,113
5,2,5,15,10,25
25,2,5,73,50,123
11,1,2,10,11,21
6,1,2,6,6,12
19,1,2,12,19,31
22,2,5,42,44,86
28,2,5,53,56,109
29,11,30,360,319,679
28,11,30,347,308,655
16,11,30,299,176,475
30,2,5,74,60,134
26,2,5,64,52,116
9,2,5,22,18,40
15,1,4,34,15,49
9,1,4,21,9,30
15,11,29,192,165,357
30,11,29,383,330,713
22,12,33,447,264,711
18,12,33,366,216,582
21,2,5,49,42,91
24,2,5,56,48,104
26,1,2,19,26,45
22,9,25,231,198,429
11,9,25,116,99,215
4,9,25,42,36,78
21,2,5,62,42,104
23,2,5,68,46,114
20,2,5,58,40,98
30,1,4,65,30,95
1,461,742,118,461,579
1,461,742,162,461,623
1,461,742,251,461,712
1,1482,2384,878,1482,2360
1,1482,2384,378,1482,1860
1,755,1215,436,755,1191
1,1482,2384,854,1482,2336
1,1482,2384,854,1482,2336
1,461,742,185,461,646
8,24,64,315,192,507
24,24,64,929,576,1505
25,45,120,1815,1125,2940
8,59,159,635,472,1107
25,4,10,148,100,248
2,4,10,12,8,20
28,3,9,163,84,247
16,4,10,58,64,122
30,4,10,108,120,228
1,4,10,6,4,10
18,4,10,106,72,178
20,2,5,49,40,89
26,2,5,64,52,116
5,2,5,10,10,20
20,2,5,58,40,98
30,2,5,87,60,147
12,2,5,34,24,58
16,2,5,45,32,77
18,3,9,87,54,141
19,2,5,56,38,94
5,2,5,15,10,25
24,3,9,99,72,171
24,3,9,99,72,171
26,2,5,60,52,112
18,2,5,41,36,77
21,2,5,61,42,103
2,2,5,6,4,10
24,4,10,101,96,197
3,4,10,13,12,25
20,7,9,17,140,157
11,7,9,21,77,98
17,7,9,2,119,121
27,7,9,52,189,241
11,7,9,-2,77,75
22,7,9,0,154,154
16,7,9,6,112,118
28,3,8,100,84,184
13,3,8,51,39,90
23,3,8,91,69,160
5,8,22,68,40,108
25,8,22,235,200,435
29,8,22,393,232,625
29,8,22,323,232,555
19,8,22,212,152,364
23,9,24,284,207,491
7,9,24,98,63,161
10,13,35,175,130,305
6,13,35,124,78,202
21,13,35,286,273,559
2,13,35,43,26,69
8,13,35,123,104,227
21,13,35,381,273,654
22,13,35,384,286,670
13,13,35,227,169,396
27,13,35,396,351,747
25,13,35,358,325,683
25,13,35,489,325,814
29,13,35,597,377,974
19,13,35,405,247,652
19,13,35,298,247,545
7,13,35,144,91,235
21,13,35,330,273,603
8,13,35,140,104,244
8,13,35,126,104,230
1,13,35,17,13,30
2,21,55,48,42,90
6,21,55,135,126,261
27,38,50,311,1026,1337
23,38,50,253,874,1127
18,42,54,177,756,933
21,38,50,210,798,1008
29,38,50,160,1102,1262
3,38,50,35,114,149
16,42,54,157,672,829
13,38,50,85,494,579
26,42,54,298,1092,1390
3,38,50,33,114,147
17,42,54,85,714,799
8,38,50,88,304,392
22,42,54,15,924,939
28,38,50,140,1064,1204
1,1252,2295,561,1252,1813
1,420,769,241,420,661
1,1252,2295,538,1252,1790
1,1252,2295,745,1252,1997
1,1252,2295,745,1252,1997
1,1266,2320,961,1266,2227
1,1266,2320,1008,1266,2274
1,1266,2320,729,1266,1995
1,308,565,246,308,554
1,1252,2295,630,1252,1882
1,2171,3578,1264,2171,3435
1,2171,3578,1264,2171,3435
1,2171,3578,548,2171,2719
1,1519,2443,875,1519,2394
1,1519,2443,655,1519,2174
1,487,783,280,487,767
1,1555,2443,375,1555,1930
1,713,1120,284,713,997
1,2171,3578,656,2171,2827
1,713,1120,362,713,1075
1,713,1120,362,713,1075
1,713,1120,385,713,1098
1,487,783,265,487,752
1,713,1120,205,713,918
1,2171,3578,1335,2171,3506
1,713,1120,205,713,918
10,26,70,412,260,672
28,26,70,1212,728,1940
7,26,70,303,182,485
20,26,70,852,520,1372
23,3,9,136,69,205
12,3,9,70,36,106
5,3,9,29,15,44
3,1,2,2,3,5
23,1,2,13,23,36
13,1,2,13,13,26
11,2,5,32,22,54
19,9,25,242,171,413
27,1,2,17,27,44
2,1,2,1,2,3
29,1,2,21,29,50
24,1,2,18,24,42
8,1,2,6,8,14
9,13,35,195,117,312
23,13,35,498,299,797
1,2,5,2,2,4
15,2,5,29,30,59
11,2,5,21,22,43
7,2,5,21,14,35
4,13,35,63,52,115
24,2,5,46,48,94
16,9,25,172,144,316
30,9,25,323,270,593
27,1,2,20,27,47
25,9,25,331,225,556
4,9,25,53,36,89
15,9,25,199,135,334
1,1,4,3,1,4
27,2,5,63,54,117
25,2,5,59,50,109
19,2,5,55,38,93
12,2,5,35,24,59
21,2,5,48,42,90
29,2,5,67,58,125
28,8,21,323,224,547
4,8,21,46,32,78
23,2,5,54,46,100
9,1,2,7,9,16
9,1,2,7,9,16
13,1,4,38,13,51
9,1,4,26,9,35
21,12,33,309,252,561
9,12,33,133,108,241
9,2,5,21,18,39
15,1,4,34,15,49
9,1,4,21,9,30
23,1,4,68,23,91
25,2,5,53,50,103
21,2,5,44,42,86
22,1,2,21,22,43
13,1,2,12,13,25
3,1,2,3,3,6
1,1482,2384,592,1482,2074
1,1482,2384,878,1482,2360
1,461,742,251,461,712
1,1482,2384,807,1482,2289
1,1482,2384,568,1482,2050
1,1482,2384,854,1482,2336
1,1482,2384,568,1482,2050
1,461,742,229,461,690
2,24,64,77,48,125
8,24,64,223,192,415
22,45,120,1624,990,2614
3,59,159,281,177,458
22,2,5,52,44,96
22,3,9,118,66,184
26,2,5,77,52,129
4,4,10,19,16,35
17,4,10,80,68,148
7,3,9,32,21,53
4,3,9,18,12,30
7,2,5,15,14,29
3,2,5,9,6,15
29,2,5,84,58,142
16,2,5,46,32,78
10,2,5,22,20,42
9,2,5,26,18,44
30,2,5,87,60,147
9,3,9,43,27,70
2,3,9,10,6,16
23,2,5,64,46,110
1,2,5,3,2,5
27,2,5,80,54,134
7,7,9,13,49,62
18,7,9,30,126,156
2,7,9,3,14,17
3,7,9,5,21,26
17,7,9,0,119,119
27,7,9,15,189,204
12,7,9,23,84,107
22,7,9,42,154,196
30,7,9,25,210,235
2,7,9,0,14,14
16,7,9,31,112,143
10,3,8,44,30,74
19,3,8,92,57,149
13,3,8,63,39,102
9,8,22,100,72,172
13,8,22,176,104,280
8,8,22,108,64,172
6,8,22,83,48,131
21,8,22,211,168,379
23,8,22,312,184,496
24,8,22,331,192,523
16,9,24,190,144,334
15,9,24,160,135,295
21,9,24,280,189,469
12,9,24,168,108,276
16,13,35,341,208,549
14,13,35,288,182,470
16,13,35,279,208,487
20,13,35,426,260,686
4,13,35,87,52,139
21,13,35,447,273,720
9,13,35,185,117,302
2,13,35,39,26,65
18,13,35,314,234,548
15,13,35,320,195,515
1,13,35,15,13,28
1,13,35,17,13,30
14,13,35,298,182,480
23,13,35,329,299,628
7,13,35,103,91,194
5,13,35,87,65,152
24,21,55,763,504,1267
5,38,50,50,190,240
14,38,50,77,532,609
9,38,50,90,342,432
10,38,50,115,380,495
18,42,54,90,756,846
5,42,54,25,210,235
19,42,54,218,798,1016
8,42,54,87,336,423
2,42,54,1,84,85
2,38,50,23,76,99
15,42,54,10,630,640
30,38,50,330,1140,1470
1,1266,2320,752,1266,2018
1,1252,2295,951,1252,2203
1,1266,2320,1031,1266,2297
1,308,565,184,308,492
1,1252,2295,951,1252,2203
1,420,769,318,420,738
1,1252,2295,997,1252,2249
1,1266,2320,1008,1266,2274
1,295,540,240,295,535
1,1266,2320,1008,1266,2274
1,295,540,164,295,459
1,1912,3400,740,1912,2652
1,2171,3578,1335,2171,3506
1,1083,1701,397,1083,1480
1,1555,2443,717,1555,2272
1,1555,2443,448,1555,2003
1,487,783,265,487,752
1,1519,2443,411,1519,1930
1,2171,3578,1371,2171,3542
1,1519,2443,411,1519,1930
1,344,540,126,344,470
1,713,1120,396,713,1109
1,2171,3578,620,2171,2791
10,26,70,412,260,672
19,26,70,557,494,1051
24,3,9,109,72,181
19,1,2,16,19,35
2,1,2,2,2,4
10,2,5,29,20,49
5,13,35,107,65,172
30,13,35,639,390,1029
14,13,35,298,182,480
20,1,2,14,20,34
4,1,2,3,4,7
30,1,2,20,30,50
7,1,2,6,7,13
1,11,30,15,11,26
7,11,30,106,77,183
22,11,30,332,242,574
8,1,2,8,8,16
1,9,25,11,9,20
24,9,25,258,216,474
19,1,2,18,19,37
24,1,2,23,24,47
19,1,2,18,19,37
26,1,2,25,26,51
5,2,5,15,10,25
7,1,2,5,7,12
22,1,2,14,22,36
26,1,2,25,26,51
16,1,2,15,16,31
25,1,2,25,25,50
12,1,2,12,12,24
22,2,5,52,44,96
2,2,5,6,4,10
27,11,30,359,297,656
16,11,30,213,176,389
30,1,4,82,30,112
6,1,4,16,6,22
17,1,4,40,17,57
1,9,25,13,9,22
24,9,25,306,216,522
18,13,35,295,234,529
14,11,30,249,154,403
30,1,2,22,30,52
6,1,2,6,6,12
29,2,5,84,58,142
2,2,5,4,4,8
4,2,5,8,8,16
2,1,2,2,2,4
22,2,5,65,44,109
17,2,5,50,34,84
11,2,5,32,22,54
22,2,5,65,44,109
4,1,2,3,4,7
26,1,2,19,26,45
28,2,5,81,56,137
26,2,5,75,52,127
12,1,4,30,12,42
21,1,4,52,21,73
29,1,4,85,29,114
16,1,4,47,16,63
6,2,5,11,12,23
9,2,5,25,18,43
27,2,5,76,54,130
1,1482,2384,735,1482,2217
1,1482,2384,735,1482,2217
1,1482,2384,807,1482,2289
1,461,742,274,461,735
1,1482,2384,854,1482,2336
1,1482,2384,854,1482,2336
1,24,64,39,24,63
18,4,10,106,72,178
11,3,9,65,33,98
4,2,5,11,8,19
2,2,5,5,4,9
14,3,9,83,42,125
10,3,9,59,30,89
2,4,10,8,8,16
3,2,5,6,6,12
9,2,5,17,18,35
27,2,5,78,54,132
2,2,5,6,4,10
21,2,5,41,42,83
22,2,5,43,44,87
24,4,10,139,96,235
20,4,10,116,80,196
24,2,5,71,48,119
1,2,5,3,2,5
23,4,10,136,92,228
3,4,10,18,12,30
17,2,5,49,34,83
6,2,5,17,12,29
26,2,5,69,52,121
26,2,5,69,52,121
16,7,9,13,112,125
15,7,9,27,105,132
29,7,9,53,203,256
22,7,9,8,154,162
12,7,9,1,84,85
22,3,8,71,66,137
2,3,8,10,6,16
23,8,22,231,184,415
19,8,22,249,152,401
14,8,22,128,112,240
18,8,22,201,144,345
8,8,22,100,64,164
13,8,22,176,104,280
13,8,22,179,104,283
11,8,22,152,88,240
8,9,24,112,72,184
11,9,24,162,99,261
4,9,24,59,36,95
23,9,24,334,207,541
27,13,35,424,351,775
25,13,35,428,325,753
28,13,35,606,364,970
20,13,35,314,260,574
6,13,35,124,78,202
4,13,35,87,52,139
1,13,35,21,13,34
16,13,35,313,208,521
20,13,35,412,260,672
8,13,35,140,104,244
22,13,35,315,286,601
5,13,35,98,65,163
19,13,35,272,247,519
23,13,35,474,299,773
9,13,35,192,117,309
10,13,35,164,130,294
16,13,35,313,208,521
6,13,35,98,78,176
9,13,35,192,117,309
26,13,35,372,338,710
1,13,35,22,13,35
19,13,35,325,247,572
16,13,35,251,208,459
8,42,54,92,336,428
6,38,50,9,228,237
18,42,54,90,756,846
1,38,50,2,38,40
24,38,50,240,912,1152
14,38,50,70,532,602
3,42,54,15,126,141
3,42,54,13,126,139
14,42,54,138,588,726
15,38,50,173,570,743
7,38,50,35,266,301
1,1266,2320,636,1266,1902
1,1252,2295,1020,1252,2272
1,1266,2320,752,1266,2018
1,420,769,318,420,738
1,1252,2295,951,1252,2203
1,1252,2295,676,1252,1928
1,1266,2320,1008,1266,2274
1,1252,2295,745,1252,1997
1,1252,2295,561,1252,1813
1,1266,2320,1008,1266,2274
1,1252,2295,630,1252,1882
1,1898,3375,1410,1898,3308
1,1083,1701,397,1083,1480
1,713,1120,362,713,1075
1,2171,3578,763,2171,2934
1,1555,2443,448,1555,2003
1,487,783,280,487,767
1,1083,1701,244,1083,1327
1,487,783,155,487,642
1,713,1120,385,713,1098
1,1555,2443,497,1555,2052
1,344,540,77,344,421
1,344,540,77,344,421
1,2171,3578,1371,2171,3542
1,1083,1701,499,1083,1582
1,2171,3578,906,2171,3077
16,26,70,682,416,1098
3,26,70,103,78,181
16,26,70,458,416,874
9,3,9,37,27,64
24,3,9,135,72,207
21,2,5,61,42,103
10,2,5,19,20,39
8,2,5,15,16,31
4,2,5,8,8,16
4,2,5,8,8,16
26,13,35,445,338,783
28,13,35,479,364,843
23,2,5,64,46,110
2,2,5,6,4,10
14,11,29,179,154,333
6,11,29,77,66,143
23,1,2,15,23,38
27,1,2,17,27,44
28,11,30,524,308,832
23,13,35,498,299,797
21,13,35,455,273,728
2,2,5,6,4,10
13,2,5,38,26,64
13,1,4,31,13,44
23,1,2,17,23,40
16,1,2,12,16,28
18,2,5,52,36,88
17,2,5,49,34,83
22,9,25,253,198,451
4,1,2,2,4,6
17,1,2,10,17,27
30,1,2,28,30,58
30,1,2,28,30,58
5,1,2,5,5,10
20,2,5,56,40,96
8,1,2,5,8,13
12,1,2,8,12,20
16,1,2,11,16,27
24,1,2,13,24,37
8,1,2,4,8,12
7,1,2,4,7,11
24,1,2,21,24,45
15,1,2,13,15,28
16,11,30,294,176,470
7,1,4,20,7,27
30,2,5,63,60,123
28,2,5,59,56,115
21,1,2,20,21,41
17,2,5,49,34,83
26,2,5,75,52,127
12,2,5,35,24,59
24,9,25,252,216,468
26,1,4,63,26,89
9,2,5,25,18,43
9,2,5,25,18,43
1,1482,2384,735,1482,2217
1,1482,2384,807,1482,2289
1,461,742,162,461,623
1,461,742,229,461,690
18,24,64,467,432,899
10,45,120,726,450,1176
23,45,120,1366,1035,2401
6,45,120,421,270,691
4,2,5,12,8,20
3,2,5,9,6,15
18,2,5,50,36,86
4,2,5,11,8,19
27,3,9,145,81,226
6,3,9,32,18,50
25,4,10,118,100,218
23,4,10,90,92,182
18,2,5,52,36,88
8,2,5,23,16,39
12,2,5,28,24,52
25,2,5,59,50,109
29,2,5,55,58,113
19,2,5,44,38,82
29,2,5,67,58,125
14,2,5,41,28,69
5,2,5,15,10,25
6,2,5,14,12,26
20,2,5,49,40,89
19,2,5,47,38,85
25,2,5,66,50,116
2,2,5,5,4,9
3,3,9,12,9,21
27,3,9,109,81,190
25,3,9,101,75,176
20,3,9,80,60,140
23,3,9,109,69,178
6,3,9,28,18,46
7,3,9,39,21,60
20,3,9,113,60,173
30,2,5,71,60,131
21,7,9,29,147,176
12,7,9,20,84,104
5,7,9,8,35,43
24,7,9,0,168,168
12,7,9,22,84,106
16,7,9,0,112,112
12,7,9,9,84,93
16,3,8,63,48,111
14,3,8,45,42,87
6,3,8,19,18,37
21,3,8,102,63,165
20,8,22,271,160,431
14,8,22,190,112,302
21,8,22,285,168,453
25,8,22,279,200,479
15,8,22,137,120,257
17,8,22,231,136,367
22,8,22,303,176,479
13,9,24,154,117,271
14,9,24,203,126,329
27,9,24,392,243,635
24,9,24,348,216,564
29,9,24,338,261,599
4,9,24,39,36,75
21,13,35,455,273,728
7,13,35,110,91,201
14,13,35,205,182,387
29,13,35,618,377,995
26,13,35,554,338,892
21,13,35,447,273,720
12,13,35,247,156,403
18,13,35,308,234,542
17,13,35,297,221,518
29,13,35,455,377,832
7,13,35,122,91,213
1,13,35,20,13,33
19,13,35,391,247,638
9,13,35,185,117,302
26,13,35,454,338,792
29,13,35,628,377,1005
22,13,35,430,286,716
4,13,35,78,52,130
13,13,35,277,169,446
18,13,35,383,234,617
8,13,35,173,104,277
13,13,35,186,169,355
8,13,35,165,104,269
22,13,35,361,286,647
6,13,35,124,78,202
21,21,55,668,441,1109
12,21,55,263,252,515
20,21,55,537,420,957
27,21,55,725,567,1292
18,38,50,198,684,882
9,38,50,99,342,441
2,38,50,20,76,96
8,38,50,68,304,372
26,42,54,284,1092,1376
4,38,50,20,152,172
3,38,50,9,114,123
29,42,54,238,1218,1456
12,42,54,138,504,642
9,42,54,74,378,452
5,42,54,17,210,227
1,1252,2295,997,1252,2249
1,1252,2295,538,1252,1790
1,1252,2295,1020,1252,2272
1,308,565,246,308,554
1,1252,2295,538,1252,1790
1,1252,2295,997,1252,2249
1,1266,2320,544,1266,1810
1,1266,2320,1008,1266,2274
1,1266,2320,961,1266,2227
1,1266,2320,961,1266,2227
1,1252,2295,882,1252,2134
1,1252,2295,997,1252,2249
1,2171,3578,906,2171,3077
1,2171,3578,942,2171,3113
1,487,783,280,487,767
1,1555,2443,790,1555,2345
1,1555,2443,790,1555,2345
1,1083,1701,244,1083,1327
1,487,783,241,487,728
1,713,1120,284,713,997
1,713,1120,161,713,874
1,2171,3578,1371,2171,3542
1,1519,2443,533,1519,2052
1,344,540,158,344,502
1,713,1120,228,713,941
1,713,1120,362,713,1075
1,344,540,174,344,518
1,344,540,99,344,443
1,487,783,155,487,642
1,2171,3578,620,2171,2791
1,344,540,126,344,470
23,26,70,658,598,1256
13,26,70,563,338,901
8,3,9,47,24,71
4,3,9,19,12,31
2,1,2,2,2,4
9,1,2,8,9,17
16,2,5,46,32,78
15,2,5,44,30,74
9,13,35,192,117,309
16,1,2,16,16,32
22,8,21,189,176,365
29,8,21,249,232,481
13,1,2,10,13,23
26,1,2,19,26,45
24,1,2,18,24,42
12,9,25,129,108,237
15,9,25,161,135,296
20,1,2,19,20,39
16,1,2,15,16,31
8,9,25,124,72,196
20,1,2,20,20,40
29,1,2,21,29,50
24,1,2,17,24,41
1,1,2,1,1,2
30,1,4,74,30,104
19,1,4,47,19,66
7,2,5,20,14,34
14,2,5,41,28,69
17,2,5,45,34,79
7,2,5,19,14,33
14,9,25,179,126,305
11,9,25,140,99,239
25,2,5,59,50,109
23,2,5,45,46,91
23,2,5,45,46,91
20,1,4,54,20,74
7,1,4,20,7,27
10,2,5,29,20,49
29,2,5,84,58,142
12,2,5,35,24,59
25,1,2,18,25,43
30,11,30,552,330,882
24,1,2,17,24,41
8,1,2,6,8,14
19,2,5,53,38,91
27,1,2,25,27,52
11,1,2,10,11,21
22,1,2,20,22,42
6,1,2,6,6,12
29,1,2,28,29,57
23,1,2,22,23,45
18,2,5,50,36,86
27,2,5,76,54,130
18,2,5,42,36,78
26,2,5,77,52,129
14,2,5,41,28,69
29,1,2,28,29,57
14,1,4,41,14,55
9,1,4,26,9,35
24,1,2,13,24,37
1,2,5,3,2,5
22,9,25,341,198,539
28,2,5,78,56,134
26,1,2,19,26,45
3,1,2,2,3,5
1,1482,2384,592,1482,2074
1,1482,2384,735,1482,2217
1,1482,2384,878,1482,2360
1,755,1215,241,755,996
1,755,1215,168,755,923
29,24,64,1141,696,1837
11,24,64,313,264,577
4,59,159,387,236,623
14,4,10,78,56,134
16,4,10,90,64,154
10,2,5,30,20,50
6,2,5,15,12,27
21,2,5,51,42,93
23,2,5,64,46,110
1,2,5,3,2,5
12,4,10,71,48,119
24,4,10,139,96,235
11,4,10,64,44,108
23,2,5,64,46,110
27,2,5,76,54,130
19,2,5,55,38,93
8,2,5,23,16,39
14,3,9,58,42,100
16,3,9,66,48,114
4,4,10,23,16,39
25,3,9,146,75,221
10,3,9,58,30,88
12,2,5,23,24,47
6,2,5,11,12,23
24,7,9,44,168,212
20,7,9,33,140,173
12,7,9,12,84,96
1,7,9,2,7,9
17,7,9,31,119,150
1,7,9,1,7,8
6,7,9,5,42,47
30,7,9,49,210,259
1,7,9,2,7,9
9,7,9,12,63,75
23,3,8,113,69,182
18,3,8,84,54,138
30,3,8,133,90,223
26,8,22,244,208,452
18,8,22,248,144,392
2,9,24,29,18,47
26,9,24,303,234,537
10,9,24,97,90,187
16,9,24,159,144,303
12,9,24,174,108,282
25,13,35,533,325,858
17,13,35,267,221,488
10,13,35,217,130,347
4,13,35,68,52,120
2,13,35,39,26,65
5,13,35,103,65,168
11,13,35,227,143,370
28,13,35,606,364,970
20,13,35,412,260,672
1,13,35,17,13,30
13,13,35,254,169,423
2,13,35,29,26,55
8,13,35,137,104,241
21,13,35,447,273,720
25,13,35,436,325,761
3,13,35,51,39,90
28,13,35,479,364,843
8,13,35,140,104,244
6,13,35,105,78,183
3,21,55,99,63,162
25,38,50,288,950,1238
25,42,54,246,1050,1296
27,38,50,149,1026,1175
9,42,54,6,378,384
11,38,50,61,418,479
21,38,50,231,798,1029
1,1252,2295,630,1252,1882
1,1266,2320,683,1266,1949
1,1252,2295,722,1252,1974
1,1266,2320,892,1266,2158
1,1252,2295,1020,1252,2272
1,1252,2295,951,1252,2203
1,1252,2295,951,1252,2203
1,420,769,341,420,761
1,1266,2320,1031,1266,2297
1,1898,3375,1410,1898,3308
1,1898,3375,1005,1898,2903
1,1252,2295,997,1252,2249
1,2171,3578,548,2171,2719
1,2171,3578,1371,2171,3542
1,1519,2443,655,1519,2174
1,344,540,185,344,529
1,2171,3578,942,2171,3113
1,713,1120,385,713,1098
1,1083,1701,550,1083,1633
1,2171,3578,1335,2171,3506
1,713,1120,261,713,974
1,2171,3578,906,2171,3077
1,344,540,126,344,470
15,26,70,650,390,1040
18,26,70,704,468,1172
30,26,70,1299,780,2079
10,26,70,426,260,686
4,2,5,8,8,16
23,1,2,23,23,46
12,1,2,12,12,24
10,1,2,6,10,16
19,1,2,11,19,30
4,1,2,2,4,6
5,13,35,108,65,173
9,13,35,195,117,312
12,2,5,28,24,52
17,9,25,183,153,336
11,2,5,29,22,51
28,2,5,74,56,130
27,2,5,72,54,126
9,2,5,24,18,42
16,2,5,42,32,74
11,2,5,29,22,51
7,11,30,99,77,176
26,11,30,369,286,655
24,1,2,23,24,47
25,1,2,24,25,49
12,2,5,34,24,58
8,2,5,22,16,38
28,1,2,19,28,47
3,2,5,9,6,15
19,9,25,271,171,442
14,9,25,200,126,326
24,1,4,70,24,94
7,1,2,4,7,11
22,1,2,12,22,34
22,1,2,12,22,34
6,2,5,13,12,25
8,2,5,17,16,33
20,2,5,42,40,82
21,1,2,19,21,40
6,1,2,6,6,12
3,2,5,7,6,13
30,2,5,69,60,129
25,8,21,315,200,515
3,1,2,3,3,6
14,2,5,33,28,61
5,2,5,12,10,22
21,2,5,61,42,103
9,2,5,26,18,44
21,2,5,61,42,103
1,461,742,185,461,646
1,755,1215,411,755,1166
1,461,742,147,461,608
1,1482,2384,807,1482,2289
1,461,742,251,461,712
1,755,1215,436,755,1191
1,755,1215,302,755,1057
1,461,742,251,461,712
1,461,742,266,461,727
12,45,120,598,540,1138
19,2,5,56,38,94
14,2,5,41,28,69
1,3,9,6,3,9
23,3,9,130,69,199
9,2,5,27,18,45
21,2,5,62,42,104
5,2,5,14,10,24
20,2,5,56,40,96
11,2,5,32,22,54
14,2,5,41,28,69
17,2,5,48,34,82
12,3,9,68,36,104
12,3,9,68,36,104
14,2,5,41,28,69
13,2,5,38,26,64
29,2,5,64,58,122
6,2,5,13,12,25
24,3,9,96,72,168
30,3,9,121,90,211
13,3,9,78,39,117
25,3,9,150,75,225
22,3,9,90,66,156
30,3,9,123,90,213
20,2,5,47,40,87
29,2,5,68,58,126
24,2,5,67,48,115
13,2,5,36,26,62
16,3,9,64,48,112
20,3,9,80,60,140
29,7,9,48,203,251
11,7,9,18,77,95
9,7,9,0,63,63
25,7,9,50,175,225
19,3,8,92,57,149
26,3,8,126,78,204
8,3,8,32,24,56
22,8,22,206,176,382
9,8,22,100,72,172
29,8,22,304,232,536
20,8,22,201,160,361
23,9,24,339,207,546
29,9,24,407,261,668
6,13,35,130,78,208
25,13,35,541,325,866
20,13,35,328,260,588
8,13,35,170,104,274
24,13,35,419,312,731
6,13,35,98,78,176
1,13,35,16,13,29
22,13,35,453,286,739
1,13,35,22,13,35
25,13,35,436,325,761
10,13,35,171,130,301
30,21,55,954,630,1584
14,42,54,2,588,590
9,38,50,99,342,441
10,42,54,34,420,454
7,38,50,70,266,336
29,42,54,19,1218,1237
1,1252,2295,1020,1252,2272
1,1898,3375,768,1898,2666
1,1912,3400,1046,1912,2958
1,1266,2320,961,1266,2227
1,1266,2320,1031,1266,2297
1,295,540,223,295,518
1,1266,2320,544,1266,1810
1,420,769,318,420,738
1,1252,2295,997,1252,2249
1,1266,2320,1008,1266,2274
1,2171,3578,1335,2171,3506
1,2171,3578,1264,2171,3435
1,487,783,265,487,752
1,1555,2443,570,1555,2125
1,487,783,132,487,619
2,26,70,57,52,109
3,26,70,128,78,206
13,26,70,554,338,892
5,3,9,28,15,43
8,3,9,45,24,69
13,3,9,76,39,115
7,2,5,14,14,28
1,2,5,2,2,4
7,1,4,21,7,28
13,2,5,25,26,51
17,2,5,48,34,82
19,2,5,55,38,93
20,2,5,58,40,98
21,2,5,61,42,103
3,2,5,7,6,13
4,2,5,9,8,17
18,13,35,371,234,605
16,13,35,330,208,538
7,13,35,144,91,235
23,1,2,16,23,39
26,1,2,22,26,48
2,1,2,2,2,4
22,11,30,279,242,521
15,11,30,191,165,356
7,11,30,89,77,166
29,11,30,368,319,687
24,11,30,305,264,569
1,2,5,2,2,4
3,2,5,7,6,13
7,2,5,16,14,30
7,1,2,6,7,13
7,1,2,4,7,11
8,1,2,8,8,16
11,1,4,30,11,41
25,1,4,68,25,93
13,2,5,38,26,64
1,2,5,3,2,5
6,2,5,17,12,29
24,12,33,330,288,618
16,1,4,45,16,61
8,1,4,23,8,31
15,1,4,43,15,58
1,755,1215,411,755,1166
1,1482,2384,878,1482,2360
1,755,1215,241,755,996
1,1482,2384,902,1482,2384
1,461,742,185,461,646
15,24,64,466,360,826
18,24,64,478,432,910
11,24,64,313,264,577
29,4,10,171,116,287
16,2,5,47,32,79
25,2,5,74,50,124
4,2,5,9,8,17
22,2,5,52,44,96
21,2,5,40,42,82
24,2,5,46,48,94
21,2,5,59,42,101
5,3,9,27,15,42
1,3,9,4,3,7
19,3,9,78,57,135
17,7,9,10,119,129
11,7,9,0,77,77
5,3,8,25,15,40
19,3,8,93,57,150
25,8,22,345,200,545
9,8,22,118,72,190
17,8,22,159,136,295
14,8,22,141,112,253
8,9,24,95,72,167
10,9,24,140,90,230
6,13,35,86,78,164
3,13,35,64,39,103
16,13,35,346,208,554
10,13,35,217,130,347
27,13,35,386,351,737
6,13,35,86,78,164
24,21,55,578,504,1082
10,42,54,34,420,454
1,38,50,1,38,39
29,38,50,334,1102,1436
12,42,54,1,504,505
11,26,70,476,286,762
24,26,70,686,624,1310
30,2,5,57,60,117
20,2,5,38,40,78
24,2,5,46,48,94
29,13,35,415,377,792
20,13,35,286,260,546
2,1,2,2,2,4
14,9,25,221,126,347
29,9,25,457,261,718
19,2,5,34,38,72
12,13,35,260,156,416
21,13,35,455,273,728
19,2,5,56,38,94
15,2,5,44,30,74
18,1,2,12,18,30
30,1,2,20,30,50
4,1,2,3,4,7
2,1,2,1,2,3
7,1,4,17,7,24
19,1,4,45,19,64
27,1,4,80,27,107
18,1,4,53,18,71
22,1,2,14,22,36
13,1,2,8,13,21
16,9,25,248,144,392
9,1,2,6,9,15
18,1,4,53,18,71
8,12,33,163,96,259
3,12,33,61,36,97
29,1,2,19,29,48
17,1,2,11,17,28
2,1,2,1,2,3
30,1,2,20,30,50
22,1,2,15,22,37
7,2,5,21,14,35
9,2,5,26,18,44
10,2,5,29,20,49
17,24,64,484,408,892
3,24,64,116,72,188
14,24,64,399,336,735
12,24,64,311,288,599
11,2,5,32,22,54
22,2,5,65,44,109
29,2,5,84,58,142
2,2,5,6,4,10
12,2,5,28,24,52
19,4,10,110,76,186
14,4,10,81,56,137
22,2,5,51,44,95
13,2,5,30,26,56
16,2,5,37,32,69
20,2,5,46,40,86
2,2,5,4,4,8
25,2,5,45,50,95
9,2,5,27,18,45
14,2,5,41,28,69
27,2,5,80,54,134
23,2,5,68,46,114
10,7,9,19,70,89
16,7,9,13,112,125
19,7,9,35,133,168
23,7,9,44,161,205
28,7,9,53,196,249
1,3,8,4,3,7
24,3,8,80,72,152
1,8,22,11,8,19
7,8,22,95,56,151
20,13,35,433,260,693
22,13,35,376,286,662
20,13,35,433,260,693
11,13,35,234,143,377
1,13,35,21,13,34
5,13,35,107,65,172
10,13,35,206,130,336
26,13,35,408,338,746
8,13,35,162,104,266
9,13,35,195,117,312
7,21,55,223,147,370
6,21,55,135,126,261
14,38,50,154,532,686
14,38,50,161,532,693
7,38,50,77,266,343
8,38,50,92,304,396
9,38,50,23,342,365
22,26,70,675,572,1247
18,1,2,13,18,31
15,1,2,11,15,26
7,1,2,4,7,11
15,1,2,8,15,23
25,1,2,14,25,39
20,13,35,412,260,672
23,13,35,474,299,773
26,1,2,25,26,51
11,1,2,11,11,22
21,1,2,20,21,41
25,1,2,24,25,49
29,1,2,17,29,46
13,1,2,8,13,21
12,2,5,35,24,59
14,2,5,41,28,69
28,2,5,83,56,139
11,2,5,32,22,54
19,1,4,47,19,66
1,1,4,2,1,3
25,1,2,23,25,48
6,1,2,6,6,12
10,1,2,9,10,19
27,9,25,270,243,513
1,9,25,10,9,19
26,2,5,55,52,107
26,2,5,55,52,107
13,2,5,38,26,64
26,2,5,77,52,129
6,2,5,18,12,30
19,1,4,55,19,74
20,1,4,58,20,78
9,8,21,83,72,155
13,2,5,38,26,64
15,1,2,14,15,29
8,9,25,102,72,174
10,9,25,128,90,218
9,2,5,27,18,45
24,2,5,71,48,119
17,4,10,100,68,168
18,4,10,106,72,178
4,3,9,19,12,31
9,2,5,27,18,45
29,4,10,128,116,244
16,4,10,70,64,134
12,7,9,16,84,100
16,7,9,26,112,138
18,7,9,5,126,131
1,7,9,2,7,9
6,7,9,3,42,45
4,3,8,16,12,28
13,8,22,179,104,283
4,8,22,55,32,87
20,8,22,276,160,436
7,8,22,96,56,152
4,8,22,55,32,87
1,8,22,11,8,19
13,9,24,154,117,271
30,13,35,429,390,819
5,13,35,103,65,168
2,13,35,43,26,69
1,13,35,21,13,34
26,13,35,536,338,874
11,13,35,192,143,335
21,13,35,455,273,728
28,13,35,606,364,970
20,13,35,286,260,546
26,13,35,445,338,783
4,13,35,87,52,139
21,13,35,366,273,639
26,21,55,870,546,1416
23,38,50,23,874,897
10,38,50,115,380,495
4,38,50,4,152,156
26,38,50,299,988,1287
6,42,54,69,252,321
11,26,70,345,286,631
4,1,2,4,4,8
8,1,2,8,8,16
6,1,2,3,6,9
18,13,35,308,234,542
20,13,35,342,260,602
7,13,35,152,91,243
25,2,5,70,50,120
19,2,5,53,38,91
9,2,5,21,18,39
20,2,5,46,40,86
15,2,5,29,30,59
20,1,4,54,20,74
24,1,4,65,24,89
15,1,2,11,15,26
20,1,2,20,20,40
15,1,4,43,15,58
29,1,4,82,29,111
15,1,4,43,15,58
26,1,4,74,26,100
30,1,4,82,30,112
28,1,4,76,28,104
10,2,5,30,20,50
4,1,4,11,4,15
9,1,4,26,9,35
6,11,30,74,66,140
28,11,30,347,308,655
11,8,21,113,88,201
30,8,21,308,240,548
28,2,5,78,56,134
30,2,5,84,60,144
1,2,5,3,2,5
20,1,2,15,20,35
15,1,2,11,15,26
15,24,64,590,360,950
2,45,120,97,90,187
15,2,5,32,30,62
9,2,5,19,18,37
6,4,10,23,24,47
17,3,9,96,51,147
14,7,9,12,98,110
3,7,9,0,21,21
10,3,8,48,30,78
25,8,22,345,200,545
20,8,22,223,160,383
25,8,22,251,200,451
8,9,24,112,72,184
8,9,24,85,72,157
28,9,24,299,252,551
29,13,35,506,377,883
13,13,35,281,169,450
11,13,35,173,143,316
5,13,35,108,65,173
10,13,35,164,130,294
19,13,35,272,247,519
2,13,35,43,26,69
25,21,55,603,525,1128
21,42,54,3,882,885
14,38,50,77,532,609
15,42,54,148,630,778
6,26,70,247,156,403
21,26,70,718,546,1264
28,26,70,977,728,1705
4,2,5,12,8,20
17,2,5,49,34,83
14,2,5,33,28,61
23,2,5,54,46,100
4,2,5,9,8,17
23,9,25,276,207,483
6,9,25,72,54,126
25,9,25,288,225,513
24,11,30,362,264,626
7,13,35,103,91,194
28,1,4,83,28,111
24,1,4,71,24,95
22,2,5,64,44,108
20,2,5,58,40,98
25,2,5,73,50,123
30,1,4,74,30,104
27,1,2,26,27,53
27,1,4,66,27,93
28,2,5,59,56,115
6,1,2,3,6,9
19,1,4,41,19,60
13,2,5,27,26,53
4,2,5,9,8,17
2,2,5,5,4,9
8,2,5,21,16,37
23,2,5,44,46,90
28,2,5,53,56,109
5,2,5,15,10,25
19,4,10,72,76,148
8,4,10,30,32,62
14,2,5,33,28,61
15,2,5,35,30,65
19,2,5,53,38,91
6,2,5,18,12,30
23,7,9,38,161,199
10,3,8,48,30,78
25,3,8,99,75,174
2,8,22,20,16,36
1,8,22,11,8,19
20,8,22,276,160,436
18,9,24,214,162,376
13,9,24,126,117,243
17,9,24,247,153,400
1,13,35,16,13,29
1,13,35,14,13,27
28,38,50,322,1064,1386
14,38,50,77,532,609
8,38,50,8,304,312
14,38,50,14,532,546
1,26,70,43,26,69
29,26,70,1012,754,1766
2,3,9,9,6,15
5,2,5,15,10,25
2,2,5,6,4,10
6,2,5,17,12,29
30,2,5,84,60,144
22,2,5,62,44,106
6,9,25,75,54,129
22,9,25,275,198,473
6,2,5,18,12,30
13,2,5,38,26,64
6,2,5,17,12,29
9,2,5,26,18,44
8,1,2,4,8,12
4,1,2,4,4,8
24,2,5,64,48,112
11,1,2,10,11,21
18,1,2,17,18,35
17,9,25,268,153,421
26,9,25,410,234,644
25,1,2,17,25,42
6,2,5,17,12,29
20,2,5,58,40,98
12,1,2,9,12,21
5,1,2,4,5,9
12,1,4,27,12,39
22,1,4,50,22,72
15,1,4,34,15,49
17,1,4,39,17,56
24,24,64,760,576,1336
14,24,64,551,336,887
9,59,159,671,531,1202
8,2,5,17,16,33
25,2,5,74,50,124
8,2,5,24,16,40
20,3,9,118,60,178
4,3,9,24,12,36
1,2,5,3,2,5
3,2,5,9,6,15
16,7,9,29,112,141
4,7,9,0,28,28
22,7,9,42,154,196
8,8,22,84,64,148
20,8,22,223,160,383
2,9,24,23,18,41
11,9,24,160,99,259
27,13,35,424,351,775
21,13,35,455,273,728
6,13,35,130,78,208
24,13,35,469,312,781
23,13,35,498,299,797
12,13,35,256,156,412
2,13,35,43,26,69
1,13,35,17,13,30
2,13,35,34,26,60
12,13,35,260,156,416
6,21,55,131,126,257
24,42,54,275,1008,1283
4,38,50,4,152,156
29,26,70,829,754,1583
16,26,70,693,416,1109
6,1,2,6,6,12
8,2,5,18,16,34
20,13,35,342,260,602
4,1,4,12,4,16
3,1,4,9,3,12
21,1,4,62,21,83
26,1,4,55,26,81
18,2,5,34,36,70
21,2,5,40,42,82
8,1,2,4,8,12
6,1,2,3,6,9
17,1,2,15,17,32
28,1,2,24,28,52
10,1,2,9,10,19
15,1,4,44,15,59
22,1,4,65,22,87
29,1,4,86,29,115
21,9,25,331,189,520
11,9,25,173,99,272
15,11,30,191,165,356
15,2,5,44,30,74
5,2,5,15,10,25
8,2,5,22,16,38
20,1,4,59,20,79
2,1,4,5,2,7
8,1,4,20,8,28
19,9,25,238,171,409
12,1,4,34,12,46
9,8,21,104,72,176
27,8,21,311,216,527
24,8,21,302,192,494
17,2,5,37,34,71
10,24,64,387,240,627
17,2,5,32,34,66
28,2,5,66,56,122
3,2,5,6,6,12
22,2,5,42,44,86
19,2,5,55,38,93
14,2,5,37,28,65
26,7,9,10,182,192
13,7,9,-2,91,89
23,7,9,32,161,193
2,8,22,27,16,43
16,8,22,217,128,345
4,8,22,55,32,87
25,8,22,229,200,429
2,9,24,20,18,38
20,13,35,314,260,574
20,13,35,433,260,693
2,13,35,27,26,53
4,13,35,63,52,115
12,13,35,235,156,391
15,13,35,215,195,410
5,13,35,73,65,138
13,42,54,9,546,555
9,1,2,6,9,15
9,13,35,132,117,249
12,13,35,176,156,332
2,9,25,22,18,40
4,2,5,12,8,20
28,2,5,83,56,139
6,2,5,13,12,25
5,2,5,11,10,21
26,2,5,55,52,107
9,9,25,90,81,171
11,9,25,127,99,226
10,9,25,115,90,205
6,1,4,16,6,22
3,1,4,8,3,11
23,1,2,17,23,40
14,1,2,13,14,27
4,1,2,4,4,8
4,11,30,59,44,103
13,11,30,192,143,335
6,2,5,18,12,30
29,2,5,86,58,144
11,2,5,21,22,43
11,2,5,21,22,43
11,2,5,32,22,54
23,2,5,68,46,114
22,2,5,64,44,108
4,2,5,12,8,20
8,2,5,23,16,39
6,2,5,17,12,29
8,1,4,17,8,25
10,1,4,21,10,31
5,24,64,194,120,314
24,24,64,760,576,1336
3,24,64,107,72,179
21,2,5,40,42,82
7,2,5,20,14,34
16,2,5,46,32,78
20,2,5,47,40,87
16,2,5,46,32,78
7,2,5,13,14,27
28,2,5,53,56,109
6,2,5,17,12,29
1,2,5,3,2,5
10,4,10,59,40,99
14,4,10,83,56,139
4,2,5,12,8,20
1,7,9,2,7,9
1,7,9,0,7,7
28,7,9,1,196,197
10,7,9,9,70,79
18,8,22,244,144,388
6,8,22,81,48,129
8,8,22,87,64,151
26,8,22,358,208,566
30,8,22,334,240,574
19,9,24,185,171,356
26,13,35,372,338,710
24,13,35,352,312,664
5,13,35,107,65,172
5,13,35,103,65,168
4,13,35,57,52,109
24,13,35,352,312,664
8,13,35,173,104,277
5,13,35,108,65,173
24,13,35,494,312,806
27,13,35,471,351,822
8,13,35,142,104,246
12,13,35,260,156,416
6,13,35,128,78,206
7,13,35,149,91,240
29,13,35,415,377,792
20,13,35,426,260,686
10,13,35,171,130,301
22,21,55,494,462,956
22,38,50,220,836,1056
7,38,50,11,266,277
17,38,50,196,646,842
24,42,54,107,1008,1115
25,38,50,213,950,1163
15,3,9,87,45,132
30,3,9,145,90,235
29,1,4,61,29,90
4,1,4,12,4,16
4,1,4,12,4,16
16,1,2,12,16,28
7,2,5,13,14,27
7,2,5,13,14,27
24,11,30,449,264,713
16,11,30,299,176,475
8,11,30,150,88,238
12,13,35,256,156,412
1,13,35,21,13,34
19,2,5,55,38,93
9,1,2,9,9,18
4,2,5,11,8,19
1,2,5,3,2,5
25,2,5,66,50,116
14,9,25,179,126,305
5,9,25,64,45,109
30,9,25,383,270,653
13,2,5,36,26,62
18,2,5,50,36,86
10,1,2,9,10,19
8,1,2,7,8,15
2,1,2,2,2,4
10,1,2,6,10,16
28,1,2,18,28,46
25,2,5,70,50,120
28,9,25,441,252,693
16,9,25,252,144,396
5,9,25,78,45,123
24,9,25,372,216,588
9,2,5,26,18,44
11,1,2,6,11,17
30,1,2,17,30,47
9,2,5,21,18,39
15,2,5,35,30,65
30,1,4,73,30,103
11,1,4,27,11,38
23,1,4,57,23,80
23,1,2,15,23,38
1,1,2,1,1,2
24,2,5,67,48,115
3,2,5,8,6,14
20,8,21,210,160,370
16,8,21,168,128,296
24,1,2,17,24,41
16,8,21,201,128,329
14,1,2,12,14,26
6,1,2,3,6,9
1,1,2,1,1,2
30,1,2,17,30,47
3,1,4,9,3,12
7,1,4,20,7,27
21,1,4,61,21,82
23,24,64,861,552,1413
23,4,10,136,92,228
6,4,10,35,24,59
6,2,5,18,12,30
29,4,10,168,116,284
4,4,10,23,16,39
17,3,9,78,51,129
20,3,9,91,60,151
25,4,10,98,100,198
7,4,10,27,28,55
29,7,9,53,203,256
17,3,8,80,51,131
2,8,22,27,16,43
12,8,22,110,96,206
25,8,22,229,200,429
29,9,24,428,261,689
18,9,24,218,162,380
7,13,35,115,91,206
20,13,35,314,260,574
7,13,35,137,91,228
29,13,35,516,377,893
13,13,35,186,169,355
15,13,35,215,195,410
18,13,35,383,234,617
8,13,35,126,104,230
7,13,35,95,91,186
15,21,55,329,315,644
29,38,50,29,1102,1131
3,38,50,18,114,132
25,3,9,146,75,221
12,3,9,49,36,85
7,2,5,20,14,34
6,2,5,17,12,29
10,11,30,187,110,297
29,1,4,72,29,101
3,1,4,7,3,10
4,9,25,52,36,88
5,9,25,65,45,110
27,1,2,20,27,47
27,1,2,20,27,47
18,1,2,13,18,31
21,1,2,21,21,42
17,1,2,17,17,34
21,2,5,61,42,103
16,2,5,46,32,78
8,2,5,23,16,39
30,11,30,561,330,891
10,1,2,6,10,16
24,1,4,70,24,94
6,1,4,18,6,24
30,8,21,277,240,517
26,8,21,240,208,448
13,1,2,7,13,20
28,1,2,16,28,44
19,1,2,18,19,37
26,1,2,25,26,51
12,8,21,96,96,192
13,45,120,944,585,1529
8,45,120,581,360,941
24,2,5,71,48,119
1,2,5,3,2,5
2,3,9,9,6,15
30,3,9,129,90,219
30,4,10,174,120,294
26,4,10,151,104,255
10,2,5,30,20,50
17,2,5,50,34,84
20,8,22,262,160,422
11,8,22,152,88,240
1,8,22,14,8,22
22,8,22,303,176,479
22,8,22,289,176,465
12,9,24,177,108,285
27,9,24,379,243,622
30,13,35,618,390,1008
18,13,35,276,234,510
16,13,35,346,208,554
28,13,35,606,364,970
10,13,35,206,130,336
29,13,35,506,377,883
3,26,70,130,78,208
23,26,70,658,598,1256
27,3,9,160,81,241
13,8,21,164,104,268
7,8,21,88,56,144
21,8,21,180,168,348
15,8,21,129,120,249
23,8,21,198,184,382
11,2,5,32,22,54
30,2,5,89,60,149
6,2,5,18,12,30
1,2,5,3,2,5
18,1,4,53,18,71
26,1,4,77,26,103
30,1,4,74,30,104
1,1,4,2,1,3
3,1,2,3,3,6
2,2,5,4,4,8
5,2,5,10,10,20
11,2,5,21,22,43
18,1,2,18,18,36
14,1,2,14,14,28
24,1,2,24,24,48
7,1,2,7,7,14
13,2,5,30,26,56
24,2,5,55,48,103
6,1,2,4,6,10
12,2,5,34,24,58
13,2,5,36,26,62
15,2,5,42,30,72
27,2,5,76,54,130
5,1,2,5,5,10
1,1,2,1,1,2
30,1,4,88,30,118
12,1,4,35,12,47
26,8,21,327,208,535
2,8,21,25,16,41
15,1,2,14,15,29
20,1,2,19,20,39
6,1,2,6,6,12
23,8,21,280,184,464
28,8,21,340,224,564
17,24,64,473,408,881
4,3,9,23,12,35
23,2,5,61,46,107
19,7,9,7,133,140
3,3,8,12,9,21
16,3,8,79,48,127
2,8,22,28,16,44
1,9,24,11,9,20
11,13,35,180,143,323
2,13,35,41,26,67
23,13,35,329,299,628
6,13,35,130,78,208
28,13,35,440,364,804
17,13,35,332,221,553
18,13,35,283,234,517
12,13,35,260,156,416
24,38,50,276,912,1188
25,38,50,250,950,1200
16,38,50,176,608,784
17,38,50,94,646,740
11,26,70,476,286,762
12,26,70,419,312,731
20,3,9,91,60,151
18,3,9,106,54,160
16,3,9,95,48,143
22,9,25,264,198,462
25,11,30,468,275,743
10,11,30,187,110,297
8,11,30,150,88,238
30,1,2,17,30,47
17,1,2,10,17,27
9,1,2,5,9,14
26,13,35,508,338,846
6,13,35,117,78,195
5,13,35,98,65,163
20,2,5,59,40,99
25,2,5,74,50,124
5,2,5,15,10,25
23,11,29,387,253,640
21,11,29,354,231,585
11,1,2,6,11,17
29,2,5,86,58,144
10,1,2,6,10,16
10,2,5,24,20,44
24,2,5,56,48,104
28,1,4,83,28,111
7,11,30,106,77,183
11,11,30,166,121,287
7,1,2,7,7,14
7,2,5,13,14,27
29,1,2,16,29,45
2,1,2,1,2,3
29,1,2,16,29,45
27,1,4,77,27,104
5,1,4,14,5,19
1,2,5,2,2,4
4,2,5,12,8,20
15,1,4,44,15,59
9,2,5,26,18,44
11,1,2,11,11,22
20,1,2,20,20,40
27,45,120,1798,1215,3013
9,59,159,886,531,1417
6,59,159,562,354,916
12,2,5,35,24,59
17,2,5,40,34,74
10,2,5,21,20,41
28,2,5,64,56,120
19,2,5,53,38,91
12,7,9,9,84,93
19,7,9,31,133,164
13,3,8,63,39,102
21,8,22,285,168,453
10,9,24,145,90,235
14,13,35,288,182,470
18,13,35,257,234,491
9,13,35,192,117,309
1,13,35,16,13,29
15,13,35,320,195,515
2,13,35,34,26,60
20,42,54,197,840,1037
22,42,54,252,924,1176
23,26,70,996,598,1594
19,26,70,823,494,1317
4,26,70,137,104,241
9,26,70,383,234,617
25,3,9,148,75,223
4,3,9,18,12,30
14,2,5,27,28,55
8,2,5,15,16,31
17,1,2,17,17,34
10,13,35,213,130,343
19,13,35,405,247,652
16,13,35,341,208,549
9,1,2,8,9,17
22,1,2,20,22,42
30,2,5,89,60,149
12,12,33,224,144,368
23,12,33,430,276,706
23,1,2,22,23,45
29,1,2,28,29,57
13,12,33,269,156,425
26,12,33,537,312,849
20,2,5,38,40,78
15,1,2,10,15,25
17,1,2,11,17,28
30,9,25,473,270,743
6,9,25,95,54,149
12,11,30,181,132,313
13,11,30,196,143,339
3,1,4,9,3,12
14,1,4,40,14,54
20,1,4,57,20,77
8,2,5,19,16,35
23,1,4,56,23,79
3,1,4,7,3,10
16,2,5,46,32,78
22,7,9,36,154,190
24,7,9,44,168,212
17,8,22,231,136,367
24,8,22,325,192,517
28,8,22,256,224,480
17,8,22,159,136,295
24,9,24,233,216,449
12,9,24,160,108,268
10,13,35,143,130,273
27,13,35,386,351,737
20,13,35,272,260,532
18,13,35,390,234,624
4,38,50,40,152,192
7,38,50,0,266,266
27,1,2,26,27,53
27,1,2,27,27,54
10,1,2,6,10,16
18,1,2,10,18,28
7,2,5,19,14,33
9,1,2,5,9,14
3,1,2,2,3,5
20,2,5,59,40,99
25,2,5,74,50,124
14,1,4,33,14,47
30,1,4,71,30,101
30,2,5,89,60,149
20,2,5,59,40,99
4,2,5,8,8,16
7,9,25,109,63,172
3,9,25,47,27,74
17,45,120,908,765,1673
3,59,159,290,177,467
4,4,10,16,16,32
12,4,10,47,48,95
2,2,5,5,4,9
1,2,5,2,2,4
8,2,5,17,16,33
14,3,9,81,42,123
18,2,5,34,36,70
2,2,5,4,4,8
13,2,5,30,26,56
12,7,9,1,84,85
24,7,9,3,168,171
18,7,9,13,126,139
4,7,9,2,28,30
28,3,8,109,84,193
21,3,8,70,63,133
7,13,35,103,91,194
17,13,35,279,221,500
27,13,35,575,351,926
10,13,35,143,130,273
17,13,35,231,221,452
11,13,35,192,143,335
22,13,35,315,286,601
16,13,35,229,208,437
10,21,55,263,210,473
10,38,50,10,380,390
12,42,54,8,504,512
7,42,54,80,294,374
3,42,54,15,126,141
5,26,70,206,130,336
5,26,70,196,130,326
10,1,4,30,10,40
8,1,4,24,8,32
26,1,2,25,26,51
16,1,2,15,16,31
2,2,5,6,4,10
22,2,5,65,44,109
25,1,4,74,25,99
30,1,4,89,30,119
30,1,4,89,30,119
6,2,5,12,12,24
17,2,5,33,34,67
4,12,33,83,48,131
3,1,4,6,3,9
21,2,5,61,42,103
6,2,5,18,12,30
19,2,5,56,38,94
26,2,5,61,52,113
1,2,5,2,2,4
1,2,5,2,2,4
17,2,5,32,34,66
2,2,5,4,4,8
13,2,5,25,26,51
21,2,5,40,42,82
29,1,4,68,29,97
2,1,4,5,2,7
29,1,4,66,29,95
22,2,5,62,44,106
8,2,5,22,16,38
22,2,5,62,44,106
15,2,5,44,30,74
16,2,5,46,32,78
13,2,5,38,26,64
1,2,5,3,2,5
3,1,2,2,3,5
12,24,64,357,288,645
1,4,10,6,4,10
15,4,10,87,60,147
12,4,10,50,48,98
11,4,10,46,44,90
30,2,5,84,60,144
2,2,5,6,4,10
15,4,10,80,60,140
2,4,10,11,8,19
13,2,5,25,26,51
30,2,5,87,60,147
6,2,5,18,12,30
3,2,5,9,6,15
29,2,5,84,58,142
17,3,9,68,51,119
18,7,9,15,126,141
20,7,9,36,140,176
30,7,9,25,210,235
18,7,9,0,126,126
15,3,8,73,45,118
12,3,8,58,36,94
8,3,8,39,24,63
24,8,22,325,192,517
12,8,22,150,96,246
21,8,22,276,168,444
30,9,24,292,270,562
19,9,24,226,171,397
15,9,24,221,135,356
17,13,35,267,221,488
22,13,35,476,286,762
7,13,35,144,91,235
28,13,35,479,364,843
10,13,35,143,130,273
16,13,35,313,208,521
11,13,35,238,143,381
3,13,35,51,39,90
11,13,35,173,143,316
2,13,35,33,26,59
6,13,35,86,78,164
27,13,35,471,351,822
16,21,55,526,336,862
11,38,50,110,418,528
7,38,50,7,266,273
12,42,54,40,504,544
22,26,70,937,572,1509
26,3,9,105,78,183
1,2,5,3,2,5
10,1,2,10,10,20
22,1,2,21,22,43
5,1,4,15,5,20
4,1,4,12,4,16
8,2,5,15,16,31
14,2,5,29,28,57
24,1,2,18,24,42
3,1,2,2,3,5
24,13,35,494,312,806
13,13,35,268,169,437
11,1,2,7,11,18
23,1,2,16,23,39
5,13,35,82,65,147
1,1,2,1,1,2
2,2,5,5,4,9
25,1,2,18,25,43
8,2,5,22,16,38
8,2,5,22,16,38
12,1,4,27,12,39
19,1,4,43,19,62
23,1,2,23,23,46
29,2,5,84,58,142
19,2,5,55,38,93
23,2,5,67,46,113
14,8,21,176,112,288
1,8,21,13,8,21
22,1,2,12,22,34
25,1,2,14,25,39
24,1,4,68,24,92
7,1,4,20,7,27
6,2,5,13,12,25
18,2,5,40,36,76
18,3,9,97,54,151
3,3,9,16,9,25
2,2,5,6,4,10
5,2,5,15,10,25
6,2,5,17,12,29
1,3,9,5,3,8
22,2,5,65,44,109
23,2,5,68,46,114
4,7,9,7,28,35
7,7,9,13,49,62
9,7,9,7,63,70
19,7,9,35,133,168
18,8,22,248,144,392
25,8,22,345,200,545
7,9,24,103,63,166
25,9,24,369,225,594
2,9,24,24,18,42
18,13,35,390,234,624
24,13,35,520,312,832
29,13,35,445,377,822
15,13,35,320,195,515
3,13,35,65,39,104
4,13,35,70,52,122
15,13,35,320,195,515
16,21,55,403,336,739
22,42,54,181,924,1105
4,38,50,44,152,196
12,38,50,138,456,594
23,42,54,251,966,1217
25,26,70,715,650,1365
2,26,70,68,52,120
30,3,9,177,90,267
27,3,9,157,81,238
25,13,35,358,325,683
22,2,5,64,44,108
22,2,5,64,44,108
1,11,30,19,11,30
1,11,30,19,11,30
30,1,2,29,30,59
18,1,2,18,18,36
21,1,2,13,21,34
13,1,2,8,13,21
13,2,5,30,26,56
17,9,25,255,153,408
13,9,25,195,117,312
11,9,25,165,99,264
23,11,30,347,253,600
30,11,30,453,330,783
1,1,2,1,1,2
6,1,2,6,6,12
13,8,21,120,104,224
8,1,2,8,8,16
4,1,2,4,4,8
24,1,2,24,24,48
26,12,33,434,312,746
6,9,25,93,54,147
8,9,25,124,72,196
4,24,64,119,96,215
2,24,64,62,48,110
4,2,5,12,8,20
23,3,9,105,69,174
7,3,9,32,21,53
10,4,10,58,40,98
17,2,5,49,34,83
23,2,5,54,46,100
2,2,5,6,4,10
8,2,5,23,16,39
17,2,5,49,34,83
15,7,9,27,105,132
20,7,9,38,140,178
23,7,9,38,161,199
3,7,9,6,21,27
26,7,9,22,182,204
14,8,22,190,112,302
7,8,22,76,56,132
16,8,22,161,128,289
23,8,22,312,184,496
20,8,22,262,160,422
30,8,22,394,240,634
6,9,24,87,54,141
27,9,24,379,243,622
26,13,35,536,338,874
22,13,35,469,286,755
5,13,35,87,65,152
18,13,35,314,234,548
27,13,35,443,351,794
19,13,35,411,247,658
19,13,35,278,247,525
22,13,35,469,286,755
9,13,35,129,117,246
15,21,55,403,315,718
12,42,54,131,504,635
1,42,54,11,42,53
6,42,54,4,252,256
28,42,54,139,1176,1315
18,42,54,197,756,953
2,38,50,20,76,96
19,42,54,95,798,893
25,26,70,1065,650,1715
21,1,2,21,21,42
20,2,5,56,40,96
10,2,5,28,20,48
27,1,4,67,27,94
27,1,4,67,27,94
24,1,2,14,24,38
28,13,35,489,364,853
21,13,35,366,273,639
18,2,5,52,36,88
3,2,5,9,6,15
25,1,2,16,25,41
18,8,21,181,144,325
19,8,21,191,152,343
28,8,21,282,224,506
20,1,2,14,20,34
27,1,2,18,27,45
5,1,4,14,5,19
9,1,4,26,9,35
27,1,4,77,27,104
30,11,30,381,330,711
15,11,30,191,165,356
15,1,2,10,15,25
26,1,2,25,26,51
28,1,2,27,28,55
27,9,25,425,243,668
24,9,25,378,216,594
9,1,2,8,9,17
29,1,2,27,29,56
29,11,30,516,319,835
5,1,2,3,5,8
5,2,5,11,10,21
23,1,2,13,23,36
30,1,2,17,30,47
10,2,5,19,20,39
30,2,5,57,60,117
5,1,2,5,5,10
17,2,5,48,34,82
30,2,5,57,60,117
2,2,5,4,4,8
7,1,4,20,7,27
13,1,4,37,13,50
27,1,2,20,27,47
14,24,64,524,336,860
8,45,120,590,360,950
21,4,10,124,84,208
30,4,10,177,120,297
15,4,10,71,60,131
30,2,5,89,60,149
9,2,5,21,18,39
20,2,5,58,40,98
19,2,5,55,38,93
14,2,5,41,28,69
6,2,5,18,12,30
18,7,9,7,126,133
18,7,9,34,126,160
23,7,9,32,161,193
14,7,9,12,98,110
16,3,8,79,48,127
22,3,8,103,66,169
19,3,8,93,57,150
30,8,22,407,240,647
1,8,22,11,8,19
14,9,24,203,126,329
1,9,24,11,9,20
4,13,35,85,52,137
8,13,35,126,104,230
20,13,35,349,260,609
18,13,35,390,234,624
8,13,35,156,104,260
3,13,35,51,39,90
5,13,35,87,65,152
23,13,35,393,299,692
14,13,35,298,182,480
26,13,35,372,338,710
18,21,55,602,378,980
7,38,50,11,266,277
20,38,50,60,760,820
2,26,70,70,52,122
28,2,5,83,56,139
30,2,5,89,60,149
16,2,5,37,32,69
20,1,2,20,20,40
8,1,2,8,8,16
23,1,2,23,23,46
22,13,35,453,286,739
11,13,35,227,143,370
26,13,35,536,338,874
22,9,25,281,198,479
27,9,25,344,243,587
2,9,25,26,18,44
9,8,21,83,72,155
14,8,21,129,112,241
17,1,2,15,17,32
29,1,2,25,29,54
2,1,4,5,2,7
24,1,4,70,24,94
30,2,5,84,60,144
13,2,5,36,26,62
2,2,5,6,4,10
25,1,2,25,25,50
12,1,2,9,12,21
4,1,2,3,4,7
9,1,2,9,9,18
11,1,2,11,11,22
6,1,2,6,6,12
28,11,29,325,308,633
3,11,29,35,33,68
8,2,5,23,16,39
4,2,5,12,8,20
3,2,5,9,6,15
29,1,2,16,29,45
1,2,5,3,2,5
23,2,5,64,46,110
3,24,64,95,72,167
11,3,9,53,33,86
17,2,5,50,34,84
25,2,5,53,50,103
26,2,5,55,52,107
19,2,5,36,38,74
19,2,5,55,38,93
1,4,10,4,4,8
22,4,10,84,88,172
5,7,9,7,35,42
28,7,9,46,196,242
4,3,8,20,12,32
9,3,8,42,27,69
9,8,22,124,72,196
19,8,22,174,152,326
5,8,22,68,40,108
21,8,22,192,168,360
18,8,22,244,144,388
6,8,22,60,48,108
21,8,22,197,168,365
8,9,24,118,72,190
4,9,24,39,36,75
4,9,24,58,36,94
4,9,24,39,36,75
7,13,35,144,91,235
9,13,35,141,117,258
12,13,35,209,156,365
28,13,35,596,364,960
30,13,35,440,390,830
10,13,35,213,130,343
10,13,35,213,130,343
29,13,35,415,377,792
10,13,35,143,130,273
5,13,35,79,65,144
10,13,35,206,130,336
20,21,55,537,420,957
14,42,54,2,588,590
5,38,50,5,190,195
9,38,50,90,342,432
9,42,54,74,378,452
9,42,54,1,378,379
13,38,50,39,494,533
3,26,70,94,78,172
2,26,70,57,52,109
11,3,9,53,33,86
6,3,9,26,18,44
13,1,2,10,13,23
27,1,2,20,27,47
3,9,25,47,27,74
10,1,2,10,10,20
20,1,2,19,20,39
14,1,2,13,14,27
19,1,2,18,19,37
24,2,5,64,48,112
17,2,5,45,34,79
14,2,5,32,28,60
11,1,2,7,11,18
21,2,5,49,42,91
25,1,4,71,25,96
2,1,4,6,2,8
9,1,4,27,9,36
22,1,4,62,22,84
20,1,4,57,20,77
2,1,2,2,2,4
29,2,5,68,58,126
5,2,5,12,10,22
21,13,35,366,273,639
14,1,2,14,14,28
6,1,2,6,6,12
2,1,2,2,2,4
22,1,2,13,22,35
26,1,2,15,26,41
24,1,4,70,24,94
21,1,4,61,21,82
20,2,5,58,40,98
12,2,5,35,24,59
4,1,2,2,4,6
14,1,2,8,14,22
27,8,21,249,216,465
6,8,21,55,48,103
16,1,4,45,16,61
24,2,5,67,48,115
18,2,5,50,36,86
4,59,159,387,236,623
20,4,10,116,80,196
16,4,10,93,64,157
29,3,9,171,87,258
21,3,9,124,63,187
1,2,5,2,2,4
7,4,10,27,28,55
21,4,10,80,84,164
18,2,5,52,36,88
10,3,9,56,30,86
30,2,5,71,60,131
14,2,5,39,28,67
1,7,9,2,7,9
18,3,8,87,54,141
4,3,8,19,12,31
12,8,22,163,96,259
2,8,22,26,16,42
11,8,22,152,88,240
7,9,24,78,63,141
13,9,24,183,117,300
26,9,24,384,234,618
25,13,35,541,325,866
6,13,35,103,78,181
7,13,35,100,91,191
30,13,35,429,390,819
30,13,35,618,390,1008
15,13,35,257,195,452
19,13,35,312,247,559
30,13,35,639,390,1029
22,13,35,361,286,647
12,13,35,188,156,344
8,21,55,263,168,431
13,38,50,130,494,624
18,38,50,72,684,756
21,38,50,21,798,819
22,38,50,22,836,858
9,38,50,90,342,432
17,42,54,140,714,854
6,3,9,34,18,52
12,1,4,25,12,37
16,1,4,34,16,50
8,1,4,24,8,32
6,2,5,14,12,26
25,1,2,18,25,43
3,1,2,2,3,5
12,1,2,9,12,21
19,11,30,355,209,564
26,11,30,486,286,772
29,1,2,20,29,49
26,2,5,55,52,107
15,2,5,32,30,62
18,13,35,383,234,617
12,13,35,256,156,412
19,9,25,219,171,390
1,1,4,2,1,3
18,1,2,10,18,28
29,1,2,16,29,45
21,9,25,315,189,504
29,9,25,435,261,696
13,1,2,13,13,26
20,1,2,20,20,40
6,2,5,14,12,26
17,2,5,40,34,74
24,2,5,56,48,104
4,2,5,8,8,16
15,11,30,276,165,441
24,11,30,442,264,706
19,11,30,350,209,559
29,2,5,84,58,142
7,2,5,20,14,34
11,1,4,30,11,41
8,1,4,22,8,30
1,12,33,14,12,26
8,12,33,110,96,206
6,1,2,6,6,12
7,1,2,6,7,13
18,3,9,106,54,160
3,3,9,18,9,27
21,4,10,124,84,208
11,4,10,65,44,109
23,4,10,87,92,179
21,4,10,99,84,183
10,7,9,1,70,71
27,7,9,49,189,238
30,7,9,25,210,235
7,7,9,1,49,50
9,7,9,1,63,64
25,7,9,46,175,221
2,3,8,10,6,16
4,3,8,19,12,31
13,3,8,63,39,102
17,8,22,231,136,367
27,9,24,399,243,642
30,13,35,650,390,1040
24,13,35,377,312,689
27,42,54,266,1134,1400
15,38,50,165,570,735
5,42,54,55,210,265
1,42,54,11,42,53
23,26,70,674,598,1272
7,26,70,298,182,480
11,2,5,21,22,43
28,13,35,596,364,960
18,13,35,383,234,617
19,13,35,411,247,658
10,1,2,10,10,20
4,1,4,9,4,13
20,1,4,47,20,67
4,1,2,4,4,8
1,1,2,1,1,2
20,2,5,59,40,99
9,2,5,27,18,45
19,1,4,45,19,64
9,1,4,21,9,30
21,9,25,242,189,431
5,9,25,58,45,103
3,1,2,3,3,6
28,1,2,26,28,54
16,1,2,15,16,31
6,1,2,4,6,10
2,1,2,1,2,3
8,1,2,8,8,16
17,2,5,49,34,83
6,4,10,28,24,52
4,2,5,12,8,20
15,4,10,87,60,147
13,2,5,36,26,62
14,4,10,78,56,134
9,4,10,41,36,77
2,4,10,9,8,17
4,2,5,9,8,17
2,7,9,4,14,18
6,7,9,11,42,53
8,7,9,15,56,71
15,3,8,74,45,119
19,8,22,258,152,410
7,8,22,70,56,126
2,8,22,28,16,44
11,8,22,152,88,240
11,8,22,120,88,208
11,9,24,162,99,261
4,9,24,59,36,95
6,9,24,87,54,141
29,13,35,597,377,974
2,13,35,43,26,69
17,13,35,249,221,470
14,13,35,200,182,382
5,13,35,107,65,172
8,13,35,156,104,260
18,13,35,352,234,586
16,13,35,341,208,549
28,21,55,921,588,1509
9,42,54,6,378,384
27,38,50,230,1026,1256
2,38,50,22,76,98
25,42,54,273,1050,1323
11,38,50,121,418,539
28,38,50,322,1064,1386
25,26,70,1083,650,1733
29,26,70,1134,754,1888
30,26,70,1278,780,2058
17,26,70,736,442,1178
29,3,9,137,87,224
19,3,9,112,57,169
4,3,9,18,12,30
23,2,5,44,46,90
4,2,5,8,8,16
3,1,2,3,3,6
29,1,2,28,29,57
19,12,33,317,228,545
28,1,2,27,28,55
10,2,5,20,20,40
2,2,5,4,4,8
10,2,5,19,20,39
13,1,2,12,13,25
11,1,2,7,11,18
9,1,2,7,9,16
10,1,2,7,10,17
10,2,5,29,20,49
15,11,29,240,165,405
8,11,29,128,88,216
22,11,30,411,242,653
9,2,5,26,18,44
18,2,5,48,36,84
28,2,5,74,56,130
7,1,2,4,7,11
7,1,2,4,7,11
15,2,5,35,30,65
30,2,5,71,60,131
18,24,64,697,432,1129
20,24,64,570,480,1050
2,24,64,75,48,123
3,59,159,214,177,391
1,59,159,75,59,134
20,4,10,118,80,198
27,4,10,159,108,267
25,4,10,105,100,205
22,4,10,92,88,180
4,2,5,12,8,20
27,2,5,78,54,132
8,3,9,47,24,71
15,3,9,89,45,134
30,2,5,69,60,129
26,2,5,60,52,112
21,2,5,62,42,104
2,2,5,6,4,10
13,2,5,38,26,64
28,2,5,81,56,137
10,2,5,28,20,48
11,7,9,20,77,97
1,7,9,0,7,7
15,7,9,29,105,134
7,7,9,11,49,60
12,7,9,5,84,89
22,8,22,303,176,479
21,9,24,234,189,423
17,9,24,247,153,400
7,13,35,103,91,194
9,13,35,195,117,312
11,13,35,238,143,381
30,38,50,165,1140,1305
28,42,54,124,1176,1300
12,38,50,12,456,468
3,42,54,15,126,141
7,38,50,70,266,336
8,26,70,229,208,437
7,26,70,205,182,387
11,3,9,65,33,98
17,13,35,291,221,512
1,13,35,17,13,30
12,1,2,12,12,24
26,1,2,25,26,51
8,9,25,86,72,158
30,9,25,323,270,593
27,2,5,63,54,117
14,12,33,289,168,457
5,9,25,54,45,99
29,1,2,20,29,49
25,1,2,17,25,42
24,1,2,16,24,40
19,1,2,12,19,31
18,1,2,12,18,30
6,1,2,4,6,10
21,1,4,50,21,71
2,1,4,5,2,7
13,1,4,31,13,44
25,2,5,74,50,124
18,2,5,53,36,89
15,1,2,14,15,29
5,2,5,9,10,19
22,2,5,40,44,84
25,1,2,25,25,50
1,1,2,1,1,2
14,1,2,8,14,22
18,1,4,38,18,56
9,1,4,19,9,28
14,8,21,176,112,288
29,8,21,365,232,597
12,12,33,181,144,325
25,12,33,377,300,677
5,59,159,397,295,692
16,2,5,47,32,79
7,2,5,16,14,30
18,3,9,105,54,159
13,2,5,38,26,64
25,7,9,1,175,176
13,7,9,25,91,116
3,7,9,5,21,26
17,7,9,31,119,150
18,3,8,71,54,125
26,3,8,128,78,206
4,8,22,55,32,87
2,8,22,21,16,37
6,9,24,71,54,125
24,9,24,279,216,495
3,13,35,65,39,104
26,13,35,445,338,783
4,13,35,63,52,115
17,13,35,291,221,512
14,13,35,244,182,426
9,13,35,192,117,309
1,21,55,27,21,48
7,38,50,28,266,294
27,42,54,134,1134,1268
5,42,54,55,210,265
30,26,70,1299,780,2079
1,26,70,34,26,60
10,26,70,426,260,686
24,26,70,1039,624,1663
7,3,9,39,21,60
3,8,21,38,24,62
1,8,21,13,8,21
6,1,2,6,6,12
6,2,5,11,12,23
28,2,5,53,56,109
30,1,2,22,30,52
3,1,2,2,3,5
26,2,5,77,52,129
18,1,2,17,18,35
24,1,2,23,24,47
10,1,2,10,10,20
4,1,2,4,4,8
9,1,2,9,9,18
4,1,2,3,4,7
17,2,5,32,34,66
22,2,5,42,44,86
24,2,5,46,48,94
16,2,5,30,32,62
23,1,2,22,23,45
4,1,2,4,4,8
17,1,2,11,17,28
3,1,2,2,3,5
21,2,5,40,42,82
19,9,25,242,171,413
28,9,25,357,252,609
20,1,2,14,20,34
20,1,2,14,20,34
25,2,5,70,50,120
22,2,5,62,44,106
20,1,2,20,20,40
1,1,2,1,1,2
22,1,4,50,22,72
21,2,5,48,42,90
26,2,5,60,52,112
16,2,5,45,32,77
4,2,5,9,8,17
3,2,5,7,6,13
26,2,5,61,52,113
30,2,5,71,60,131
16,2,5,30,32,62
1,2,5,2,2,4
4,2,5,8,8,16
7,2,5,20,14,34
26,2,5,73,52,125
13,2,5,38,26,64
11,24,64,412,264,676
24,4,10,91,96,187
10,2,5,24,20,44
22,2,5,65,44,109
19,2,5,56,38,94
19,2,5,36,38,74
11,7,9,20,77,97
1,7,9,1,7,8
22,7,9,18,154,172
14,7,9,0,98,98
7,3,8,27,21,48
23,3,8,113,69,182
25,8,22,345,200,545
30,8,22,301,240,541
24,8,22,225,192,417
8,9,24,80,72,152
10,13,35,217,130,347
8,13,35,173,104,277
27,13,35,585,351,936
10,13,35,175,130,305
3,13,35,65,39,104
3,13,35,65,39,104
20,13,35,293,260,553
4,38,50,22,152,174
8,42,54,92,336,428
24,38,50,264,912,1176
27,26,70,1150,702,1852
19,3,9,112,57,169
16,1,2,16,16,32
14,1,4,41,14,55
5,1,4,15,5,20
29,1,2,21,29,50
3,1,2,2,3,5
23,2,5,44,46,90
16,2,5,30,32,62
4,2,5,12,8,20
16,2,5,47,32,79
28,13,35,489,364,853
11,13,35,192,143,335
9,2,5,19,18,37
20,2,5,42,40,82
6,2,5,12,12,24
23,2,5,45,46,91
5,11,30,92,55,147
3,2,5,9,6,15
15,2,5,44,30,74
8,2,5,23,16,39
30,2,5,87,60,147
28,2,5,83,56,139
23,2,5,68,46,114
8,2,5,23,16,39
20,1,4,49,20,69
24,1,4,59,24,83
7,24,64,271,168,439
1,59,159,75,59,134
1,59,159,65,59,124
20,4,10,118,80,198
20,4,10,118,80,198
5,2,5,12,10,22
8,2,5,18,16,34
8,2,5,23,16,39
11,2,5,21,22,43
9,2,5,17,18,35
17,2,5,49,34,83
23,2,5,67,46,113
5,2,5,15,10,25
23,2,5,67,46,113
7,7,9,13,49,62
14,7,9,10,98,108
13,3,8,48,39,87
10,8,22,109,80,189
29,8,22,393,232,625
6,8,22,79,48,127
5,8,22,58,40,98
26,8,22,238,208,446
10,8,22,111,80,191
24,9,24,233,216,449
1,13,35,22,13,35
20,13,35,412,260,672
20,13,35,286,260,546
3,13,35,64,39,103
24,13,35,520,312,832
20,13,35,286,260,546
21,13,35,330,273,603
7,13,35,120,91,211
16,42,54,71,672,743
2,38,50,5,76,81
1,38,50,11,38,49
7,42,54,35,294,329
1,42,54,11,42,53
6,42,54,27,252,279
9,26,70,383,234,617
22,1,2,15,22,37
18,2,5,52,36,88
20,2,5,58,40,98
12,2,5,28,24,52
30,2,5,69,60,129
21,1,4,62,21,83
1,1,4,3,1,4
3,11,30,55,33,88
7,11,30,129,77,206
3,2,5,9,6,15
20,2,5,59,40,99
6,1,2,6,6,12
13,1,2,12,13,25
4,1,4,12,4,16
23,1,4,67,23,90
2,1,4,6,2,8
20,1,2,19,20,39
6,1,2,6,6,12
28,1,2,20,28,48
21,2,5,46,42,88
17,12,33,234,204,438
10,2,5,19,20,39
20,8,21,184,160,344
11,8,21,101,88,189
26,1,4,74,26,100
26,8,21,300,208,508
18,8,21,208,144,352
28,8,21,323,224,547
8,8,21,101,64,165
2,8,21,25,16,41
2,8,21,25,16,41
2,9,25,31,18,49
11,9,25,171,99,270
27,2,5,80,54,134
5,2,5,15,10,25
8,2,5,18,16,34
13,2,5,27,26,53
12,7,9,10,84,94
18,7,9,33,126,159
27,7,9,52,189,241
16,8,22,217,128,345
22,8,22,289,176,465
15,9,24,221,135,356
24,9,24,354,216,570
14,9,24,197,126,323
4,9,24,59,36,95
4,9,24,39,36,75
12,9,24,143,108,251
2,9,24,23,18,41
13,13,35,222,169,391
12,13,35,176,156,332
11,13,35,234,143,377
4,13,35,70,52,122
5,13,35,108,65,173
14,13,35,303,182,485
17,13,35,297,221,518
19,13,35,411,247,658
5,13,35,72,65,137
2,38,50,22,76,98
23,38,50,23,874,897
15,38,50,173,570,743
12,26,70,352,312,664
7,26,70,303,182,485
18,1,2,13,18,31
15,1,2,14,15,29
4,9,25,63,36,99
24,1,2,24,24,48
3,1,2,3,3,6
7,1,2,4,7,11
30,1,2,17,30,47
8,11,29,142,88,230
7,1,2,5,7,12
23,1,2,17,23,40
27,1,2,20,27,47
27,9,25,405,243,648
11,9,25,165,99,264
4,1,4,12,4,16
28,9,25,322,252,574
12,1,2,8,12,20
18,1,2,12,18,30
3,9,25,47,27,74
20,1,2,15,20,35
30,1,2,22,30,52
30,11,29,383,330,713
15,11,29,192,165,357
26,8,21,223,208,431
14,8,21,176,112,288
16,1,4,40,16,56
13,1,4,32,13,45
21,8,21,264,168,432
3,1,2,2,3,5
6,24,64,225,144,369
4,45,120,238,180,418
15,4,10,59,60,119
23,4,10,90,92,182
27,4,10,151,108,259
26,4,10,153,104,257
21,2,5,49,42,91
2,2,5,4,4,8
3,2,5,5,6,11
8,2,5,14,16,30
27,2,5,63,54,117
12,2,5,35,24,59
28,2,5,83,56,139
27,2,5,80,54,134
21,2,5,62,42,104
14,7,9,5,98,103
3,7,9,0,21,21
29,8,22,323,232,555
19,8,22,166,152,318
10,8,22,109,80,189
4,8,22,55,32,87
27,8,22,372,216,588
27,9,24,321,243,564
25,9,24,297,225,522
27,13,35,396,351,747
15,13,35,309,195,504
5,13,35,72,65,137
14,13,35,288,182,470
8,13,35,173,104,277
28,13,35,381,364,745
23,13,35,490,299,789
5,13,35,108,65,173
18,13,35,283,234,517
22,13,35,469,286,755
26,13,35,454,338,792
14,21,55,468,294,762
11,38,50,17,418,435
19,38,50,105,722,827
24,42,54,120,1008,1128
23,38,50,115,874,989
4,38,50,44,152,196
3,42,54,2,126,128
16,26,70,682,416,1098
11,1,2,11,11,22
16,1,2,15,16,31
18,2,5,34,36,70
29,1,2,21,29,50
3,1,2,2,3,5
3,2,5,8,6,14
9,2,5,25,18,43
27,2,5,80,54,134
3,2,5,9,6,15
20,2,5,59,40,99
29,1,2,16,29,45
14,1,4,41,14,55
2,1,2,1,2,3
26,1,2,18,26,44
23,2,5,68,46,114
18,2,5,53,36,89
21,2,5,62,42,104
9,2,5,25,18,43
3,2,5,8,6,14
28,1,2,27,28,55
30,1,2,29,30,59
1,1,2,1,1,2
12,1,2,8,12,20
11,1,4,27,11,38
4,1,2,4,4,8
17,1,2,15,17,32
26,1,2,23,26,49
28,2,5,59,56,115
19,2,5,40,38,78
9,1,4,24,9,33
17,1,4,46,17,63
15,1,4,32,15,47
19,12,33,386,228,614
10,12,33,203,120,323
11,1,2,11,11,22
28,1,2,16,28,44
4,1,2,2,4,6
29,2,5,81,58,139
23,2,5,64,46,110
4,2,5,11,8,19
8,45,120,533,360,893
19,45,120,1334,855,2189
15,4,10,89,60,149
28,4,10,165,112,277
19,2,5,55,38,93
16,2,5,46,32,78
17,2,5,40,34,74
27,4,10,124,108,232
7,4,10,32,28,60
11,2,5,32,22,54
30,2,5,87,60,147
23,2,5,67,46,113
13,7,9,24,91,115
25,7,9,3,175,178
11,7,9,21,77,98
6,3,8,30,18,48
28,3,8,111,84,195
7,8,22,95,56,151
21,8,22,289,168,457
22,9,24,325,198,523
8,13,35,170,104,274
4,13,35,70,52,122
22,13,35,345,286,631
8,13,35,170,104,274
8,13,35,173,104,277
26,38,50,299,988,1287
9,38,50,99,342,441
21,42,54,241,882,1123
8,42,54,92,336,428
4,42,54,44,168,212
15,42,54,123,630,753
1,38,50,3,38,41
22,26,70,953,572,1525
14,26,70,596,364,960
10,26,70,286,260,546
25,1,2,19,25,44
14,11,30,262,154,416
4,11,30,75,44,119
29,9,25,457,261,718
10,1,2,10,10,20
15,1,2,15,15,30
12,1,2,12,12,24
9,1,4,22,9,31
22,9,25,314,198,512
24,9,25,342,216,558
6,2,5,18,12,30
8,2,5,19,16,35
4,2,5,12,8,20
29,2,5,86,58,144
21,1,2,21,21,42
9,1,2,9,9,18
23,11,30,423,253,676
2,11,30,37,22,59
19,1,2,14,19,33
25,1,2,19,25,44
30,8,21,384,240,624
8,8,21,102,64,166
24,2,5,46,48,94
2,2,5,6,4,10
6,2,5,17,12,29
1,2,5,2,2,4
21,2,5,40,42,82
15,2,5,29,30,59
25,4,10,115,100,215
29,4,10,133,116,249
2,2,5,6,4,10
12,2,5,35,24,59
10,2,5,30,20,50
16,7,9,12,112,124
20,7,9,38,140,178
15,3,8,74,45,119
10,8,22,109,80,189
4,9,24,39,36,75
19,9,24,226,171,397
3,13,35,65,39,104
29,13,35,618,377,995
8,13,35,114,104,218
24,13,35,520,312,832
15,13,35,220,195,415
9,13,35,157,117,274
8,21,55,268,168,436
14,21,55,368,294,662
17,38,50,196,646,842
7,38,50,81,266,347
6,42,54,4,252,256
26,42,54,115,1092,1207
20,38,50,200,760,960
23,3,9,95,69,164
25,2,5,73,50,123
20,2,5,58,40,98
4,2,5,12,8,20
4,1,2,4,4,8
2,1,2,2,2,4
28,13,35,606,364,970
5,13,35,108,65,173
26,13,35,445,338,783
14,13,35,239,182,421
22,2,5,64,44,108
23,2,5,67,46,113
17,1,4,42,17,59
23,1,4,68,23,91
1,1,2,1,1,2
15,1,2,9,15,24
27,8,21,232,216,448
27,2,5,63,54,117
18,1,2,13,18,31
2,1,2,1,2,3
14,1,2,10,14,24
11,1,2,6,11,17
4,1,2,2,4,6
29,1,2,28,29,57
20,1,2,20,20,40
1,1,2,1,1,2
7,1,2,6,7,13
26,1,2,19,26,45
21,1,2,16,21,37
17,24,64,669,408,1077
12,24,64,372,288,660
26,45,120,1388,1170,2558
7,45,120,391,315,706
4,2,5,12,8,20
13,2,5,38,26,64
14,2,5,27,28,55
13,2,5,25,26,51
17,4,10,99,68,167
19,2,5,55,38,93
29,7,9,55,203,258
26,7,9,47,182,229
6,7,9,11,42,53
18,7,9,30,126,156
16,7,9,0,112,112
21,3,8,68,63,131
9,3,8,32,27,59
19,3,8,75,57,132
11,3,8,36,33,69
6,3,8,29,18,47
27,3,8,131,81,212
28,3,8,136,84,220
22,8,22,298,176,474
1,8,22,14,8,22
14,8,22,193,112,305
24,9,24,337,216,553
27,9,24,269,243,512
30,13,35,639,390,1029
8,13,35,131,104,235
25,13,35,541,325,866
10,13,35,206,130,336
20,13,35,293,260,553
9,13,35,185,117,302
14,13,35,303,182,485
29,13,35,618,377,995
6,13,35,105,78,183
4,21,55,132,84,216
4,21,55,107,84,191
10,21,55,329,210,539
22,21,55,736,462,1198
20,38,50,220,760,980
25,38,50,288,950,1238
23,38,50,92,874,966
22,42,54,3,924,927
23,38,50,230,874,1104
13,26,70,372,338,710
14,26,70,596,364,960
19,3,9,83,57,140
5,2,5,10,10,20
16,2,5,30,32,62
4,2,5,8,8,16
19,2,5,40,38,78
30,1,2,29,30,59
16,2,5,34,32,66
28,2,5,59,56,115
8,1,2,8,8,16
9,1,2,9,9,18
19,1,4,56,19,75
25,1,4,59,25,84
8,1,4,19,8,27
19,1,4,45,19,64
18,1,4,42,18,60
15,2,5,42,30,72
22,2,5,64,44,108
12,2,5,35,24,59
1,2,5,3,2,5
27,11,29,455,297,752
27,2,5,76,54,130
1,1,2,1,1,2
4,11,30,54,44,98
18,2,5,50,36,86
3,2,5,8,6,14
3,2,5,7,6,13
12,1,2,7,12,19
14,1,2,8,14,22
7,1,2,4,7,11
22,1,2,22,22,44
25,1,2,25,25,50
28,13,35,410,364,774
12,13,35,176,156,332
17,2,5,40,34,74
8,2,5,19,16,35
13,24,64,512,312,824
16,24,64,620,384,1004
1,1266,2320,1008,1266,2274
3,2171,3578,1860,6513,8373
1,1555,2443,448,1555,2003
3,487,783,771,1461,2232
1,487,783,186,487,673
1,1555,2443,717,1555,2272
1,1083,1701,346,1083,1429
1,713,1120,261,713,974
1,1252,2295,745,1252,1997
1,1252,2295,882,1252,2134
1,1266,2320,752,1266,2018
1,1266,2320,683,1266,1949
1,2171,3578,1335,2171,3506
1,2171,3578,1264,2171,3435
2,1083,1701,1100,2166,3266
2,2171,3578,1884,4342,6226
2,1083,1701,794,2166,2960
1,344,540,174,344,518
1,344,540,174,344,518
1,344,540,126,344,470
1,1266,2320,752,1266,2018
1,1252,2295,561,1252,1813
1,1266,2320,961,1266,2227
3,487,783,841,1461,2302
1,1555,2443,790,1555,2345
2,2171,3578,2742,4342,7084
2,1083,1701,692,2166,2858
2,295,540,252,590,842
2,1083,1701,794,2166,2960
3,1083,1701,935,3249,4184
1,1083,1701,312,1083,1395
1,1083,1701,397,1083,1480
1,1083,1701,397,1083,1480
1,344,540,174,344,518
1,713,1120,172,713,885
1,1252,2295,561,1252,1813
1,308,565,246,308,554
1,1266,2320,1031,1266,2297
1,2171,3578,1264,2171,3435
3,2171,3578,1967,6513,8480
2,1555,2443,1141,3110,4251
1,344,540,174,344,518
2,1555,2443,897,3110,4007
2,713,1120,411,1426,1837
3,1252,2295,2854,3756,6610
1,308,565,184,308,492
2,1266,2320,1273,2532,3805
2,2171,3578,1812,4342,6154
2,1519,2443,773,3038,3811
1,1519,2443,387,1519,1906
3,1083,1701,1650,3249,4899
3,1555,2443,1345,4665,6010
1,1083,1701,312,1083,1395
1,1266,2320,567,1266,1833
1,1252,2295,745,1252,1997
1,1252,2295,745,1252,1997
1,1252,2295,722,1252,1974
1,1266,2320,752,1266,2018
1,420,769,211,420,631
1,2171,3578,1264,2171,3435
3,487,783,841,1461,2302
1,487,783,124,487,611
3,1083,1701,782,3249,4031
1,1266,2320,1008,1266,2274
1,1266,2320,683,1266,1949
3,420,769,1001,1260,2261
1,1266,2320,1008,1266,2274
1,420,769,249,420,669
1,1555,2443,570,1555,2125
1,1519,2443,753,1519,2272
2,713,1120,500,1426,1926
1,713,1120,194,713,907
1,1252,2295,676,1252,1928
1,308,565,251,308,559
1,2171,3578,620,2171,2791
2,344,540,349,688,1037
1,1083,1701,346,1083,1429
1,1083,1701,550,1083,1633
2,344,540,165,688,853
1,1083,1701,312,1083,1395
1,1083,1701,261,1083,1344
1,713,1120,194,713,907
1,2171,3578,1335,2171,3506
1,1266,2320,961,1266,2227
3,308,565,551,924,1475
1,1266,2320,1008,1266,2274
1,1555,2443,839,1555,2394
2,1519,2443,1653,3038,4691
1,2171,3578,942,2171,3113
1,344,540,83,344,427
1,1266,2320,567,1266,1833
3,1252,2295,2991,3756,6747
1,1266,2320,1008,1266,2274
1,420,769,249,420,669
1,420,769,318,420,738
3,1083,1701,1650,3249,4899
1,2171,3578,1335,2171,3506
1,1266,2320,544,1266,1810
2,1266,2320,1505,2532,4037
2,420,769,498,840,1338
1,1555,2443,717,1555,2272
2,1555,2443,1581,3110,4691
3,1555,2443,1711,4665,6376
1,487,783,288,487,775
2,487,783,529,974,1503
1,1555,2443,570,1555,2125
1,344,540,174,344,518
1,344,540,126,344,470
1,2171,3578,1335,2171,3506
3,1252,2295,1614,3756,5370
2,1252,2295,1489,2504,3993
3,1266,2320,2048,3798,5846
1,1266,2320,961,1266,2227
1,1266,2320,1008,1266,2274
1,1266,2320,729,1266,1995
3,1266,2320,1631,3798,5429
3,1266,2320,1700,3798,5498
3,1266,2320,2257,3798,6055
1,1252,2295,561,1252,1813
3,2171,3578,3792,6513,10305
3,1519,2443,1819,4557,6376
3,1083,1701,1803,3249,5052
1,1555,2443,497,1555,2052
1,1083,1701,261,1083,1344
1,2171,3578,1335,2171,3506
1,1252,2295,882,1252,2134
2,1266,2320,1922,2532,4454
3,1266,2320,1909,3798,5707
1,1252,2295,722,1252,1974
1,1519,2443,484,1519,2003
3,1555,2443,2371,4665,7036
1,487,783,186,487,673
1,1555,2443,839,1555,2394
3,2171,3578,2826,6513,9339
1,344,540,191,344,535
1,2171,3578,1335,2171,3506
1,1912,3400,774,1912,2686
3,1252,2295,2991,3756,6747
3,1266,2320,1700,3798,5498
1,1266,2320,544,1266,1810
3,2171,3578,4006,6513,10519
1,1555,2443,839,1555,2394
1,1083,1701,550,1083,1633
1,1252,2295,630,1252,1882
1,1898,3375,1410,1898,3308
1,1555,2443,717,1555,2272
3,713,1120,1087,2139,3226
3,1083,1701,1191,3249,4440
1,1555,2443,497,1555,2052
3,1555,2443,2591,4665,7256
1,1252,2295,745,1252,1997
1,1266,2320,683,1266,1949
2,1252,2295,1076,2504,3580
1,2171,3578,656,2171,2827
1,1083,1701,550,1083,1633
1,1266,2320,683,1266,1949
1,420,769,249,420,669
1,308,565,234,308,542
1,295,540,169,295,464
1,1266,2320,636,1266,1902
1,2171,3578,763,2171,2934
3,1555,2443,1491,4665,6156
1,308,565,184,308,492
1,1266,2320,683,1266,1949
2,1252,2295,1076,2504,3580
1,1519,2443,753,1519,2272
1,2171,3578,656,2171,2827
1,344,540,126,344,470
2,344,540,252,688,940
3,1266,2320,2048,3798,5846
1,1252,2295,745,1252,1997
1,713,1120,261,713,974
1,1555,2443,717,1555,2272
1,1555,2443,717,1555,2272
1,1555,2443,839,1555,2394
1,487,783,265,487,752
1,1555,2443,497,1555,2052
1,1519,2443,900,1519,2419
1,2171,3578,620,2171,2791
3,1252,2295,1890,3756,5646
3,1252,2295,1683,3756,5439
3,420,769,955,1260,2215
1,713,1120,362,713,1075
1,713,1120,250,713,963
1,713,1120,205,713,918
1,713,1120,385,713,1098
1,713,1120,385,713,1098
3,713,1120,986,2139,3125
1,344,540,93,344,437
1,1083,1701,397,1083,1480
1,1083,1701,261,1083,1344
1,2171,3578,835,2171,3006
1,2171,3578,1335,2171,3506
3,1252,2295,3060,3756,6816
2,1252,2295,1902,2504,4406
3,1898,3375,3722,5694,9416
1,1555,2443,570,1555,2125
2,344,540,370,688,1058
1,2171,3578,1335,2171,3506
1,713,1120,329,713,1042
1,1252,2295,561,1252,1813
1,2171,3578,1335,2171,3506
1,2171,3578,942,2171,3113
1,344,540,77,344,421
2,1252,2295,1489,2504,3993
2,1266,2320,1505,2532,4037
3,420,769,1001,1260,2261
1,1266,2320,961,1266,2227
1,1252,2295,882,1252,2134
1,1555,2443,717,1555,2272
2,1555,2443,848,3110,3958
3,1555,2443,1491,4665,6156
2,344,540,165,688,853
1,344,540,126,344,470
2,1252,2295,1994,2504,4498
1,1083,1701,261,1083,1344
1,1083,1701,550,1083,1633
1,1912,3400,944,1912,2856
1,1266,2320,683,1266,1949
1,2171,3578,1157,2171,3328
1,713,1120,250,713,963
1,1555,2443,375,1555,1930
1,713,1120,261,713,974
3,1083,1701,1650,3249,4899
3,713,1120,1087,2139,3226
2,1555,2443,1141,3110,4251
2,1555,2443,750,3110,3860
1,1083,1701,346,1083,1429
1,344,540,174,344,518
1,2171,3578,620,2171,2791
2,1266,2320,1366,2532,3898
2,2171,3578,2313,4342,6655
1,713,1120,385,713,1098
2,1555,2443,1141,3110,4251
2,344,540,273,688,961
1,344,540,126,344,470
1,1266,2320,1008,1266,2274
1,1266,2320,1031,1266,2297
1,295,540,240,295,535
3,1266,2320,1909,3798,5707
1,1519,2443,826,1519,2345
1,344,540,83,344,427
1,713,1120,172,713,885
1,2171,3578,620,2171,2791
1,1266,2320,683,1266,1949
1,308,565,184,308,492
1,1252,2295,538,1252,1790
1,1266,2320,1008,1266,2274
2,2171,3578,2671,4342,7013
1,2171,3578,620,2171,2791
1,1555,2443,497,1555,2052
1,344,540,185,344,529
1,1083,1701,346,1083,1429
1,2171,3578,620,2171,2791
1,1252,2295,722,1252,1974
1,1252,2295,630,1252,1882
1,1266,2320,752,1266,2018
1,2171,3578,942,2171,3113
3,1519,2443,1819,4557,6376
1,1083,1701,397,1083,1480
3,1083,1701,884,3249,4133
1,1555,2443,570,1555,2125
1,487,783,265,487,752
2,344,540,370,688,1058
1,1252,2295,1020,1252,2272
1,308,565,155,308,463
2,1266,2320,1273,2532,3805
1,2171,3578,1264,2171,3435
1,713,1120,329,713,1042
1,1083,1701,261,1083,1344
1,713,1120,396,713,1109
2,1555,2443,750,3110,3860
1,344,540,174,344,518
3,420,769,747,1260,2007
1,1266,2320,752,1266,2018
1,1266,2320,1031,1266,2297
1,1266,2320,1008,1266,2274
1,2171,3578,1264,2171,3435
3,713,1120,751,2139,2890
1,487,783,280,487,767
1,2171,3578,763,2171,2934
1,2171,3578,835,2171,3006
2,1555,2443,603,3110,3713
1,1555,2443,497,1555,2052
1,713,1120,228,713,941
2,713,1120,411,1426,1837
1,487,783,194,487,681
1,1083,1701,550,1083,1633
1,344,540,110,344,454
3,344,540,523,1032,1555
2,1266,2320,2015,2532,4547
1,420,769,180,420,600
1,1252,2295,951,1252,2203
1,1266,2320,752,1266,2018
1,1252,2295,722,1252,1974
1,2171,3578,1335,2171,3506
1,2171,3578,1371,2171,3542
2,1083,1701,794,2166,2960
2,1266,2320,994,2532,3526
1,1252,2295,882,1252,2134
2,1252,2295,2040,2504,4544
1,1266,2320,544,1266,1810
1,2171,3578,1264,2171,3435
3,487,783,559,1461,2020
1,713,1120,329,713,1042
1,2171,3578,942,2171,3113
1,1555,2443,839,1555,2394
3,1555,2443,1711,4665,6376
3,344,540,232,1032,1264
2,344,540,154,688,842
1,344,540,126,344,470
1,2171,3578,1335,2171,3506
3,1898,3375,2811,5694,8505
1,308,565,184,308,492
3,1252,2295,2027,3756,5783
1,1252,2295,1020,1252,2272
1,1252,2295,538,1252,1790
1,2171,3578,942,2171,3113
2,1555,2443,1141,3110,4251
2,713,1120,344,1426,1770
1,1898,3375,768,1898,2666
1,1266,2320,1031,1266,2297
2,1266,2320,1273,2532,3805
3,1266,2320,2048,3798,5846
1,2171,3578,1264,2171,3435
1,713,1120,284,713,997
1,1083,1701,244,1083,1327
3,713,1120,415,2139,2554
1,1083,1701,346,1083,1429
1,344,540,185,344,529
1,713,1120,205,713,918
1,1266,2320,1008,1266,2274
1,1266,2320,961,1266,2227
2,1252,2295,1122,2504,3626
1,1252,2295,630,1252,1882
1,1266,2320,613,1266,1879
3,1252,2295,2234,3756,5990
1,420,769,318,420,738
2,1898,3375,1739,3796,5535
1,1555,2443,717,1555,2272
2,1083,1701,624,2166,2790
1,1083,1701,550,1083,1633
1,1252,2295,745,1252,1997
1,1266,2320,961,1266,2227
1,1252,2295,1020,1252,2272
1,1252,2295,1020,1252,2272
1,1912,3400,672,1912,2584
1,487,783,124,487,611
1,2171,3578,656,2171,2827
1,420,769,249,420,669
1,1266,2320,683,1266,1949
1,1252,2295,951,1252,2203
1,1083,1701,550,1083,1633
1,308,565,167,308,475
1,420,769,249,420,669
1,1252,2295,745,1252,1997
2,1266,2320,1505,2532,4037
1,1252,2295,722,1252,1974
1,1266,2320,1008,1266,2274
3,1519,2443,2479,4557,7036
1,2171,3578,942,2171,3113
3,487,783,465,1461,1926
2,1555,2443,897,3110,4007
1,1898,3375,768,1898,2666
1,1252,2295,882,1252,2134
3,1266,2320,2048,3798,5846
1,1252,2295,561,1252,1813
1,308,565,155,308,463
1,2171,3578,942,2171,3113
1,487,783,280,487,767
1,1519,2443,484,1519,2003
1,713,1120,250,713,963
1,344,540,174,344,518
2,713,1120,523,1426,1949
1,1898,3375,937,1898,2835
1,1252,2295,676,1252,1928
1,2171,3578,1335,2171,3506
1,2171,3578,1264,2171,3435
1,2171,3578,1157,2171,3328
1,2171,3578,763,2171,2934
1,1083,1701,397,1083,1480
1,344,540,185,344,529
1,344,540,185,344,529
1,344,540,174,344,518
3,344,540,556,1032,1588
1,1252,2295,745,1252,1997
1,1266,2320,567,1266,1833
1,1252,2295,630,1252,1882
1,1252,2295,538,1252,1790
3,1555,2443,1711,4665,6376
1,344,540,120,344,464
1,1083,1701,397,1083,1480
2,1083,1701,590,2166,2756
1,1083,1701,397,1083,1480
3,1519,2443,2699,4557,7256
1,344,540,126,344,470
1,1252,2295,882,1252,2134
1,1252,2295,951,1252,2203
3,1266,2320,2257,3798,6055
3,420,769,1024,1260,2284
1,1266,2320,1008,1266,2274
1,1266,2320,636,1266,1902
2,308,565,277,616,893
1,1252,2295,745,1252,1997
1,420,769,249,420,669
1,1252,2295,1020,1252,2272
1,2171,3578,835,2171,3006
1,1519,2443,631,1519,2150
3,1083,1701,1191,3249,4440
1,344,540,99,344,443
1,344,540,174,344,518
3,344,540,523,1032,1555
1,1898,3375,768,1898,2666
1,1266,2320,567,1266,1833
1,420,769,188,420,608
2,420,769,636,840,1476
1,1266,2320,636,1266,1902
1,1898,3375,735,1898,2633
1,1555,2443,717,1555,2272
2,487,783,561,974,1535
3,1519,2443,2259,4557,6816
1,1555,2443,717,1555,2272
2,713,1120,344,1426,1770
2,713,1120,344,1426,1770
2,713,1120,344,1426,1770
2,1266,2320,2015,2532,4547
1,420,769,334,420,754
1,1252,2295,745,1252,1997
1,713,1120,250,713,963
2,2171,3578,1526,4342,5868
2,1083,1701,998,2166,3164
2,713,1120,724,1426,2150
2,1083,1701,692,2166,2858
2,713,1120,344,1426,1770
1,2171,3578,1335,2171,3506
1,1266,2320,683,1266,1949
1,1252,2295,951,1252,2203
1,1252,2295,722,1252,1974
1,487,783,186,487,673
1,487,783,124,487,611
3,2171,3578,2826,6513,9339
3,1083,1701,884,3249,4133
2,1083,1701,522,2166,2688
2,713,1120,344,1426,1770
1,713,1120,205,713,918
1,1266,2320,1008,1266,2274
3,1252,2295,2647,3756,6403
1,1252,2295,630,1252,1882
1,1266,2320,1008,1266,2274
1,1266,2320,752,1266,2018
1,2171,3578,1264,2171,3435
2,2171,3578,1884,4342,6226
1,1555,2443,448,1555,2003
1,2171,3578,942,2171,3113
1,713,1120,385,713,1098
2,713,1120,411,1426,1837
1,713,1120,205,713,918
3,2171,3578,4006,6513,10519
2,1266,2320,1273,2532,3805
1,1266,2320,567,1266,1833
3,1555,2443,1711,4665,6376
1,487,783,155,487,642
1,1083,1701,346,1083,1429
1,713,1120,205,713,918
3,1083,1701,1191,3249,4440
3,1083,1701,1191,3249,4440
3,1083,1701,1650,3249,4899
2,344,540,349,688,1037
1,2171,3578,1335,2171,3506
3,487,783,371,1461,1832
3,713,1120,616,2139,2755
1,713,1120,194,713,907
1,1252,2295,1020,1252,2272
1,1266,2320,892,1266,2158
2,1266,2320,1273,2532,3805
2,1252,2295,1214,2504,3718
1,1266,2320,1008,1266,2274
1,487,783,280,487,767
2,2171,3578,1669,4342,6011
1,2171,3578,1335,2171,3506
2,713,1120,724,1426,2150
1,1083,1701,550,1083,1633
3,2171,3578,4006,6513,10519
1,1912,3400,774,1912,2686
2,1252,2295,1902,2504,4406
2,713,1120,769,1426,2195
1,1519,2443,484,1519,2003
1,1555,2443,570,1555,2125
2,1083,1701,1202,2166,3368
1,1555,2443,570,1555,2125
1,2171,3578,835,2171,3006
1,2171,3578,835,2171,3006
1,2171,3578,835,2171,3006
1,487,783,155,487,642
1,713,1120,362,713,1075
1,713,1120,362,713,1075
1,1083,1701,346,1083,1429
1,713,1120,194,713,907
3,420,769,678,1260,1938
1,1519,2443,484,1519,2003
1,713,1120,205,713,918
1,713,1120,385,713,1098
2,1083,1701,1100,2166,3266
1,2171,3578,906,2171,3077
1,2171,3578,1335,2171,3506
2,2171,3578,1311,4342,5653
1,713,1120,362,713,1075
1,2171,3578,1335,2171,3506
1,1266,2320,683,1266,1949
1,420,769,249,420,669
1,1266,2320,567,1266,1833
1,1252,2295,997,1252,2249
1,2171,3578,763,2171,2934
1,1083,1701,312,1083,1395
2,713,1120,411,1426,1837
1,2171,3578,1335,2171,3506
1,1266,2320,683,1266,1949
1,1252,2295,951,1252,2203
2,1519,2443,1750,3038,4788
2,2171,3578,2528,4342,6870
3,2171,3578,2826,6513,9339
3,487,783,630,1461,2091
1,1555,2443,448,1555,2003
1,344,540,174,344,518
2,713,1120,523,1426,1949
1,1252,2295,951,1252,2203
3,1252,2295,1890,3756,5646
1,1266,2320,683,1266,1949
1,1266,2320,1031,1266,2297
1,1266,2320,1008,1266,2274
1,1555,2443,546,1555,2101
2,1555,2443,701,3110,3811
1,2171,3578,1371,2171,3542
2,1555,2443,1141,3110,4251
1,344,540,126,344,470
3,344,540,572,1032,1604
1,1266,2320,1008,1266,2274
3,1252,2295,2234,3756,5990
3,420,769,563,1260,1823
3,487,783,465,1461,1926
1,344,540,126,344,470
3,713,1120,784,2139,2923
3,1266,2320,2048,3798,5846
1,420,769,249,420,669
1,1083,1701,312,1083,1395
3,1083,1701,1497,3249,4746
1,1083,1701,499,1083,1582
2,487,783,482,974,1456
1,1266,2320,636,1266,1902
1,1252,2295,951,1252,2203
2,1266,2320,1505,2532,4037
3,1252,2295,2234,3756,5990
1,1252,2295,745,1252,1997
1,1266,2320,1031,1266,2297
1,1266,2320,1008,1266,2274
1,1555,2443,375,1555,1930
1,1555,2443,448,1555,2003
1,1083,1701,550,1083,1633
2,1083,1701,488,2166,2654
1,2171,3578,656,2171,2827
1,713,1120,161,713,874
1,344,540,83,344,427
1,344,540,83,344,427
1,1083,1701,261,1083,1344
1,2171,3578,906,2171,3077
3,344,540,199,1032,1231
2,2171,3578,2671,4342,7013
2,1519,2443,773,3038,3811
1,1083,1701,380,1083,1463
1,1519,2443,606,1519,2125
1,2171,3578,942,2171,3113
3,1252,2295,2234,3756,5990
1,308,565,184,308,492
1,1266,2320,1008,1266,2274
2,2171,3578,1812,4342,6154
1,487,783,280,487,767
1,1555,2443,570,1555,2125
1,1555,2443,448,1555,2003
1,344,540,174,344,518
2,344,540,349,688,1037
1,1252,2295,676,1252,1928
2,1252,2295,1489,2504,3993
1,420,769,249,420,669
2,420,769,406,840,1246
2,308,565,435,616,1051
1,420,769,188,420,608
3,1266,2320,2188,3798,5986
1,1912,3400,672,1912,2584
1,713,1120,205,713,918
3,1519,2443,2479,4557,7036
1,1555,2443,790,1555,2345
3,2171,3578,2826,6513,9339
1,1555,2443,448,1555,2003
3,1555,2443,1711,4665,6376
1,1252,2295,676,1252,1928
2,1266,2320,1134,2532,3666
1,1266,2320,1008,1266,2274
1,487,783,280,487,767
2,2171,3578,1311,4342,5653
1,1252,2295,538,1252,1790
1,1266,2320,567,1266,1833
2,1083,1701,794,2166,2960
1,713,1120,396,713,1109
3,713,1120,784,2139,2923
3,1266,2320,1909,3798,5707
1,1252,2295,676,1252,1928
1,420,769,249,420,669
2,2171,3578,2027,4342,6369
1,1555,2443,790,1555,2345
2,713,1120,523,1426,1949
1,1555,2443,570,1555,2125
3,344,540,377,1032,1409
2,1266,2320,1505,2532,4037
1,1252,2295,951,1252,2203
3,1266,2320,3023,3798,6821
1,1252,2295,745,1252,1997
1,420,769,226,420,646
1,1252,2295,745,1252,1997
1,295,540,240,295,535
1,1266,2320,544,1266,1810
2,2171,3578,1526,4342,5868
3,1519,2443,2479,4557,7036
1,344,540,77,344,421
1,1083,1701,312,1083,1395
2,2171,3578,1884,4342,6226
1,713,1120,385,713,1098
1,1555,2443,570,1555,2125
1,344,540,174,344,518
1,713,1120,261,713,974
1,487,783,132,487,619
2,344,540,349,688,1037
1,1898,3375,1038,1898,2936
1,1252,2295,745,1252,1997
1,1266,2320,683,1266,1949
1,1266,2320,1008,1266,2274
1,1252,2295,882,1252,2134
1,344,540,174,344,518
2,344,540,187,688,875
2,1266,2320,1922,2532,4454
1,420,769,249,420,669
1,1266,2320,961,1266,2227
1,1266,2320,1008,1266,2274
1,1555,2443,570,1555,2125
1,2171,3578,656,2171,2827
1,1519,2443,484,1519,2003
1,1083,1701,550,1083,1633
2,713,1120,769,1426,2195
2,295,540,468,590,1058
1,295,540,240,295,535
1,2171,3578,942,2171,3113
1,487,783,265,487,752
1,2171,3578,906,2171,3077
1,1266,2320,961,1266,2227
1,713,1120,161,713,874
2,1519,2443,1213,3038,4251
3,1555,2443,1345,4665,6010
1,344,540,126,344,470
1,1083,1701,550,1083,1633
1,487,783,194,487,681
1,1252,2295,882,1252,2134
1,1252,2295,745,1252,1997
1,1252,2295,745,1252,1997
2,1266,2320,2062,2532,4594
1,1555,2443,375,1555,1930
1,1083,1701,550,1083,1633
1,713,1120,396,713,1109
1,713,1120,205,713,918
2,344,540,349,688,1037
1,1252,2295,882,1252,2134
1,1252,2295,1020,1252,2272
3,420,769,747,1260,2007
1,295,540,132,295,427
2,420,769,498,840,1338
1,1252,2295,997,1252,2249
3,1555,2443,1638,4665,6303
1,2171,3578,1264,2171,3435
1,1519,2443,826,1519,2345
3,1083,1701,1293,3249,4542
1,713,1120,138,713,851
3,1083,1701,1191,3249,4440
1,1083,1701,550,1083,1633
1,2171,3578,942,2171,3113
1,1083,1701,346,1083,1429
3,1252,2295,2854,3756,6610
1,1266,2320,1008,1266,2274
3,1252,2295,1683,3756,5439
2,1266,2320,1922,2532,4454
1,1555,2443,790,1555,2345
1,2171,3578,656,2171,2827
1,1555,2443,717,1555,2272
2,487,783,482,974,1456
1,344,540,126,344,470
1,344,540,99,344,443
3,713,1120,683,2139,2822
1,2171,3578,620,2171,2791
1,1912,3400,1046,1912,2958
1,1266,2320,567,1266,1833
2,1252,2295,1076,2504,3580
2,1912,3400,2568,3824,6392
1,2171,3578,1264,2171,3435
1,1083,1701,499,1083,1582
1,487,783,194,487,681
1,713,1120,385,713,1098
1,713,1120,250,713,963
1,713,1120,261,713,974
1,2171,3578,835,2171,3006
1,420,769,249,420,669
3,2171,3578,4006,6513,10519
1,713,1120,161,713,874
2,487,783,388,974,1362
1,487,783,288,487,775
1,1252,2295,882,1252,2134
1,1898,3375,1410,1898,3308
1,2171,3578,1264,2171,3435
3,2171,3578,1967,6513,8480
2,1083,1701,760,2166,2926
2,713,1120,657,1426,2083
1,1083,1701,261,1083,1344
3,308,565,364,924,1288
1,1252,2295,630,1252,1882
2,1252,2295,1489,2504,3993
1,308,565,184,308,492
3,344,540,523,1032,1555
1,713,1120,261,713,974
1,420,769,341,420,761
1,2171,3578,1335,2171,3506
1,2171,3578,1264,2171,3435
3,713,1120,616,2139,2755
1,2171,3578,1371,2171,3542
1,1912,3400,774,1912,2686
3,1252,2295,2027,3756,5783
3,1252,2295,2991,3756,6747
2,2171,3578,2528,4342,6870
2,420,769,498,840,1338
1,420,769,180,420,600
1,1252,2295,538,1252,1790
1,1519,2443,606,1519,2125
1,1555,2443,570,1555,2125
1,1083,1701,397,1083,1480
3,1519,2443,2699,4557,7256
1,2171,3578,1335,2171,3506
1,1252,2295,745,1252,1997
2,1252,2295,1902,2504,4406
3,1519,2443,2699,4557,7256
2,713,1120,792,1426,2218
1,1912,3400,774,1912,2686
1,420,769,295,420,715
1,420,769,188,420,608
2,1252,2295,1994,2504,4498
2,487,783,263,974,1237
2,2171,3578,2742,4342,7084
1,713,1120,329,713,1042
1,1083,1701,550,1083,1633
1,344,540,110,344,454
1,344,540,174,344,518
1,713,1120,261,713,974
2,1083,1701,522,2166,2688
2,1083,1701,624,2166,2790
3,1252,2295,3060,3756,6816
1,1266,2320,752,1266,2018
1,1266,2320,1008,1266,2274
1,2171,3578,1264,2171,3435
1,1083,1701,584,1083,1667
1,1083,1701,346,1083,1429
1,1083,1701,397,1083,1480
3,1555,2443,1711,4665,6376
1,487,783,132,487,619
1,2171,3578,620,2171,2791
3,1266,2320,1700,3798,5498
1,420,769,249,420,669
1,420,769,249,420,669
2,1266,2320,1366,2532,3898
1,344,540,66,344,410
1,1555,2443,790,1555,2345
1,2171,3578,942,2171,3113
3,1555,2443,2151,4665,6816
1,2171,3578,1371,2171,3542
3,487,783,583,1461,2044
2,1266,2320,1273,2532,3805
3,1252,2295,1614,3756,5370
1,1252,2295,538,1252,1790
2,1519,2443,969,3038,4007
2,1555,2443,897,3110,4007
1,487,783,265,487,752
1,344,540,185,344,529
1,1083,1701,346,1083,1429
1,487,783,132,487,619
1,344,540,83,344,427
2,1266,2320,1505,2532,4037
2,2171,3578,2313,4342,6655
2,487,783,247,974,1221
1,487,783,186,487,673
2,1555,2443,1483,3110,4593
3,487,783,465,1461,1926
2,713,1120,411,1426,1837
3,1083,1701,1191,3249,4440
3,1083,1701,1803,3249,5052
1,1555,2443,570,1555,2125
1,344,540,99,344,443
1,1266,2320,1008,1266,2274
1,420,769,188,420,608
1,420,769,180,420,600
1,1252,2295,561,1252,1813
1,1266,2320,683,1266,1949
1,1252,2295,630,1252,1882
1,420,769,318,420,738
3,420,769,747,1260,2007
1,1252,2295,1020,1252,2272
3,2171,3578,4006,6513,10519
2,344,540,252,688,940
1,344,540,174,344,518
1,344,540,126,344,470
3,1252,2295,2027,3756,5783
1,2171,3578,620,2171,2791
3,713,1120,784,2139,2923
1,1083,1701,550,1083,1633
1,1083,1701,397,1083,1480
1,1252,2295,630,1252,1882
1,1266,2320,567,1266,1833
1,420,769,318,420,738
1,1252,2295,1020,1252,2272
1,2171,3578,906,2171,3077
1,2171,3578,942,2171,3113
2,2171,3578,2313,4342,6655
3,487,783,583,1461,2044
1,1555,2443,790,1555,2345
1,1555,2443,448,1555,2003
3,1083,1701,1038,3249,4287
3,344,540,232,1032,1264
2,1252,2295,1902,2504,4406
3,420,769,539,1260,1799
2,420,769,498,840,1338
1,420,769,211,420,631
1,1266,2320,1008,1266,2274
2,1252,2295,1765,2504,4269
1,2171,3578,620,2171,2791
1,344,540,158,344,502
1,1555,2443,570,1555,2125
1,2171,3578,1335,2171,3506
3,1252,2295,1683,3756,5439
1,1555,2443,790,1555,2345
2,713,1120,724,1426,2150
1,2171,3578,906,2171,3077
3,487,783,395,1461,1856
3,1266,2320,2048,3798,5846
1,1252,2295,561,1252,1813
1,420,769,203,420,623
2,1266,2320,2015,2532,4547
3,713,1120,751,2139,2890
1,2171,3578,835,2171,3006
3,2171,3578,1967,6513,8480
1,2171,3578,942,2171,3113
3,713,1120,784,2139,2923
1,344,540,126,344,470
2,344,540,252,688,940
2,1252,2295,1443,2504,3947
2,1252,2295,1260,2504,3764
1,420,769,211,420,631
1,1266,2320,752,1266,2018
1,308,565,184,308,492
1,1266,2320,961,1266,2227
1,487,783,280,487,767
1,487,783,280,487,767
3,2171,3578,2504,6513,9017
2,1555,2443,1141,3110,4251
1,713,1120,261,713,974
1,713,1120,362,713,1075
1,344,540,83,344,427
3,1252,2295,2027,3756,5783
1,1252,2295,882,1252,2134
1,1266,2320,567,1266,1833
1,420,769,318,420,738
3,1252,2295,2234,3756,5990
1,2171,3578,620,2171,2791
1,2171,3578,620,2171,2791
1,1555,2443,448,1555,2003
2,1083,1701,1168,2166,3334
1,344,540,126,344,470
1,1266,2320,636,1266,1902
1,1898,3375,768,1898,2666
1,1266,2320,752,1266,2018
1,1252,2295,745,1252,1997
1,1252,2295,676,1252,1928
2,1252,2295,2040,2504,4544
1,1252,2295,1020,1252,2272
2,1252,2295,1902,2504,4406
1,1266,2320,636,1266,1902
1,1266,2320,892,1266,2158
1,1252,2295,722,1252,1974
2,1266,2320,1087,2532,3619
3,1266,2320,1631,3798,5429
3,713,1120,482,2139,2621
3,2171,3578,3792,6513,10305
3,344,540,475,1032,1507
1,344,540,191,344,535
1,344,540,99,344,443
1,713,1120,261,713,974
3,1266,2320,2048,3798,5846
1,1266,2320,636,1266,1902
1,1266,2320,544,1266,1810
3,1519,2443,2699,4557,7256
3,1083,1701,1497,3249,4746
1,2171,3578,763,2171,2934
3,713,1120,616,2139,2755
1,1266,2320,752,1266,2018
1,1266,2320,752,1266,2018
1,1266,2320,961,1266,2227
2,420,769,498,840,1338
1,1266,2320,544,1266,1810
1,1252,2295,722,1252,1974
1,1555,2443,839,1555,2394
2,1083,1701,624,2166,2790
1,713,1120,261,713,974
1,713,1120,362,713,1075
1,1083,1701,550,1083,1633
1,344,540,158,344,502
3,344,540,556,1032,1588
3,1083,1701,1497,3249,4746
1,1083,1701,601,1083,1684
2,487,783,576,974,1550
3,344,540,377,1032,1409
2,344,540,252,688,940
1,1266,2320,636,1266,1902
2,1266,2320,1366,2532,3898
1,1252,2295,997,1252,2249
1,1266,2320,544,1266,1810
1,2171,3578,942,2171,3113
1,713,1120,161,713,874
1,713,1120,261,713,974
1,308,565,138,308,446
1,1252,2295,997,1252,2249
1,1519,2443,387,1519,1906
2,1555,2443,1678,3110,4788
1,2171,3578,656,2171,2827
1,713,1120,362,713,1075
2,344,540,370,688,1058
1,344,540,126,344,470
1,487,783,194,487,681
1,2171,3578,1335,2171,3506
1,1898,3375,937,1898,2835
1,1266,2320,1008,1266,2274
1,1252,2295,745,1252,1997
1,420,769,318,420,738
1,2171,3578,763,2171,2934
1,2171,3578,763,2171,2934
1,344,540,99,344,443
1,1266,2320,567,1266,1833
3,420,769,747,1260,2007
2,2171,3578,1884,4342,6226
1,487,783,124,487,611
1,1555,2443,448,1555,2003
3,1519,2443,1599,4557,6156
1,1083,1701,584,1083,1667
1,2171,3578,1335,2171,3506
1,344,540,126,344,470
1,1555,2443,497,1555,2052
1,1083,1701,550,1083,1633
1,487,783,171,487,658
1,487,783,171,487,658
1,487,783,132,487,619
1,713,1120,228,713,941
1,2171,3578,620,2171,2791
3,1252,2295,2647,3756,6403
1,420,769,180,420,600
1,1266,2320,752,1266,2018
3,1252,2295,2234,3756,5990
3,1266,2320,2884,3798,6682
1,713,1120,362,713,1075
1,344,540,185,344,529
1,713,1120,205,713,918
1,344,540,99,344,443
1,344,540,126,344,470
2,344,540,252,688,940
1,1266,2320,752,1266,2018
1,1266,2320,1008,1266,2274
1,2171,3578,1157,2171,3328
3,713,1120,851,2139,2990
3,713,1120,1154,2139,3293
2,2171,3578,1311,4342,5653
2,344,540,198,688,886
1,1912,3400,774,1912,2686
1,420,769,257,420,677
1,1252,2295,676,1252,1928
1,1252,2295,1020,1252,2272
1,1555,2443,448,1555,2003
1,487,783,241,487,728
1,713,1120,273,713,986
2,713,1120,769,1426,2195
1,713,1120,205,713,918
2,713,1120,500,1426,1926
2,487,783,388,974,1362
1,1083,1701,550,1083,1633
1,344,540,77,344,421
1,2171,3578,1335,2171,3506
1,713,1120,161,713,874
3,1555,2443,1711,4665,6376
1,487,783,194,487,681
1,2171,3578,906,2171,3077
1,344,540,126,344,470
2,2171,3578,1240,4342,5582
1,1266,2320,544,1266,1810
1,1555,2443,448,1555,2003
1,713,1120,362,713,1075
2,2171,3578,1311,4342,5653
2,344,540,273,688,961
3,344,540,377,1032,1409
3,1898,3375,3115,5694,8809
1,1266,2320,567,1266,1833
1,1252,2295,630,1252,1882
3,1266,2320,2257,3798,6055
3,1266,2320,3023,3798,6821
2,1266,2320,1087,2532,3619
2,1266,2320,1087,2532,3619
1,2171,3578,620,2171,2791
2,1083,1701,998,2166,3164
1,487,783,194,487,681
2,344,540,381,688,1069
1,487,783,171,487,658
2,2171,3578,1240,4342,5582
1,344,540,174,344,518
2,2171,3578,2671,4342,7013
1,1252,2295,630,1252,1882
2,420,769,375,840,1215
2,1266,2320,1226,2532,3758
1,1266,2320,752,1266,2018
1,1252,2295,997,1252,2249
3,1555,2443,1345,4665,6010
3,1083,1701,1191,3249,4440
2,1083,1701,1168,2166,3334
1,2171,3578,656,2171,2827
1,713,1120,250,713,963
1,713,1120,362,713,1075
1,1083,1701,550,1083,1633
3,344,540,377,1032,1409
3,487,783,583,1461,2044
1,2171,3578,1335,2171,3506
1,1266,2320,683,1266,1949
1,1266,2320,1008,1266,2274
1,2171,3578,763,2171,2934
2,713,1120,321,1426,1747
1,713,1120,250,713,963
2,1083,1701,1202,2166,3368
1,344,540,174,344,518
1,344,540,191,344,535
3,344,540,377,1032,1409
1,1266,2320,567,1266,1833
1,1252,2295,745,1252,1997
2,1266,2320,1134,2532,3666
2,1266,2320,1366,2532,3898
1,2171,3578,656,2171,2827
1,713,1120,205,713,918
3,344,540,556,1032,1588
1,344,540,185,344,529
1,344,540,126,344,470
3,1083,1701,1650,3249,4899
2,713,1120,411,1426,1837
3,1266,2320,2048,3798,5846
2,1252,2295,1489,2504,3993
1,1252,2295,538,1252,1790
3,2171,3578,4006,6513,10519
1,1083,1701,499,1083,1582
2,713,1120,724,1426,2150
1,1083,1701,550,1083,1633
1,344,540,126,344,470
1,1555,2443,448,1555,2003
1,1555,2443,717,1555,2272
1,2171,3578,942,2171,3113
1,713,1120,205,713,918
1,344,540,83,344,427
1,344,540,93,344,437
2,2171,3578,1669,4342,6011
1,1252,2295,630,1252,1882
1,1266,2320,752,1266,2018
1,1266,2320,1031,1266,2297
2,295,540,468,590,1058
1,2171,3578,763,2171,2934
1,1083,1701,397,1083,1480
1,1083,1701,312,1083,1395
1,713,1120,396,713,1109
3,2171,3578,2718,6513,9231
3,713,1120,1087,2139,3226
1,344,540,83,344,427
1,1252,2295,630,1252,1882
1,1266,2320,1008,1266,2274
3,308,565,415,924,1339
1,1266,2320,1031,1266,2297
1,420,769,180,420,600
2,1266,2320,1134,2532,3666
1,420,769,249,420,669
1,1252,2295,997,1252,2249
1,1519,2443,875,1519,2394
1,487,783,124,487,611
1,713,1120,362,713,1075
1,1083,1701,550,1083,1633
1,713,1120,172,713,885
1,1252,2295,676,1252,1928
1,1252,2295,630,1252,1882
1,420,769,341,420,761
1,295,540,234,295,529
1,1252,2295,997,1252,2249
2,1252,2295,1994,2504,4498
1,2171,3578,620,2171,2791
1,2171,3578,1157,2171,3328
3,487,783,465,1461,1926
1,1519,2443,900,1519,2419
1,1083,1701,550,1083,1633
1,420,769,249,420,669
2,1266,2320,1134,2532,3666
1,1266,2320,752,1266,2018
1,420,769,334,420,754
2,2171,3578,1884,4342,6226
1,1555,2443,790,1555,2345
2,344,540,154,688,842
2,713,1120,724,1426,2150
1,344,540,185,344,529
1,344,540,185,344,529
1,344,540,77,344,421
2,344,540,219,688,907
1,1083,1701,295,1083,1378
1,1083,1701,397,1083,1480
1,2171,3578,942,2171,3113
1,1252,2295,722,1252,1974
2,1266,2320,1134,2532,3666
1,295,540,175,295,470
1,1266,2320,1008,1266,2274
1,1083,1701,601,1083,1684
2,2171,3578,2742,4342,7084
2,344,540,349,688,1037
3,1083,1701,1803,3249,5052
1,2171,3578,1335,2171,3506
1,1898,3375,1038,1898,2936
1,1252,2295,951,1252,2203
1,1252,2295,745,1252,1997
1,1266,2320,1008,1266,2274
2,1252,2295,1122,2504,3626
2,1252,2295,1076,2504,3580
1,2171,3578,763,2171,2934
1,2171,3578,763,2171,2934
1,2171,3578,656,2171,2827
1,1083,1701,397,1083,1480
1,1083,1701,397,1083,1480
1,713,1120,205,713,918
1,487,783,155,487,642
1,1083,1701,295,1083,1378
1,1252,2295,882,1252,2134
1,1252,2295,745,1252,1997
1,1266,2320,683,1266,1949
1,1266,2320,752,1266,2018
2,1252,2295,1902,2504,4406
3,1912,3400,3036,5736,8772
1,1252,2295,997,1252,2249
1,1266,2320,1008,1266,2274
2,2171,3578,1240,4342,5582
3,487,783,371,1461,1832
1,487,783,124,487,611
1,1083,1701,601,1083,1684
1,2171,3578,942,2171,3113
1,713,1120,161,713,874
1,2171,3578,1371,2171,3542
1,1266,2320,752,1266,2018
2,1266,2320,2062,2532,4594
2,420,769,421,840,1261
1,2171,3578,1264,2171,3435
1,713,1120,329,713,1042
1,1555,2443,375,1555,1930
1,344,540,185,344,529
3,1555,2443,1711,4665,6376
1,344,540,174,344,518
1,1252,2295,630,1252,1882
1,1266,2320,636,1266,1902
1,420,769,334,420,754
3,1252,2295,2234,3756,5990
3,1266,2320,2048,3798,5846
2,1252,2295,1994,2504,4498
1,1519,2443,826,1519,2345
1,2171,3578,656,2171,2827
1,2171,3578,942,2171,3113
2,1519,2443,969,3038,4007
1,487,783,265,487,752
1,344,540,158,344,502
1,487,783,265,487,752
1,713,1120,385,713,1098
2,2171,3578,1240,4342,5582
1,1252,2295,1020,1252,2272
1,1266,2320,776,1266,2042
3,2171,3578,2718,6513,9231
1,713,1120,385,713,1098
1,2171,3578,942,2171,3113
2,1083,1701,488,2166,2654
1,713,1120,205,713,918
1,1555,2443,375,1555,1930
3,1898,3375,2811,5694,8505
1,1266,2320,961,1266,2227
1,487,783,280,487,767
2,1519,2443,1506,3038,4544
1,2171,3578,942,2171,3113
1,713,1120,205,713,918
1,1912,3400,774,1912,2686
1,1266,2320,752,1266,2018
1,1266,2320,683,1266,1949
1,1266,2320,799,1266,2065
1,1252,2295,1020,1252,2272
3,1266,2320,1909,3798,5707
1,2171,3578,620,2171,2791
3,2171,3578,2826,6513,9339
1,713,1120,329,713,1042
1,2171,3578,1371,2171,3542
1,1083,1701,550,1083,1633
1,344,540,174,344,518
1,295,540,175,295,470
3,1266,2320,2257,3798,6055
2,1252,2295,1489,2504,3993
1,1266,2320,729,1266,1995
1,1266,2320,1008,1266,2274
1,1555,2443,570,1555,2125
3,2171,3578,2289,6513,8802
1,713,1120,205,713,918
1,2171,3578,656,2171,2827
2,1555,2443,1434,3110,4544
1,1083,1701,550,1083,1633
3,713,1120,616,2139,2755
1,1083,1701,397,1083,1480
1,1252,2295,630,1252,1882
1,1252,2295,745,1252,1997
3,713,1120,1087,2139,3226
2,1083,1701,794,2166,2960
2,713,1120,724,1426,2150
3,713,1120,1087,2139,3226
1,1083,1701,346,1083,1429
1,344,540,110,344,454
2,344,540,219,688,907
3,1912,3400,2322,5736,8058
3,1266,2320,3023,3798,6821
1,295,540,175,295,470
1,1252,2295,951,1252,2203
1,1252,2295,538,1252,1790
1,487,783,124,487,611
2,1555,2443,603,3110,3713
3,1083,1701,731,3249,3980
1,487,783,265,487,752
1,713,1120,261,713,974
3,1083,1701,1191,3249,4440
1,344,540,126,344,470
1,1252,2295,745,1252,1997
2,1266,2320,1505,2532,4037
2,1252,2295,1489,2504,3993
1,1252,2295,997,1252,2249
3,1519,2443,2479,4557,7036
2,713,1120,500,1426,1926
1,713,1120,172,713,885
1,713,1120,205,713,918
1,344,540,83,344,427
2,420,769,498,840,1338
1,1252,2295,676,1252,1928
1,295,540,234,295,529
1,2171,3578,906,2171,3077
1,713,1120,385,713,1098
1,1555,2443,302,1555,1857
1,487,783,155,487,642
1,2171,3578,620,2171,2791
1,1266,2320,961,1266,2227
2,1252,2295,1260,2504,3764
3,1555,2443,1345,4665,6010
3,1555,2443,2371,4665,7036
3,344,540,475,1032,1507
1,1555,2443,497,1555,2052
1,344,540,83,344,427
3,344,540,248,1032,1280
1,2171,3578,763,2171,2934
3,2171,3578,2504,6513,9017
2,1266,2320,1783,2532,4315
2,1266,2320,1134,2532,3666
1,1252,2295,607,1252,1859
1,1252,2295,997,1252,2249
1,1252,2295,997,1252,2249
1,2171,3578,1264,2171,3435
1,1083,1701,584,1083,1667
1,1266,2320,544,1266,1810
1,1252,2295,951,1252,2203
3,1252,2295,1614,3756,5370
3,2171,3578,1860,6513,8373
2,2171,3578,1240,4342,5582
2,1519,2443,1653,3038,4691
1,713,1120,205,713,918
1,1519,2443,900,1519,2419
2,1555,2443,1141,3110,4251
1,713,1120,172,713,885
1,1266,2320,497,1266,1763
1,1266,2320,892,1266,2158
2,420,769,360,840,1200
3,713,1120,1087,2139,3226
1,713,1120,261,713,974
1,487,783,265,487,752
2,2171,3578,1884,4342,6226
3,1083,1701,1191,3249,4440
1,344,540,185,344,529
3,1083,1701,1038,3249,4287
1,1912,3400,774,1912,2686
1,1266,2320,567,1266,1833
2,1252,2295,1765,2504,4269
2,1266,2320,1134,2532,3666
1,1252,2295,1020,1252,2272
2,1266,2320,1087,2532,3619
1,2171,3578,1264,2171,3435
3,487,783,841,1461,2302
3,1083,1701,1191,3249,4440
2,1083,1701,794,2166,2960
1,713,1120,228,713,941
1,713,1120,261,713,974
1,1252,2295,882,1252,2134
3,1252,2295,2854,3756,6610
1,1252,2295,745,1252,1997
2,1266,2320,1366,2532,3898
3,1266,2320,3162,3798,6960
1,2171,3578,763,2171,2934
1,344,540,158,344,502
1,344,540,158,344,502
3,487,783,794,1461,2255
1,713,1120,362,713,1075
1,1083,1701,346,1083,1429
1,2171,3578,1335,2171,3506
1,1266,2320,1031,1266,2297
1,1266,2320,1008,1266,2274
1,420,769,226,420,646
1,1252,2295,997,1252,2249
3,1266,2320,2605,3798,6403
1,1555,2443,351,1555,1906
3,2171,3578,3470,6513,9983
3,1555,2443,2371,4665,7036
3,1083,1701,1752,3249,5001
1,2171,3578,656,2171,2827
3,713,1120,784,2139,2923
1,713,1120,385,713,1098
2,1083,1701,522,2166,2688
1,1083,1701,550,1083,1633
1,713,1120,172,713,885
1,2171,3578,1335,2171,3506
1,420,769,249,420,669
1,1252,2295,745,1252,1997
3,2171,3578,3792,6513,10305
3,1083,1701,1803,3249,5052
1,1519,2443,484,1519,2003
2,1083,1701,1168,2166,3334
1,1083,1701,312,1083,1395
1,420,769,334,420,754
1,420,769,249,420,669
1,420,769,180,420,600
3,420,769,1001,1260,2261
1,1266,2320,683,1266,1949
3,308,565,568,924,1492
1,1252,2295,997,1252,2249
2,1266,2320,2015,2532,4547
2,1083,1701,998,2166,3164
2,487,783,576,974,1550
1,1266,2320,752,1266,2018
3,1252,2295,2234,3756,5990
1,1266,2320,544,1266,1810
2,1252,2295,1489,2504,3993
2,1252,2295,2040,2504,4544
1,1252,2295,538,1252,1790
1,2171,3578,942,2171,3113
1,713,1120,329,713,1042
1,1083,1701,499,1083,1582
1,1555,2443,570,1555,2125
1,1912,3400,1046,1912,2958
2,1252,2295,1489,2504,3993
1,1252,2295,561,1252,1813
3,1252,2295,2991,3756,6747
1,1266,2320,544,1266,1810
1,487,783,280,487,767
2,1083,1701,794,2166,2960
3,487,783,841,1461,2302
1,344,540,158,344,502
1,1083,1701,397,1083,1480
1,713,1120,261,713,974
1,1555,2443,864,1555,2419
1,1266,2320,1008,1266,2274
2,1252,2295,1857,2504,4361
1,1266,2320,729,1266,1995
1,1252,2295,997,1252,2249
1,2171,3578,942,2171,3113
1,713,1120,340,713,1053
2,2171,3578,2742,4342,7084
1,1083,1701,261,1083,1344
1,344,540,191,344,535
3,1266,2320,2048,3798,5846
1,1266,2320,683,1266,1949
2,1266,2320,1273,2532,3805
1,2171,3578,763,2171,2934
1,1555,2443,448,1555,2003
1,713,1120,362,713,1075
3,1083,1701,935,3249,4184
2,2171,3578,1884,4342,6226
1,487,783,265,487,752
1,1555,2443,351,1555,1906
2,1555,2443,1141,3110,4251
2,344,540,349,688,1037
2,2171,3578,2671,4342,7013
1,1083,1701,397,1083,1480
1,713,1120,228,713,941
3,1266,2320,2675,3798,6473
1,1266,2320,729,1266,1995
1,1266,2320,567,1266,1833
1,1252,2295,997,1252,2249
1,1252,2295,997,1252,2249
2,1555,2443,1581,3110,4691
1,1083,1701,584,1083,1667
1,2171,3578,942,2171,3113
1,1083,1701,601,1083,1684
1,713,1120,261,713,974
3,344,540,572,1032,1604
1,344,540,185,344,529
1,1083,1701,499,1083,1582
1,2171,3578,620,2171,2791
1,344,540,99,344,443
1,487,783,132,487,619
2,2171,3578,2671,4342,7013
1,1266,2320,567,1266,1833
1,1252,2295,538,1252,1790
1,2171,3578,1264,2171,3435
3,1519,2443,1160,4557,5717
1,487,783,280,487,767
1,1519,2443,484,1519,2003
1,487,783,241,487,728
3,487,783,606,1461,2067
1,1555,2443,448,1555,2003
1,344,540,126,344,470
1,487,783,265,487,752
1,1083,1701,261,1083,1344
3,713,1120,515,2139,2654
2,1083,1701,794,2166,2960
1,713,1120,172,713,885
1,1266,2320,892,1266,2158
1,1252,2295,630,1252,1882
1,1252,2295,630,1252,1882
1,1252,2295,768,1252,2020
1,1912,3400,1046,1912,2958
1,1252,2295,745,1252,1997
1,1266,2320,567,1266,1833
1,1252,2295,951,1252,2203
1,295,540,234,295,529
2,713,1120,769,1426,2195
1,487,783,265,487,752
1,487,783,132,487,619
1,713,1120,362,713,1075
1,1252,2295,951,1252,2203
2,1252,2295,1994,2504,4498
1,487,783,186,487,673
1,487,783,265,487,752
3,344,540,556,1032,1588
1,344,540,83,344,427
3,344,540,248,1032,1280
1,344,540,126,344,470
1,2171,3578,1335,2171,3506
3,420,769,632,1260,1892
1,1252,2295,676,1252,1928
3,2171,3578,4006,6513,10519
1,1083,1701,312,1083,1395
2,1083,1701,794,2166,2960
1,713,1120,205,713,918
2,344,540,241,688,929
2,1083,1701,1168,2166,3334
3,713,1120,683,2139,2822
1,308,565,155,308,463
1,420,769,249,420,669
1,1252,2295,630,1252,1882
2,2171,3578,1884,4342,6226
3,1555,2443,2151,4665,6816
1,713,1120,385,713,1098
3,2171,3578,1967,6513,8480
1,344,540,110,344,454
3,1266,2320,2257,3798,6055
1,295,540,159,295,454
1,420,769,334,420,754
1,420,769,341,420,761
1,295,540,148,295,443
2,1266,2320,1134,2532,3666
2,2171,3578,1884,4342,6226
1,1555,2443,448,1555,2003
1,1083,1701,601,1083,1684
3,1083,1701,1497,3249,4746
1,713,1120,172,713,885
1,1252,2295,951,1252,2203
1,1266,2320,544,1266,1810
1,420,769,249,420,669
1,1555,2443,839,1555,2394
3,1555,2443,1345,4665,6010
1,1555,2443,790,1555,2345
1,2171,3578,942,2171,3113
3,1555,2443,2591,4665,7256
3,713,1120,1154,2139,3293
1,487,783,265,487,752
3,1083,1701,884,3249,4133
1,1266,2320,799,1266,2065
2,1912,3400,1548,3824,5372
1,1266,2320,636,1266,1902
3,420,769,747,1260,2007
3,1266,2320,3023,3798,6821
1,295,540,175,295,470
2,1252,2295,1994,2504,4498
1,1252,2295,997,1252,2249
1,344,540,174,344,518
1,1555,2443,570,1555,2125
1,344,540,174,344,518
1,1555,2443,546,1555,2101
2,1555,2443,1581,3110,4691
1,1555,2443,839,1555,2394
1,1555,2443,570,1555,2125
1,2171,3578,1335,2171,3506
1,2171,3578,620,2171,2791
1,1252,2295,538,1252,1790
3,1266,2320,1909,3798,5707
1,295,540,132,295,427
2,1898,3375,2009,3796,5805
1,1252,2295,538,1252,1790
1,2171,3578,942,2171,3113
1,1519,2443,606,1519,2125
1,1252,2295,997,1252,2249
1,420,769,211,420,631
1,1266,2320,567,1266,1833
1,295,540,234,295,529
3,1252,2295,2027,3756,5783
2,1266,2320,1922,2532,4454
1,1266,2320,729,1266,1995
1,1266,2320,1008,1266,2274
1,1519,2443,387,1519,1906
2,2171,3578,1526,4342,5868
1,1555,2443,570,1555,2125
3,1083,1701,1752,3249,5001
1,1083,1701,584,1083,1667
1,713,1120,261,713,974
1,1266,2320,683,1266,1949
1,1266,2320,636,1266,1902
1,1266,2320,636,1266,1902
3,1252,2295,2234,3756,5990
3,1252,2295,2234,3756,5990
1,1083,1701,210,1083,1293
1,2171,3578,656,2171,2827
1,1083,1701,499,1083,1582
1,713,1120,261,713,974
1,344,540,83,344,427
1,1252,2295,745,1252,1997
2,1912,3400,2092,3824,5916
1,420,769,249,420,669
1,1252,2295,676,1252,1928
1,1252,2295,997,1252,2249
1,295,540,234,295,529
1,1083,1701,550,1083,1633
1,1555,2443,790,1555,2345
1,1555,2443,302,1555,1857
1,713,1120,385,713,1098
1,713,1120,161,713,874
1,1252,2295,630,1252,1882
3,1266,2320,3023,3798,6821
1,295,540,132,295,427
1,1252,2295,997,1252,2249
2,2171,3578,1669,4342,6011
2,713,1120,769,1426,2195
1,1083,1701,397,1083,1480
1,1555,2443,570,1555,2125
1,713,1120,172,713,885
3,2171,3578,4006,6513,10519
1,1252,2295,745,1252,1997
1,1252,2295,951,1252,2203
1,1252,2295,951,1252,2203
1,1252,2295,722,1252,1974
1,2171,3578,942,2171,3113
1,1083,1701,210,1083,1293
1,2171,3578,835,2171,3006
3,1083,1701,1803,3249,5052
2,1083,1701,794,2166,2960
1,487,783,132,487,619
3,344,540,248,1032,1280
1,1266,2320,799,1266,2065
1,1266,2320,752,1266,2018
1,1266,2320,567,1266,1833
1,295,540,126,295,421
1,1252,2295,607,1252,1859
1,713,1120,362,713,1075
1,487,783,280,487,767
1,1555,2443,448,1555,2003
1,1555,2443,717,1555,2272
1,1083,1701,312,1083,1395
3,1083,1701,1191,3249,4440
1,1555,2443,448,1555,2003
3,713,1120,784,2139,2923
1,713,1120,261,713,974
1,1252,2295,882,1252,2134
1,1519,2443,753,1519,2272
1,713,1120,340,713,1053
2,1083,1701,488,2166,2654
1,713,1120,329,713,1042
1,713,1120,205,713,918
1,713,1120,228,713,941
1,1912,3400,1352,1912,3264
3,1266,2320,2675,3798,6473
1,1266,2320,1008,1266,2274
1,1266,2320,683,1266,1949
3,420,769,747,1260,2007
1,1519,2443,826,1519,2345
3,1555,2443,2151,4665,6816
1,1555,2443,448,1555,2003
1,1083,1701,397,1083,1480
1,713,1120,205,713,918
2,1252,2295,1489,2504,3993
3,1252,2295,2854,3756,6610
2,1252,2295,1994,2504,4498
3,308,565,449,924,1373
1,1555,2443,351,1555,1906
1,487,783,265,487,752
3,713,1120,1154,2139,3293
1,487,783,265,487,752
1,1252,2295,951,1252,2203
1,420,769,334,420,754
1,1252,2295,997,1252,2249
1,420,769,295,420,715
1,2171,3578,978,2171,3149
2,487,783,561,974,1535
1,344,540,185,344,529
3,1555,2443,1345,4665,6010
1,1083,1701,397,1083,1480
1,1083,1701,550,1083,1633
2,1555,2443,1434,3110,4544
1,1083,1701,397,1083,1480
3,2171,3578,1860,6513,8373
1,2171,3578,1335,2171,3506
1,1252,2295,561,1252,1813
1,1252,2295,745,1252,1997
1,420,769,249,420,669
1,1252,2295,997,1252,2249
2,1252,2295,1994,2504,4498
1,487,783,265,487,752
1,1555,2443,570,1555,2125
1,713,1120,261,713,974
2,1083,1701,1168,2166,3334
1,2171,3578,1371,2171,3542
1,1252,2295,561,1252,1813
1,1252,2295,997,1252,2249
3,1266,2320,3023,3798,6821
1,344,540,174,344,518
1,713,1120,362,713,1075
1,1519,2443,875,1519,2394
1,2171,3578,1264,2171,3435
1,713,1120,138,713,851
1,1083,1701,244,1083,1327
3,2171,3578,1967,6513,8480
1,2171,3578,942,2171,3113
1,2171,3578,656,2171,2827
1,713,1120,385,713,1098
2,713,1120,411,1426,1837
1,344,540,99,344,443
2,344,540,219,688,907
1,1252,2295,538,1252,1790
1,1266,2320,1008,1266,2274
1,2171,3578,942,2171,3113
1,487,783,280,487,767
1,1083,1701,601,1083,1684
3,487,783,583,1461,2044
1,1898,3375,1038,1898,2936
3,420,769,1001,1260,2261
1,295,540,175,295,470
2,1519,2443,773,3038,3811
1,344,540,185,344,529
1,487,783,241,487,728
1,713,1120,194,713,907
1,2171,3578,620,2171,2791
1,2171,3578,942,2171,3113
1,1252,2295,630,1252,1882
3,1252,2295,1477,3756,5233
1,1266,2320,752,1266,2018
1,1266,2320,567,1266,1833
2,420,769,667,840,1507
1,1252,2295,561,1252,1813
2,1266,2320,1273,2532,3805
1,2171,3578,620,2171,2791
2,1555,2443,1581,3110,4691
1,1519,2443,606,1519,2125
1,713,1120,205,713,918
1,1266,2320,567,1266,1833
1,420,769,318,420,738
2,1252,2295,1260,2504,3764
1,1519,2443,411,1519,1930
1,2171,3578,656,2171,2827
1,1083,1701,397,1083,1480
2,1083,1701,692,2166,2858
1,713,1120,261,713,974
2,344,540,198,688,886
1,1252,2295,538,1252,1790
3,1252,2295,2854,3756,6610
3,420,769,678,1260,1938
1,2171,3578,1264,2171,3435
3,2171,3578,2826,6513,9339
3,344,540,556,1032,1588
1,344,540,126,344,470
1,713,1120,261,713,974
1,1252,2295,882,1252,2134
1,1266,2320,544,1266,1810
3,1252,2295,2234,3756,5990
2,1252,2295,1122,2504,3626
3,1252,2295,1890,3756,5646
1,308,565,155,308,463
3,1083,1701,1650,3249,4899
1,2171,3578,763,2171,2934
1,1555,2443,375,1555,1930
1,487,783,155,487,642
1,487,783,265,487,752
1,344,540,77,344,421
1,344,540,99,344,443
1,1266,2320,752,1266,2018
1,1266,2320,636,1266,1902
1,295,540,148,295,443
2,308,565,356,616,972
1,1266,2320,636,1266,1902
1,487,783,280,487,767
1,487,783,280,487,767
3,1083,1701,935,3249,4184
3,2171,3578,1967,6513,8480
1,487,783,155,487,642
1,2171,3578,1335,2171,3506
2,713,1120,523,1426,1949
1,344,540,126,344,470
3,1266,2320,3023,3798,6821
1,1912,3400,1046,1912,2958
1,1266,2320,729,1266,1995
1,420,769,226,420,646
1,1252,2295,997,1252,2249
1,713,1120,205,713,918
1,2171,3578,1335,2171,3506
1,1912,3400,1352,1912,3264
2,1266,2320,2015,2532,4547
1,1266,2320,567,1266,1833
3,1266,2320,3092,3798,6890
1,1266,2320,567,1266,1833
2,420,769,498,840,1338
1,295,540,240,295,535
1,713,1120,362,713,1075
1,1083,1701,397,1083,1480
1,2171,3578,620,2171,2791
8,59,159,635,472,1107
6,3,9,32,18,50
28,3,9,150,84,234
17,2,5,40,34,74
10,2,5,24,20,44
3,2,5,7,6,13
1,13,35,16,13,29
26,13,35,454,338,792
22,13,35,315,286,601
11,13,35,192,143,335
16,38,50,184,608,792
6,38,50,33,228,261
1,42,54,4,42,46
1,1266,2320,892,1266,2158
1,295,540,126,295,421
1,2171,3578,763,2171,2934
2,1555,2443,1727,3110,4837
3,1555,2443,1711,4665,6376
2,713,1120,500,1426,1926
2,1083,1701,794,2166,2960
1,1555,2443,570,1555,2125
3,2171,3578,4114,6513,10627
1,2171,3578,1335,2171,3506
21,1,2,12,21,33
29,1,2,16,29,45
20,1,2,13,20,33
24,1,2,15,24,39
7,9,25,109,63,172
26,8,21,267,208,475
14,8,21,144,112,256
1,1,4,2,1,3
19,1,4,47,19,66
1,755,1215,436,755,1191
1,1482,2384,592,1482,2074
3,1482,2384,1776,4446,6222
21,4,10,111,84,195
10,4,10,53,40,93
22,2,5,64,44,108
4,2,5,12,8,20
26,2,5,55,52,107
28,2,5,59,56,115
30,2,5,71,60,131
12,2,5,28,24,52
11,3,9,45,33,78
10,3,9,41,30,71
4,7,9,0,28,28
30,7,9,55,210,265
26,8,22,353,208,561
15,8,22,207,120,327
4,9,24,43,36,79
9,13,35,185,117,302
31,13,35,487,403,890
12,13,35,188,156,344
5,13,35,107,65,172
9,13,35,176,117,293
10,13,35,206,130,336
21,13,35,433,273,706
13,42,54,30,546,576
30,42,54,247,1260,1507
1,1898,3375,768,1898,2666
3,1252,2295,2647,3756,6403
2,1266,2320,1134,2532,3666
3,1266,2320,2884,3798,6682
1,308,565,251,308,559
1,420,769,249,420,669
1,308,565,246,308,554
1,2171,3578,763,2171,2934
2,2171,3578,1526,4342,5868
3,2171,3578,4006,6513,10519
3,713,1120,1087,2139,3226
3,344,540,523,1032,1555
21,9,25,315,189,504
24,9,25,360,216,576
14,2,5,27,28,55
22,2,5,43,44,87
1,755,1215,375,755,1130
2,1482,2384,1613,2964,4577
4,3,9,19,12,31
7,3,9,34,21,55
7,2,5,19,14,33
24,2,5,64,48,112
2,4,10,12,8,20
25,2,5,53,50,103
15,2,5,32,30,62
7,2,5,16,14,30
1,2,5,2,2,4
10,2,5,24,20,44
1,2,5,2,2,4
25,2,5,70,50,120
2,2,5,6,4,10
26,2,5,73,52,125
8,2,5,22,16,38
9,7,9,12,63,75
7,7,9,11,49,60
31,7,9,26,217,243
15,8,22,203,120,323
32,8,22,356,256,612
5,9,24,73,45,118
27,9,24,392,243,635
17,13,35,297,221,518
22,13,35,469,286,755
19,13,35,405,247,652
4,13,35,70,52,122
6,13,35,128,78,206
25,13,35,489,325,814
4,13,35,82,52,134
12,13,35,176,156,332
1,42,54,8,42,50
14,42,54,70,588,658
1,1898,3375,1038,1898,2936
1,1898,3375,768,1898,2666
1,1898,3375,768,1898,2666
1,1898,3375,1038,1898,2936
1,420,769,334,420,754
1,1252,2295,951,1252,2203
1,1252,2295,745,1252,1997
1,1266,2320,1008,1266,2274
1,1252,2295,951,1252,2203
1,1083,1701,499,1083,1582
1,2171,3578,763,2171,2934
1,2171,3578,942,2171,3113
2,713,1120,724,1426,2150
3,344,540,556,1032,1588
3,344,540,475,1032,1507
1,713,1120,261,713,974
1,344,540,83,344,427
1,3,9,6,3,9
27,3,9,145,81,226
18,1,2,17,18,35
9,1,2,9,9,18
7,2,5,14,14,28
7,2,5,14,14,28
1,2,5,2,2,4
12,1,2,9,12,21
25,1,2,19,25,44
1,1,2,1,1,2
32,1,4,91,32,123
2,755,1215,750,1510,2260
1,755,1215,436,755,1191
1,1482,2384,807,1482,2289
1,1482,2384,401,1482,1883
14,3,9,75,42,117
14,3,9,75,42,117
20,3,9,100,60,160
5,3,9,25,15,40
10,2,5,22,20,42
19,2,5,42,38,80
9,3,9,52,27,79
11,3,9,64,33,97
28,7,9,28,196,224
3,7,9,5,21,26
22,7,9,8,154,162
6,8,22,81,48,129
3,13,35,65,39,104
1,13,35,20,13,33
14,13,35,288,182,470
13,13,35,213,169,382
15,13,35,262,195,457
6,13,35,94,78,172
1,13,35,21,13,34
21,21,55,587,441,1028
1,21,55,27,21,48
4,42,54,39,168,207
1,1912,3400,842,1912,2754
3,1912,3400,2322,5736,8058
1,1898,3375,937,1898,2835
1,1252,2295,630,1252,1882
1,1252,2295,745,1252,1997
1,1266,2320,799,1266,2065
1,1252,2295,745,1252,1997
2,1266,2320,2015,2532,4547
1,1252,2295,997,1252,2249
1,713,1120,362,713,1075
1,1519,2443,826,1519,2345
3,2171,3578,2504,6513,9017
1,713,1120,385,713,1098
1,2171,3578,1371,2171,3542
3,1555,2443,2371,4665,7036
1,2171,3578,1335,2171,3506
1,2171,3578,1335,2171,3506
3,344,540,377,1032,1409
1,2171,3578,942,2171,3113
13,1,2,12,13,25
1,1,2,1,1,2
28,2,5,78,56,134
23,12,33,453,276,729
19,12,33,374,228,602
21,13,35,366,273,639
8,13,35,140,104,244
8,8,21,101,64,165
25,8,21,315,200,515
32,1,4,79,32,111
18,1,4,45,18,63
17,1,4,42,17,59
2,461,742,295,922,1217
1,1482,2384,735,1482,2217
3,1482,2384,1776,4446,6222
1,755,1215,411,755,1166
28,24,64,1084,672,1756
23,2,5,48,46,94
13,2,5,27,26,53
16,2,5,34,32,66
9,2,5,19,18,37
11,2,5,31,22,53
2,2,5,6,4,10
5,2,5,14,10,24
7,2,5,20,14,34
17,2,5,45,34,79
26,2,5,69,52,121
1,7,9,0,7,7
28,3,8,136,84,220
22,3,8,108,66,174
27,8,22,253,216,469
1,9,24,11,9,20
30,13,35,471,390,861
5,13,35,82,65,147
17,13,35,368,221,589
23,38,50,230,874,1104
9,42,54,89,378,467
1,1898,3375,768,1898,2666
1,1266,2320,636,1266,1902
1,295,540,223,295,518
1,1266,2320,544,1266,1810
1,344,540,99,344,443
1,2171,3578,656,2171,2827
2,2171,3578,1669,4342,6011
3,1083,1701,1803,3249,5052
1,713,1120,385,713,1098
1,2171,3578,1371,2171,3542
1,1083,1701,550,1083,1633
1,2171,3578,1335,2171,3506
15,2,5,44,30,74
14,2,5,41,28,69
1,1,4,2,1,3
20,1,4,42,20,62
1,1482,2384,473,1482,1955
1,755,1215,411,755,1166
1,461,742,229,461,690
11,2,5,23,22,45
27,2,5,57,54,111
18,2,5,42,36,78
6,2,5,14,12,26
6,7,9,0,42,42
26,8,22,238,208,446
18,8,22,165,144,309
8,8,22,89,64,153
29,9,24,345,261,606
21,13,35,366,273,639
11,13,35,227,143,370
2,42,54,5,84,89
9,38,50,9,342,351
3,1252,2295,1890,3756,5646
1,1912,3400,1046,1912,2958
3,1252,2295,1614,3756,5370
3,1266,2320,1631,3798,5429
2,1252,2295,1902,2504,4406
13,13,35,186,169,355
7,13,35,100,91,191
28,1,2,26,28,54
4,1,2,4,4,8
2,1482,2384,1184,2964,4148
16,24,64,415,384,799
26,2,5,51,52,103
10,2,5,20,20,40
5,7,9,8,35,43
4,3,8,16,12,28
14,8,22,128,112,240
15,8,22,207,120,327
6,9,24,71,54,125
24,13,35,494,312,806
25,13,35,489,325,814
26,13,35,454,338,792
8,13,35,114,104,218
2,13,35,29,26,55
4,13,35,70,52,122
27,21,55,859,567,1426
17,38,50,94,646,740
1,42,54,5,42,47
22,42,54,216,924,1140
8,42,54,66,336,402
1,1898,3375,768,1898,2666
3,1912,3400,4056,5736,9792
1,308,565,251,308,559
1,1266,2320,544,1266,1810
1,295,540,126,295,421
2,1519,2443,969,3038,4007
1,1555,2443,790,1555,2345
3,2171,3578,2504,6513,9017
1,1083,1701,397,1083,1480
1,2171,3578,942,2171,3113
1,2171,3578,942,2171,3113
1,2171,3578,1371,2171,3542
1,1083,1701,550,1083,1633
3,1083,1701,1650,3249,4899
1,487,783,194,487,681
24,2,5,67,48,115
14,2,5,29,28,57
11,2,5,23,22,45
28,1,2,27,28,55
26,1,2,25,26,51
19,2,5,42,38,80
11,2,5,24,22,46
31,2,5,68,62,130
10,2,5,20,20,40
3,1482,2384,1776,4446,6222
1,461,742,229,461,690
22,24,64,866,528,1394
22,3,9,100,66,166
26,3,9,119,78,197
23,2,5,48,46,94
17,4,10,80,68,148
8,2,5,22,16,38
9,2,5,25,18,43
20,7,9,8,140,148
17,8,22,234,136,370
25,13,35,489,325,814
2,13,35,29,26,55
6,13,35,117,78,195
4,13,35,63,52,115
11,21,55,265,231,496
1,1912,3400,876,1912,2788
1,1266,2320,729,1266,1995
1,1912,3400,1454,1912,3366
3,1898,3375,2811,5694,8505
1,1266,2320,636,1266,1902
2,1266,2320,1505,2532,4037
3,1252,2295,1683,3756,5439
1,1266,2320,752,1266,2018
1,295,540,223,295,518
1,2171,3578,1157,2171,3328
3,713,1120,1087,2139,3226
1,344,540,158,344,502
1,1555,2443,448,1555,2003
24,1,2,21,24,45
20,1,2,17,20,37
27,1,4,66,27,93
15,1,2,11,15,26
27,1,2,20,27,47
22,2,5,62,44,106
18,2,5,50,36,86
4,2,5,11,8,19
6,1,2,6,6,12
3,1482,2384,1133,4446,5579
2,1482,2384,1470,2964,4434
21,24,64,746,504,1250
8,2,5,17,16,33
12,2,5,25,24,49
8,2,5,23,16,39
5,2,5,15,10,25
30,2,5,80,60,140
13,2,5,34,26,60
24,2,5,64,48,112
6,2,5,17,12,29
1,2,5,3,2,5
2,2,5,5,4,9
11,2,5,26,22,48
29,2,5,59,58,117
4,2,5,8,8,16
3,2,5,6,6,12
18,2,5,35,36,71
25,3,9,134,75,209
11,3,9,59,33,92
5,3,9,22,15,37
24,3,9,105,72,177
23,7,9,19,161,180
22,7,9,8,154,162
31,7,9,12,217,229
7,7,9,11,49,60
8,3,8,39,24,63
24,8,22,315,192,507
29,9,24,407,261,668
9,9,24,120,81,201
14,13,35,220,182,402
10,13,35,213,130,343
18,13,35,352,234,586
9,38,50,77,342,419
18,38,50,54,684,738
9,42,54,89,378,467
2,308,565,243,616,859
3,1252,2295,3060,3756,6816
1,1266,2320,636,1266,1902
1,1912,3400,1046,1912,2958
2,1252,2295,1902,2504,4406
3,1252,2295,2647,3756,6403
3,420,769,1001,1260,2261
1,420,769,318,420,738
1,295,540,234,295,529
1,1519,2443,753,1519,2272
1,2171,3578,656,2171,2827
1,1083,1701,550,1083,1633
1,2171,3578,763,2171,2934
1,1555,2443,717,1555,2272
3,713,1120,583,2139,2722
2,344,540,316,688,1004
2,344,540,198,688,886
10,2,5,29,20,49
12,1,2,8,12,20
7,1,2,6,7,13
1,461,742,147,461,608
1,1482,2384,473,1482,1955
1,1482,2384,401,1482,1883
1,1482,2384,401,1482,1883
1,24,64,27,24,51
7,2,5,16,14,30
8,3,9,32,24,56
4,3,9,16,12,28
25,2,5,59,50,109
27,2,5,63,54,117
27,7,9,49,189,238
19,3,8,89,57,146
32,13,35,682,416,1098
13,13,35,277,169,446
7,13,35,110,91,201
28,13,35,489,364,853
15,42,54,34,630,664
18,42,54,2,756,758
1,1912,3400,1046,1912,2958
3,1252,2295,2991,3756,6747
1,1266,2320,1008,1266,2274
1,1519,2443,826,1519,2345
2,1555,2443,897,3110,4007
1,2171,3578,942,2171,3113
1,1083,1701,312,1083,1395
3,1083,1701,1650,3249,4899
1,487,783,194,487,681
2,2171,3578,1669,4342,6011
3,2171,3578,1860,6513,8373
7,13,35,149,91,240
27,13,35,575,351,926
24,1,2,15,24,39
18,1,2,17,18,35
19,1,2,17,19,36
1,755,1215,193,755,948
1,461,742,147,461,608
1,461,742,266,461,727
3,461,742,798,1383,2181
18,24,64,570,432,1002
3,2,5,6,6,12
18,2,5,38,36,74
10,3,9,54,30,84
23,3,9,124,69,193
26,4,10,151,104,255
21,4,10,122,84,206
8,3,9,47,24,71
17,3,9,99,51,150
6,7,9,11,42,53
7,7,9,13,49,62
13,8,22,142,104,246
22,8,22,298,176,474
25,8,22,279,200,479
21,13,35,447,273,720
20,13,35,349,260,609
11,13,35,227,143,370
24,13,35,410,312,722
24,13,35,419,312,731
8,21,55,180,168,348
10,21,55,329,210,539
14,38,50,42,532,574
21,42,54,14,882,896
1,38,50,11,38,49
1,42,54,11,42,53
24,42,54,120,1008,1128
3,1912,3400,2322,5736,8058
1,1266,2320,567,1266,1833
1,1266,2320,729,1266,1995
3,1266,2320,1909,3798,5707
1,420,769,211,420,631
1,1266,2320,752,1266,2018
1,1266,2320,1008,1266,2274
2,1266,2320,2015,2532,4547
3,1266,2320,2257,3798,6055
1,1252,2295,538,1252,1790
3,1555,2443,2151,4665,6816
1,2171,3578,763,2171,2934
3,1519,2443,1599,4557,6156
2,1083,1701,1168,2166,3334
2,344,540,252,688,940
2,713,1120,724,1426,2150
1,344,540,120,344,464
3,2171,3578,1967,6513,8480
2,1083,1701,1168,2166,3334
3,1083,1701,1191,3249,4440
1,713,1120,228,713,941
12,3,9,58,36,94
3,11,29,38,33,71
16,11,29,204,176,380
16,11,29,204,176,380
23,9,25,265,207,472
23,9,25,265,207,472
22,9,25,253,198,451
2,2,5,6,4,10
28,2,5,81,56,137
15,1,2,11,15,26
16,2,5,46,32,78
25,2,5,73,50,123
16,1,2,12,16,28
27,1,2,19,27,46
22,2,5,43,44,87
25,2,5,49,50,99
10,2,5,20,20,40
16,9,25,204,144,348
19,9,25,242,171,413
8,2,5,15,16,31
3,1482,2384,1419,4446,5865
3,755,1215,1307,2265,3572
9,24,64,256,216,472
10,2,5,28,20,48
1,2,5,3,2,5
29,2,5,84,58,142
14,2,5,41,28,69
6,2,5,11,12,23
22,2,5,42,44,86
8,2,5,18,16,34
31,2,5,71,62,133
4,3,9,23,12,35
19,3,9,111,57,168
20,3,9,82,60,142
1,3,9,4,3,7
3,7,9,2,21,23
6,7,9,1,42,43
26,3,8,122,78,200
3,13,35,47,39,86
17,13,35,362,221,583
17,13,35,332,221,553
14,21,55,461,294,755
13,38,50,20,494,514
1,1266,2320,961,1266,2227
2,420,769,667,840,1507
1,420,769,334,420,754
2,308,565,491,616,1107
1,1519,2443,387,1519,1906
1,713,1120,261,713,974
1,2171,3578,1157,2171,3328
1,487,783,186,487,673
3,713,1120,415,2139,2554
1,1555,2443,448,1555,2003
1,2171,3578,763,2171,2934
2,2171,3578,1526,4342,5868
1,1083,1701,261,1083,1344
21,3,9,92,63,155
20,2,5,58,40,98
5,2,5,15,10,25
19,1,2,12,19,31
6,1,2,4,6,10
27,1,2,17,27,44
20,1,4,41,20,61
2,1,4,4,2,6
25,1,4,53,25,78
2,1,4,4,2,6
1,1,2,1,1,2
7,1,2,7,7,14
1,1482,2384,854,1482,2336
3,1482,2384,1133,4446,5579
10,45,120,726,450,1176
28,2,5,66,56,122
29,2,5,68,58,126
19,2,5,45,38,83
20,2,5,47,40,87
13,7,9,18,91,109
14,3,8,46,42,88
1,8,22,11,8,19
2,9,24,24,18,42
27,9,24,379,243,622
28,13,35,489,364,853
25,13,35,436,325,761
1,13,35,17,13,30
15,13,35,262,195,457
17,13,35,231,221,452
25,13,35,436,325,761
2,38,50,23,76,99
13,38,50,72,494,566
6,38,50,51,228,279
21,42,54,105,882,987
3,1912,3400,2322,5736,8058
1,1266,2320,729,1266,1995
1,420,769,180,420,600
1,1252,2295,538,1252,1790
1,1898,3375,768,1898,2666
3,1252,2295,2234,3756,5990
1,1252,2295,745,1252,1997
1,420,769,249,420,669
1,1266,2320,1031,1266,2297
1,1266,2320,1008,1266,2274
1,1083,1701,499,1083,1582
1,2171,3578,942,2171,3113
2,2171,3578,1884,4342,6226
2,2171,3578,1884,4342,6226
3,713,1120,1087,2139,3226
22,9,25,237,198,435
22,9,25,237,198,435
8,9,25,86,72,158
23,2,5,67,46,113
3,2,5,9,6,15
1,1,4,2,1,3
21,1,4,51,21,72
1,755,1215,302,755,1057
1,1482,2384,330,1482,1812
24,2,5,50,48,98
14,2,5,29,28,57
2,2,5,6,4,10
21,2,5,61,42,103
12,7,9,20,84,104
17,7,9,32,119,151
3,8,22,41,24,65
18,13,35,283,234,517
8,13,35,170,104,274
11,13,35,234,143,377
5,13,35,107,65,172
12,13,35,209,156,365
6,42,54,27,252,279
4,38,50,40,152,192
3,1252,2295,2165,3756,5921
2,1252,2295,1994,2504,4498
1,1252,2295,1020,1252,2272
1,1252,2295,722,1252,1974
1,2171,3578,1264,2171,3435
1,487,783,280,487,767
1,1083,1701,550,1083,1633
1,487,783,155,487,642
2,1083,1701,1168,2166,3334
1,713,1120,261,713,974
1,713,1120,385,713,1098
3,2171,3578,4006,6513,10519
3,344,540,523,1032,1555
2,26,70,68,52,120
8,2,5,22,16,38
22,2,5,62,44,106
29,9,25,435,261,696
26,2,5,75,52,127
25,1,2,24,25,49
16,1,2,15,16,31
9,1,2,9,9,18
3,461,742,821,1383,2204
3,1482,2384,1705,4446,6151
1,461,742,266,461,727
6,24,64,186,144,330
7,45,120,349,315,664
8,45,120,427,360,787
2,45,120,133,90,223
9,45,120,502,405,907
28,4,10,162,112,274
24,4,10,139,96,235
20,2,5,59,40,99
6,3,9,25,18,43
20,3,9,82,60,142
27,2,5,76,54,130
14,2,5,39,28,67
22,7,9,36,154,190
1,3,8,5,3,8
7,3,8,33,21,54
22,8,22,221,176,397
29,8,22,272,232,504
1,8,22,12,8,20
29,8,22,304,232,536
17,9,24,251,153,404
27,9,24,399,243,642
7,13,35,103,91,194
2,13,35,43,26,69
8,13,35,165,104,269
27,13,35,556,351,907
12,42,54,1,504,505
26,38,50,299,988,1287
28,38,50,308,1064,1372
6,38,50,9,228,237
1,1898,3375,768,1898,2666
1,1252,2295,1020,1252,2272
2,1252,2295,1260,2504,3764
1,1912,3400,944,1912,2856
2,1266,2320,1366,2532,3898
1,308,565,217,308,525
1,1252,2295,951,1252,2203
3,1266,2320,2884,3798,6682
1,1252,2295,1020,1252,2272
1,1252,2295,997,1252,2249
1,1555,2443,839,1555,2394
1,344,540,77,344,421
1,713,1120,396,713,1109
1,344,540,126,344,470
2,1083,1701,522,2166,2688
2,344,540,273,688,961
1,344,540,83,344,427
27,26,70,1169,702,1871
9,8,21,77,72,149
19,8,21,163,152,315
8,1,2,5,8,13
8,1,2,5,8,13
23,2,5,54,46,100
10,2,5,24,20,44
24,2,5,59,48,107
11,2,5,27,22,49
28,1,2,27,28,55
22,1,2,22,22,44
10,1,2,10,10,20
13,2,5,25,26,51
15,1,4,43,15,58
10,1,4,28,10,38
1,461,742,251,461,712
3,1482,2384,2634,4446,7080
15,2,5,29,30,59
24,2,5,46,48,94
3,2,5,9,6,15
27,2,5,78,54,132
10,3,9,58,30,88
5,3,9,29,15,44
1,2,5,2,2,4
1,2,5,2,2,4
21,7,9,0,147,147
14,7,9,25,98,123
20,8,22,210,160,370
16,8,22,217,128,345
15,9,24,182,135,317
19,9,24,203,171,374
9,13,35,185,117,302
17,13,35,362,221,583
19,13,35,405,247,652
13,13,35,213,169,382
3,13,35,43,39,82
5,13,35,107,65,172
11,21,55,368,231,599
25,42,54,3,1050,1053
23,38,50,253,874,1127
5,38,50,25,190,215
1,420,769,180,420,600
2,1912,3400,2704,3824,6528
1,1266,2320,1008,1266,2274
1,1266,2320,683,1266,1949
1,1266,2320,1031,1266,2297
1,2171,3578,978,2171,3149
3,487,783,371,1461,1832
1,713,1120,385,713,1098
2,713,1120,411,1426,1837
1,1555,2443,497,1555,2052
1,344,540,120,344,464
27,2,5,76,54,130
1,2,5,2,2,4
3,1482,2384,2563,4446,7009
1,755,1215,436,755,1191
1,1482,2384,854,1482,2336
6,45,120,335,270,605
9,2,5,24,18,42
9,2,5,24,18,42
5,3,9,20,15,35
17,3,9,68,51,119
17,3,8,61,51,112
11,8,22,123,88,211
10,8,22,136,80,216
14,8,22,190,112,302
9,9,24,131,81,212
15,13,35,220,195,415
14,13,35,274,182,456
27,13,35,575,351,926
17,13,35,350,221,571
1,13,35,17,13,30
24,21,55,790,504,1294
12,38,50,120,456,576
12,38,50,36,456,492
1,1898,3375,870,1898,2768
1,1252,2295,997,1252,2249
1,1266,2320,683,1266,1949
1,420,769,249,420,669
1,308,565,246,308,554
1,308,565,251,308,559
1,2171,3578,620,2171,2791
2,2171,3578,1526,4342,5868
1,1083,1701,550,1083,1633
1,2171,3578,835,2171,3006
1,344,540,185,344,529
1,1083,1701,261,1083,1344
3,344,540,523,1032,1555
27,13,35,556,351,907
25,13,35,515,325,840
26,9,25,390,234,624
18,9,25,270,162,432
14,9,25,221,126,347
23,9,25,362,207,569
1,13,35,16,13,29
7,13,35,110,91,201
1,1482,2384,735,1482,2217
3,755,1215,1307,2265,3572
1,461,742,147,461,608
15,7,9,0,105,105
14,3,8,66,42,108
1,3,8,5,3,8
3,8,22,41,24,65
13,13,35,268,169,437
16,13,35,330,208,538
18,42,54,177,756,933
9,38,50,9,342,351
1,1252,2295,997,1252,2249
1,2171,3578,1264,2171,3435
1,487,783,280,487,767
1,1083,1701,584,1083,1667
1,1083,1701,244,1083,1327
1,487,783,265,487,752
3,1519,2443,1819,4557,6376
16,1,2,12,16,28
1,2,5,3,2,5
5,2,5,15,10,25
1,1482,2384,807,1482,2289
1,461,742,251,461,712
9,24,64,348,216,564
9,45,120,524,405,929
2,2,5,5,4,9
5,2,5,12,10,22
1,3,9,5,3,8
10,3,9,46,30,76
15,2,5,35,30,65
20,2,5,47,40,87
17,7,9,28,119,147
19,8,22,258,152,410
15,13,35,215,195,410
9,13,35,148,117,265
16,13,35,234,208,442
10,42,54,1,420,421
16,38,50,80,608,688
26,38,50,26,988,1014
5,42,54,25,210,235
1,1252,2295,722,1252,1974
1,1252,2295,997,1252,2249
1,1083,1701,244,1083,1327
3,1083,1701,731,3249,3980
1,1083,1701,397,1083,1480
1,2171,3578,763,2171,2934
3,2171,3578,2504,6513,9017
3,1519,2443,1233,4557,5790
1,1083,1701,261,1083,1344
1,2171,3578,906,2171,3077
2,2171,3578,1812,4342,6154
24,1,2,17,24,41
5,1,2,4,5,9
14,1,2,13,14,27
1,11,29,17,11,28
20,11,29,348,220,568
26,11,29,453,286,739
9,1,2,5,9,14
31,1,2,18,31,49
2,461,742,503,922,1425
1,461,742,251,461,712
1,59,159,97,59,156
1,2,5,3,2,5
20,4,10,94,80,174
3,4,10,14,12,26
27,4,10,157,108,265
23,4,10,133,92,225
9,3,9,39,27,66
26,3,9,114,78,192
15,2,5,44,30,74
7,2,5,20,14,34
28,3,9,158,84,242
32,3,9,180,96,276
3,3,9,17,9,26
13,3,9,53,39,92
8,3,9,33,24,57
3,2,5,6,6,12
14,7,9,25,98,123
5,7,9,10,35,45
5,7,9,4,35,39
20,7,9,0,140,140
24,3,8,116,72,188
10,8,22,94,80,174
21,8,22,197,168,365
25,8,22,339,200,539
23,8,22,312,184,496
3,8,22,39,24,63
17,13,35,267,221,488
27,13,35,556,351,907
1,13,35,17,13,30
5,13,35,87,65,152
27,13,35,424,351,775
7,13,35,149,91,240
20,13,35,426,260,686
19,13,35,371,247,618
2,21,55,66,42,108
22,38,50,253,836,1089
17,42,54,11,714,725
9,42,54,89,378,467
26,38,50,260,988,1248
3,1912,3400,2322,5736,8058
1,1266,2320,636,1266,1902
1,1898,3375,768,1898,2666
3,420,769,1001,1260,2261
3,1266,2320,3023,3798,6821
3,420,769,563,1260,1823
1,420,769,318,420,738
2,1252,2295,1994,2504,4498
2,1083,1701,794,2166,2960
1,2171,3578,763,2171,2934
1,1555,2443,839,1555,2394
2,713,1120,769,1426,2195
1,487,783,265,487,752
1,344,540,174,344,518
1,344,540,77,344,421
2,713,1120,769,1426,2195
1,344,540,174,344,518
1,344,540,185,344,529
1,1083,1701,312,1083,1395
1,713,1120,261,713,974
1,344,540,174,344,518
13,1,2,7,13,20
17,1,2,10,17,27
7,1,2,4,7,11
1,2,5,2,2,4
27,1,2,26,27,53
9,2,5,25,18,43
2,2,5,6,4,10
4,11,30,74,44,118
14,1,4,32,14,46
19,1,4,43,19,62
9,2,5,26,18,44
6,2,5,17,12,29
1,755,1215,193,755,948
1,461,742,229,461,690
1,1482,2384,878,1482,2360
5,24,64,187,120,307
7,2,5,15,14,29
24,2,5,50,48,98
6,2,5,16,12,28
7,2,5,19,14,33
10,3,8,47,30,77
28,3,8,111,84,195
32,8,22,321,256,577
25,13,35,393,325,718
3,13,35,62,39,101
16,13,35,341,208,549
5,13,35,107,65,172
27,13,35,575,351,926
28,13,35,547,364,911
1,1266,2320,752,1266,2018
1,1266,2320,1008,1266,2274
2,1252,2295,1489,2504,3993
1,308,565,155,308,463
2,344,540,316,688,1004
2,487,783,561,974,1535
1,1083,1701,584,1083,1667
29,26,70,1012,754,1766
17,2,5,48,34,82
24,2,5,67,48,115
1,1482,2384,807,1482,2289
1,461,742,251,461,712
3,45,120,218,135,353
10,3,9,58,30,88
27,3,9,157,81,238
20,2,5,59,40,99
9,2,5,27,18,45
20,2,5,58,40,98
24,2,5,70,48,118
7,2,5,13,14,27
1,2,5,2,2,4
5,2,5,15,10,25
23,2,5,67,46,113
4,7,9,7,28,35
20,7,9,33,140,173
10,7,9,18,70,88
28,3,8,104,84,188
16,8,22,217,128,345
29,13,35,597,377,974
5,13,35,87,65,152
10,38,50,110,380,490
25,42,54,-24,1050,1026
21,38,50,210,798,1008
25,42,54,246,1050,1296
2,1912,3400,1888,3824,5712
3,1266,2320,3023,3798,6821
1,1266,2320,752,1266,2018
3,420,769,1024,1260,2284
1,420,769,318,420,738
1,1912,3400,1420,1912,3332
2,2171,3578,2528,4342,6870
1,1555,2443,790,1555,2345
1,1083,1701,210,1083,1293
1,1083,1701,584,1083,1667
1,1083,1701,397,1083,1480
1,1083,1701,397,1083,1480
1,344,540,77,344,421
1,1083,1701,550,1083,1633
1,487,783,288,487,775
21,26,70,909,546,1455
27,11,30,319,297,616
10,1,4,30,10,40
30,2,5,87,60,147
20,9,25,255,180,435
15,9,25,191,135,326
1,755,1215,436,755,1191
1,755,1215,193,755,948
24,2,5,67,48,115
13,2,5,36,26,62
14,2,5,33,28,61
16,2,5,38,32,70
12,2,5,28,24,52
1,7,9,1,7,8
2,7,9,3,14,17
14,7,9,25,98,123
8,3,8,32,24,56
13,8,22,176,104,280
21,13,35,366,273,639
22,13,35,469,286,755
25,13,35,515,325,840
26,13,35,536,338,874
24,13,35,394,312,706
1,38,50,11,38,49
2,38,50,20,76,96
23,38,50,253,874,1127
2,1898,3375,2684,3796,6480
1,420,769,334,420,754
1,1266,2320,1008,1266,2274
1,1555,2443,839,1555,2394
2,1555,2443,1581,3110,4691
1,2171,3578,942,2171,3113
1,1555,2443,839,1555,2394
1,1083,1701,550,1083,1633
3,713,1120,1087,2139,3226
1,1555,2443,570,1555,2125
2,1555,2443,994,3110,4104
1,487,783,194,487,681
1,344,540,174,344,518
2,2171,3578,2671,4342,7013
26,13,35,554,338,892
1,461,742,162,461,623
3,59,159,224,177,401
24,3,9,116,72,188
20,3,9,97,60,157
22,2,5,62,44,106
19,2,5,53,38,91
28,3,9,150,84,234
21,3,9,113,63,176
2,2,5,6,4,10
4,2,5,12,8,20
2,2,5,6,4,10
29,2,5,84,58,142
28,2,5,53,56,109
1,2,5,2,2,4
23,3,9,134,69,203
4,3,9,23,12,35
18,3,9,105,54,159
4,3,9,23,12,35
1,2,5,3,2,5
26,2,5,77,52,129
30,2,5,84,60,144
1,2,5,3,2,5
18,7,9,0,126,126
4,7,9,7,28,35
11,7,9,20,77,97
27,7,9,22,189,211
6,8,22,81,48,129
10,8,22,105,80,185
25,8,22,345,200,545
12,9,24,117,108,225
27,9,24,392,243,635
6,13,35,124,78,202
26,13,35,536,338,874
20,13,35,349,260,609
23,13,35,377,299,676
19,21,55,583,399,982
12,38,50,120,456,576
23,42,54,251,966,1217
13,38,50,143,494,637
3,1252,2295,1614,3756,5370
2,1898,3375,1874,3796,5670
2,1266,2320,2062,2532,4594
1,1912,3400,1352,1912,3264
1,1898,3375,937,1898,2835
3,420,769,1001,1260,2261
2,420,769,636,840,1476
1,1266,2320,544,1266,1810
1,420,769,249,420,669
1,295,540,126,295,421
1,1266,2320,1008,1266,2274
3,2171,3578,3577,6513,10090
1,2171,3578,1264,2171,3435
1,713,1120,385,713,1098
2,2171,3578,2313,4342,6655
1,2171,3578,1264,2171,3435
1,487,783,280,487,767
1,1083,1701,550,1083,1633
1,2171,3578,942,2171,3113
1,2171,3578,942,2171,3113
2,344,540,252,688,940
3,713,1120,683,2139,2822
1,344,540,110,344,454
1,2171,3578,1335,2171,3506
19,26,70,543,494,1037
26,3,9,151,78,229
26,2,5,73,52,125
17,2,5,32,34,66
20,2,5,59,40,99
17,2,5,50,34,84
1,2,5,3,2,5
27,1,2,20,27,47
3,1,2,2,3,5
8,1,2,6,8,14
11,1,2,7,11,18
28,1,2,19,28,47
4,1,2,3,4,7
4,1,4,9,4,13
1,1,4,2,1,3
6,2,5,17,12,29
15,2,5,44,30,74
1,1482,2384,854,1482,2336
3,755,1215,1307,2265,3572
1,461,742,274,461,735
1,1482,2384,854,1482,2336
29,1482,2384,15096,42978,58074
26,24,64,924,624,1548
32,2,5,70,64,134
26,2,5,57,52,109
2,2,5,5,4,9
13,2,5,31,26,57
12,7,9,7,84,91
16,8,22,150,128,278
23,9,24,273,207,480
9,13,35,132,117,249
22,13,35,469,286,755
26,13,35,408,338,746
7,13,35,149,91,240
11,13,35,157,143,300
11,13,35,227,143,370
22,21,55,591,462,1053
15,42,54,10,630,640
25,38,50,138,950,1088
1,1912,3400,774,1912,2686
1,1252,2295,997,1252,2249
1,1266,2320,752,1266,2018
3,420,769,747,1260,2007
1,1252,2295,951,1252,2203
1,487,783,280,487,767
2,1555,2443,1434,3110,4544
1,1555,2443,448,1555,2003
1,713,1120,385,713,1098
1,2171,3578,835,2171,3006
1,713,1120,161,713,874
1,344,540,174,344,518
1,344,540,126,344,470
1,344,540,126,344,470
19,2,5,45,38,83
29,2,5,68,58,126
23,2,5,54,46,100
12,1,2,10,12,22
2,8,21,17,16,33
16,8,21,137,128,265
15,8,21,154,120,274
13,8,21,134,104,238
1,1482,2384,401,1482,1883
32,2,5,75,64,139
6,2,5,14,12,26
27,7,9,44,189,233
15,3,8,52,45,97
13,8,22,145,104,249
8,8,22,108,64,172
10,9,24,107,90,197
8,13,35,170,104,274
8,13,35,140,104,244
26,13,35,563,338,901
10,13,35,213,130,343
10,13,35,196,130,326
18,13,35,383,234,617
10,13,35,143,130,273
25,21,55,603,525,1128
6,21,55,141,126,267
10,42,54,50,420,470
1,1252,2295,630,1252,1882
1,1898,3375,836,1898,2734
3,1912,3400,3138,5736,8874
2,1898,3375,1874,3796,5670
1,1252,2295,997,1252,2249
2,1252,2295,1994,2504,4498
1,295,540,234,295,529
1,1252,2295,997,1252,2249
1,2171,3578,1371,2171,3542
1,713,1120,261,713,974
1,344,540,174,344,518
3,1555,2443,1711,4665,6376
1,2171,3578,1335,2171,3506
30,13,35,639,390,1029
3,1,4,9,3,12
6,1,4,18,6,24
17,1,4,42,17,59
17,1,4,42,17,59
29,1,2,20,29,49
20,1,2,14,20,34
25,2,5,73,50,123
6,2,5,17,12,29
1,1482,2384,735,1482,2217
1,461,742,251,461,712
1,1482,2384,854,1482,2336
2,1482,2384,1709,2964,4673
1,755,1215,193,755,948
17,2,5,45,34,79
8,2,5,16,16,32
9,2,5,18,18,36
3,2,5,9,6,15
21,2,5,62,42,104
12,3,9,71,36,107
12,3,9,71,36,107
31,3,9,147,93,240
19,3,9,90,57,147
16,7,9,31,112,143
19,3,8,62,57,119
7,8,22,76,56,132
6,13,35,130,78,208
17,13,35,350,221,571
28,13,35,479,364,843
9,38,50,14,342,356
23,42,54,3,966,969
1,1898,3375,937,1898,2835
3,1266,2320,2675,3798,6473
1,1252,2295,722,1252,1974
3,1266,2320,1631,3798,5429
1,308,565,246,308,554
2,1555,2443,1092,3110,4202
1,2171,3578,656,2171,2827
3,1083,1701,1803,3249,5052
3,1083,1701,1650,3249,4899
1,713,1120,385,713,1098
3,344,540,523,1032,1555
1,713,1120,205,713,918
28,3,9,113,84,197
1,1,2,1,1,2
15,1,2,10,15,25
2,1,2,1,2,3
29,1,2,21,29,50
24,1,2,22,24,46
2,1,2,2,2,4
19,1,4,55,19,74
14,1,4,41,14,55
9,1,4,26,9,35
1,461,742,274,461,735
1,755,1215,193,755,948
1,461,742,118,461,579
10,3,9,41,30,71
31,2,5,90,62,152
4,2,5,12,8,20
28,2,5,81,56,137
16,2,5,38,32,70
6,2,5,14,12,26
24,7,9,39,168,207
23,3,8,104,69,173
6,8,22,56,48,104
1,8,22,9,8,17
27,8,22,271,216,487
3,13,35,44,39,83
1,13,35,21,13,34
23,38,50,69,874,943
22,38,50,220,836,1056
27,38,50,149,1026,1175
27,38,50,270,1026,1296
1,1898,3375,768,1898,2666
2,1252,2295,1260,2504,3764
2,1252,2295,1076,2504,3580
1,295,540,234,295,529
1,308,565,184,308,492
1,2171,3578,1335,2171,3506
2,1519,2443,1750,3038,4788
3,2171,3578,3792,6513,10305
1,2171,3578,656,2171,2827
2,487,783,310,974,1284
1,487,783,288,487,775
1,487,783,265,487,752
1,344,540,164,344,508
1,344,540,174,344,518
5,1,2,4,5,9
3,1,2,3,3,6
23,1,2,20,23,43
26,2,5,49,52,101
11,2,5,31,22,53
24,2,5,67,48,115
1,755,1215,205,755,960
2,1482,2384,1184,2964,4148
1,2,5,2,2,4
16,2,5,31,32,63
22,2,5,51,44,95
5,2,5,12,10,22
15,4,10,63,60,123
10,3,9,46,30,76
16,4,10,61,64,125
24,4,10,91,96,187
15,2,5,44,30,74
32,4,10,147,128,275
30,3,8,107,90,197
22,9,24,319,198,517
19,9,24,253,171,424
10,13,35,206,130,336
8,13,35,173,104,277
8,13,35,156,104,260
22,13,35,345,286,631
12,21,55,269,252,521
9,21,55,197,189,386
7,21,55,169,147,316
2,42,54,5,84,89
14,38,50,77,532,609
1,38,50,1,38,39
31,38,50,31,1178,1209
6,38,50,51,228,279
8,38,50,68,304,372
3,1912,3400,2322,5736,8058
1,1252,2295,538,1252,1790
2,1252,2295,1443,2504,3947
1,1266,2320,636,1266,1902
1,1898,3375,870,1898,2768
1,1266,2320,636,1266,1902
2,420,769,667,840,1507
2,1252,2295,1489,2504,3993
1,1252,2295,676,1252,1928
2,420,769,375,840,1215
2,420,769,636,840,1476
3,1266,2320,2675,3798,6473
1,1266,2320,544,1266,1810
1,2171,3578,942,2171,3113
1,2171,3578,906,2171,3077
1,2171,3578,1157,2171,3328
1,1555,2443,570,1555,2125
1,344,540,77,344,421
1,2171,3578,1371,2171,3542
3,1083,1701,1650,3249,4899
1,2171,3578,835,2171,3006
4,1,2,3,4,7
1,1,2,1,1,2
29,1,2,19,29,48
19,13,35,405,247,652
30,13,35,639,390,1029
1,1,2,1,1,2
2,1,2,1,2,3
17,2,5,48,34,82
13,2,5,36,26,62
29,2,5,81,58,139
1,1482,2384,473,1482,1955
1,1482,2384,735,1482,2217
1,755,1215,436,755,1191
2,461,742,547,922,1469
10,24,64,259,240,499
27,24,64,855,648,1503
15,24,64,590,360,950
8,45,120,398,360,758
3,2,5,6,6,12
29,3,9,119,87,206
14,3,9,58,42,100
24,3,9,129,72,201
19,3,9,102,57,159
5,3,9,27,15,42
6,3,9,32,18,50
1,7,9,0,7,7
14,7,9,19,98,117
17,7,9,31,119,150
18,8,22,244,144,388
25,13,35,515,325,840
32,13,35,626,416,1042
16,42,54,2,672,674
3,1252,2295,2647,3756,6403
3,1252,2295,2027,3756,5783
1,1266,2320,544,1266,1810
1,1266,2320,1008,1266,2274
1,420,769,188,420,608
1,1555,2443,790,1555,2345
3,1083,1701,1497,3249,4746
1,487,783,132,487,619
1,1555,2443,717,1555,2272
1,713,1120,329,713,1042
11,2,5,31,22,53
7,2,5,20,14,34
12,1,2,7,12,19
18,1,2,10,18,28
1,755,1215,193,755,948
1,755,1215,436,755,1191
22,45,120,1597,990,2587
28,2,5,66,56,122
25,2,5,59,50,109
17,2,5,48,34,82
17,2,5,49,34,83
3,2,5,9,6,15
4,2,5,9,8,17
1,2,5,2,2,4
22,2,5,52,44,96
25,3,9,134,75,209
13,3,9,70,39,109
23,2,5,64,46,110
3,2,5,8,6,14
13,7,9,18,91,109
3,8,22,33,24,57
23,9,24,334,207,541
14,13,35,200,182,382
11,13,35,192,143,335
29,13,35,506,377,883
12,13,35,256,156,412
1,13,35,16,13,29
13,13,35,254,169,423
11,13,35,227,143,370
10,21,55,329,210,539
28,42,54,139,1176,1315
1,1266,2320,544,1266,1810
2,1912,3400,2092,3824,5916
3,1252,2295,2991,3756,6747
3,1252,2295,2234,3756,5990
1,1266,2320,1008,1266,2274
1,308,565,184,308,492
1,1252,2295,997,1252,2249
1,344,540,174,344,518
1,1555,2443,546,1555,2101
1,2171,3578,1264,2171,3435
1,1555,2443,448,1555,2003
3,1083,1701,1191,3249,4440
3,2171,3578,4006,6513,10519
8,2,5,22,16,38
16,2,5,45,32,77
17,2,5,48,34,82
21,1,2,13,21,34
25,1,2,16,25,41
9,8,21,113,72,185
1,755,1215,411,755,1166
1,461,742,229,461,690
1,1482,2384,592,1482,2074
1,1482,2384,735,1482,2217
3,1482,2384,2420,4446,6866
4,59,159,317,236,553
7,59,159,500,413,913
28,2,5,83,56,139
15,2,5,44,30,74
22,2,5,51,44,95
23,2,5,53,46,99
9,2,5,27,18,45
19,2,5,56,38,94
2,2,5,6,4,10
21,2,5,61,42,103
13,2,5,38,26,64
26,2,5,75,52,127
20,3,9,116,60,176
12,3,9,58,36,94
29,7,9,53,203,256
23,7,9,42,161,203
15,3,8,74,45,119
11,3,8,54,33,87
1,8,22,14,8,22
5,8,22,68,40,108
21,9,24,280,189,469
2,9,24,30,18,48
28,9,24,393,252,645
4,9,24,45,36,81
15,9,24,221,135,356
1,13,35,14,13,27
7,13,35,122,91,213
16,13,35,251,208,459
9,13,35,132,117,249
14,13,35,303,182,485
18,13,35,352,234,586
20,13,35,398,260,658
14,13,35,298,182,480
16,13,35,341,208,549
28,13,35,547,364,911
1,13,35,21,13,34
4,21,55,132,84,216
17,21,55,559,357,916
25,42,54,17,1050,1067
16,38,50,184,608,792
11,38,50,94,418,512
17,38,50,187,646,833
31,42,54,355,1302,1657
25,38,50,275,950,1225
23,38,50,23,874,897
1,1266,2320,497,1266,1763
3,1252,2295,3060,3756,6816
1,1266,2320,961,1266,2227
3,713,1120,1154,2139,3293
1,2171,3578,656,2171,2827
1,713,1120,161,713,874
1,1555,2443,351,1555,1906
1,344,540,185,344,529
1,2171,3578,1371,2171,3542
16,26,70,626,416,1042
7,3,9,33,21,54
12,8,21,96,96,192
25,8,21,199,200,399
16,8,21,137,128,265
20,2,5,38,40,78
26,2,5,49,52,101
2,2,5,5,4,9
12,2,5,26,24,50
12,1,4,27,12,39
26,1,4,59,26,85
14,1,2,13,14,27
12,1,2,12,12,24
18,2,5,53,36,89
24,2,5,71,48,119
4,1,2,4,4,8
2,1,2,2,2,4
2,2,5,6,4,10
20,2,5,56,40,96
15,12,33,280,180,460
14,12,33,262,168,430
26,1,2,25,26,51
9,1,2,9,9,18
1,1,2,1,1,2
30,1,2,20,30,50
18,1,2,12,18,30
1,1,2,1,1,2
10,2,5,19,20,39
4,2,5,8,8,16
18,2,5,34,36,70
16,2,5,30,32,62
18,13,35,264,234,498
5,13,35,73,65,138
29,13,35,425,377,802
2,2,5,6,4,10
2,1,4,6,2,8
18,1,2,15,18,33
6,1,2,3,6,9
13,1,2,9,13,22
19,1,2,11,19,30
9,1,2,9,9,18
2,1,2,2,2,4
1,1,2,1,1,2
9,2,5,26,18,44
21,2,5,61,42,103
8,2,5,23,16,39
9,2,5,26,18,44
25,2,5,73,50,123
15,2,5,35,30,65
19,2,5,45,38,83
14,1,4,40,14,54
13,9,25,202,117,319
24,9,25,372,216,588
1,755,1215,387,755,1142
1,1482,2384,592,1482,2074
8,24,64,310,192,502
7,45,120,517,315,832
30,2,5,89,60,149
25,3,9,148,75,223
25,3,9,148,75,223
21,3,9,124,63,187
5,3,9,30,15,45
26,2,5,77,52,129
17,2,5,48,34,82
20,2,5,47,40,87
16,2,5,38,32,70
5,2,5,15,10,25
9,4,10,52,36,88
8,2,5,23,16,39
6,2,5,17,12,29
19,2,5,40,38,78
32,2,5,94,64,158
24,3,9,105,72,177
5,3,9,22,15,37
25,2,5,55,50,105
7,2,5,15,14,29
23,7,9,38,161,199
29,7,9,55,203,258
23,7,9,0,161,161
15,7,9,27,105,132
22,3,8,106,66,172
11,3,8,43,33,76
21,3,8,68,63,131
26,3,8,101,78,179
22,3,8,98,66,164
5,3,8,20,15,35
3,8,22,27,24,51
2,8,22,22,16,38
9,8,22,118,72,190
26,8,22,272,208,480
10,9,24,148,90,238
19,9,24,280,171,451
4,9,24,59,36,95
20,9,24,290,180,470
21,9,24,234,189,423
20,13,35,349,260,609
23,13,35,498,299,797
5,13,35,103,65,168
26,13,35,354,338,692
19,13,35,292,247,539
31,13,35,454,403,857
11,13,35,238,143,381
17,13,35,368,221,589
8,13,35,165,104,269
30,13,35,650,390,1040
10,13,35,213,130,343
27,13,35,424,351,775
20,13,35,314,260,574
13,13,35,213,169,382
9,13,35,176,117,293
10,21,55,335,210,545
21,21,55,702,441,1143
21,21,55,564,441,1005
2,42,54,10,84,94
3,1266,2320,1631,3798,5429
3,1252,2295,2234,3756,5990
1,2171,3578,942,2171,3113
1,1555,2443,546,1555,2101
1,344,540,110,344,454
1,344,540,99,344,443
7,26,70,298,182,480
23,3,9,134,69,203
1,2,5,3,2,5
26,2,5,77,52,129
5,8,21,61,40,101
15,8,21,182,120,302
2,8,21,24,16,40
13,8,21,158,104,262
8,2,5,16,16,32
11,2,5,23,22,45
2,1,4,6,2,8
7,1,4,21,7,28
26,2,5,75,52,127
29,2,5,84,58,142
7,2,5,21,14,35
17,2,5,50,34,84
1,2,5,3,2,5
10,9,25,100,90,190
1,9,25,10,9,19
18,1,2,18,18,36
18,1,2,18,18,36
12,11,30,178,132,310
3,11,30,44,33,77
23,2,5,67,46,113
23,2,5,67,46,113
10,1,2,9,10,19
15,1,2,13,15,28
10,1,4,24,10,34
7,1,2,6,7,13
18,1,2,15,18,33
21,2,5,40,42,82
6,1,2,3,6,9
8,1,2,4,8,12
6,2,5,11,12,23
20,1,2,12,20,32
19,1,2,11,19,30
1,461,742,251,461,712
1,1482,2384,878,1482,2360
2,1482,2384,946,2964,3910
24,24,64,929,576,1505
31,24,64,883,744,1627
24,24,64,684,576,1260
1,45,120,74,45,119
11,45,120,799,495,1294
12,45,120,886,540,1426
5,59,159,484,295,779
9,59,159,714,531,1245
25,2,5,53,50,103
2,2,5,4,4,8
24,2,5,71,48,119
5,2,5,15,10,25
10,4,10,59,40,99
4,4,10,24,16,40
14,4,10,83,56,139
26,4,10,153,104,257
23,2,5,64,46,110
14,4,10,59,56,115
9,4,10,38,36,74
29,2,5,84,58,142
7,2,5,20,14,34
24,3,9,142,72,214
14,3,9,83,42,125
17,2,5,50,34,84
1,2,5,2,2,4
16,2,5,33,32,65
18,7,9,7,126,133
18,7,9,34,126,160
27,7,9,44,189,233
23,7,9,19,161,180
16,7,9,2,112,114
24,7,9,44,168,212
30,7,9,25,210,235
1,3,8,4,3,7
25,8,22,339,200,539
26,8,22,353,208,561
20,8,22,276,160,436
4,8,22,44,32,76
10,8,22,136,80,216
1,8,22,11,8,19
5,8,22,69,40,109
2,8,22,28,16,44
7,9,24,83,63,146
13,9,24,139,117,256
15,9,24,221,135,356
1,9,24,13,9,22
13,13,35,268,169,437
22,13,35,469,286,755
14,13,35,230,182,412
24,13,35,494,312,806
26,13,35,563,338,901
8,13,35,173,104,277
3,13,35,51,39,90
13,13,35,277,169,446
3,13,35,44,39,83
17,13,35,332,221,553
10,13,35,213,130,343
21,13,35,359,273,632
27,13,35,414,351,765
9,21,55,237,189,426
20,21,55,636,420,1056
16,42,54,183,672,855
15,42,54,2,630,632
2,42,54,22,84,106
3,38,50,9,114,123
13,38,50,143,494,637
18,42,54,41,756,797
28,38,50,42,1064,1106
17,38,50,196,646,842
1,38,50,11,38,49
9,42,54,40,378,418
3,1252,2295,1890,3756,5646
1,1252,2295,1020,1252,2272
3,1266,2320,1700,3798,5498
1,1266,2320,1008,1266,2274
1,420,769,334,420,754
2,420,769,667,840,1507
1,420,769,341,420,761
1,1266,2320,544,1266,1810
3,1252,2295,2991,3756,6747
1,1266,2320,1008,1266,2274
1,487,783,280,487,767
1,2171,3578,656,2171,2827
1,2171,3578,656,2171,2827
2,344,540,241,688,929
1,1083,1701,550,1083,1633
1,2171,3578,1335,2171,3506
1,26,70,43,26,69
11,26,70,469,286,755
11,26,70,376,286,662
25,26,70,1083,650,1733
3,3,9,17,9,26
1,13,35,21,13,34
22,13,35,469,286,755
10,1,2,6,10,16
15,1,2,11,15,26
8,1,2,6,8,14
25,1,2,19,25,44
5,2,5,13,10,23
13,9,25,140,117,257
26,1,4,61,26,87
19,1,4,45,19,64
4,2,5,8,8,16
14,2,5,27,28,55
10,2,5,30,20,50
13,2,5,38,26,64
24,2,5,71,48,119
2,2,5,6,4,10
14,2,5,41,28,69
20,2,5,59,40,99
5,11,30,64,55,119
14,11,30,178,154,332
20,1,4,50,20,70
6,1,2,6,6,12
27,1,2,25,27,52
28,1,2,26,28,54
27,2,5,53,54,107
7,2,5,14,14,28
22,9,25,341,198,539
11,9,25,171,99,270
16,2,5,47,32,79
16,2,5,47,32,79
18,2,5,53,36,89
19,2,5,56,38,94
11,9,25,124,99,223
4,9,25,45,36,81
27,1,2,26,27,53
28,1,2,27,28,55
16,1,2,15,16,31
5,1,2,5,5,10
26,2,5,61,52,113
27,2,5,63,54,117
20,1,2,17,20,37
3,2,5,6,6,12
3,1482,2384,1776,4446,6222
1,755,1215,411,755,1166
1,1482,2384,473,1482,1955
4,59,159,375,236,611
5,2,5,10,10,20
25,2,5,48,50,98
5,2,5,12,10,22
4,2,5,9,8,17
11,4,10,46,44,90
4,4,10,17,16,33
13,2,5,36,26,62
10,2,5,28,20,48
9,2,5,17,18,35
27,2,5,51,54,105
16,2,5,30,32,62
15,4,10,84,60,144
15,2,5,29,30,59
20,2,5,38,40,78
4,2,5,8,8,16
23,2,5,51,46,97
16,2,5,35,32,67
6,2,5,14,12,26
18,2,5,38,36,74
1,7,9,2,7,9
27,7,9,1,189,190
1,7,9,2,7,9
14,7,9,0,98,98
2,7,9,1,14,15
7,3,8,23,21,44
15,8,22,137,120,257
29,8,22,361,232,593
1,8,22,10,8,18
4,8,22,37,32,69
20,8,22,201,160,361
4,8,22,55,32,87
23,9,24,339,207,546
12,9,24,177,108,285
26,13,35,563,338,901
7,13,35,115,91,206
4,13,35,57,52,109
23,13,35,498,299,797
21,13,35,455,273,728
6,13,35,88,78,166
19,13,35,405,247,652
27,13,35,424,351,775
15,13,35,220,195,415
26,13,35,381,338,719
26,21,55,569,546,1115
28,21,55,613,588,1201
25,38,50,138,950,1088
15,38,50,128,570,698
16,42,54,183,672,855
20,42,54,2,840,842
5,38,50,55,190,245
23,38,50,23,874,897
15,38,50,173,570,743
29,38,50,319,1102,1421
15,42,54,172,630,802
1,1912,3400,1352,1912,3264
1,1252,2295,538,1252,1790
2,1252,2295,1765,2504,4269
2,420,769,636,840,1476
1,1252,2295,951,1252,2203
3,1266,2320,2884,3798,6682
1,1266,2320,1008,1266,2274
1,308,565,251,308,559
1,487,783,280,487,767
1,2171,3578,656,2171,2827
1,1555,2443,497,1555,2052
1,344,540,126,344,470
18,26,70,779,468,1247
26,26,70,1126,676,1802
6,1,2,3,6,9
19,1,2,14,19,33
7,1,2,5,7,12
26,9,25,312,234,546
6,9,25,72,54,126
17,2,5,50,34,84
2,2,5,6,4,10
17,1,2,11,17,28
21,1,2,13,21,34
20,13,35,433,260,693
20,1,2,11,20,31
8,1,2,4,8,12
6,2,5,18,12,30
15,9,25,161,135,296
8,1,2,8,8,16
11,1,2,11,11,22
29,2,5,86,58,144
9,2,5,27,18,45
29,1,2,17,29,46
21,1,4,57,21,78
17,1,2,16,17,33
13,1,2,12,13,25
18,8,21,219,144,363
27,8,21,232,216,448
9,8,21,113,72,185
20,8,21,252,160,412
24,2,5,70,48,118
1,1482,2384,568,1482,2050
3,461,742,554,1383,1937
1,461,742,185,461,646
8,24,64,315,192,507
2,59,159,130,118,248
26,2,5,55,52,107
16,2,5,34,32,66
21,4,10,88,84,172
5,4,10,21,20,41
1,4,10,5,4,9
1,4,10,5,4,9
4,2,5,12,8,20
27,2,5,80,54,134
9,4,10,52,36,88
15,2,5,35,30,65
8,4,10,47,32,79
2,4,10,12,8,20
9,2,5,17,18,35
27,2,5,51,54,105
4,2,5,12,8,20
20,2,5,59,40,99
26,7,9,1,182,183
27,7,9,1,189,190
17,3,8,82,51,133
30,3,8,107,90,197
23,3,8,108,69,177
17,8,22,234,136,370
19,8,22,174,152,326
24,8,22,331,192,523
29,8,22,291,232,523
1,9,24,15,9,24
5,13,35,79,65,144
4,13,35,87,52,139
31,13,35,530,403,933
20,13,35,314,260,574
18,13,35,264,234,498
18,13,35,383,234,617
5,13,35,107,65,172
8,13,35,126,104,230
11,13,35,238,143,381
22,13,35,315,286,601
31,21,55,935,651,1586
4,21,55,88,84,172
11,42,54,25,462,487
11,38,50,61,418,479
9,38,50,104,342,446
19,38,50,19,722,741
1,1252,2295,1020,1252,2272
1,1252,2295,722,1252,1974
3,295,540,703,885,1588
1,713,1120,205,713,918
28,26,70,1212,728,1940
19,26,70,543,494,1037
5,26,70,213,130,343
24,26,70,686,624,1310
23,26,70,996,598,1594
12,3,9,48,36,84
25,3,9,146,75,221
4,1,4,12,4,16
18,13,35,390,234,624
14,13,35,303,182,485
21,1,2,20,21,41
28,1,2,27,28,55
26,12,33,512,312,824
3,12,33,59,36,95
12,11,30,178,132,310
6,11,30,89,66,155
14,2,5,41,28,69
1,2,5,3,2,5
24,1,2,15,24,39
22,1,2,14,22,36
22,11,30,273,242,515
26,11,30,322,286,608
2,1,2,1,2,3
20,12,33,314,240,554
9,1,2,7,9,16
12,1,2,7,12,19
22,1,2,21,22,43
17,2,5,49,34,83
26,2,5,75,52,127
10,2,5,19,20,39
9,2,5,17,18,35
16,1,4,44,16,60
24,2,5,67,48,115
18,2,5,50,36,86
22,12,33,302,264,566
29,12,33,398,348,746
29,12,33,398,348,746
14,2,5,33,28,61
18,2,5,42,36,78
18,2,5,42,36,78
6,2,5,17,12,29
5,9,25,78,45,123
23,9,25,357,207,564
15,9,25,233,135,368
1,1482,2384,854,1482,2336
16,45,120,931,720,1651
16,3,9,93,48,141
30,3,9,175,90,265
19,2,5,53,38,91
1,2,5,3,2,5
7,2,5,13,14,27
15,2,5,42,30,72
16,2,5,42,32,74
29,3,9,169,87,256
28,2,5,78,56,134
27,2,5,76,54,130
22,7,9,40,154,194
1,7,9,2,7,9
3,7,9,0,21,21
4,7,9,5,28,33
28,7,9,46,196,242
12,7,9,20,84,104
15,3,8,58,45,103
3,3,8,14,9,23
7,3,8,25,21,46
24,8,22,262,192,454
21,8,22,192,168,360
18,8,22,248,144,392
26,8,22,358,208,566
32,8,22,441,256,697
18,9,24,266,162,428
27,9,24,392,243,635
16,9,24,225,144,369
10,13,35,175,130,305
24,13,35,419,312,731
29,13,35,628,377,1005
20,13,35,426,260,686
21,13,35,344,273,617
20,13,35,412,260,672
2,13,35,43,26,69
1,13,35,20,13,33
4,13,35,85,52,137
2,13,35,41,26,67
1,13,35,16,13,29
8,13,35,131,104,235
5,13,35,87,65,152
15,13,35,236,195,431
10,13,35,175,130,305
1,42,54,11,42,53
2,42,54,0,84,84
11,42,54,108,462,570
9,42,54,98,378,476
23,38,50,35,874,909
1,42,54,10,42,52
17,38,50,51,646,697
1,1252,2295,722,1252,1974
1,1266,2320,752,1266,2018
1,1252,2295,1020,1252,2272
2,1252,2295,1489,2504,3993
1,1252,2295,951,1252,2203
1,420,769,318,420,738
1,295,540,148,295,443
3,487,783,841,1461,2302
1,2171,3578,835,2171,3006
1,2171,3578,942,2171,3113
1,1555,2443,375,1555,1930
2,344,540,349,688,1037
1,344,540,174,344,518
3,344,540,523,1032,1555
29,26,70,1195,754,1949
32,26,70,1094,832,1926
9,26,70,276,234,510
24,3,9,140,72,212
20,2,5,47,40,87
15,2,5,35,30,65
19,9,25,204,171,375
22,1,2,14,22,36
3,1,2,2,3,5
7,2,5,21,14,35
13,2,5,38,26,64
10,2,5,30,20,50
15,2,5,44,30,74
23,11,29,327,253,580
16,11,29,228,176,404
3,1,2,2,3,5
23,1,2,13,23,36
10,1,2,6,10,16
22,2,5,64,44,108
23,2,5,67,46,113
2,9,25,32,18,50
22,2,5,62,44,106
20,1,2,13,20,33
6,1,2,4,6,10
29,1,4,82,29,111
6,9,25,90,54,144
18,9,25,270,162,432
14,9,25,210,126,336
19,2,5,45,38,83
10,8,21,90,80,170
16,8,21,144,128,272
10,1,2,7,10,17
14,1,2,14,14,28
23,1,2,23,23,46
17,1,2,16,17,33
29,2,5,67,58,125
22,2,5,51,44,95
15,1,2,14,15,29
24,1,2,23,24,47
4,2,5,12,8,20
30,2,5,71,60,131
2,1482,2384,1041,2964,4005
1,45,120,53,45,98
6,4,10,25,24,49
1,4,10,4,4,8
11,3,9,48,33,81
29,3,9,127,87,214
4,4,10,18,16,34
28,4,10,123,112,235
22,3,9,130,66,196
26,2,5,53,52,105
23,2,5,47,46,93
15,2,5,44,30,74
10,3,9,41,30,71
9,3,9,37,27,64
20,2,5,58,40,98
26,2,5,73,52,125
12,2,5,34,24,58
9,2,5,18,18,36
16,2,5,31,32,63
1,2,5,3,2,5
11,2,5,21,22,43
5,2,5,10,10,20
1,2,5,2,2,4
12,2,5,35,24,59
8,2,5,24,16,40
1,2,5,3,2,5
7,3,9,34,21,55
24,3,9,116,72,188
15,2,5,29,30,59
10,2,5,20,20,40
22,7,9,42,154,196
2,7,9,1,14,15
11,3,8,44,33,77
7,3,8,25,21,46
11,3,8,41,33,74
27,3,8,131,81,212
26,3,8,126,78,204
9,3,8,44,27,71
9,8,22,122,72,194
19,8,22,258,152,410
27,8,22,336,216,552
5,8,22,69,40,109
22,8,22,289,176,465
10,9,24,119,90,209
30,9,24,443,270,713
5,9,24,73,45,118
7,13,35,149,91,240
7,13,35,152,91,243
1,13,35,15,13,28
18,13,35,264,234,498
13,13,35,186,169,355
14,13,35,200,182,382
9,13,35,192,117,309
5,13,35,103,65,168
3,13,35,62,39,101
13,13,35,186,169,355
1,13,35,21,13,34
21,13,35,447,273,720
16,13,35,341,208,549
5,13,35,108,65,173
30,13,35,639,390,1029
10,21,55,252,210,462
10,21,55,329,210,539
7,21,55,165,147,312
29,42,54,144,1218,1362
19,42,54,95,798,893
1,38,50,3,38,41
5,42,54,57,210,267
20,42,54,89,840,929
1,38,50,9,38,47
22,38,50,121,836,957
1,1898,3375,1038,1898,2936
1,1912,3400,876,1912,2788
1,1252,2295,951,1252,2203
1,1252,2295,1020,1252,2272
2,420,769,421,840,1261
3,420,769,955,1260,2215
3,295,540,443,885,1328
1,1266,2320,1008,1266,2274
1,1266,2320,1008,1266,2274
1,1555,2443,448,1555,2003
2,2171,3578,1884,4342,6226
2,2171,3578,1311,4342,5653
3,2171,3578,1967,6513,8480
1,2171,3578,727,2171,2898
2,2171,3578,1311,4342,5653
2,344,540,154,688,842
1,713,1120,362,713,1075
1,1083,1701,261,1083,1344
1,344,540,99,344,443
1,713,1120,172,713,885
8,26,70,274,208,482
25,26,70,715,650,1365
27,26,70,1169,702,1871
4,3,9,23,12,35
12,3,9,64,36,100
30,9,25,383,270,653
18,9,25,230,162,392
3,9,25,32,27,59
24,9,25,258,216,474
24,1,2,23,24,47
17,1,2,11,17,28
27,1,2,17,27,44
26,1,2,17,26,43
19,2,5,56,38,94
10,1,2,10,10,20
21,1,2,21,21,42
15,2,5,29,30,59
20,2,5,38,40,78
14,1,2,12,14,26
6,9,25,95,54,149
18,9,25,284,162,446
27,1,2,16,27,43
9,1,2,5,9,14
18,2,5,34,36,70
11,2,5,21,22,43
4,1,4,8,4,12
4,1,4,8,4,12
27,1,4,57,27,84
17,2,5,49,34,83
23,2,5,67,46,113
15,1,4,43,15,58
15,1,4,43,15,58
25,1,2,25,25,50
3,1,2,3,3,6
9,1,2,9,9,18
16,2,5,47,32,79
12,11,30,152,132,284
24,9,25,300,216,516
20,9,25,250,180,430
11,1,4,31,11,42
12,1,4,34,12,46
10,1,4,29,10,39
6,1,4,18,6,24
11,1,2,8,11,19
23,1,2,17,23,40
22,1,4,62,22,84
1,1,4,3,1,4
21,8,21,264,168,432
22,8,21,277,176,453
17,1,2,10,17,27
8,1,2,4,8,12
25,1,2,14,25,39
1,1482,2384,521,1482,2003
1,1482,2384,592,1482,2074
6,45,120,443,270,713
14,2,5,39,28,67
25,2,5,48,50,98
27,2,5,51,54,105
12,2,5,35,24,59
7,2,5,20,14,34
6,4,10,35,24,59
22,2,5,51,44,95
2,2,5,5,4,9
4,2,5,9,8,17
23,2,5,53,46,99
23,4,10,108,92,200
27,2,5,63,54,117
20,2,5,47,40,87
18,2,5,52,36,88
9,2,5,26,18,44
18,2,5,52,36,88
31,2,5,73,62,135
6,2,5,14,12,26
15,3,9,87,45,132
24,3,9,140,72,212
14,3,9,66,42,108
1,3,9,6,3,9
26,2,5,75,52,127
9,2,5,26,18,44
28,2,5,83,56,139
10,2,5,30,20,50
12,3,9,64,36,100
23,3,9,124,69,193
11,2,5,32,22,54
23,7,9,44,161,205
16,7,9,6,112,118
24,7,9,3,168,171
26,7,9,22,182,204
8,7,9,15,56,71
29,7,9,21,203,224
19,7,9,14,133,147
17,7,9,14,119,133
4,7,9,7,28,35
5,3,8,24,15,39
21,8,22,285,168,453
1,8,22,9,8,17
11,8,22,149,88,237
11,8,22,149,88,237
26,8,22,284,208,492
7,8,22,78,56,134
12,8,22,165,96,261
18,8,22,197,144,341
24,9,24,256,216,472
5,9,24,59,45,104
12,9,24,168,108,276
22,13,35,345,286,631
1,13,35,16,13,29
9,13,35,192,117,309
22,13,35,315,286,601
16,13,35,341,208,549
6,13,35,105,78,183
1,13,35,21,13,34
6,13,35,105,78,183
14,13,35,303,182,485
30,13,35,440,390,830
13,13,35,277,169,446
10,13,35,171,130,301
15,13,35,320,195,515
13,13,35,268,169,437
26,13,35,454,338,792
18,13,35,314,234,548
13,13,35,268,169,437
24,13,35,343,312,655
6,13,35,94,78,172
17,13,35,243,221,464
11,21,55,241,231,472
21,21,55,702,441,1143
18,42,54,90,756,846
10,42,54,23,420,443
2,42,54,5,84,89
26,38,50,104,988,1092
24,42,54,120,1008,1128
12,38,50,132,456,588
14,42,54,62,588,650
16,38,50,88,608,696
26,42,54,17,1092,1109
1,1898,3375,937,1898,2835
1,1266,2320,729,1266,1995
1,1266,2320,544,1266,1810
1,420,769,249,420,669
1,1266,2320,1008,1266,2274
1,1266,2320,636,1266,1902
3,1252,2295,1890,3756,5646
1,2171,3578,1264,2171,3435
1,1555,2443,448,1555,2003
3,2171,3578,2826,6513,9339
2,1555,2443,1434,3110,4544
1,1083,1701,397,1083,1480
1,344,540,185,344,529
1,1083,1701,346,1083,1429
1,1083,1701,550,1083,1633
2,2171,3578,1812,4342,6154
18,26,70,565,468,1033
26,26,70,744,676,1420
13,26,70,472,338,810
29,1,2,28,29,57
1,1,2,1,1,2
1,1,2,1,1,2
9,13,35,141,117,258
14,13,35,298,182,480
28,2,5,66,56,122
18,2,5,42,36,78
23,1,2,21,23,44
27,1,2,25,27,52
12,1,2,11,12,23
13,2,5,38,26,64
16,2,5,46,32,78
10,2,5,28,20,48
5,1,4,14,5,19
25,1,4,71,25,96
5,2,5,15,10,25
15,2,5,44,30,74
14,1,2,10,14,24
24,2,5,70,48,118
16,11,30,242,176,418
6,1,2,4,6,10
5,1,2,4,5,9
6,1,2,4,6,10
3,2,5,6,6,12
24,2,5,46,48,94
15,2,5,35,30,65
2,2,5,5,4,9
12,2,5,28,24,52
23,2,5,61,46,107
2,2,5,5,4,9
8,1,2,6,8,14
8,1,2,6,8,14
13,2,5,38,26,64
26,2,5,77,52,129
16,2,5,47,32,79
6,1,2,4,6,10
4,1,2,3,4,7
17,2,5,48,34,82
5,12,33,74,60,134
29,12,33,427,348,775
23,1,2,17,23,40
5,2,5,12,10,22
4,2,5,9,8,17
4,1,2,3,4,7
28,1,2,21,28,49
21,11,30,386,231,617
30,12,33,472,360,832
19,12,33,299,228,527
3,8,21,36,24,60
1,1,2,1,1,2
8,1,2,8,8,16
19,1,2,18,19,37
16,9,25,168,144,312
1,9,25,11,9,20
7,1,2,5,7,12
12,1,2,9,12,21
25,2,5,74,50,124
6,2,5,17,12,29
23,2,5,67,46,113
18,1,4,38,18,56
16,1,4,34,16,50
1,12,33,20,12,32
17,12,33,335,204,539
22,9,25,231,198,429
21,9,25,221,189,410
14,1,2,8,14,22
14,1,2,8,14,22
13,1,2,7,13,20
17,9,25,264,153,417
1,9,25,16,9,25
14,9,25,217,126,343
1,2,5,3,2,5
1,2,5,3,2,5
1,1482,2384,854,1482,2336
1,1482,2384,854,1482,2336
1,755,1215,375,755,1130
2,1482,2384,1184,2964,4148
1,461,742,266,461,727
13,24,64,503,312,815
2,59,159,133,118,251
14,2,5,41,28,69
13,2,5,38,26,64
10,2,5,21,20,41
8,2,5,16,16,32
8,4,10,31,32,63
21,4,10,82,84,166
3,2,5,6,6,12
2,3,9,9,6,15
11,3,9,48,33,81
30,4,10,174,120,294
19,4,10,110,76,186
12,2,5,35,24,59
29,2,5,68,58,126
29,2,5,68,58,126
29,2,5,68,58,126
3,3,9,17,9,26
26,3,9,147,78,225
15,3,9,68,45,113
10,3,9,46,30,76
15,2,5,35,30,65
13,2,5,31,26,57
21,3,9,124,63,187
21,7,9,17,147,164
7,7,9,5,49,54
29,7,9,24,203,227
23,7,9,9,161,170
18,7,9,33,126,159
18,3,8,60,54,114
13,3,8,50,39,89
9,8,22,82,72,154
8,8,22,108,64,172
7,8,22,73,56,129
7,9,24,98,63,161
23,9,24,323,207,530
14,9,24,203,126,329
16,9,24,159,144,303
6,13,35,105,78,183
5,13,35,108,65,173
22,13,35,430,286,716
29,13,35,506,377,883
15,13,35,262,195,457
25,13,35,541,325,866
5,13,35,87,65,152
28,13,35,577,364,941
23,13,35,401,299,700
17,13,35,362,221,583
27,13,35,462,351,813
14,13,35,288,182,470
5,13,35,107,65,172
20,13,35,426,260,686
19,13,35,405,247,652
2,13,35,29,26,55
13,21,55,328,273,601
9,21,55,301,189,490
16,21,55,535,336,871
22,42,54,240,924,1164
9,42,54,45,378,423
3,38,50,30,114,144
28,38,50,308,1064,1372
14,42,54,153,588,741
2,1266,2320,1087,2532,3619
1,1252,2295,997,1252,2249
1,1266,2320,544,1266,1810
1,1266,2320,729,1266,1995
1,420,769,295,420,715
1,295,540,234,295,529
1,1252,2295,951,1252,2203
3,420,769,955,1260,2215
1,2171,3578,942,2171,3113
1,2171,3578,942,2171,3113
3,1083,1701,1803,3249,5052
1,1555,2443,570,1555,2125
2,2171,3578,1311,4342,5653
2,1083,1701,624,2166,2790
1,344,540,77,344,421
1,487,783,132,487,619
1,713,1120,205,713,918
15,3,9,60,45,105
18,3,9,77,54,131
17,1,4,50,17,67
24,9,25,300,216,516
19,9,25,238,171,409
13,8,21,112,104,216
1,8,21,9,8,17
23,8,21,198,184,382
25,13,35,358,325,683
19,9,25,228,171,399
20,9,25,240,180,420
6,1,2,3,6,9
25,1,2,14,25,39
3,1,2,3,3,6
18,1,2,17,18,35
27,9,25,344,243,587
9,9,25,115,81,196
11,1,2,8,11,19
24,1,2,18,24,42
17,13,35,297,221,518
1,13,35,17,13,30
3,2,5,9,6,15
1,2,5,3,2,5
24,2,5,70,48,118
10,1,2,10,10,20
14,11,30,211,154,365
7,11,30,106,77,183
28,11,30,423,308,731
11,11,30,166,121,287
4,2,5,12,8,20
2,2,5,6,4,10
19,9,25,219,171,390
27,9,25,311,243,554
10,11,30,142,110,252
28,13,35,459,364,823
4,1,4,12,4,16
29,1,4,85,29,114
7,1,2,5,7,12
12,1,2,9,12,21
26,1,4,59,26,85
21,1,2,18,21,39
24,1,2,21,24,45
1,1,2,1,1,2
19,1,2,18,19,37
19,2,5,55,38,93
22,1,4,64,22,86
25,8,21,257,200,457
22,8,21,226,176,402
1,1,2,1,1,2
6,1,2,6,6,12
5,1,2,4,5,9
15,1,2,11,15,26
16,1,2,12,16,28
1,755,1215,229,755,984
3,1482,2384,2563,4446,7009
1,461,742,125,461,586
7,24,64,199,168,367
5,59,159,309,295,604
12,3,9,53,36,89
18,3,9,79,54,133
6,4,10,35,24,59
13,2,5,38,26,64
10,2,5,23,20,43
31,3,9,141,93,234
7,3,9,32,21,53
8,2,5,21,16,37
15,2,5,35,30,65
13,3,9,77,39,116
14,7,9,10,98,108
2,7,9,2,14,16
17,7,9,31,119,150
17,7,9,6,119,125
17,7,9,14,119,133
19,7,9,36,133,169
15,3,8,74,45,119
24,3,8,116,72,188
23,3,8,111,69,180
26,3,8,93,78,171
3,8,22,41,24,65
3,8,22,30,24,54
27,8,22,366,216,582
5,8,22,69,40,109
4,9,24,48,36,84
19,13,35,272,247,519
21,13,35,286,273,559
8,13,35,114,104,218
2,13,35,33,26,59
6,13,35,94,78,172
10,13,35,196,130,326
20,13,35,433,260,693
20,13,35,426,260,686
20,13,35,426,260,686
13,13,35,277,169,446
16,42,54,175,672,847
7,38,50,81,266,347
25,42,54,125,1050,1175
1,38,50,9,38,47
27,42,54,295,1134,1429
1,420,769,334,420,754
2,1266,2320,1273,2532,3805
2,487,783,310,974,1284
1,2171,3578,835,2171,3006
1,1555,2443,839,1555,2394
1,344,540,185,344,529
9,26,70,314,234,548
9,26,70,257,234,491
7,26,70,303,182,485
14,13,35,298,182,480
32,13,35,682,416,1098
25,2,5,73,50,123
20,13,35,433,260,693
9,13,35,195,117,312
7,13,35,152,91,243
3,11,29,38,33,71
14,2,5,41,28,69
30,2,5,87,60,147
29,2,5,86,58,144
12,9,25,186,108,294
3,9,25,47,27,74
23,1,2,22,23,45
1,11,30,12,11,23
10,11,30,118,110,228
6,1,2,4,6,10
21,1,2,16,21,37
14,9,25,221,126,347
23,1,2,23,23,46
4,1,2,4,4,8
16,9,25,184,144,328
28,2,5,74,56,130
11,2,5,29,22,51
1,1,2,1,1,2
4,9,25,62,36,98
29,9,25,450,261,711
10,1,4,21,10,31
26,1,2,15,26,41
7,1,2,4,7,11
27,2,5,62,54,116
14,2,5,32,28,60
10,8,21,126,80,206
24,1,2,13,24,37
14,1,2,8,14,22
15,1,2,15,15,30
7,24,64,271,168,439
11,24,64,271,264,535
23,24,64,817,552,1369
7,59,159,689,413,1102
6,59,159,581,354,935
29,2,5,86,58,144
17,2,5,50,34,84
20,2,5,59,40,99
28,2,5,74,56,130
6,4,10,35,24,59
21,4,10,122,84,206
26,4,10,146,104,250
22,4,10,123,88,211
21,3,9,101,63,164
11,3,9,53,33,86
16,4,10,61,64,125
7,4,10,27,28,55
26,2,5,75,52,127
3,2,5,9,6,15
25,7,9,48,175,223
6,7,9,11,42,53
18,7,9,33,126,159
18,7,9,33,126,159
10,7,9,16,70,86
4,7,9,2,28,30
12,3,8,59,36,95
9,3,8,44,27,71
14,3,8,45,42,87
2,8,22,18,16,34
19,9,24,221,171,392
14,9,24,163,126,289
23,13,35,337,299,636
24,13,35,511,312,823
14,13,35,215,182,397
15,13,35,262,195,457
30,13,35,440,390,830
4,13,35,82,52,134
28,13,35,577,364,941
5,13,35,87,65,152
20,13,35,412,260,672
19,13,35,405,247,652
13,13,35,227,169,396
3,38,50,33,114,147
1,42,54,11,42,53
26,38,50,286,988,1274
21,38,50,105,798,903
1,1266,2320,1008,1266,2274
3,1252,2295,2991,3756,6747
1,2171,3578,1264,2171,3435
2,2171,3578,1884,4342,6226
2,2171,3578,1884,4342,6226
3,1083,1701,1650,3249,4899
2,487,783,529,974,1503
1,713,1120,250,713,963
1,1083,1701,550,1083,1633
3,344,540,377,1032,1409
1,1083,1701,312,1083,1395
3,2171,3578,4006,6513,10519
14,26,70,606,364,970
26,26,70,889,676,1565
5,26,70,164,130,294
24,3,9,140,72,212
23,3,9,130,69,199
11,1,2,7,11,18
6,1,2,4,6,10
7,2,5,20,14,34
16,2,5,47,32,79
7,2,5,21,14,35
18,2,5,53,36,89
9,2,5,27,18,45
19,2,5,56,38,94
3,11,30,45,33,78
11,11,30,166,121,287
27,11,30,408,297,705
12,12,33,248,144,392
20,12,33,413,240,653
8,2,5,19,16,35
29,2,5,68,58,126
7,2,5,21,14,35
3,2,5,9,6,15
1,2,5,3,2,5
3,11,30,55,33,88
11,9,25,146,99,245
6,9,25,80,54,134
9,1,2,5,9,14
8,1,2,5,8,13
23,1,2,21,23,44
6,1,2,6,6,12
25,1,2,24,25,49
24,1,2,23,24,47
29,1,2,16,29,45
25,1,2,14,25,39
1,1,2,1,1,2
7,1,2,7,7,14
29,1,4,85,29,114
18,1,4,53,18,71
14,1,4,41,14,55
1,1,4,3,1,4
23,1,4,50,23,73
27,1,4,66,27,93
1,1482,2384,878,1482,2360
1,1482,2384,854,1482,2336
1,59,159,75,59,134
1,3,9,6,3,9
6,3,9,35,18,53
17,2,5,32,34,66
21,2,5,40,42,82
27,3,9,123,81,204
13,3,9,59,39,98
2,2,5,6,4,10
6,2,5,17,12,29
9,2,5,26,18,44
9,2,5,26,18,44
19,4,10,106,76,182
7,2,5,15,14,29
9,2,5,25,18,43
29,2,5,81,58,139
21,3,9,113,63,176
6,3,9,32,18,50
21,2,5,56,42,98
31,2,5,91,62,153
1,2,5,3,2,5
9,2,5,25,18,43
16,2,5,38,32,70
25,2,5,59,50,109
21,7,9,38,147,185
23,7,9,9,161,170
29,7,9,53,203,256
13,7,9,11,91,102
15,7,9,21,105,126
7,3,8,34,21,55
22,8,22,303,176,479
22,8,22,298,176,474
1,8,22,14,8,22
27,8,22,366,216,582
27,8,22,366,216,582
25,9,24,249,225,474
19,9,24,276,171,447
9,9,24,120,81,201
4,9,24,56,36,92
1,9,24,15,9,24
12,9,24,128,108,236
18,13,35,383,234,617
29,13,35,628,377,1005
4,13,35,87,52,139
13,13,35,277,169,446
25,13,35,515,325,840
24,13,35,394,312,706
14,13,35,288,182,470
16,13,35,341,208,549
6,13,35,130,78,208
1,13,35,21,13,34
15,21,55,378,315,693
16,38,50,160,608,768
20,38,50,230,760,990
10,42,54,109,420,529
26,38,50,286,988,1274
21,42,54,229,882,1111
27,42,54,295,1134,1429
13,42,54,2,546,548
4,38,50,46,152,198
12,42,54,8,504,512
30,38,50,165,1140,1305
1,1898,3375,1443,1898,3341
1,420,769,334,420,754
1,1266,2320,1008,1266,2274
1,420,769,249,420,669
1,1252,2295,745,1252,1997
1,308,565,246,308,554
2,1266,2320,1922,2532,4454
1,2171,3578,1335,2171,3506
1,1083,1701,550,1083,1633
3,2171,3578,3792,6513,10305
2,2171,3578,2528,4342,6870
2,2171,3578,1669,4342,6011
1,2171,3578,620,2171,2791
3,713,1120,1154,2139,3293
1,344,540,99,344,443
1,344,540,185,344,529
1,713,1120,172,713,885
3,1083,1701,1497,3249,4746
1,713,1120,172,713,885
1,2171,3578,1335,2171,3506
21,26,70,733,546,1279
21,26,70,601,546,1147
10,26,70,286,260,546
20,3,9,116,60,176
13,3,9,62,39,101
5,3,9,29,15,44
5,3,9,29,15,44
21,3,9,84,63,147
5,1,4,15,5,20
17,1,4,50,17,67
17,1,4,50,17,67
2,1,2,2,2,4
1,1,2,1,1,2
1,13,35,17,13,30
21,2,5,59,42,101
19,2,5,53,38,91
28,2,5,83,56,139
1,2,5,3,2,5
11,2,5,32,22,54
20,1,4,59,20,79
15,1,4,44,15,59
14,1,4,41,14,55
7,9,25,105,63,168
12,9,25,180,108,288
23,2,5,67,46,113
6,2,5,17,12,29
21,2,5,48,42,90
8,2,5,18,16,34
12,2,5,34,24,58
7,2,5,20,14,34
14,2,5,39,28,67
18,1,2,12,18,30
13,1,2,9,13,22
25,11,30,340,275,615
10,2,5,24,20,44
1,2,5,2,2,4
15,12,33,236,180,416
28,12,33,440,336,776
19,12,33,299,228,527
11,1,2,7,11,18
10,1,4,29,10,39
2,1,4,6,2,8
14,1,4,41,14,55
14,2,5,41,28,69
1,2,5,3,2,5
2,2,5,4,4,8
1,2,5,2,2,4
23,11,30,423,253,676
11,1,4,32,11,43
26,1,2,15,26,41
25,1,2,14,25,39
10,1,2,6,10,16
14,12,33,285,168,453
23,2,5,67,46,113
32,2,5,93,64,157
15,1,4,44,15,59
16,8,21,201,128,329
6,8,21,75,48,123
5,8,21,63,40,103
5,2,5,15,10,25
30,2,5,87,60,147
22,1,2,14,22,36
2,1,2,1,2,3
1,1482,2384,807,1482,2289
1,1482,2384,807,1482,2289
1,755,1215,375,755,1130
2,461,742,369,922,1291
6,2,5,18,12,30
23,2,5,68,46,114
3,4,10,13,12,25
8,4,10,34,32,66
14,2,5,32,28,60
23,2,5,53,46,99
28,2,5,64,56,120
16,2,5,37,32,69
30,4,10,123,120,243
10,4,10,59,40,99
5,4,10,30,20,50
15,2,5,29,30,59
20,2,5,58,40,98
31,2,5,90,62,152
19,2,5,45,38,83
30,2,5,89,60,149
8,2,5,24,16,40
1,2,5,2,2,4
10,2,5,24,20,44
18,7,9,30,126,156
18,7,9,13,126,139
20,7,9,8,140,148
24,7,9,44,168,212
11,7,9,18,77,95
24,7,9,44,168,212
9,7,9,7,63,70
2,3,8,10,6,16
16,3,8,57,48,105
21,8,22,211,168,379
11,8,22,110,88,198
22,8,22,298,176,474
18,8,22,248,144,392
9,8,22,98,72,170
4,9,24,59,36,95
27,9,24,399,243,642
23,9,24,268,207,475
15,9,24,218,135,353
19,9,24,276,171,447
4,13,35,57,52,109
3,13,35,64,39,103
27,13,35,585,351,936
24,13,35,494,312,806
26,13,35,563,338,901
18,13,35,390,234,624
30,13,35,618,390,1008
7,13,35,122,91,213
6,13,35,124,78,202
26,13,35,554,338,892
1,13,35,22,13,35
4,13,35,87,52,139
22,13,35,453,286,739
11,13,35,238,143,381
28,13,35,400,364,764
2,13,35,41,26,67
17,21,55,569,357,926
25,21,55,561,525,1086
10,21,55,329,210,539
14,21,55,468,294,762
30,42,54,149,1260,1409
7,38,50,11,266,277
19,38,50,219,722,941
15,42,54,164,630,794
17,42,54,186,714,900
12,42,54,53,504,557
2,1266,2320,2015,2532,4547
1,1266,2320,1008,1266,2274
1,1266,2320,961,1266,2227
1,308,565,184,308,492
1,1266,2320,636,1266,1902
1,420,769,180,420,600
3,295,540,703,885,1588
2,308,565,469,616,1085
1,308,565,138,308,446
1,308,565,251,308,559
3,420,769,747,1260,2007
2,1555,2443,1678,3110,4788
1,713,1120,396,713,1109
1,713,1120,250,713,963
2,344,540,349,688,1037
13,26,70,563,338,901
27,26,70,1150,702,1852
13,26,70,554,338,892
18,26,70,590,468,1058
1,26,70,43,26,69
12,26,70,520,312,832
7,3,9,41,21,62
1,2,5,2,2,4
27,2,5,57,54,111
18,9,25,284,162,446
6,9,25,95,54,149
6,9,25,95,54,149
26,13,35,554,338,892
3,13,35,64,39,103
5,1,2,5,5,10
16,1,2,16,16,32
5,2,5,14,10,24
31,2,5,73,62,135
14,2,5,33,28,61
3,2,5,7,6,13
5,1,2,5,5,10
24,1,2,24,24,48
24,1,2,23,24,47
1,1,2,1,1,2
15,11,30,281,165,446
10,11,30,187,110,297
28,1,2,26,28,54
14,1,2,13,14,27
9,2,5,25,18,43
4,2,5,8,8,16
24,9,25,378,216,594
10,9,25,158,90,248
3,9,25,47,27,74
21,1,2,19,21,40
24,1,2,24,24,48
1,2,5,3,2,5
24,2,5,71,48,119
10,1,2,10,10,20
24,1,4,55,24,79
21,1,4,48,21,69
2,12,33,41,24,65
29,1,4,85,29,114
6,1,2,6,6,12
28,1,2,27,28,55
4,1,2,3,4,7
14,1,2,10,14,24
21,1,4,60,21,81
13,1,4,37,13,50
1,1,4,3,1,4
17,1,4,50,17,67
1,755,1215,448,755,1203
1,755,1215,436,755,1191
24,24,64,945,576,1521
18,24,64,467,432,899
14,45,120,1016,630,1646
8,59,159,775,472,1247
14,2,5,41,28,69
11,2,5,32,22,54
9,2,5,25,18,43
17,2,5,33,34,67
7,2,5,21,14,35
23,2,5,68,46,114
6,2,5,13,12,25
12,2,5,25,24,49
22,2,5,64,44,108
23,2,5,67,46,113
16,2,5,29,32,61
20,2,5,42,40,82
4,2,5,8,8,16
9,2,5,18,18,36
17,2,5,33,34,67
17,2,5,32,34,66
1,2,5,2,2,4
26,2,5,77,52,129
22,2,5,42,44,86
3,2,5,6,6,12
24,2,5,56,48,104
27,2,5,63,54,117
27,2,5,78,54,132
13,2,5,38,26,64
15,7,9,12,105,117
13,7,9,24,91,115
20,7,9,17,140,157
24,7,9,46,168,214
6,3,8,24,18,42
3,8,22,41,24,65
14,8,22,184,112,296
23,8,22,211,184,395
19,8,22,174,152,326
27,8,22,372,216,588
6,8,22,67,48,115
26,8,22,261,208,469
16,9,24,236,144,380
1,9,24,11,9,20
20,13,35,433,260,693
10,13,35,213,130,343
26,13,35,554,338,892
31,13,35,443,403,846
27,13,35,528,351,879
17,13,35,297,221,518
25,13,35,541,325,866
12,13,35,163,156,319
26,13,35,536,338,874
16,13,35,341,208,549
9,13,35,185,117,302
1,21,55,22,21,43
12,21,55,401,252,653
10,42,54,7,420,427
10,38,50,100,380,480
27,38,50,311,1026,1337
30,42,54,149,1260,1409
8,42,54,40,336,376
6,42,54,14,252,266
18,38,50,99,684,783
31,38,50,171,1178,1349
12,38,50,66,456,522
18,38,50,207,684,891
1,1252,2295,951,1252,2203
1,420,769,334,420,754
1,1252,2295,951,1252,2203
1,295,540,234,295,529
1,420,769,211,420,631
1,1252,2295,997,1252,2249
1,487,783,124,487,611
1,487,783,155,487,642
1,713,1120,205,713,918
3,1083,1701,1650,3249,4899
1,1519,2443,411,1519,1930
1,344,540,126,344,470
1,344,540,77,344,421
1,487,783,194,487,681
1,2171,3578,1335,2171,3506
13,26,70,563,338,901
3,26,70,130,78,208
13,26,70,454,338,792
27,26,70,1169,702,1871
17,3,9,100,51,151
9,3,9,53,27,80
20,1,2,17,20,37
30,1,2,26,30,56
4,1,2,4,4,8
12,1,2,12,12,24
25,11,29,443,275,718
10,2,5,24,20,44
4,1,2,3,4,7
5,1,2,4,5,9
1,11,30,15,11,26
26,11,30,478,286,764
16,11,30,294,176,470
11,9,25,165,99,264
15,1,2,11,15,26
23,2,5,64,46,110
21,1,2,16,21,37
21,1,2,16,21,37
10,2,5,29,20,49
13,2,5,38,26,64
28,1,2,20,28,48
21,1,2,15,21,36
27,1,2,15,27,42
30,1,2,17,30,47
19,2,5,56,38,94
2,2,5,6,4,10
5,8,21,61,40,101
25,8,21,304,200,504
24,8,21,292,192,484
8,2,5,22,16,38
29,2,5,81,58,139
8,1,4,18,8,26
1,1,4,2,1,3
18,1,2,18,18,36
23,1,2,23,23,46
18,1,2,18,18,36
16,1,2,16,16,32
5,2,5,12,10,22
10,2,5,24,20,44
28,2,5,66,56,122
15,1,2,15,15,30
11,2,5,31,22,53
21,2,5,59,42,101
10,9,25,155,90,245
18,9,25,279,162,441
1,461,742,229,461,690
6,3,9,34,18,52
12,4,10,71,48,119
16,4,10,94,64,158
21,2,5,40,42,82
30,2,5,84,60,144
1,2,5,3,2,5
7,2,5,20,14,34
14,4,10,66,56,122
31,2,5,76,62,138
18,2,5,44,36,80
11,2,5,32,22,54
15,2,5,44,30,74
9,2,5,21,18,39
28,2,5,66,56,122
17,2,5,40,34,74
14,2,5,33,28,61
16,7,9,26,112,138
19,7,9,36,133,169
27,7,9,3,189,192
14,7,9,19,98,117
1,3,8,3,3,6
19,8,22,174,152,326
26,8,22,358,208,566
5,8,22,69,40,109
18,8,22,201,144,345
26,8,22,364,208,572
3,8,22,33,24,57
9,9,24,133,81,214
24,9,24,256,216,472
11,13,35,173,143,316
1,13,35,14,13,27
24,13,35,520,312,832
20,13,35,314,260,574
1,13,35,20,13,33
3,13,35,64,39,103
15,13,35,220,195,415
15,13,35,220,195,415
21,13,35,433,273,706
14,13,35,205,182,387
2,13,35,39,26,65
29,21,55,970,609,1579
2,38,50,6,76,82
1,38,50,6,38,44
16,42,54,183,672,855
19,42,54,187,798,985
19,38,50,190,722,912
18,42,54,216,756,972
1,38,50,2,38,40
23,42,54,226,966,1192
2,1252,2295,1260,2504,3764
1,1266,2320,544,1266,1810
1,713,1120,362,713,1075
1,344,540,137,344,481
1,344,540,174,344,518
3,1555,2443,2591,4665,7256
20,26,70,824,520,1344
22,26,70,691,572,1263
11,3,9,48,33,81
22,3,9,124,66,190
13,3,9,63,39,102
11,3,9,45,33,78
30,3,9,121,90,211
2,2,5,4,4,8
16,2,5,30,32,62
1,2,5,2,2,4
25,2,5,59,50,109
19,2,5,40,38,78
23,9,25,247,207,454
22,9,25,237,198,435
18,2,5,35,36,71
2,2,5,6,4,10
16,2,5,46,32,78
1,1,2,1,1,2
23,1,2,15,23,38
29,1,4,82,29,111
6,1,2,5,6,11
16,1,2,14,16,30
19,1,4,40,19,59
3,1,4,6,3,9
16,2,5,38,32,70
15,1,2,13,15,28
4,1,2,3,4,7
13,2,5,36,26,62
5,2,5,14,10,24
9,1,2,5,9,14
5,8,21,43,40,83
24,8,21,206,192,398
9,2,5,26,18,44
6,1,4,18,6,24
19,1,4,55,19,74
22,1,4,47,22,69
5,8,21,61,40,101
9,8,21,109,72,181
29,2,5,61,58,119
31,2,5,65,62,127
1,1482,2384,378,1482,1860
5,45,120,333,225,558
8,59,159,596,472,1068
28,3,9,123,84,207
12,2,5,28,24,52
10,2,5,24,20,44
17,2,5,32,34,66
11,2,5,21,22,43
1,2,5,3,2,5
21,2,5,59,42,101
15,2,5,29,30,59
23,2,5,44,46,90
2,2,5,6,4,10
21,2,5,62,42,104
4,2,5,12,8,20
21,4,10,122,84,206
20,4,10,116,80,196
21,3,9,124,63,187
14,3,9,83,42,125
21,3,9,118,63,181
4,3,9,23,12,35
17,2,5,32,34,66
30,2,5,57,60,117
6,2,5,18,12,30
1,2,5,3,2,5
9,2,5,27,18,45
7,2,5,21,14,35
24,2,5,46,48,94
14,2,5,27,28,55
2,2,5,5,4,9
28,7,9,1,196,197
8,7,9,15,56,71
10,7,9,16,70,86
25,7,9,41,175,216
7,7,9,13,49,62
9,7,9,15,63,78
17,3,8,75,51,126
16,3,8,60,48,108
11,3,8,54,33,87
4,3,8,13,12,25
2,8,22,18,16,34
4,8,22,54,32,86
21,8,22,220,168,388
27,8,22,372,216,588
27,8,22,247,216,463
23,8,22,317,184,501
19,9,24,185,171,356
21,9,24,310,189,499
25,13,35,533,325,858
12,13,35,247,156,403
12,13,35,172,156,328
6,13,35,130,78,208
27,13,35,471,351,822
20,13,35,412,260,672
17,13,35,249,221,470
20,13,35,286,260,546
16,13,35,229,208,437
14,13,35,244,182,426
26,13,35,536,338,874
28,13,35,547,364,911
8,13,35,165,104,269
23,13,35,490,299,789
22,13,35,469,286,755
29,13,35,618,377,995
8,13,35,140,104,244
3,13,35,65,39,104
15,13,35,236,195,431
21,21,55,702,441,1143
26,42,54,17,1092,1109
8,38,50,12,304,316
18,42,54,90,756,846
13,38,50,13,494,507
14,38,50,14,532,546
20,38,50,60,760,820
3,1252,2295,1890,3756,5646
3,1266,2320,3023,3798,6821
3,1266,2320,2257,3798,6055
1,1252,2295,997,1252,2249
3,420,769,563,1260,1823
1,420,769,318,420,738
1,487,783,155,487,642
3,344,540,523,1032,1555
1,1083,1701,601,1083,1684
20,26,70,586,520,1106
3,26,70,130,78,208
15,3,9,85,45,130
29,8,21,334,232,566
26,8,21,300,208,508
22,8,21,254,176,430
16,13,35,341,208,549
13,13,35,277,169,446
29,13,35,618,377,995
21,2,5,59,42,101
1,13,35,20,13,33
6,13,35,128,78,206
8,13,35,170,104,274
11,11,30,206,121,327
11,11,30,206,121,327
25,9,25,288,225,513
25,9,25,288,225,513
14,1,2,10,14,24
8,2,5,22,16,38
22,11,30,372,242,614
16,11,30,270,176,446
6,1,2,3,6,9
21,1,2,16,21,37
13,1,2,10,13,23
23,2,5,68,46,114
6,2,5,18,12,30
16,2,5,47,32,79
23,9,25,362,207,569
12,9,25,189,108,297
20,2,5,47,40,87
16,2,5,38,32,70
26,1,4,59,26,85
17,1,4,39,17,56
26,2,5,75,52,127
10,2,5,29,20,49
12,1,2,12,12,24
23,1,2,23,23,46
19,2,5,55,38,93
14,2,5,41,28,69
20,2,5,56,40,96
23,11,30,423,253,676
21,8,21,216,168,384
24,8,21,246,192,438
24,9,25,372,216,588
1,755,1215,411,755,1166
1,1482,2384,878,1482,2360
2,755,1215,896,1510,2406
3,755,1215,578,2265,2843
1,1482,2384,807,1482,2289
2,1482,2384,755,2964,3719
3,1482,2384,2420,4446,6866
25,24,64,792,600,1392
4,24,64,150,96,246
27,45,120,1636,1215,2851
6,59,159,562,354,916
12,2,5,35,24,59
24,2,5,46,48,94
9,2,5,17,18,35
14,2,5,39,28,67
26,7,9,47,182,229
29,7,9,24,203,227
2,7,9,3,14,17
6,7,9,10,42,52
11,7,9,20,77,97
15,8,22,157,120,277
8,8,22,91,64,155
20,8,22,276,160,436
9,8,22,82,72,154
9,8,22,122,72,194
12,8,22,165,96,261
6,9,24,71,54,125
8,9,24,116,72,188
28,9,24,333,252,585
14,9,24,156,126,282
20,13,35,433,260,693
24,13,35,352,312,664
8,13,35,126,104,230
9,13,35,157,117,274
22,13,35,476,286,762
19,13,35,405,247,652
10,13,35,171,130,301
31,13,35,639,403,1042
15,13,35,236,195,431
11,13,35,234,143,377
10,13,35,213,130,343
1,13,35,20,13,33
13,21,55,313,273,586
19,42,54,187,798,985
27,38,50,297,1026,1323
16,38,50,184,608,792
23,38,50,253,874,1127
10,38,50,55,380,435
26,42,54,115,1092,1207
2,1252,2295,1994,2504,4498
1,1252,2295,951,1252,2203
1,1266,2320,544,1266,1810
1,308,565,189,308,497
1,713,1120,205,713,918
1,1555,2443,570,1555,2125
1,2171,3578,656,2171,2827
1,1083,1701,550,1083,1633
1,344,540,126,344,470
1,713,1120,205,713,918
1,1555,2443,864,1555,2419
1,344,540,174,344,518
3,2171,3578,4006,6513,10519
2,26,70,70,52,122
24,26,70,1022,624,1646
26,26,70,944,676,1620
2,3,9,12,6,18
29,2,5,86,58,144
14,1,2,9,14,23
8,1,2,5,8,13
31,2,5,74,62,136
9,2,5,22,18,40
23,12,33,369,276,645
17,2,5,50,34,84
1,2,5,3,2,5
6,1,4,17,6,23
14,1,4,40,14,54
17,9,25,183,153,336
16,9,25,172,144,316
25,9,25,269,225,494
20,11,30,374,220,594
4,11,30,75,44,119
3,2,5,8,6,14
8,2,5,22,16,38
11,2,5,32,22,54
8,1,4,20,8,28
23,13,35,401,299,700
8,13,35,140,104,244
14,13,35,244,182,426
17,9,25,255,153,408
26,9,25,390,234,624
22,13,35,453,286,739
26,2,5,77,52,129
21,2,5,62,42,104
3,1,2,2,3,5
28,1,2,18,28,46
17,2,5,50,34,84
29,2,5,86,58,144
19,1,2,17,19,36
8,1,2,7,8,15
6,2,5,17,12,29
4,2,5,12,8,20
28,2,5,81,56,137
15,1,2,15,15,30
5,2,5,15,10,25
29,12,33,475,348,823
21,12,33,344,252,596
13,1,2,9,13,22
12,1,2,8,12,20
20,8,21,231,160,391
15,8,21,173,120,293
24,1,2,23,24,47
1,1,2,1,1,2
3,1,2,3,3,6
28,2,5,64,56,120
5,2,5,15,10,25
25,2,5,73,50,123
11,2,5,32,22,54
4,2,5,12,8,20
16,2,5,46,32,78
18,1,2,17,18,35
25,1,2,23,25,48
30,2,5,71,60,131
29,2,5,68,58,126
25,8,21,315,200,515
20,8,21,252,160,412
7,8,21,88,56,144
16,1,4,39,16,55
14,1,4,34,14,48
1,1482,2384,473,1482,1955
1,755,1215,290,755,1045
1,1482,2384,854,1482,2336
3,1482,2384,1562,4446,6008
12,24,64,380,288,668
3,45,120,221,135,356
6,45,120,349,270,619
7,59,159,555,413,968
27,2,5,65,54,119
26,2,5,77,52,129
12,2,5,35,24,59
31,2,5,59,62,121
11,2,5,21,22,43
20,2,5,38,40,78
10,3,9,56,30,86
26,3,9,147,78,225
14,4,10,59,56,115
18,4,10,76,72,148
25,3,9,146,75,221
5,3,9,29,15,44
21,4,10,118,84,202
13,4,10,73,52,125
26,2,5,75,52,127
13,2,5,38,26,64
20,2,5,59,40,99
29,2,5,57,58,115
8,2,5,16,16,32
5,2,5,12,10,22
31,2,5,73,62,135
5,2,5,10,10,20
18,2,5,35,36,71
7,7,9,0,49,49
19,7,9,7,133,140
7,7,9,3,49,52
4,7,9,7,28,35
25,7,9,46,175,221
21,7,9,17,147,164
27,7,9,49,189,238
1,7,9,2,7,9
18,3,8,89,54,143
17,3,8,69,51,120
21,8,22,285,168,453
26,8,22,358,208,566
29,8,22,253,232,485
14,8,22,190,112,302
20,8,22,271,160,431
7,8,22,95,56,151
27,8,22,372,216,588
22,9,24,309,198,507
3,9,24,42,27,69
23,9,24,334,207,541
25,9,24,363,225,588
14,13,35,200,182,382
24,13,35,427,312,739
15,13,35,236,195,431
9,13,35,129,117,246
15,13,35,262,195,457
12,13,35,172,156,328
5,13,35,103,65,168
14,13,35,288,182,470
4,13,35,85,52,137
8,13,35,170,104,274
30,13,35,524,390,914
16,13,35,279,208,487
9,13,35,192,117,309
9,13,35,157,117,274
18,13,35,383,234,617
7,13,35,149,91,240
26,13,35,408,338,746
25,21,55,658,525,1183
8,21,55,263,168,431
25,42,54,3,1050,1053
16,38,50,0,608,608
17,42,54,39,714,753
20,38,50,60,760,820
17,42,54,39,714,753
23,42,54,52,966,1018
18,38,50,27,684,711
10,42,54,109,420,529
13,38,50,130,494,624
2,420,769,513,840,1353
1,1252,2295,538,1252,1790
1,1266,2320,729,1266,1995
1,1266,2320,1008,1266,2274
1,1252,2295,997,1252,2249
3,420,769,1024,1260,2284
1,2171,3578,1264,2171,3435
1,1555,2443,570,1555,2125
2,344,540,370,688,1058
1,344,540,185,344,529
1,2171,3578,942,2171,3113
2,487,783,310,974,1284
1,2171,3578,656,2171,2827
3,713,1120,616,2139,2755
3,713,1120,616,2139,2755
1,487,783,265,487,752
3,344,540,377,1032,1409
1,713,1120,205,713,918
1,713,1120,172,713,885
1,344,540,174,344,518
3,344,540,523,1032,1555
1,26,70,43,26,69
1,26,70,29,26,55
14,3,9,66,42,108
26,13,35,563,338,901
6,13,35,130,78,208
8,13,35,173,104,277
25,11,30,468,275,743
10,2,5,28,20,48
11,2,5,31,22,53
9,1,2,7,9,16
8,13,35,142,104,246
19,13,35,338,247,585
28,2,5,83,56,139
17,1,2,10,17,27
1,1,2,1,1,2
19,2,5,56,38,94
4,2,5,12,8,20
1,2,5,3,2,5
30,9,25,345,270,615
5,1,2,5,5,10
7,1,2,6,7,13
3,1,2,3,3,6
20,1,4,49,20,69
16,1,4,39,16,55
20,1,2,19,20,39
6,12,33,122,72,194
12,12,33,244,144,388
23,8,21,280,184,464
5,1,2,4,5,9
27,1,2,19,27,46
27,1,2,19,27,46
13,2,5,36,26,62
1,2,5,3,2,5
15,2,5,44,30,74
3,1482,2384,1419,4446,5865
1,461,742,118,461,579
1,461,742,251,461,712
1,755,1215,205,755,960
2,1482,2384,898,2964,3862
5,24,64,133,120,253
11,24,64,433,264,697
9,45,120,653,405,1058
5,59,159,333,295,628
17,2,5,39,34,73
25,4,10,95,100,195
27,2,5,51,54,105
18,2,5,34,36,70
23,2,5,67,46,113
25,2,5,73,50,123
25,2,5,73,50,123
10,2,5,29,20,49
14,4,10,83,56,139
20,2,5,47,40,87
23,2,5,68,46,114
13,2,5,38,26,64
18,4,10,104,72,176
16,4,10,93,64,157
13,2,5,25,26,51
29,3,9,171,87,258
1,3,9,6,3,9
1,3,9,4,3,7
31,3,9,127,93,220
19,2,5,55,38,93
27,2,5,78,54,132
29,7,9,55,203,258
8,7,9,7,56,63
15,7,9,29,105,134
13,7,9,11,91,102
2,7,9,3,14,17
3,7,9,5,21,26
15,7,9,2,105,107
18,3,8,67,54,121
10,3,8,48,30,78
25,8,22,345,200,545
23,8,22,312,184,496
8,8,22,108,64,172
4,8,22,55,32,87
15,9,24,221,135,356
4,9,24,58,36,94
11,9,24,162,99,261
8,13,35,173,104,277
24,13,35,343,312,655
25,13,35,533,325,858
17,13,35,350,221,571
10,13,35,217,130,347
24,13,35,494,312,806
23,13,35,329,299,628
17,13,35,291,221,512
28,13,35,606,364,970
5,13,35,107,65,172
18,13,35,314,234,548
20,13,35,433,260,693
13,13,35,281,169,450
5,13,35,108,65,173
21,13,35,300,273,573
17,13,35,368,221,589
25,13,35,515,325,840
4,13,35,57,52,109
1,13,35,14,13,27
8,13,35,165,104,269
15,21,55,502,315,817
5,38,50,58,190,248
10,42,54,50,420,470
12,38,50,138,456,594
22,38,50,22,836,858
2,38,50,20,76,96
1,38,50,11,38,49
23,38,50,253,874,1127
8,38,50,40,304,344
14,42,54,70,588,658
30,38,50,30,1140,1170
24,42,54,120,1008,1128
14,38,50,161,532,693
3,1252,2295,3060,3756,6816
2,1266,2320,2062,2532,4594
3,1252,2295,2854,3756,6610
1,1252,2295,997,1252,2249
2,420,769,683,840,1523
1,1266,2320,544,1266,1810
1,1519,2443,387,1519,1906
3,2171,3578,3792,6513,10305
3,487,783,841,1461,2302
1,713,1120,362,713,1075
1,1083,1701,397,1083,1480
3,344,540,523,1032,1555
1,713,1120,172,713,885
3,2171,3578,4006,6513,10519
1,2171,3578,1335,2171,3506
24,26,70,1039,624,1663
22,26,70,937,572,1509
12,26,70,343,312,655
9,3,9,36,27,63
2,1,2,2,2,4
14,13,35,298,182,480
5,13,35,107,65,172
14,2,5,29,28,57
22,12,33,368,264,632
18,2,5,53,36,89
5,2,5,15,10,25
18,1,2,10,18,28
21,1,2,12,21,33
6,1,2,3,6,9
21,2,5,40,42,82
26,2,5,49,52,101
16,2,5,30,32,62
16,9,25,228,144,372
28,13,35,577,364,941
4,13,35,82,52,134
15,1,2,10,15,25
14,1,2,10,14,24
3,1,2,2,3,5
11,13,35,238,143,381
10,9,25,128,90,218
19,2,5,53,38,91
3,2,5,8,6,14
13,1,4,37,13,50
23,1,4,65,23,88
30,11,30,561,330,891
17,1,4,46,17,63
16,1,4,44,16,60
26,2,5,77,52,129
14,1,4,34,14,48
6,1,2,3,6,9
20,1,2,11,20,31
32,1,2,29,32,61
18,1,2,17,18,35
15,1,2,14,15,29
12,1,2,7,12,19
10,1,2,6,10,16
22,2,5,43,44,87
22,2,5,43,44,87
18,2,5,34,36,70
25,2,5,48,50,98
8,2,5,23,16,39
7,1,2,7,7,14
16,1,2,16,16,32
3,1,2,2,3,5
14,1,2,10,14,24
23,1,4,65,23,88
19,1,4,54,19,73
4,1,4,11,4,15
22,1,4,62,22,84
13,1,4,38,13,51
6,1,2,3,6,9
24,2,5,70,48,118
25,1,4,57,25,82
2,1482,2384,1613,2964,4577
1,1482,2384,401,1482,1883
3,461,742,821,1383,2204
11,24,64,412,264,676
3,45,120,175,135,310
2,2,5,6,4,10
21,2,5,61,42,103
32,2,5,93,64,157
21,2,5,49,42,91
9,7,9,12,63,75
18,7,9,26,126,152
4,7,9,7,28,35
4,7,9,7,28,35
10,3,8,47,30,77
12,8,22,163,96,259
1,8,22,9,8,17
14,8,22,193,112,305
17,8,22,234,136,370
6,9,24,71,54,125
1,9,24,12,9,21
10,13,35,164,130,294
9,13,35,192,117,309
13,13,35,277,169,446
6,13,35,124,78,202
18,13,35,383,234,617
17,13,35,243,221,464
1,13,35,17,13,30
16,13,35,346,208,554
6,13,35,119,78,197
2,13,35,35,26,61
17,13,35,368,221,589
11,13,35,234,143,377
7,13,35,100,91,191
6,13,35,94,78,172
19,13,35,391,247,638
2,13,35,33,26,59
5,42,54,55,210,265
3,38,50,33,114,147
28,38,50,154,1064,1218
20,38,50,200,760,960
1,1266,2320,752,1266,2018
1,1266,2320,961,1266,2227
1,420,769,334,420,754
1,420,769,249,420,669
1,344,540,77,344,421
1,1083,1701,499,1083,1582
1,2171,3578,942,2171,3113
2,1083,1701,1168,2166,3334
2,713,1120,724,1426,2150
2,2171,3578,1311,4342,5653
1,344,540,174,344,518
1,344,540,83,344,427
1,26,70,43,26,69
24,26,70,703,624,1327
11,3,9,64,33,97
17,3,9,68,51,119
4,2,5,12,8,20
11,13,35,234,143,377
6,13,35,128,78,206
28,1,2,27,28,55
13,1,2,13,13,26
20,1,2,20,20,40
16,2,5,45,32,77
20,2,5,56,40,96
14,1,4,41,14,55
25,1,4,74,25,99
5,11,29,64,55,119
24,11,29,307,264,571
14,2,5,41,28,69
6,1,2,4,6,10
27,2,5,76,54,130
3,2,5,8,6,14
8,1,2,5,8,13
28,1,2,19,28,47
19,13,35,411,247,658
25,2,5,68,50,118
24,2,5,65,48,113
22,1,2,16,22,38
23,1,2,17,23,40
14,8,21,161,112,273
3,8,21,35,24,59
2,2,5,4,4,8
7,2,5,16,14,30
10,2,5,24,20,44
22,2,5,52,44,96
9,2,5,25,18,43
4,2,5,11,8,19
21,2,5,59,42,101
20,12,33,281,240,521
19,12,33,267,228,495
18,12,33,253,216,469
13,2,5,38,26,64
9,2,5,26,18,44
1,2,5,2,2,4
2,2,5,5,4,9
27,2,5,62,54,116
30,2,5,69,60,129
7,1,2,7,7,14
10,1,2,10,10,20
21,1,2,20,21,41
1,1482,2384,521,1482,2003
1,1482,2384,521,1482,2003
2,1482,2384,755,2964,3719
1,755,1215,241,755,996
29,24,64,1141,696,1837
1,2,5,3,2,5
24,2,5,71,48,119
19,2,5,55,38,93
12,2,5,35,24,59
25,2,5,53,50,103
26,2,5,55,52,107
17,4,10,99,68,167
6,2,5,17,12,29
22,2,5,64,44,108
21,2,5,51,42,93
10,2,5,25,20,45
18,2,5,34,36,70
24,3,9,142,72,214
29,3,9,171,87,258
3,7,9,5,21,26
21,7,9,38,147,185
24,7,9,46,168,214
8,7,9,13,56,69
3,3,8,12,9,21
17,8,22,231,136,367
18,8,22,244,144,388
19,8,22,212,152,364
16,8,22,220,128,348
1,9,24,15,9,24
18,9,24,175,162,337
3,9,24,37,27,64
7,13,35,100,91,191
4,13,35,85,52,137
15,13,35,293,195,488
26,13,35,554,338,892
11,13,35,234,143,377
9,13,35,154,117,271
1,13,35,16,13,29
1,13,35,14,13,27
23,13,35,490,299,789
13,13,35,222,169,391
5,13,35,108,65,173
26,13,35,508,338,846
10,13,35,143,130,273
2,13,35,35,26,61
13,21,55,435,273,708
2,21,55,66,42,108
19,42,54,207,798,1005
22,38,50,253,836,1089
13,42,54,58,546,604
3,42,54,13,126,139
7,38,50,21,266,287
17,38,50,196,646,842
2,38,50,22,76,98
3,38,50,3,114,117
22,38,50,121,836,957
6,42,54,14,252,266
2,1266,2320,2015,2532,4547
1,1266,2320,1008,1266,2274
1,487,783,280,487,767
1,487,783,280,487,767
3,487,783,465,1461,1926
3,487,783,630,1461,2091
2,713,1120,500,1426,1926
1,713,1120,284,713,997
1,344,540,174,344,518
3,344,540,232,1032,1264
3,1083,1701,935,3249,4184
1,344,540,99,344,443
1,344,540,126,344,470
16,26,70,547,416,963
26,26,70,1071,676,1747
27,3,9,109,81,190
24,3,9,116,72,188
12,3,9,53,36,89
7,3,9,32,21,53
2,1,2,1,2,3
18,1,2,10,18,28
5,2,5,10,10,20
23,2,5,44,46,90
11,1,2,11,11,22
7,1,2,7,7,14
19,13,35,405,247,652
27,2,5,57,54,111
18,2,5,38,36,74
22,2,5,46,44,90
18,1,2,17,18,35
4,13,35,70,52,122
24,1,2,17,24,41
18,2,5,34,36,70
11,2,5,32,22,54
13,2,5,38,26,64
9,1,2,8,9,17
4,1,2,3,4,7
15,1,2,8,15,23
19,1,2,11,19,30
1,9,25,13,9,22
18,9,25,239,162,401
8,9,25,106,72,178
9,1,2,6,9,15
18,13,35,295,234,529
16,13,35,262,208,470
7,2,5,21,14,35
21,8,21,176,168,344
24,8,21,201,192,393
12,11,30,203,132,335
29,11,30,490,319,809
7,11,30,129,77,206
20,11,30,368,220,588
1,1,2,1,1,2
16,1,2,12,16,28
26,1,2,19,26,45
16,1,2,14,16,30
26,1,2,22,26,48
27,2,5,51,54,105
25,1,2,17,25,42
10,1,2,7,10,17
13,1,4,35,13,48
6,2,5,14,12,26
25,2,5,59,50,109
18,2,5,42,36,78
24,2,5,56,48,104
15,2,5,35,30,65
1,755,1215,448,755,1203
1,2,5,2,2,4
12,2,5,23,24,47
9,2,5,17,18,35
9,2,5,20,18,38
15,2,5,33,30,63
11,4,10,58,44,102
23,2,5,64,46,110
1,2,5,3,2,5
22,2,5,64,44,108
27,7,9,15,189,204
4,7,9,7,28,35
25,7,9,41,175,216
11,7,9,21,77,98
8,7,9,1,56,57
24,3,8,116,72,188
24,3,8,116,72,188
32,3,8,142,96,238
27,3,8,87,81,168
28,8,22,306,224,530
7,8,22,96,56,152
22,13,35,315,286,601
24,13,35,410,312,722
2,13,35,39,26,65
19,13,35,405,247,652
17,13,35,362,221,583
6,13,35,103,78,181
21,21,55,460,441,901
4,42,54,13,168,181
12,38,50,132,456,588
25,38,50,138,950,1088
8,42,54,18,336,354
29,38,50,29,1102,1131
20,38,50,200,760,960
2,42,54,22,84,106
2,1266,2320,2015,2532,4547
2,1252,2295,1443,2504,3947
1,1266,2320,752,1266,2018
2,2171,3578,1669,4342,6011
3,344,540,556,1032,1588
1,344,540,185,344,529
3,2171,3578,4006,6513,10519
1,2171,3578,1335,2171,3506
3,2171,3578,4006,6513,10519
16,26,70,502,416,918
8,26,70,341,208,549
24,26,70,1022,624,1646
4,26,70,117,104,221
13,1,2,12,13,25
10,1,2,10,10,20
9,2,5,17,18,35
25,2,5,48,50,98
10,13,35,213,130,343
8,2,5,21,16,37
6,2,5,16,12,28
25,1,2,22,25,47
16,12,33,252,192,444
12,12,33,189,144,333
29,1,2,19,29,48
6,1,4,17,6,23
23,1,4,65,23,88
23,2,5,54,46,100
18,1,4,53,18,71
22,1,4,60,22,82
2,461,742,354,922,1276
1,45,120,70,45,115
6,59,159,476,354,830
25,4,10,118,100,218
1,2,5,3,2,5
14,2,5,41,28,69
27,4,10,151,108,259
14,4,10,78,56,134
6,2,5,17,12,29
12,2,5,35,24,59
14,2,5,33,28,61
10,3,9,58,30,88
18,3,9,105,54,159
12,2,5,35,24,59
11,2,5,26,22,48
11,2,5,24,22,46
27,2,5,59,54,113
3,7,9,2,21,23
21,7,9,17,147,164
10,7,9,8,70,78
26,7,9,10,182,192
5,7,9,4,35,39
25,8,22,229,200,429
4,8,22,54,32,86
14,8,22,156,112,268
12,8,22,163,96,259
11,9,24,107,99,206
5,9,24,73,45,118
17,13,35,368,221,589
16,13,35,346,208,554
1,13,35,22,13,35
24,13,35,394,312,706
3,13,35,52,39,91
26,13,35,563,338,901
28,13,35,400,364,764
15,13,35,293,195,488
27,13,35,575,351,926
28,13,35,400,364,764
18,13,35,383,234,617
4,13,35,87,52,139
26,21,55,855,546,1401
14,38,50,77,532,609
13,42,54,9,546,555
17,42,54,85,714,799
23,38,50,69,874,943
12,38,50,66,456,522
14,42,54,47,588,635
3,1252,2295,3060,3756,6816
1,1252,2295,1020,1252,2272
1,1266,2320,961,1266,2227
3,1252,2295,1614,3756,5370
1,420,769,249,420,669
1,1266,2320,961,1266,2227
1,308,565,246,308,554
2,1555,2443,1434,3110,4544
1,2171,3578,942,2171,3113
1,1555,2443,497,1555,2052
1,344,540,83,344,427
11,26,70,384,286,670
8,2,5,15,16,31
28,2,5,53,56,109
25,13,35,533,325,858
1,13,35,21,13,34
10,2,5,24,20,44
16,2,5,38,32,70
3,2,5,6,6,12
13,2,5,38,26,64
11,2,5,32,22,54
17,2,5,48,34,82
15,11,29,253,165,418
26,11,29,438,286,724
6,12,33,94,72,166
8,12,33,126,96,222
25,2,5,74,50,124
10,11,30,169,110,279
25,11,30,340,275,615
29,11,30,394,319,713
23,1,2,21,23,44
13,1,2,12,13,25
5,1,2,5,5,10
17,1,2,10,17,27
19,2,5,36,38,74
15,2,5,44,30,74
7,1,4,20,7,27
24,2,5,67,48,115
2,2,5,6,4,10
19,2,5,55,38,93
1,461,742,274,461,735
19,24,64,736,456,1192
24,24,64,929,576,1505
1,59,159,97,59,156
1,59,159,65,59,124
26,2,5,51,52,103
21,2,5,41,42,83
7,4,10,41,28,69
6,4,10,35,24,59
18,4,10,106,72,178
17,4,10,100,68,168
18,2,5,53,36,89
8,4,10,46,32,78
15,4,10,87,60,147
8,4,10,47,32,79
24,4,10,142,96,238
23,4,10,136,92,228
25,4,10,148,100,248
6,2,5,17,12,29
18,2,5,52,36,88
9,2,5,26,18,44
28,2,5,81,56,137
26,2,5,60,52,112
10,2,5,23,20,43
10,2,5,24,20,44
11,2,5,26,22,48
28,2,5,66,56,122
29,2,5,68,58,126
23,2,5,67,46,113
1,2,5,3,2,5
27,7,9,3,189,192
32,7,9,52,224,276
14,7,9,27,98,125
14,7,9,4,98,102
11,7,9,20,77,97
21,7,9,38,147,185
10,3,8,40,30,70
1,8,22,14,8,22
22,8,22,202,176,378
10,8,22,138,80,218
19,8,22,262,152,414
10,8,22,98,80,178
26,8,22,290,208,498
7,9,24,103,63,166
17,9,24,251,153,404
30,9,24,443,270,713
1,9,24,15,9,24
15,9,24,218,135,353
12,9,24,174,108,282
1,9,24,12,9,21
25,13,35,533,325,858
20,13,35,426,260,686
29,13,35,506,377,883
17,13,35,368,221,589
26,13,35,399,338,737
20,13,35,293,260,553
20,13,35,433,260,693
20,13,35,426,260,686
21,13,35,455,273,728
4,13,35,87,52,139
30,13,35,650,390,1040
5,13,35,103,65,168
24,13,35,410,312,722
11,13,35,234,143,377
14,13,35,303,182,485
24,13,35,419,312,731
24,13,35,520,312,832
13,13,35,268,169,437
21,13,35,447,273,720
12,13,35,247,156,403
8,13,35,126,104,230
6,13,35,130,78,208
21,13,35,344,273,617
16,21,55,526,336,862
21,21,55,691,441,1132
18,42,54,206,756,962
13,38,50,150,494,644
7,38,50,18,266,284
17,42,54,11,714,725
18,38,50,27,684,711
1,1252,2295,997,1252,2249
1,1266,2320,1008,1266,2274
1,1898,3375,768,1898,2666
1,420,769,341,420,761
1,1252,2295,1020,1252,2272
1,1252,2295,722,1252,1974
1,1266,2320,1008,1266,2274
1,1266,2320,961,1266,2227
1,308,565,178,308,486
1,1898,3375,1410,1898,3308
1,1266,2320,1008,1266,2274
1,2171,3578,1264,2171,3435
1,2171,3578,656,2171,2827
1,713,1120,385,713,1098
1,2171,3578,763,2171,2934
1,1519,2443,606,1519,2125
1,713,1120,396,713,1109
1,2171,3578,1335,2171,3506
1,2171,3578,1335,2171,3506
3,2171,3578,4006,6513,10519
5,26,70,217,130,347
24,26,70,821,624,1445
19,26,70,809,494,1303
16,8,21,137,128,265
4,8,21,34,32,66
17,8,21,146,136,282
6,2,5,17,12,29
3,2,5,9,6,15
18,11,29,319,198,517
25,13,35,436,325,761
12,2,5,35,24,59
24,2,5,71,48,119
9,13,35,192,117,309
17,13,35,362,221,583
17,2,5,33,34,67
9,2,5,21,18,39
11,2,5,29,22,51
6,9,25,95,54,149
12,9,25,189,108,297
16,2,5,38,32,70
20,2,5,47,40,87
12,2,5,28,24,52
21,1,2,21,21,42
11,1,2,11,11,22
22,1,2,22,22,44
15,1,2,15,15,30
19,1,2,19,19,38
9,2,5,27,18,45
10,8,21,126,80,206
10,8,21,126,80,206
14,8,21,117,112,229
13,8,21,109,104,213
1,2,5,3,2,5
1,2,5,3,2,5
25,2,5,74,50,124
32,2,5,94,64,158
2,1,2,1,2,3
17,12,33,346,204,550
17,12,33,346,204,550
6,12,33,122,72,194
17,12,33,346,204,550
21,1,2,16,21,37
7,1,2,7,7,14
25,1,2,24,25,49
26,8,21,316,208,524
12,8,21,146,96,242
7,8,21,85,56,141
32,1,4,91,32,123
5,1,4,14,5,19
8,1,2,8,8,16
18,9,25,230,162,392
3,9,25,38,27,65
18,1,2,15,18,33
16,1,2,14,16,30
15,1,2,13,15,28
14,1,2,12,14,26
16,1,2,14,16,30
1,1,2,1,1,2
8,1,2,4,8,12
11,1,4,27,11,38
21,1,4,51,21,72
1,1482,2384,878,1482,2360
1,461,742,147,461,608
1,461,742,229,461,690
1,755,1215,266,755,1021
30,24,64,797,720,1517
25,24,64,792,600,1392
23,24,64,640,552,1192
21,24,64,665,504,1169
1,45,120,74,45,119
2,45,120,92,90,182
2,45,120,148,90,238
19,2,5,56,38,94
16,4,10,94,64,158
16,4,10,94,64,158
7,4,10,41,28,69
4,4,10,19,16,35
5,4,10,24,20,44
10,2,5,28,20,48
16,2,5,45,32,77
25,2,5,48,50,98
21,2,5,61,42,103
15,2,5,44,30,74
26,3,9,126,78,204
4,2,5,12,8,20
23,2,5,68,46,114
30,2,5,63,60,123
17,2,5,50,34,84
27,2,5,80,54,134
10,2,5,28,20,48
5,2,5,14,10,24
17,3,9,96,51,147
9,7,9,16,63,79
20,7,9,38,140,178
15,7,9,6,105,111
18,7,9,7,126,133
31,7,9,12,217,229
10,7,9,18,70,88
31,3,8,123,93,216
5,3,8,25,15,40
32,3,8,127,96,223
25,3,8,121,75,196
29,8,22,323,232,555
19,8,22,262,152,414
16,8,22,220,128,348
14,8,22,193,112,305
15,8,22,187,120,307
15,9,24,221,135,356
4,9,24,59,36,95
1,9,24,15,9,24
10,9,24,145,90,235
10,13,35,164,130,294
30,13,35,639,390,1029
10,13,35,206,130,336
32,13,35,693,416,1109
7,13,35,122,91,213
16,13,35,251,208,459
23,13,35,490,299,789
11,13,35,238,143,381
23,13,35,498,299,797
1,13,35,21,13,34
25,13,35,541,325,866
16,13,35,330,208,538
24,21,55,803,504,1307
6,21,55,181,126,307
24,42,54,262,1008,1270
9,38,50,104,342,446
20,38,50,110,760,870
2,38,50,22,76,98
1,38,50,11,38,49
20,38,50,230,760,990
14,38,50,42,532,574
2,1266,2320,2015,2532,4547
3,1912,3400,2322,5736,8058
1,1252,2295,630,1252,1882
1,1266,2320,1008,1266,2274
1,308,565,246,308,554
1,1898,3375,1410,1898,3308
1,2171,3578,942,2171,3113
1,1519,2443,826,1519,2345
2,2171,3578,1884,4342,6226
1,344,540,174,344,518
1,1555,2443,864,1555,2419
1,713,1120,396,713,1109
1,344,540,191,344,535
1,344,540,174,344,518
7,26,70,303,182,485
29,26,70,1256,754,2010
17,13,35,291,221,512
20,9,25,315,180,495
1,9,25,16,9,25
14,9,25,221,126,347
1,2,5,3,2,5
8,2,5,23,16,39
6,2,5,17,12,29
27,1,2,15,27,42
17,1,2,10,17,27
24,1,2,13,24,37
17,9,25,217,153,370
21,9,25,268,189,457
8,9,25,102,72,174
9,13,35,195,117,312
18,13,35,390,234,624
13,9,25,163,117,280
2,1,2,2,2,4
5,1,2,5,5,10
21,2,5,49,42,91
1,9,25,12,9,21
13,2,5,31,26,57
20,2,5,46,40,86
7,2,5,16,14,30
24,2,5,55,48,103
28,1,4,69,28,97
6,1,4,15,6,21
15,12,33,310,180,490
28,1,2,18,28,46
4,1,4,10,4,14
3,1,4,7,3,10
12,1,2,12,12,24
23,11,30,313,253,566
7,1,2,6,7,13
19,2,5,55,38,93
19,2,5,55,38,93
29,2,5,55,58,113
31,2,5,73,62,135
32,2,5,75,64,139
15,2,5,35,30,65
28,1,2,27,28,55
2,2,5,6,4,10
10,2,5,30,20,50
28,1,2,15,28,43
8,1,2,4,8,12
9,2,5,19,18,37
10,1,2,7,10,17
6,1,2,4,6,10
10,2,5,24,20,44
6,2,5,14,12,26
27,1,2,25,27,52
25,1,2,23,25,48
18,8,21,151,144,295
20,8,21,168,160,328
27,2,5,78,54,132
3,2,5,9,6,15
19,1,4,54,19,73
19,1,4,54,19,73
28,1,2,21,28,49
27,1,2,20,27,47
22,8,21,277,176,453
9,8,21,113,72,185
1,2,5,3,2,5
20,1,2,10,20,30
27,2,5,78,54,132
7,2,5,20,14,34
1,2,5,3,2,5
16,2,5,38,32,70
21,9,25,326,189,515
1,1482,2384,473,1482,1955
2,755,1215,871,1510,2381
3,461,742,798,1383,2181
1,461,742,266,461,727
25,24,64,968,600,1568
6,45,120,443,270,713
27,4,10,127,108,235
10,4,10,47,40,87
2,2,5,6,4,10
23,2,5,68,46,114
1,2,5,2,2,4
20,2,5,39,40,79
6,2,5,18,12,30
21,2,5,62,42,104
25,2,5,74,50,124
29,7,9,24,203,227
4,7,9,7,28,35
11,3,8,45,33,78
15,3,8,53,45,98
14,3,8,68,42,110
25,8,22,339,200,539
11,8,22,101,88,189
27,8,22,271,216,487
14,8,22,156,112,268
11,8,22,152,88,240
4,8,22,55,32,87
17,8,22,223,136,359
7,9,24,83,63,146
12,9,24,177,108,285
23,9,24,273,207,480
23,9,24,224,207,431
4,9,24,58,36,94
12,13,35,235,156,391
6,13,35,86,78,164
27,13,35,396,351,747
10,13,35,143,130,273
1,13,35,14,13,27
25,13,35,489,325,814
21,13,35,455,273,728
6,13,35,124,78,202
18,13,35,308,234,542
22,13,35,476,286,762
1,13,35,14,13,27
29,13,35,506,377,883
25,13,35,454,325,779
26,13,35,554,338,892
4,21,55,132,84,216
23,21,55,516,483,999
29,42,54,332,1218,1550
1,38,50,11,38,49
13,38,50,143,494,637
9,42,54,45,378,423
7,38,50,11,266,277
8,42,54,92,336,428
4,38,50,46,152,198
1,1266,2320,799,1266,2065
2,1252,2295,1076,2504,3580
2,1252,2295,1489,2504,3993
1,1266,2320,729,1266,1995
1,1266,2320,1008,1266,2274
1,1252,2295,951,1252,2203
1,2171,3578,620,2171,2791
1,2171,3578,1264,2171,3435
3,713,1120,751,2139,2890
2,487,783,529,974,1503
1,344,540,77,344,421
1,713,1120,261,713,974
1,344,540,83,344,427
1,713,1120,284,713,997
1,2171,3578,1335,2171,3506
1,2171,3578,1335,2171,3506
1,26,70,43,26,69
27,26,70,1169,702,1871
12,26,70,343,312,655
22,3,9,130,66,196
4,3,9,16,12,28
21,2,5,56,42,98
26,2,5,69,52,121
17,1,4,44,17,61
3,1,4,8,3,11
28,1,4,72,28,100
23,1,2,23,23,46
27,1,2,26,27,53
26,1,4,64,26,90
19,1,4,47,19,66
8,2,5,24,16,40
1,2,5,3,2,5
23,1,2,13,23,36
14,1,2,13,14,27
16,1,2,15,16,31
18,2,5,52,36,88
19,12,33,374,228,602
14,12,33,276,168,444
25,2,5,59,50,109
7,13,35,137,91,228
6,13,35,117,78,195
17,13,35,332,221,553
6,2,5,17,12,29
12,2,5,34,24,58
4,1,2,4,4,8
10,1,2,10,10,20
14,1,2,10,14,24
13,1,2,10,13,23
5,1,2,4,5,9
10,2,5,30,20,50
10,1,2,6,10,16
29,1,2,16,29,45
14,1,2,9,14,23
26,12,33,357,312,669
1,12,33,14,12,26
11,2,5,32,22,54
7,1,2,5,7,12
15,1,2,11,15,26
16,1,2,12,16,28
22,1,2,16,22,38
12,1,2,9,12,21
17,2,5,49,34,83
6,2,5,17,12,29
24,11,29,404,264,668
1,1,4,3,1,4
27,1,4,79,27,106
1,1,4,2,1,3
1,755,1215,302,755,1057
3,461,742,687,1383,2070
2,1482,2384,1613,2964,4577
1,755,1215,448,755,1203
1,755,1215,290,755,1045
1,1482,2384,330,1482,1812
1,45,120,74,45,119
20,2,5,39,40,79
6,3,9,35,18,53
32,2,5,61,64,125
27,2,5,57,54,111
26,2,5,55,52,107
5,3,9,29,15,44
1,2,5,3,2,5
5,2,5,15,10,25
12,2,5,35,24,59
26,2,5,73,52,125
23,2,5,67,46,113
15,2,5,44,30,74
7,2,5,15,14,29
3,2,5,6,6,12
1,2,5,3,2,5
22,2,5,64,44,108
1,2,5,3,2,5
8,2,5,16,16,32
25,4,10,118,100,218
30,2,5,89,60,149
1,2,5,3,2,5
18,2,5,52,36,88
1,3,9,5,3,8
15,7,9,0,105,105
3,7,9,6,21,27
10,7,9,16,70,86
24,7,9,9,168,177
2,7,9,1,14,15
30,7,9,55,210,265
26,7,9,47,182,229
15,7,9,25,105,130
17,7,9,2,119,121
27,8,22,366,216,582
1,8,22,10,8,18
1,8,22,11,8,19
4,9,24,40,36,76
23,9,24,334,207,541
13,9,24,189,117,306
21,9,24,305,189,494
28,13,35,430,364,794
6,13,35,86,78,164
5,13,35,72,65,137
1,13,35,15,13,28
10,13,35,217,130,347
17,13,35,332,221,553
24,13,35,377,312,689
2,13,35,39,26,65
27,13,35,471,351,822
9,13,35,157,117,274
10,13,35,213,130,343
16,13,35,330,208,538
3,13,35,62,39,101
1,13,35,21,13,34
7,13,35,152,91,243
19,13,35,391,247,638
7,13,35,120,91,211
21,13,35,447,273,720
31,13,35,443,403,846
28,21,55,937,588,1525
22,21,55,724,462,1186
17,21,55,559,357,916
27,42,54,134,1134,1268
19,38,50,209,722,931
1,1266,2320,544,1266,1810
2,308,565,311,616,927
1,1252,2295,997,1252,2249
2,487,783,247,974,1221
1,344,540,120,344,464
1,487,783,265,487,752
1,3,9,4,3,7
11,1,2,10,11,21
23,1,2,23,23,46
21,1,2,21,21,42
18,2,5,52,36,88
3,13,35,65,39,104
3,1,2,3,3,6
16,11,30,299,176,475
2,2,5,5,4,9
1,2,5,3,2,5
16,2,5,46,32,78
27,2,5,78,54,132
15,2,5,29,30,59
8,2,5,15,16,31
27,13,35,528,351,879
31,13,35,606,403,1009
30,1,2,17,30,47
17,1,4,42,17,59
4,1,4,10,4,14
29,2,5,55,58,113
21,2,5,40,42,82
12,9,25,189,108,297
3,9,25,47,27,74
8,2,5,15,16,31
9,2,5,17,18,35
28,2,5,53,56,109
2,9,25,30,18,48
1,9,25,16,9,25
17,9,25,264,153,417
23,1,2,15,23,38
11,8,21,92,88,180
18,1,4,41,18,59
9,2,5,25,18,43
12,2,5,34,24,58
4,1,4,11,4,15
18,1,2,17,18,35
8,1,2,8,8,16
25,2,5,73,50,123
20,2,5,47,40,87
26,2,5,61,52,113
1,8,21,8,8,16
1,8,21,8,8,16
29,8,21,298,232,530
20,8,21,205,160,365
1,1482,2384,449,1482,1931
1,755,1215,436,755,1191
3,1482,2384,1419,4446,5865
22,24,64,852,528,1380
10,45,120,726,450,1176
6,45,120,349,270,619
6,45,120,443,270,713
9,45,120,632,405,1037
27,2,5,80,54,134
5,2,5,15,10,25
16,2,5,46,32,78
6,2,5,11,12,23
19,2,5,55,38,93
15,2,5,44,30,74
15,2,5,35,30,65
19,3,9,111,57,168
8,3,9,47,24,71
28,2,5,53,56,109
3,2,5,6,6,12
26,2,5,73,52,125
13,3,9,76,39,115
23,3,9,134,69,203
1,4,10,6,4,10
13,4,10,77,52,129
2,2,5,6,4,10
14,2,5,41,28,69
22,2,5,64,44,108
3,2,5,9,6,15
15,7,9,29,105,134
7,7,9,13,49,62
13,7,9,25,91,116
24,7,9,39,168,207
21,7,9,38,147,185
4,7,9,7,28,35
4,3,8,20,12,32
10,8,22,136,80,216
23,8,22,312,184,496
13,8,22,162,104,266
11,8,22,110,88,198
25,8,22,345,200,545
26,8,22,358,208,566
31,8,22,427,248,675
22,9,24,235,198,433
7,13,35,152,91,243
27,13,35,386,351,737
13,13,35,268,169,437
14,13,35,274,182,456
17,13,35,243,221,464
27,13,35,386,351,737
13,13,35,268,169,437
12,13,35,260,156,416
20,13,35,433,260,693
25,13,35,541,325,866
20,13,35,433,260,693
24,13,35,419,312,731
11,13,35,157,143,300
27,13,35,462,351,813
2,13,35,35,26,61
3,13,35,62,39,101
31,13,35,660,403,1063
27,13,35,386,351,737
24,13,35,419,312,731
26,13,35,536,338,874
18,13,35,383,234,617
21,13,35,330,273,603
3,21,55,100,63,163
18,21,55,592,378,970
31,42,54,355,1302,1657
25,38,50,275,950,1225
21,38,50,242,798,1040
20,42,54,229,840,1069
10,42,54,50,420,470
23,38,50,230,874,1104
3,1266,2320,1631,3798,5429
2,1898,3375,2482,3796,6278
2,1252,2295,1902,2504,4406
1,420,769,180,420,600
1,1266,2320,1008,1266,2274
1,1266,2320,1008,1266,2274
2,308,565,367,616,983
2,1266,2320,1273,2532,3805
1,487,783,280,487,767
3,713,1120,1154,2139,3293
2,713,1120,724,1426,2150
1,344,540,99,344,443
1,2171,3578,906,2171,3077
30,26,70,1278,780,2058
8,8,21,67,64,131
13,8,21,109,104,213
7,1,2,4,7,11
10,1,2,6,10,16
25,1,2,24,25,49
16,1,2,15,16,31
14,1,4,38,14,52
17,1,2,10,17,27
8,1,2,4,8,12
26,2,5,77,52,129
27,2,5,80,54,134
32,2,5,94,64,158
1,2,5,3,2,5
9,1,4,22,9,31
29,1,4,72,29,101
17,1,4,42,17,59
13,2,5,25,26,51
15,2,5,29,30,59
1,13,35,22,13,35
15,13,35,325,195,520
18,13,35,257,234,491
7,13,35,100,91,191
31,2,5,73,62,135
29,2,5,68,58,126
11,1,2,10,11,21
27,1,2,25,27,52
24,1,4,55,24,79
10,1,4,23,10,33
23,1,4,68,23,91
7,2,5,20,14,34
1,2,5,3,2,5
23,2,5,48,46,94
10,2,5,21,20,41
2,1,4,5,2,7
3,1,4,7,3,10
9,1,4,21,9,30
14,1,4,33,14,47
27,1,2,19,27,46
14,1,2,10,14,24
14,2,5,33,28,61
1,8,21,12,8,20
11,8,21,134,88,222
8,8,21,97,64,161
11,1,4,27,11,38
1,1482,2384,854,1482,2336
2,755,1215,871,1510,2381
5,24,64,194,120,314
7,59,159,678,413,1091
9,59,159,714,531,1245
15,3,9,68,45,113
28,3,9,128,84,212
9,2,5,21,18,39
5,2,5,12,10,22
28,2,5,66,56,122
20,2,5,44,40,84
20,2,5,44,40,84
12,2,5,22,24,46
8,2,5,14,16,30
25,2,5,73,50,123
9,2,5,17,18,35
1,2,5,2,2,4
6,2,5,12,12,24
28,2,5,55,56,111
11,2,5,32,22,54
6,2,5,17,12,29
27,2,5,80,54,134
18,3,9,87,54,141
27,3,9,130,81,211
29,2,5,68,58,126
12,2,5,28,24,52
24,7,9,20,168,188
9,7,9,7,63,70
18,7,9,15,126,141
18,7,9,30,126,156
22,7,9,8,154,162
13,7,9,25,91,116
3,7,9,2,21,23
21,3,8,68,63,131
13,3,8,48,39,87
21,8,22,234,168,402
14,8,22,190,112,302
29,8,22,393,232,625
19,9,24,203,171,374
18,9,24,179,162,341
15,9,24,167,135,302
4,9,24,58,36,94
24,9,24,337,216,553
20,9,24,214,180,394
24,9,24,337,216,553
2,13,35,39,26,65
20,13,35,391,260,651
21,13,35,447,273,720
2,13,35,35,26,61
30,13,35,639,390,1029
24,13,35,343,312,655
12,13,35,247,156,403
19,13,35,391,247,638
17,13,35,350,221,571
29,13,35,496,377,873
24,13,35,326,312,638
3,13,35,44,39,83
3,13,35,65,39,104
11,13,35,173,143,316
1,13,35,21,13,34
6,13,35,94,78,172
16,13,35,346,208,554
16,13,35,279,208,487
25,13,35,533,325,858
28,13,35,489,364,853
15,21,55,403,315,718
8,38,50,80,304,384
16,38,50,80,608,688
24,42,54,55,1008,1063
22,42,54,15,924,939
15,38,50,150,570,720
26,42,54,129,1092,1221
7,38,50,77,266,343
10,38,50,110,380,490
1,38,50,3,38,41
7,42,54,80,294,374
26,42,54,129,1092,1221
1,1266,2320,892,1266,2158
1,1266,2320,752,1266,2018
1,308,565,184,308,492
1,420,769,241,420,661
2,1266,2320,2015,2532,4547
2,2171,3578,2528,4342,6870
1,487,783,132,487,619
3,487,783,841,1461,2302
1,344,540,185,344,529
1,2171,3578,835,2171,3006
1,1083,1701,499,1083,1582
1,2171,3578,942,2171,3113
1,1555,2443,302,1555,1857
1,344,540,83,344,427
1,344,540,126,344,470
1,2171,3578,835,2171,3006
1,2171,3578,620,2171,2791
19,26,70,823,494,1317
1,26,70,43,26,69
21,26,70,718,546,1264
32,3,9,189,96,285
22,3,9,128,66,194
23,3,9,95,69,164
29,1,2,16,29,45
1,1,2,1,1,2
15,1,2,8,15,23
4,1,4,9,4,13
9,9,25,97,81,178
21,2,5,59,42,101
10,2,5,28,20,48
29,2,5,81,58,139
24,1,2,16,24,40
14,1,4,33,14,47
27,1,2,26,27,53
10,1,2,10,10,20
8,1,2,8,8,16
30,8,21,277,240,517
17,8,21,157,136,293
12,8,21,111,96,207
11,1,2,11,11,22
31,9,25,357,279,636
1,9,25,12,9,21
29,12,33,408,348,756
25,12,33,352,300,652
22,1,2,15,22,37
12,2,5,35,24,59
1,2,5,3,2,5
7,2,5,21,14,35
8,2,5,17,16,33
4,2,5,8,8,16
1,2,5,2,2,4
23,2,5,44,46,90
23,2,5,44,46,90
1,11,30,15,11,26
17,2,5,49,34,83
25,2,5,73,50,123
11,11,29,121,121,242
11,11,29,121,121,242
28,11,29,309,308,617
4,1,2,3,4,7
16,1,2,10,16,26
24,1,2,13,24,37
27,2,5,76,54,130
14,2,5,39,28,67
20,2,5,56,40,96
19,2,5,55,38,93
6,2,5,17,12,29
13,1,4,38,13,51
11,1,4,27,11,38
25,1,4,62,25,87
23,2,5,51,46,97
8,1,4,23,8,31
12,1,4,34,12,46
19,1,4,54,19,73
2,1482,2384,803,2964,3767
1,1482,2384,854,1482,2336
3,755,1215,1344,2265,3609
1,1482,2384,521,1482,2003
1,461,742,266,461,727
6,45,120,436,270,706
1,2,5,2,2,4
9,2,5,27,18,45
7,3,9,41,21,62
28,3,9,163,84,247
21,2,5,48,42,90
27,2,5,62,54,116
25,2,5,53,50,103
4,2,5,8,8,16
25,2,5,48,50,98
9,2,5,18,18,36
25,2,5,49,50,99
10,2,5,30,20,50
7,2,5,21,14,35
26,3,9,147,78,225
3,3,9,17,9,26
25,3,9,101,75,176
7,7,9,11,49,60
10,7,9,1,70,71
1,7,9,2,7,9
27,7,9,22,189,211
30,7,9,1,210,211
21,7,9,40,147,187
13,7,9,0,91,91
10,3,8,32,30,62
8,3,8,28,24,52
10,8,22,125,80,205
10,8,22,136,80,216
19,8,22,258,152,410
23,8,22,231,184,415
18,8,22,248,144,392
3,8,22,41,24,65
24,9,24,348,216,564
28,9,24,326,252,578
23,9,24,334,207,541
32,13,35,659,416,1075
12,13,35,256,156,412
12,13,35,235,156,391
26,13,35,372,338,710
13,13,35,222,169,391
25,13,35,436,325,761
29,13,35,618,377,995
25,13,35,515,325,840
30,13,35,650,390,1040
4,13,35,57,52,109
3,13,35,65,39,104
6,13,35,128,78,206
8,13,35,126,104,230
27,13,35,575,351,926
23,13,35,450,299,749
19,13,35,298,247,545
1,13,35,21,13,34
25,21,55,548,525,1073
28,21,55,675,588,1263
1,42,54,5,42,47
31,38,50,341,1178,1519
15,38,50,15,570,585
9,38,50,9,342,351
14,42,54,160,588,748
22,42,54,110,924,1034
10,42,54,1,420,421
6,42,54,66,252,318
10,42,54,98,420,518
6,42,54,27,252,279
3,1898,3375,3115,5694,8809
3,1266,2320,3023,3798,6821
1,1252,2295,882,1252,2134
3,344,540,556,1032,1588
3,1083,1701,1140,3249,4389
1,713,1120,138,713,851
1,2171,3578,656,2171,2827
3,2171,3578,2182,6513,8695
2,2171,3578,1884,4342,6226
2,713,1120,500,1426,1926
1,2171,3578,656,2171,2827
1,713,1120,172,713,885
2,344,540,349,688,1037
1,344,540,99,344,443
4,26,70,170,104,274
29,26,70,1195,754,1949
7,26,70,200,182,382
26,26,70,853,676,1529
3,3,9,18,9,27
29,3,9,171,87,258
28,3,9,163,84,247
9,2,5,17,18,35
1,9,25,11,9,20
6,9,25,95,54,149
22,1,2,20,22,42
7,2,5,20,14,34
14,2,5,41,28,69
22,2,5,65,44,109
24,1,4,71,24,95
20,1,4,59,20,79
5,2,5,14,10,24
12,2,5,34,24,58
25,2,5,70,50,120
15,13,35,293,195,488
31,13,35,606,403,1009
5,12,33,103,60,163
14,1,2,10,14,24
3,1,2,2,3,5
1,2,5,2,2,4
12,2,5,22,24,46
19,2,5,34,38,72
16,12,33,267,192,459
5,12,33,84,60,144
3,12,33,50,36,86
1,2,5,3,2,5
8,1,4,18,8,26
11,1,4,25,11,36
25,1,4,57,25,82
18,2,5,34,36,70
20,2,5,38,40,78
3,2,5,6,6,12
19,1,4,43,19,62
21,1,4,48,21,69
19,1,2,17,19,36
18,1,2,17,18,35
5,1,2,4,5,9
28,1,2,21,28,49
6,1,2,4,6,10
1,1,4,3,1,4
27,1,2,26,27,53
24,1,2,23,24,47
18,1,2,18,18,36
19,1,2,11,19,30
20,1,2,12,20,32
11,2,5,32,22,54
8,1,2,4,8,12
10,1,2,6,10,16
1,755,1215,436,755,1191
2,1482,2384,1756,2964,4720
1,461,742,274,461,735
6,2,5,15,12,27
20,2,5,49,40,89
3,2,5,6,6,12
19,2,5,36,38,74
2,3,9,12,6,18
1,3,9,6,3,9
16,2,5,47,32,79
5,2,5,15,10,25
20,2,5,38,40,78
25,2,5,48,50,98
5,2,5,12,10,22
3,2,5,7,6,13
11,2,5,25,22,47
22,2,5,51,44,95
24,2,5,70,48,118
29,4,10,122,116,238
22,4,10,92,88,180
28,2,5,55,56,111
5,2,5,10,10,20
12,2,5,34,24,58
9,7,9,1,63,64
31,7,9,26,217,243
27,7,9,49,189,238
30,7,9,55,210,265
28,3,8,109,84,193
3,3,8,15,9,24
4,3,8,19,12,31
28,8,22,380,224,604
8,8,22,73,64,137
19,8,22,258,152,410
6,8,22,60,48,108
24,8,22,331,192,523
16,8,22,157,128,285
7,9,24,81,63,144
25,13,35,533,325,858
27,13,35,386,351,737
16,13,35,330,208,538
19,13,35,371,247,618
3,13,35,44,39,83
6,13,35,94,78,172
31,13,35,487,403,890
1,13,35,17,13,30
4,13,35,59,52,111
9,13,35,141,117,258
6,13,35,103,78,181
2,13,35,33,26,59
1,13,35,14,13,27
29,13,35,506,377,883
5,13,35,72,65,137
6,13,35,98,78,176
4,13,35,61,52,113
7,21,55,234,147,381
10,38,50,100,380,480
15,42,54,91,630,721
30,38,50,345,1140,1485
21,38,50,32,798,830
5,38,50,58,190,248
17,42,54,85,714,799
12,38,50,18,456,474
1,38,50,5,38,43
13,38,50,143,494,637
17,38,50,68,646,714
1,1266,2320,1008,1266,2274
1,1252,2295,951,1252,2203
1,1252,2295,997,1252,2249
3,1252,2295,2991,3756,6747
1,1252,2295,607,1252,1859
1,1083,1701,244,1083,1327
1,713,1120,250,713,963
1,487,783,155,487,642
3,713,1120,1154,2139,3293
1,1555,2443,497,1555,2052
2,487,783,388,974,1362
1,487,783,132,487,619
2,1083,1701,624,2166,2790
1,344,540,110,344,454
20,26,70,866,520,1386
13,26,70,563,338,901
2,26,70,85,52,137
13,3,9,76,39,115
29,13,35,496,377,873
2,13,35,34,26,60
13,1,2,10,13,23
21,1,2,16,21,37
13,1,2,12,13,25
13,11,30,243,143,386
14,2,5,41,28,69
13,1,2,8,13,21
17,1,2,10,17,27
6,2,5,13,12,25
15,2,5,32,30,62
28,1,2,19,28,47
6,1,2,4,6,10
13,11,30,196,143,339
14,11,30,211,154,365
10,11,30,151,110,261
15,2,5,44,30,74
30,2,5,89,60,149
4,1,2,3,4,7
23,1,2,15,23,38
17,1,4,48,17,65
5,11,30,68,55,123
1,11,30,14,11,25
5,2,5,15,10,25
15,13,35,236,195,431
24,13,35,377,312,689
9,2,5,21,18,39
3,2,5,7,6,13
27,9,25,324,243,567
18,1,2,9,18,27
31,1,2,16,31,47
18,12,33,283,216,499
7,12,33,110,84,194
7,1,2,7,7,14
9,1,2,9,9,18
4,1,2,2,4,6
5,12,33,84,60,144
6,12,33,100,72,172
14,12,33,234,168,402
1,1482,2384,878,1482,2360
1,1482,2384,735,1482,2217
3,1482,2384,2563,4446,7009
2,461,742,236,922,1158
15,24,64,389,360,749
14,24,64,399,336,735
25,24,64,792,600,1392
27,4,10,127,108,235
1,4,10,5,4,9
17,4,10,65,68,133
30,4,10,114,120,234
27,2,5,62,54,116
14,2,5,33,28,61
21,2,5,49,42,91
2,2,5,4,4,8
5,2,5,12,10,22
15,2,5,44,30,74
4,2,5,12,8,20
22,7,9,16,154,170
5,7,9,5,35,40
12,3,8,59,36,95
1,3,8,5,3,8
18,3,8,89,54,143
1,8,22,11,8,19
18,8,22,244,144,388
8,9,24,93,72,165
14,9,24,203,126,329
27,9,24,314,243,557
27,9,24,392,243,635
21,13,35,455,273,728
16,13,35,346,208,554
12,13,35,256,156,412
24,13,35,410,312,722
15,13,35,325,195,520
7,13,35,100,91,191
7,13,35,120,91,211
8,13,35,137,104,241
20,13,35,342,260,602
9,13,35,192,117,309
2,13,35,43,26,69
17,13,35,332,221,553
6,21,55,201,126,327
11,42,54,55,462,517
9,38,50,45,342,387
16,38,50,80,608,688
29,38,50,145,1102,1247
27,42,54,295,1134,1429
7,42,54,1,294,295
10,38,50,65,380,445
3,1266,2320,1909,3798,5707
1,1266,2320,567,1266,1833
1,1252,2295,997,1252,2249
2,2171,3578,1884,4342,6226
1,2171,3578,1335,2171,3506
1,344,540,120,344,464
1,344,540,120,344,464
1,1083,1701,397,1083,1480
2,487,783,388,974,1362
1,2171,3578,1335,2171,3506
13,26,70,445,338,783
25,26,70,1065,650,1715
1,26,70,43,26,69
21,26,70,601,546,1147
13,3,9,73,39,112
30,9,25,473,270,743
26,9,25,410,234,644
18,9,25,284,162,446
5,1,2,5,5,10
5,2,5,14,10,24
14,2,5,41,28,69
23,2,5,68,46,114
11,1,4,33,11,44
4,1,4,12,4,16
24,1,4,71,24,95
20,11,30,374,220,594
20,11,30,374,220,594
15,1,4,37,15,52
12,1,4,29,12,41
4,1,4,9,4,13
15,1,4,35,15,50
15,2,5,44,30,74
9,2,5,26,18,44
26,2,5,73,52,125
2,2,5,6,4,10
1,1,4,2,1,3
14,1,2,10,14,24
26,1,2,19,26,45
1,755,1215,436,755,1191
1,1482,2384,592,1482,2074
1,461,742,229,461,690
23,24,64,596,552,1148
1,45,120,74,45,119
2,45,120,148,90,238
26,3,9,154,78,232
23,3,9,136,69,205
12,2,5,34,24,58
26,2,5,73,52,125
16,4,10,94,64,158
5,2,5,10,10,20
14,2,5,27,28,55
3,2,5,9,6,15
10,2,5,29,20,49
31,2,5,90,62,152
15,2,5,44,30,74
20,2,5,46,40,86
24,2,5,55,48,103
12,2,5,34,24,58
13,2,5,36,26,62
12,3,9,68,36,104
22,3,9,124,66,190
7,3,9,34,21,55
11,3,9,59,33,92
27,3,9,145,81,226
2,2,5,4,4,8
12,2,5,25,24,49
15,7,9,29,105,134
2,7,9,4,14,18
2,7,9,1,14,15
17,7,9,14,119,133
19,7,9,7,133,140
28,7,9,1,196,197
23,7,9,42,161,203
16,7,9,2,112,114
3,8,22,41,24,65
16,8,22,217,128,345
30,8,22,314,240,554
13,8,22,119,104,223
8,8,22,110,64,174
22,8,22,240,176,416
24,8,22,267,192,459
22,8,22,303,176,479
8,8,22,108,64,172
6,9,24,89,54,143
5,9,24,59,45,104
23,9,24,246,207,453
15,13,35,246,195,441
28,13,35,606,364,970
30,13,35,618,390,1008
12,13,35,197,156,353
20,13,35,433,260,693
1,13,35,21,13,34
4,13,35,82,52,134
19,13,35,405,247,652
26,13,35,554,338,892
15,13,35,325,195,520
28,13,35,440,364,804
11,13,35,161,143,304
5,13,35,82,65,147
15,21,55,403,315,718
27,21,55,859,567,1426
12,42,54,27,504,531
15,38,50,128,570,698
6,38,50,60,228,288
25,38,50,288,950,1238
1,42,54,11,42,53
26,42,54,298,1092,1390
25,38,50,250,950,1200
3,1266,2320,3023,3798,6821
1,1252,2295,1020,1252,2272
1,1266,2320,961,1266,2227
1,1252,2295,676,1252,1928
1,1266,2320,752,1266,2018
1,1266,2320,961,1266,2227
1,1266,2320,1008,1266,2274
1,295,540,234,295,529
3,1266,2320,1909,3798,5707
1,344,540,174,344,518
1,2171,3578,1264,2171,3435
1,1555,2443,448,1555,2003
1,1555,2443,839,1555,2394
1,487,783,280,487,767
1,1083,1701,244,1083,1327
1,2171,3578,763,2171,2934
1,487,783,155,487,642
1,2171,3578,656,2171,2827
2,713,1120,500,1426,1926
1,2171,3578,1335,2171,3506
2,344,540,370,688,1058
1,1083,1701,499,1083,1582
9,26,70,390,234,624
9,26,70,264,234,498
21,3,9,124,63,187
5,3,9,30,15,45
18,1,2,12,18,30
12,1,2,8,12,20
17,8,21,217,136,353
18,8,21,230,144,374
1,1,2,1,1,2
26,1,2,25,26,51
30,1,2,29,30,59
22,1,2,22,22,44
13,2,5,25,26,51
29,2,5,55,58,113
23,1,2,22,23,45
2,13,35,33,26,59
15,13,35,246,195,441
22,9,25,253,198,451
18,1,2,17,18,35
14,1,2,13,14,27
15,1,2,8,15,23
23,1,2,13,23,36
7,1,2,5,7,12
8,1,2,6,8,14
16,1,2,12,16,28
23,1,2,22,23,45
12,1,2,12,12,24
4,1,2,3,4,7
26,1,2,24,26,50
14,1,2,9,14,23
13,2,5,38,26,64
23,2,5,68,46,114
30,1,2,20,30,50
27,1,2,18,27,45
3,1,2,2,3,5
28,1,2,19,28,47
23,2,5,54,46,100
6,1,2,6,6,12
18,1,2,18,18,36
23,2,5,44,46,90
12,2,5,23,24,47
13,1,4,37,13,50
3,1,4,9,3,12
14,1,2,10,14,24
9,2,5,19,18,37
22,2,5,46,44,90
8,2,5,16,16,32
7,2,5,14,14,28
6,2,5,12,12,24
1,1482,2384,878,1482,2360
1,1482,2384,521,1482,2003
7,24,64,217,168,385
9,45,120,437,405,842
6,45,120,421,270,691
24,2,5,71,48,119
2,2,5,6,4,10
20,2,5,46,40,86
11,2,5,25,22,47
26,2,5,75,52,127
18,2,5,53,36,89
17,3,9,68,51,119
23,7,9,44,161,205
21,7,9,34,147,181
7,8,22,95,56,151
5,8,22,46,40,86
23,8,22,287,184,471
19,8,22,207,152,359
28,8,22,380,224,604
26,8,22,358,208,566
17,9,24,202,153,355
1,9,24,12,9,21
25,9,24,363,225,588
19,9,24,276,171,447
22,13,35,322,286,608
1,13,35,17,13,30
1,13,35,21,13,34
23,13,35,401,299,700
20,13,35,286,260,546
17,13,35,243,221,464
29,13,35,618,377,995
9,13,35,148,117,265
13,13,35,281,169,450
5,13,35,86,65,151
21,13,35,411,273,684
14,13,35,244,182,426
3,13,35,52,39,91
18,21,55,602,378,980
10,42,54,1,420,421
8,42,54,18,336,354
10,42,54,109,420,529
2,42,54,22,84,106
1,1252,2295,722,1252,1974
2,1912,3400,2092,3824,5916
3,1252,2295,3060,3756,6816
1,1266,2320,752,1266,2018
1,1252,2295,1020,1252,2272
1,1252,2295,997,1252,2249
1,1266,2320,961,1266,2227
3,1266,2320,1631,3798,5429
1,1266,2320,729,1266,1995
3,1266,2320,3023,3798,6821
2,1555,2443,1678,3110,4788
1,1555,2443,351,1555,1906
3,1555,2443,1491,4665,6156
3,1083,1701,1650,3249,4899
2,1083,1701,1100,2166,3266
1,344,540,126,344,470
21,26,70,865,546,1411
19,26,70,597,494,1091
20,26,70,852,520,1372
22,3,9,88,66,154
27,3,9,160,81,241
3,3,9,18,9,27
24,3,9,116,72,188
16,13,35,274,208,482
28,13,35,479,364,843
7,1,2,6,7,13
8,1,2,7,8,15
11,2,5,29,22,51
7,1,2,6,7,13
5,1,2,4,5,9
18,1,2,10,18,28
26,1,4,74,26,100
15,1,4,43,15,58
23,1,4,65,23,88
8,2,5,19,16,35
7,1,4,17,7,24
13,1,4,31,13,44
6,1,4,14,6,20
26,1,4,64,26,90
2,1,4,5,2,7
1,1,4,2,1,3
14,1,4,35,14,49
26,1,4,64,26,90
11,13,35,227,143,370
19,13,35,391,247,638
7,1,2,5,7,12
5,1,2,4,5,9
23,12,33,324,276,600
12,2,5,26,24,50
21,1,4,45,21,66
1,1,4,2,1,3
6,1,4,13,6,19
25,2,5,59,50,109
26,2,5,61,52,113
31,2,5,90,62,152
21,2,5,61,42,103
9,2,5,26,18,44
10,1,4,29,10,39
2,1,4,6,2,8
14,1,4,41,14,55
29,2,5,84,58,142
14,2,5,41,28,69
15,1,2,11,15,26
1,1,2,1,1,2
24,1,2,13,24,37
32,8,21,329,256,585
24,1,4,71,24,95
11,1,4,33,11,44
5,1,4,15,5,20
26,11,29,302,286,588
23,2,5,54,46,100
7,2,5,16,14,30
11,1,2,11,11,22
1,1482,2384,401,1482,1883
3,1482,2384,990,4446,5436
1,461,742,229,461,690
2,461,742,532,922,1454
2,461,742,547,922,1469
15,24,64,533,360,893
24,45,120,1397,1080,2477
10,59,159,793,590,1383
21,2,5,62,42,104
20,2,5,59,40,99
30,2,5,80,60,140
27,2,5,76,54,130
32,2,5,90,64,154
24,3,9,140,72,212
25,3,9,146,75,221
1,2,5,2,2,4
7,2,5,16,14,30
11,2,5,26,22,48
15,4,10,57,60,117
3,4,10,11,12,23
27,2,5,78,54,132
4,2,5,12,8,20
24,4,10,139,96,235
4,2,5,12,8,20
28,2,5,81,56,137
2,4,10,12,8,20
11,2,5,32,22,54
14,2,5,33,28,61
1,2,5,2,2,4
15,2,5,29,30,59
20,3,9,95,60,155
1,2,5,2,2,4
4,2,5,8,8,16
25,3,9,101,75,176
1,3,9,4,3,7
2,2,5,6,4,10
9,4,10,35,36,71
7,4,10,27,28,55
21,7,9,0,147,147
5,7,9,10,35,45
28,7,9,23,196,219
27,7,9,37,189,226
19,3,8,71,57,128
26,3,8,122,78,200
20,3,8,79,60,139
19,8,22,258,152,410
17,8,22,159,136,295
6,8,22,67,48,115
14,8,22,153,112,265
19,8,22,212,152,364
25,9,24,369,225,594
15,9,24,146,135,281
9,13,35,141,117,258
2,13,35,41,26,67
22,13,35,376,286,662
14,13,35,288,182,470
8,13,35,173,104,277
22,13,35,384,286,670
16,13,35,251,208,459
21,13,35,447,273,720
10,13,35,175,130,305
11,13,35,173,143,316
14,13,35,200,182,382
28,13,35,577,364,941
1,21,55,27,21,48
16,42,54,2,672,674
16,42,54,2,672,674
20,42,54,197,840,1037
2,38,50,2,76,78
16,42,54,2,672,674
16,42,54,175,672,847
3,42,54,33,126,159
20,42,54,100,840,940
25,38,50,288,950,1238
22,38,50,33,836,869
11,38,50,61,418,479
23,42,54,251,966,1217
3,1898,3375,2305,5694,7999
2,420,769,483,840,1323
1,1252,2295,1020,1252,2272
3,295,540,622,885,1507
2,2171,3578,2528,4342,6870
2,487,783,247,974,1221
1,1555,2443,570,1555,2125
1,344,540,185,344,529
1,2171,3578,942,2171,3113
1,1083,1701,397,1083,1480
1,344,540,99,344,443
1,344,540,185,344,529
1,344,540,174,344,518
11,26,70,376,286,662
21,26,70,601,546,1147
16,26,70,458,416,874
5,26,70,213,130,343
15,26,70,639,390,1029
6,3,9,24,18,42
13,2,5,38,26,64
28,2,5,83,56,139
1,1,2,1,1,2
2,1,2,2,2,4
20,1,2,13,20,33
18,13,35,314,234,548
1,2,5,3,2,5
28,1,2,20,28,48
23,1,2,17,23,40
18,2,5,50,36,86
4,2,5,11,8,19
11,1,2,8,11,19
30,9,25,473,270,743
8,9,25,126,72,198
15,9,25,236,135,371
15,1,2,15,15,30
8,1,2,8,8,16
4,2,5,9,8,17
27,9,25,425,243,668
23,9,25,362,207,569
10,1,4,28,10,38
23,1,4,65,23,88
11,1,2,10,11,21
9,1,2,8,9,17
8,1,2,7,8,15
9,1,2,8,9,17
3,1,2,3,3,6
20,2,5,47,40,87
22,2,5,52,44,96
8,1,2,5,8,13
26,1,2,18,26,44
1,2,5,2,2,4
19,2,5,53,38,91
3,2,5,8,6,14
22,1,4,50,22,72
16,1,4,36,16,52
30,1,4,74,30,104
26,1,4,64,26,90
27,1,2,23,27,50
9,8,21,83,72,155
21,8,21,194,168,362
4,1,2,2,4,6
2,1,2,1,2,3
28,1,4,60,28,88
22,1,4,48,22,70
1,1482,2384,807,1482,2289
1,1482,2384,854,1482,2336
1,461,742,251,461,712
15,24,64,398,360,758
7,24,64,181,168,349
6,24,64,232,144,376
14,24,64,542,336,878
2,45,120,145,90,235
2,59,159,197,118,315
19,2,5,45,38,83
13,2,5,31,26,57
14,2,5,39,28,67
3,2,5,8,6,14
26,2,5,75,52,127
15,2,5,44,30,74
17,2,5,49,34,83
12,2,5,35,24,59
25,2,5,73,50,123
17,2,5,36,34,70
18,2,5,38,36,74
23,2,5,44,46,90
8,2,5,15,16,31
6,2,5,16,12,28
14,2,5,41,28,69
12,2,5,35,24,59
15,2,5,35,30,65
25,2,5,58,50,108
2,2,5,6,4,10
32,2,5,93,64,157
15,3,9,85,45,130
22,7,9,36,154,190
3,7,9,4,21,25
22,7,9,36,154,190
6,3,8,19,18,37
25,8,22,339,200,539
23,8,22,256,184,440
11,8,22,149,88,237
26,8,22,353,208,561
12,8,22,163,96,259
18,8,22,197,144,341
1,9,24,15,9,24
14,13,35,303,182,485
22,13,35,361,286,647
4,13,35,57,52,109
10,13,35,196,130,326
27,13,35,414,351,765
2,13,35,31,26,57
22,13,35,384,286,670
25,13,35,533,325,858
6,13,35,86,78,164
25,13,35,533,325,858
24,13,35,511,312,823
20,13,35,342,260,602
18,13,35,352,234,586
18,13,35,314,234,548
2,13,35,29,26,55
8,21,55,263,168,431
25,21,55,836,525,1361
22,42,54,38,924,962
1,38,50,3,38,41
13,38,50,150,494,644
3,38,50,33,114,147
24,38,50,204,912,1116
31,42,54,339,1302,1641
1,1898,3375,1038,1898,2936
1,1266,2320,1008,1266,2274
3,1252,2295,1890,3756,5646
1,420,769,334,420,754
3,1252,2295,2991,3756,6747
3,295,540,703,885,1588
3,295,540,703,885,1588
1,308,565,246,308,554
1,2171,3578,942,2171,3113
2,2171,3578,1669,4342,6011
1,2171,3578,763,2171,2934
2,1083,1701,1100,2166,3266
1,1555,2443,570,1555,2125
2,2171,3578,2671,4342,7013
1,2171,3578,1335,2171,3506
1,344,540,158,344,502
1,2171,3578,620,2171,2791
12,26,70,343,312,655
4,26,70,170,104,274
29,26,70,1235,754,1989
18,1,2,17,18,35
20,1,2,18,20,38
6,13,35,130,78,208
28,13,35,606,364,970
15,2,5,44,30,74
8,2,5,24,16,40
19,2,5,56,38,94
20,9,25,230,180,410
29,9,25,334,261,595
19,2,5,44,38,82
31,2,5,91,62,153
26,2,5,77,52,129
20,1,2,20,20,40
31,1,2,30,31,61
13,2,5,38,26,64
24,2,5,70,48,118
1,2,5,2,2,4
3,2,5,7,6,13
3,11,30,44,33,77
29,11,30,429,319,748
8,1,4,20,8,28
2,1,4,5,2,7
2,1,4,5,2,7
6,9,25,90,54,144
24,9,25,360,216,576
8,9,25,120,72,192
27,2,5,63,54,117
4,2,5,9,8,17
32,2,5,93,64,157
1,2,5,3,2,5
12,1,4,35,12,47
1,1482,2384,807,1482,2289
1,1482,2384,807,1482,2289
3,1482,2384,1204,4446,5650
3,1482,2384,2563,4446,7009
1,461,742,274,461,735
8,45,120,590,360,950
11,2,5,21,22,43
16,2,5,42,32,74
23,2,5,61,46,107
5,2,5,14,10,24
22,2,5,51,44,95
26,2,5,73,52,125
7,2,5,20,14,34
16,2,5,46,32,78
6,2,5,18,12,30
24,2,5,71,48,119
10,4,10,38,40,78
4,4,10,23,16,39
29,4,10,168,116,284
15,7,9,27,105,132
17,7,9,28,119,147
18,7,9,30,126,156
20,7,9,36,140,176
22,7,9,40,154,194
9,3,8,32,27,59
9,3,8,33,27,60
13,3,8,51,39,90
4,8,22,38,32,70
27,8,22,354,216,570
18,8,22,244,144,388
5,8,22,68,40,108
24,8,22,262,192,454
12,8,22,165,96,261
22,9,24,325,198,523
16,9,24,186,144,330
13,9,24,183,117,300
2,9,24,20,18,38
29,13,35,476,377,853
12,13,35,256,156,412
21,13,35,359,273,632
14,13,35,200,182,382
26,13,35,445,338,783
12,13,35,209,156,365
8,13,35,170,104,274
24,13,35,511,312,823
1,13,35,21,13,34
17,13,35,362,221,583
5,13,35,103,65,168
14,13,35,220,182,402
29,13,35,618,377,995
3,13,35,62,39,101
23,13,35,361,299,660
8,21,55,180,168,348
27,42,54,18,1134,1152
4,38,50,22,152,174
9,38,50,90,342,432
27,38,50,297,1026,1323
21,42,54,105,882,987
2,38,50,22,76,98
1,1912,3400,774,1912,2686
3,1266,2320,2675,3798,6473
3,1252,2295,2854,3756,6610
1,295,540,175,295,470
1,420,769,249,420,669
3,1252,2295,2991,3756,6747
1,1266,2320,1031,1266,2297
1,420,769,211,420,631
1,2171,3578,835,2171,3006
1,1555,2443,570,1555,2125
1,713,1120,362,713,1075
3,713,1120,683,2139,2822
1,1083,1701,550,1083,1633
1,344,540,174,344,518
2,344,540,165,688,853
25,26,70,1065,650,1715
16,26,70,693,416,1109
10,3,9,40,30,70
20,1,4,57,20,77
11,1,4,31,11,42
28,13,35,459,364,823
12,1,2,12,12,24
28,1,4,80,28,108
25,1,2,15,25,40
13,1,2,8,13,21
3,2,5,9,6,15
18,2,5,52,36,88
16,1,4,40,16,56
11,1,4,27,11,38
11,1,4,27,11,38
16,1,2,15,16,31
18,1,2,13,18,31
1,1,2,1,1,2
8,2,5,22,16,38
29,2,5,81,58,139
11,1,4,27,11,38
22,12,33,346,264,610
23,12,33,362,276,638
12,11,30,221,132,353
15,11,30,276,165,441
15,1,2,10,15,25
27,1,2,18,27,45
14,1,2,14,14,28
17,1,2,16,17,33
9,1,2,5,9,14
1,1,2,1,1,2
29,1,2,28,29,57
19,1,2,12,19,31
14,2,5,27,28,55
29,11,29,337,319,656
3,1,2,3,3,6
25,1,2,24,25,49
3,1482,2384,1776,4446,6222
1,1482,2384,854,1482,2336
2,1482,2384,946,2964,3910
1,45,120,74,45,119
19,2,5,56,38,94
1,2,5,2,2,4
21,2,5,49,42,91
13,2,5,38,26,64
9,2,5,27,18,45
29,4,10,136,116,252
5,4,10,24,20,44
27,2,5,78,54,132
27,2,5,78,54,132
32,2,5,70,64,134
17,2,5,37,34,71
6,2,5,12,12,24
2,2,5,4,4,8
3,4,10,17,12,29
3,4,10,17,12,29
24,2,5,46,48,94
23,2,5,44,46,90
11,2,5,29,22,51
6,7,9,11,42,53
27,7,9,15,189,204
28,7,9,16,196,212
7,7,9,11,49,60
13,7,9,18,91,109
24,3,8,112,72,184
21,3,8,81,63,144
20,8,22,271,160,431
26,8,22,238,208,446
10,8,22,136,80,216
12,8,22,165,96,261
20,8,22,276,160,436
25,8,22,262,200,462
9,9,24,90,81,171
25,9,24,351,225,576
1,9,24,15,9,24
4,9,24,48,36,84
13,9,24,129,117,246
6,9,24,89,54,143
9,9,24,131,81,212
19,13,35,278,247,525
26,13,35,508,338,846
5,13,35,107,65,172
14,13,35,288,182,470
10,13,35,175,130,305
8,13,35,173,104,277
11,13,35,238,143,381
3,13,35,52,39,91
15,13,35,262,195,457
26,13,35,554,338,892
20,13,35,412,260,672
12,13,35,260,156,416
19,13,35,371,247,618
22,13,35,345,286,631
29,13,35,618,377,995
14,13,35,288,182,470
23,21,55,769,483,1252
13,21,55,328,273,601
4,21,55,132,84,216
32,21,55,701,672,1373
11,38,50,11,418,429
3,38,50,33,114,147
20,38,50,230,760,990
18,38,50,18,684,702
27,38,50,108,1026,1134
4,42,54,3,168,171
23,38,50,196,874,1070
4,38,50,44,152,196
19,42,54,43,798,841
20,42,54,100,840,940
17,38,50,94,646,740
15,42,54,10,630,640
24,38,50,240,912,1152
14,42,54,47,588,635
3,1266,2320,3092,3798,6890
1,1252,2295,745,1252,1997
1,1252,2295,745,1252,1997
2,1266,2320,2015,2532,4547
3,1266,2320,1700,3798,5498
1,2171,3578,835,2171,3006
3,2171,3578,2826,6513,9339
2,1083,1701,794,2166,2960
2,713,1120,344,1426,1770
3,487,783,395,1461,1856
1,344,540,126,344,470
16,26,70,693,416,1109
24,26,70,703,624,1327
8,26,70,341,208,549
25,26,70,1065,650,1715
14,26,70,459,364,823
24,26,70,787,624,1411
6,3,9,35,18,53
10,13,35,171,130,301
20,13,35,342,260,602
21,1,2,20,21,41
10,1,2,10,10,20
19,13,35,325,247,572
29,13,35,496,377,873
24,13,35,520,312,832
15,13,35,325,195,520
16,12,33,315,192,507
27,11,30,481,297,778
7,11,30,125,77,202
32,2,5,75,64,139
27,13,35,575,351,926
27,2,5,51,54,105
2,1,4,6,2,8
4,1,4,11,4,15
3,1,2,2,3,5
12,1,2,7,12,19
9,1,2,8,9,17
24,1,2,21,24,45
16,1,2,15,16,31
23,1,2,21,23,44
3,1,4,9,3,12
11,2,5,32,22,54
27,1,4,62,27,89
5,1,4,11,5,16
8,2,5,17,16,33
22,2,5,46,44,90
11,1,4,32,11,43
14,1,4,41,14,55
25,1,2,14,25,39
5,1,2,3,5,8
4,1,2,2,4,6
18,2,5,50,36,86
22,2,5,62,44,106
15,1,4,43,15,58
31,9,25,326,279,605
9,9,25,95,81,176
5,1,4,12,5,17
19,1,4,47,19,66
14,2,5,27,28,55
28,9,25,434,252,686
3,1482,2384,2420,4446,6866
1,1482,2384,807,1482,2289
2,461,742,503,922,1425
1,755,1215,436,755,1191
21,24,64,544,504,1048
7,45,120,407,315,722
1,45,120,70,45,115
8,59,159,787,472,1259
6,59,159,447,354,801
13,2,5,34,26,60
22,4,10,128,88,216
12,2,5,28,24,52
22,3,9,124,66,190
26,3,9,147,78,225
16,4,10,93,64,157
13,4,10,75,52,127
13,2,5,36,26,62
4,2,5,11,8,19
24,2,5,67,48,115
26,2,5,73,52,125
11,3,9,62,33,95
17,7,9,10,119,129
19,7,9,0,133,133
7,7,9,10,49,59
14,7,9,12,98,110
3,7,9,2,21,23
6,7,9,10,42,52
3,7,9,5,21,26
1,7,9,0,7,7
19,3,8,93,57,150
17,3,8,82,51,133
13,3,8,42,39,81
30,3,8,97,90,187
6,8,22,55,48,103
29,8,22,393,232,625
27,8,22,366,216,582
22,8,22,303,176,479
16,8,22,220,128,348
23,8,22,216,184,400
2,9,24,29,18,47
7,9,24,103,63,166
25,9,24,351,225,576
21,13,35,308,273,581
2,13,35,43,26,69
3,13,35,64,39,103
3,13,35,64,39,103
23,13,35,498,299,797
4,13,35,78,52,130
31,13,35,639,403,1042
30,13,35,639,390,1029
18,13,35,390,234,624
13,13,35,268,169,437
8,13,35,117,104,221
5,13,35,107,65,172
1,13,35,21,13,34
11,13,35,234,143,377
1,13,35,20,13,33
16,13,35,313,208,521
20,13,35,412,260,672
5,21,55,110,105,215
3,21,55,95,63,158
21,42,54,71,882,953
1,38,50,10,38,48
6,38,50,69,228,297
12,38,50,36,456,492
4,42,54,20,168,188
9,42,54,30,378,408
20,42,54,100,840,940
26,42,54,3,1092,1095
4,38,50,20,152,172
17,38,50,170,646,816
13,42,54,142,546,688
9,42,54,98,378,476
1,1898,3375,937,1898,2835
3,1266,2320,3023,3798,6821
1,420,769,341,420,761
1,1266,2320,752,1266,2018
1,1266,2320,1008,1266,2274
1,1252,2295,951,1252,2203
1,420,769,318,420,738
1,1083,1701,550,1083,1633
2,344,540,241,688,929
1,344,540,185,344,529
3,344,540,248,1032,1280
10,26,70,433,260,693
11,26,70,453,286,739
24,26,70,754,624,1378
28,3,9,165,84,249
8,9,25,102,72,174
18,9,25,230,162,392
14,1,2,14,14,28
1,1,2,1,1,2
8,1,2,8,8,16
1,8,21,9,8,17
26,13,35,554,338,892
6,1,2,6,6,12
15,1,2,14,15,29
11,1,2,10,11,21
25,2,5,70,50,120
21,2,5,59,42,101
19,2,5,53,38,91
17,1,2,13,17,30
23,1,2,17,23,40
1,2,5,3,2,5
29,9,25,370,261,631
26,9,25,332,234,566
18,9,25,230,162,392
2,11,30,37,22,59
13,1,4,31,13,44
18,2,5,53,36,89
2,1,4,6,2,8
1,1,4,3,1,4
13,2,5,38,26,64
9,2,5,27,18,45
8,2,5,24,16,40
10,2,5,28,20,48
26,2,5,61,52,113
8,1,4,23,8,31
19,1,4,54,19,73
25,1,4,71,25,96
25,1,2,24,25,49
11,1,2,11,11,22
18,2,5,35,36,71
2,2,5,4,4,8
14,1,2,12,14,26
5,1,2,4,5,9
10,1,2,7,10,17
5,1,2,4,5,9
11,1,2,8,11,19
4,1,2,2,4,6
22,1,2,12,22,34
27,1,2,20,27,47
2,1,2,1,2,3
28,1,2,21,28,49
2,1482,2384,1613,2964,4577
1,1482,2384,735,1482,2217
2,461,742,547,922,1469
1,755,1215,193,755,948
1,755,1215,375,755,1130
1,461,742,118,461,579
1,1482,2384,854,1482,2336
3,461,742,754,1383,2137
1,461,742,125,461,586
11,24,64,433,264,697
26,24,64,1007,624,1631
28,24,64,1048,672,1720
11,45,120,812,495,1307
3,59,159,195,177,372
16,2,5,47,32,79
27,2,5,80,54,134
18,3,9,105,54,159
29,2,5,81,58,139
5,2,5,12,10,22
10,2,5,24,20,44
7,4,10,27,28,55
12,3,9,58,36,94
23,3,9,111,69,180
16,4,10,94,64,158
15,4,10,89,60,149
6,2,5,13,12,25
19,2,5,40,38,78
20,2,5,59,40,99
27,2,5,80,54,134
14,3,9,64,42,106
19,2,5,55,38,93
1,2,5,3,2,5
10,3,9,48,30,78
7,3,9,34,21,55
30,2,5,87,60,147
19,2,5,55,38,93
22,2,5,64,44,108
25,2,5,73,50,123
12,2,5,35,24,59
18,2,5,53,36,89
28,2,5,81,56,137
1,2,5,2,2,4
22,2,5,40,44,84
23,3,9,111,69,180
26,3,9,126,78,204
12,7,9,10,84,94
9,7,9,7,63,70
7,7,9,13,49,62
12,7,9,22,84,106
31,7,9,51,217,268
6,7,9,5,42,47
13,3,8,63,39,102
18,3,8,87,54,141
21,8,22,229,168,397
14,8,22,193,112,305
30,8,22,334,240,574
18,8,22,165,144,309
9,8,22,124,72,196
12,8,22,110,96,206
5,8,22,69,40,109
21,9,24,310,189,499
9,9,24,107,81,188
27,9,24,379,243,622
10,9,24,140,90,230
2,9,24,28,18,46
5,9,24,73,45,118
21,13,35,308,273,581
23,13,35,361,299,660
17,13,35,297,221,518
18,13,35,390,234,624
14,13,35,303,182,485
16,13,35,229,208,437
21,13,35,411,273,684
8,13,35,140,104,244
11,13,35,192,143,335
26,13,35,554,338,892
18,13,35,383,234,617
5,13,35,103,65,168
24,13,35,494,312,806
20,13,35,286,260,546
5,13,35,98,65,163
23,21,55,731,483,1214
32,21,55,859,672,1531
8,21,55,263,168,431
12,38,50,138,456,594
23,38,50,127,874,1001
24,42,54,275,1008,1283
30,38,50,345,1140,1485
9,38,50,36,342,378
4,38,50,44,152,196
3,38,50,33,114,147
19,38,50,95,722,817
15,42,54,2,630,632
24,38,50,240,912,1152
2,1252,2295,1489,2504,3993
1,1266,2320,1008,1266,2274
1,1252,2295,630,1252,1882
1,1252,2295,722,1252,1974
2,1252,2295,1902,2504,4406
1,1252,2295,745,1252,1997
1,420,769,334,420,754
1,1252,2295,997,1252,2249
1,1252,2295,997,1252,2249
1,1266,2320,1008,1266,2274
1,295,540,126,295,421
1,1266,2320,1031,1266,2297
3,1266,2320,3092,3798,6890
1,295,540,234,295,529
1,2171,3578,942,2171,3113
3,713,1120,482,2139,2621
2,1083,1701,624,2166,2790
2,344,540,349,688,1037
1,344,540,174,344,518
1,26,70,41,26,67
7,26,70,288,182,470
22,26,70,906,572,1478
5,26,70,143,130,273
20,26,70,852,520,1372
25,26,70,1065,650,1715
18,26,70,767,468,1235
15,3,9,58,45,103
26,1,2,25,26,51
20,2,5,58,40,98
20,1,2,19,20,39
23,2,5,45,46,91
14,2,5,27,28,55
6,1,4,18,6,24
18,1,4,53,18,71
4,2,5,11,8,19
27,2,5,76,54,130
9,2,5,21,18,39
15,2,5,35,30,65
30,2,5,89,60,149
27,2,5,80,54,134
23,1,2,23,23,46
5,1,2,5,5,10
16,1,2,15,16,31
30,1,2,28,30,58
20,1,2,20,20,40
13,9,25,205,117,322
20,9,25,315,180,495
17,9,25,268,153,421
26,11,30,478,286,764
9,11,30,166,99,265
22,1,2,20,22,42
22,1,2,20,22,42
13,2,5,38,26,64
1,2,5,3,2,5
6,1,2,3,6,9
12,1,2,7,12,19
18,12,33,247,216,463
2,12,33,27,24,51
7,1,4,19,7,26
12,1,4,33,12,45
27,8,21,232,216,448
10,8,21,86,80,166
16,1,2,14,16,30
1,1,2,1,1,2
10,1,4,25,10,35
1,1,4,2,1,3
27,1,4,66,27,93
10,1,4,24,10,34
9,1,4,22,9,31
3,1482,2384,2205,4446,6651
1,1482,2384,330,1482,1812
1,755,1215,436,755,1191
9,59,159,585,531,1116
26,4,10,101,104,205
9,4,10,40,36,76
15,4,10,66,60,126
14,4,10,76,56,132
21,4,10,124,84,208
14,2,5,39,28,67
28,2,5,50,56,106
1,2,5,2,2,4
32,4,10,179,128,307
7,4,10,39,28,67
9,2,5,24,18,42
3,2,5,9,6,15
31,2,5,90,62,152
25,2,5,53,50,103
17,2,5,37,34,71
30,2,5,66,60,126
29,7,9,53,203,256
20,7,9,36,140,176
1,7,9,2,7,9
15,7,9,6,105,111
24,7,9,39,168,207
16,3,8,52,48,100
2,3,8,9,6,15
14,8,22,174,112,286
29,9,24,345,261,606
3,9,24,40,27,67
31,9,24,458,279,737
28,13,35,577,364,941
12,13,35,172,156,328
6,13,35,105,78,183
24,13,35,419,312,731
10,13,35,206,130,336
17,13,35,362,221,583
30,13,35,587,390,977
11,13,35,234,143,377
26,13,35,408,338,746
9,13,35,185,117,302
8,13,35,131,104,235
24,21,55,526,504,1030
20,42,54,197,840,1037
12,38,50,120,456,576
15,38,50,165,570,735
24,38,50,276,912,1188
7,38,50,0,266,266
7,42,54,76,294,370
1,1266,2320,1008,1266,2274
1,1912,3400,774,1912,2686
1,1266,2320,636,1266,1902
1,1252,2295,997,1252,2249
1,1252,2295,951,1252,2203
2,1252,2295,1902,2504,4406
1,420,769,334,420,754
1,1266,2320,961,1266,2227
1,713,1120,161,713,874
2,1083,1701,1168,2166,3334
3,1083,1701,1803,3249,5052
1,487,783,108,487,595
1,487,783,265,487,752
2,2171,3578,1669,4342,6011
1,344,540,110,344,454
1,1083,1701,397,1083,1480
1,713,1120,228,713,941
2,2171,3578,2671,4342,7013
1,344,540,110,344,454
16,26,70,682,416,1098
8,26,70,341,208,549
17,3,9,100,51,151
19,3,9,87,57,144
2,3,9,9,6,15
5,1,2,5,5,10
21,1,2,21,21,42
30,1,2,19,30,49
26,1,2,17,26,43
1,13,35,21,13,34
16,13,35,330,208,538
24,13,35,494,312,806
9,11,30,160,99,259
18,2,5,53,36,89
12,13,35,209,156,365
20,13,35,349,260,609
16,11,30,299,176,475
12,11,30,224,132,356
1,2,5,2,2,4
32,2,5,61,64,125
29,1,2,21,29,50
21,1,2,20,21,41
21,1,2,20,21,41
10,2,5,30,20,50
11,2,5,32,22,54
7,2,5,21,14,35
26,2,5,73,52,125
23,2,5,64,46,110
17,2,5,49,34,83
11,2,5,32,22,54
7,1,2,5,7,12
17,2,5,32,34,66
2,2,5,4,4,8
3,9,25,38,27,65
14,9,25,179,126,305
18,8,21,226,144,370
14,8,21,176,112,288
6,8,21,75,48,123
9,1,2,6,9,15
22,1,2,14,22,36
13,1,2,8,13,21
21,12,33,330,252,582
24,8,21,292,192,484
11,8,21,134,88,222
14,1,2,13,14,27
18,1,2,18,18,36
27,1,2,26,27,53
30,1,2,28,30,58
7,1,2,6,7,13
14,2,5,31,28,59
4,2,5,9,8,17
3,2,5,7,6,13
1,1482,2384,759,1482,2241
1,755,1215,411,755,1166
1,755,1215,375,755,1130
1,755,1215,241,755,996
5,45,120,243,225,468
9,45,120,653,405,1058
9,59,159,642,531,1173
1,2,5,3,2,5
14,2,5,39,28,67
24,2,5,70,48,118
15,2,5,35,30,65
25,2,5,59,50,109
27,2,5,63,54,117
22,4,10,128,88,216
7,2,5,13,14,27
13,2,5,25,26,51
15,2,5,29,30,59
20,7,9,36,140,176
19,7,9,35,133,168
1,7,9,1,7,8
17,3,8,84,51,135
11,8,22,149,88,237
11,8,22,152,88,240
3,8,22,41,24,65
6,8,22,66,48,114
15,9,24,178,135,313
1,13,35,22,13,35
11,13,35,157,143,300
1,13,35,21,13,34
1,13,35,21,13,34
15,13,35,320,195,515
14,13,35,254,182,436
18,13,35,371,234,605
9,13,35,192,117,309
14,13,35,274,182,456
2,21,55,44,42,86
10,38,50,15,380,395
26,38,50,286,988,1274
13,38,50,130,494,624
17,42,54,75,714,789
1,42,54,11,42,53
3,1252,2295,2165,3756,5921
1,1912,3400,1454,1912,3366
2,1252,2295,1994,2504,4498
3,2171,3578,3040,6513,9553
1,2171,3578,1335,2171,3506
1,2171,3578,1371,2171,3542
1,1083,1701,584,1083,1667
3,2171,3578,2826,6513,9339
1,344,540,77,344,421
1,344,540,174,344,518
2,713,1120,344,1426,1770
2,2171,3578,2671,4342,7013
1,2171,3578,1335,2171,3506
1,344,540,126,344,470
5,26,70,143,130,273
5,3,9,24,15,39
1,3,9,4,3,7
12,1,2,12,12,24
14,2,5,41,28,69
23,11,29,307,253,560
9,11,29,120,99,219
16,1,2,15,16,31
10,13,35,213,130,343
25,13,35,533,325,858
17,2,5,48,34,82
6,9,25,90,54,144
27,9,25,405,243,648
8,1,2,5,8,13
10,1,2,7,10,17
11,2,5,26,22,48
17,2,5,40,34,74
21,2,5,49,42,91
26,2,5,49,52,101
21,1,2,12,21,33
1,1,2,1,1,2
19,12,33,261,228,489
6,12,33,82,72,154
5,1,4,11,5,16
10,1,4,23,10,33
25,9,25,375,225,600
18,9,25,270,162,432
3,8,21,31,24,55
20,1,4,58,20,78
17,1,4,50,17,67
2,1,4,6,2,8
12,1,4,34,12,46
15,8,21,173,120,293
2,8,21,23,16,39
1,461,742,229,461,690
7,24,64,262,168,430
10,59,159,746,590,1336
20,2,5,56,40,96
3,2,5,8,6,14
11,2,5,29,22,51
27,4,10,151,108,259
4,4,10,22,16,38
11,2,5,32,22,54
28,2,5,83,56,139
5,2,5,10,10,20
24,2,5,46,48,94
22,2,5,65,44,109
22,2,5,52,44,96
1,2,5,2,2,4
8,2,5,18,16,34
5,2,5,11,10,21
3,2,5,7,6,13
21,2,5,46,42,88
4,7,9,-1,28,27
15,7,9,29,105,134
8,7,9,15,56,71
13,7,9,24,91,115
24,7,9,39,168,207
2,7,9,1,14,15
32,3,8,124,96,220
19,3,8,92,57,149
27,3,8,100,81,181
2,3,8,10,6,16
7,8,22,96,56,152
9,8,22,122,72,194
5,8,22,68,40,108
27,8,22,253,216,469
19,8,22,166,152,318
27,8,22,301,216,517
1,8,22,10,8,18
16,8,22,178,128,306
16,9,24,236,144,380
15,9,24,211,135,346
17,9,24,202,153,355
10,9,24,97,90,187
9,9,24,133,81,214
23,9,24,257,207,464
16,9,24,186,144,330
14,9,24,166,126,292
28,13,35,596,364,960
20,13,35,433,260,693
21,13,35,433,273,706
17,13,35,368,221,589
9,13,35,176,117,293
7,13,35,149,91,240
21,13,35,455,273,728
21,13,35,344,273,617
20,13,35,307,260,567
20,13,35,433,260,693
13,13,35,227,169,396
19,13,35,371,247,618
16,13,35,330,208,538
24,13,35,511,312,823
8,13,35,117,104,221
13,13,35,213,169,382
2,13,35,43,26,69
24,13,35,377,312,689
20,13,35,342,260,602
14,21,55,353,294,647
21,21,55,564,441,1005
16,21,55,359,336,695
25,42,54,273,1050,1323
22,38,50,33,836,869
22,38,50,253,836,1089
14,38,50,140,532,672
17,42,54,167,714,881
14,38,50,154,532,686
18,42,54,177,756,933
7,42,54,16,294,310
13,38,50,20,494,514
4,42,54,13,168,181
1,1266,2320,961,1266,2227
1,420,769,249,420,669
1,420,769,334,420,754
2,1266,2320,1134,2532,3666
1,1252,2295,676,1252,1928
2,1252,2295,1122,2504,3626
2,1266,2320,1922,2532,4454
1,295,540,175,295,470
1,1252,2295,882,1252,2134
3,487,783,371,1461,1832
3,2171,3578,3792,6513,10305
1,2171,3578,835,2171,3006
1,344,540,185,344,529
3,2171,3578,2504,6513,9017
1,1083,1701,499,1083,1582
3,2171,3578,2182,6513,8695
2,2171,3578,2671,4342,7013
3,344,540,523,1032,1555
1,713,1120,172,713,885
1,713,1120,261,713,974
1,713,1120,261,713,974
1,713,1120,205,713,918
15,26,70,440,390,830
24,26,70,1039,624,1663
14,26,70,596,364,960
20,26,70,852,520,1372
1,26,70,33,26,59
21,3,9,118,63,181
1,1,4,3,1,4
26,1,2,25,26,51
14,1,2,14,14,28
7,13,35,120,91,211
2,13,35,34,26,60
16,9,25,204,144,348
10,13,35,213,130,343
25,13,35,533,325,858
6,1,2,4,6,10
20,1,2,14,20,34
3,9,25,32,27,59
23,2,5,68,46,114
27,1,4,64,27,91
13,1,4,31,13,44
3,11,30,56,33,89
23,11,30,430,253,683
25,2,5,74,50,124
23,1,2,22,23,45
13,1,2,12,13,25
16,1,2,12,16,28
19,1,2,14,19,33
21,1,2,14,21,35
18,1,2,12,18,30
3,1,2,2,3,5
23,12,33,384,276,660
12,12,33,201,144,345
26,2,5,61,52,113
26,9,25,410,234,644
1,9,25,16,9,25
10,1,2,7,10,17
5,1,2,4,5,9
28,2,5,81,56,137
1,2,5,3,2,5
12,2,5,35,24,59
10,1,4,28,10,38
7,1,4,20,7,27
19,2,5,36,38,74
29,2,5,55,58,113
27,2,5,51,54,105
28,1,2,27,28,55
8,1,2,8,8,16
26,1,4,76,26,102
16,1,4,47,16,63
19,11,30,350,209,559
1,11,30,18,11,29
32,8,21,329,256,585
9,8,21,92,72,164
26,11,29,370,286,656
26,11,29,370,286,656
3,2,5,7,6,13
11,2,5,21,22,43
28,2,5,53,56,109
22,9,25,275,198,473
26,9,25,325,234,559
28,1,2,27,28,55
8,1,2,8,8,16
1,1,4,3,1,4
19,1,4,54,19,73
2,755,1215,604,1510,2114
2,755,1215,531,1510,2041
2,45,120,140,90,230
6,45,120,292,270,562
4,59,159,375,236,611
1,59,159,94,59,153
29,2,5,86,58,144
25,2,5,74,50,124
9,2,5,19,18,37
3,2,5,6,6,12
22,4,10,90,88,178
15,4,10,62,60,122
3,2,5,9,6,15
3,2,5,9,6,15
19,2,5,45,38,83
3,2,5,7,6,13
14,2,5,33,28,61
17,2,5,40,34,74
17,2,5,33,34,67
15,2,5,29,30,59
20,3,9,100,60,160
1,3,9,5,3,8
18,2,5,34,36,70
18,2,5,52,36,88
5,2,5,15,10,25
25,4,10,145,100,245
8,4,10,46,32,78
10,2,5,29,20,49
13,2,5,25,26,51
19,2,5,55,38,93
14,2,5,41,28,69
22,2,5,64,44,108
1,2,5,3,2,5
18,2,5,52,36,88
4,2,5,9,8,17
5,2,5,12,10,22
2,3,9,11,6,17
31,3,9,175,93,268
11,3,9,53,33,86
1,3,9,5,3,8
26,2,5,73,52,125
1,2,5,3,2,5
26,7,9,3,182,185
2,7,9,3,14,17
6,7,9,10,42,52
6,7,9,5,42,47
31,7,9,56,217,273
10,7,9,18,70,88
23,7,9,42,161,203
17,7,9,31,119,150
10,3,8,48,30,78
10,3,8,33,30,63
7,8,22,69,56,125
5,8,22,56,40,96
2,8,22,27,16,43
20,8,22,271,160,431
14,9,24,207,126,333
17,9,24,177,153,330
4,9,24,40,36,76
21,9,24,260,189,449
21,9,24,305,189,494
17,13,35,249,221,470
12,13,35,256,156,412
16,13,35,330,208,538
4,13,35,70,52,122
21,13,35,366,273,639
26,13,35,454,338,792
5,13,35,89,65,154
1,13,35,15,13,28
7,13,35,152,91,243
32,13,35,682,416,1098
27,13,35,386,351,737
8,13,35,165,104,269
16,13,35,330,208,538
1,13,35,21,13,34
25,13,35,515,325,840
21,13,35,447,273,720
12,21,55,322,252,574
28,21,55,921,588,1509
2,42,54,10,84,94
11,42,54,55,462,517
9,38,50,104,342,446
17,38,50,187,646,833
1,42,54,11,42,53
7,42,54,76,294,370
1,1252,2295,630,1252,1882
3,1252,2295,1890,3756,5646
1,1912,3400,842,1912,2754
1,1266,2320,1008,1266,2274
2,1266,2320,1505,2532,4037
1,1266,2320,961,1266,2227
1,1252,2295,561,1252,1813
2,1266,2320,1134,2532,3666
1,1266,2320,799,1266,2065
1,1266,2320,1008,1266,2274
3,420,769,747,1260,2007
1,420,769,318,420,738
2,420,769,498,840,1338
3,308,565,551,924,1475
1,420,769,249,420,669
3,487,783,841,1461,2302
1,1555,2443,717,1555,2272
1,487,783,155,487,642
1,713,1120,273,713,986
1,713,1120,385,713,1098
2,344,540,349,688,1037
1,713,1120,362,713,1075
1,1083,1701,397,1083,1480
2,2171,3578,2671,4342,7013
1,2171,3578,1335,2171,3506
17,26,70,700,442,1142
24,26,70,686,624,1310
5,26,70,213,130,343
17,26,70,736,442,1178
4,3,9,18,12,30
11,1,4,23,11,34
23,8,21,294,184,478
7,1,2,7,7,14
3,9,25,36,27,63
4,9,25,48,36,84
24,9,25,288,216,504
24,1,4,68,24,92
31,1,4,88,31,119
15,8,21,129,120,249
21,8,21,180,168,348
1,2,5,2,2,4
20,2,5,42,40,82
28,2,5,59,56,115
18,1,4,51,18,69
7,1,4,20,7,27
7,2,5,20,14,34
3,2,5,8,6,14
22,1,2,21,22,43
1,1,2,1,1,2
1,13,35,16,13,29
2,1,2,2,2,4
19,1,2,19,19,38
1,1,2,1,1,2
28,1,2,21,28,49
8,1,4,20,8,28
3,13,35,43,39,82
4,13,35,57,52,109
26,11,30,486,286,772
18,11,30,337,198,535
17,1,2,10,17,27
12,1,2,7,12,19
1,1,2,1,1,2
31,1,2,18,31,49
12,2,5,35,24,59
18,2,5,52,36,88
23,2,5,68,46,114
19,2,5,56,38,94
4,1,2,4,4,8
5,1,4,11,5,16
10,1,4,22,10,32
27,1,4,58,27,85
1,2,5,3,2,5
28,8,21,352,224,576
5,8,21,63,40,103
19,8,21,239,152,391
26,2,5,75,52,127
27,2,5,78,54,132
1,461,742,185,461,646
1,755,1215,266,755,1021
1,461,742,251,461,712
2,1482,2384,1613,2964,4577
1,461,742,125,461,586
1,461,742,266,461,727
28,24,64,1084,672,1756
17,24,64,636,408,1044
7,45,120,416,315,731
21,2,5,46,42,88
21,2,5,46,42,88
29,2,5,84,58,142
5,2,5,15,10,25
14,4,10,59,56,115
18,4,10,76,72,148
24,2,5,64,48,112
21,3,9,86,63,149
1,3,9,4,3,7
20,7,9,8,140,148
9,7,9,16,63,79
7,7,9,13,49,62
13,7,9,18,91,109
27,7,9,22,189,211
21,7,9,8,147,155
24,7,9,33,168,201
29,7,9,48,203,251
3,3,8,15,9,24
24,3,8,78,72,150
25,3,8,117,75,192
3,3,8,11,9,20
23,3,8,111,69,180
17,8,22,186,136,322
13,8,22,119,104,223
3,8,22,27,24,51
13,8,22,176,104,280
3,8,22,39,24,63
7,9,24,70,63,133
5,9,24,50,45,95
1,13,35,22,13,35
28,13,35,577,364,941
13,13,35,190,169,359
22,13,35,453,286,739
15,13,35,246,195,441
11,13,35,238,143,381
1,13,35,17,13,30
19,13,35,298,247,545
13,13,35,204,169,373
25,13,35,541,325,866
1,13,35,21,13,34
25,13,35,533,325,858
17,21,55,372,357,729
15,21,55,494,315,809
21,38,50,210,798,1008
15,42,54,67,630,697
8,42,54,40,336,376
6,38,50,18,228,246
21,38,50,179,798,977
23,42,54,15,966,981
24,42,54,3,1008,1011
21,42,54,173,882,1055
1,38,50,6,38,44
1,1252,2295,745,1252,1997
1,420,769,249,420,669
2,295,540,296,590,886
1,420,769,249,420,669
3,420,769,563,1260,1823
1,1266,2320,544,1266,1810
3,1252,2295,1890,3756,5646
1,1555,2443,839,1555,2394
3,2171,3578,4114,6513,10627
1,713,1120,385,713,1098
1,1519,2443,753,1519,2272
1,1555,2443,717,1555,2272
1,713,1120,329,713,1042
2,2171,3578,1884,4342,6226
1,2171,3578,763,2171,2934
1,344,540,99,344,443
1,344,540,99,344,443
1,487,783,171,487,658
23,26,70,722,598,1320
12,26,70,520,312,832
23,26,70,787,598,1385
15,26,70,524,390,914
18,26,70,779,468,1247
15,2,5,42,30,72
7,1,2,4,7,11
21,13,35,447,273,720
29,13,35,618,377,995
8,13,35,170,104,274
1,13,35,21,13,34
32,9,25,400,288,688
29,2,5,86,58,144
9,2,5,27,18,45
2,1,2,1,2,3
29,1,2,19,29,48
28,1,2,19,28,47
23,1,2,16,23,39
32,1,4,79,32,111
21,1,4,52,21,73
3,9,25,35,27,62
14,9,25,161,126,287
16,9,25,228,144,372
6,9,25,86,54,140
19,9,25,271,171,442
24,11,29,404,264,668
24,11,29,404,264,668
15,11,30,276,165,441
10,1,2,6,10,16
26,1,2,17,26,43
4,1,4,9,4,13
18,1,4,41,18,59
8,1,2,6,8,14
22,11,29,351,242,593
21,11,29,335,231,566
6,8,21,60,48,108
13,1,2,13,13,26
18,11,30,245,198,443
13,11,30,177,143,320
21,2,5,59,42,101
7,2,5,20,14,34
11,1,2,11,11,22
11,1,2,11,11,22
4,1,2,4,4,8
18,2,5,52,36,88
6,2,5,17,12,29
13,2,5,31,26,57
9,2,5,21,18,39
20,8,21,231,160,391
6,1,2,6,6,12
7,1,2,7,7,14
26,2,5,57,52,109
26,2,5,57,52,109
1,461,742,251,461,712
1,461,742,185,461,646
2,1482,2384,946,2964,3910
1,755,1215,436,755,1191
1,461,742,251,461,712
1,1482,2384,854,1482,2336
9,24,64,285,216,501
11,24,64,426,264,690
10,59,159,984,590,1574
23,2,5,48,46,94
11,2,5,23,22,45
13,4,10,47,52,99
9,4,10,32,36,68
21,2,5,44,42,86
8,2,5,17,16,33
26,2,5,61,52,113
1,2,5,2,2,4
32,2,5,93,64,157
4,2,5,12,8,20
31,2,5,82,62,144
14,2,5,27,28,55
1,2,5,2,2,4
6,2,5,14,12,26
22,2,5,65,44,109
3,2,5,9,6,15
29,2,5,81,58,139
18,3,9,85,54,139
5,3,9,24,15,39
14,2,5,39,28,67
29,2,5,81,58,139
5,2,5,12,10,22
15,2,5,35,30,65
14,7,9,5,98,103
8,7,9,15,56,71
24,7,9,46,168,214
21,7,9,8,147,155
1,3,8,5,3,8
21,3,8,70,63,133
22,8,22,245,176,421
3,9,24,44,27,71
10,9,24,97,90,187
7,9,24,65,63,128
4,9,24,58,36,94
17,9,24,239,153,392
22,9,24,325,198,523
17,13,35,267,221,488
14,13,35,274,182,456
7,13,35,152,91,243
24,13,35,494,312,806
14,13,35,220,182,402
1,13,35,14,13,27
9,13,35,195,117,312
2,13,35,43,26,69
4,13,35,78,52,130
18,13,35,257,234,491
18,13,35,390,234,624
2,13,35,31,26,57
11,13,35,192,143,335
25,21,55,823,525,1348
25,21,55,658,525,1183
5,38,50,58,190,248
20,38,50,230,760,990
13,42,54,2,546,548
12,38,50,132,456,588
26,42,54,115,1092,1207
10,38,50,55,380,435
13,38,50,143,494,637
1,1266,2320,892,1266,2158
1,1252,2295,676,1252,1928
3,1252,2295,3060,3756,6816
2,1252,2295,1902,2504,4406
1,1266,2320,752,1266,2018
3,1266,2320,1909,3798,5707
1,1266,2320,892,1266,2158
1,2171,3578,1371,2171,3542
2,2171,3578,2528,4342,6870
1,2171,3578,942,2171,3113
1,1083,1701,244,1083,1327
1,2171,3578,656,2171,2827
1,2171,3578,942,2171,3113
1,344,540,126,344,470
3,344,540,232,1032,1264
15,26,70,513,390,903
18,3,9,106,54,160
8,3,9,39,24,63
14,1,2,14,14,28
17,1,2,17,17,34
16,1,2,16,16,32
9,13,35,195,117,312
1,1,2,1,1,2
25,1,2,25,25,50
2,1,2,1,2,3
4,1,2,3,4,7
17,1,2,13,17,30
28,12,33,551,336,887
6,1,2,4,6,10
28,1,2,20,28,48
4,11,30,75,44,119
22,2,5,64,44,108
27,2,5,78,54,132
22,2,5,65,44,109
26,2,5,77,52,129
24,2,5,71,48,119
1,2,5,3,2,5
10,11,30,118,110,228
25,11,30,295,275,570
25,1,2,19,25,44
24,1,2,18,24,42
3,1,2,2,3,5
12,11,29,192,132,324
21,2,5,62,42,104
17,2,5,50,34,84
13,1,2,12,13,25
6,1,2,6,6,12
13,2,5,38,26,64
5,2,5,15,10,25
5,1,4,15,5,20
20,1,4,59,20,79
2,1,4,5,2,7
31,1,2,18,31,49
17,1,2,10,17,27
22,2,5,52,44,96
23,2,5,54,46,100
11,1,4,31,11,42
10,1,4,28,10,38
4,1,4,11,4,15
28,2,5,81,56,137
26,2,5,75,52,127
27,1,2,25,27,52
17,1,2,16,17,33
22,1,2,21,22,43
15,1,2,14,15,29
19,1,2,12,19,31
6,2,5,11,12,23
12,2,5,23,24,47
29,2,5,61,58,119
13,2,5,27,26,53
4,2,5,8,8,16
5,2,5,15,10,25
1,1482,2384,807,1482,2289
1,461,742,103,461,564
1,461,742,177,461,638
2,1482,2384,1709,2964,4673
6,24,64,225,144,369
9,3,9,43,27,70
30,2,5,66,60,126
14,2,5,31,28,59
14,4,10,53,56,109
10,4,10,38,40,78
31,2,5,91,62,153
31,2,5,90,62,152
26,2,5,77,52,129
31,2,5,91,62,153
22,2,5,65,44,109
25,2,5,74,50,124
13,2,5,31,26,57
1,3,9,5,3,8
15,3,9,71,45,116
18,2,5,35,36,71
10,7,9,8,70,78
19,7,9,-3,133,130
25,7,9,41,175,216
15,7,9,12,105,117
3,3,8,10,9,19
25,3,8,123,75,198
11,3,8,43,33,76
22,3,8,106,66,172
22,8,22,240,176,416
7,8,22,64,56,120
26,8,22,238,208,446
8,8,22,100,64,164
25,8,22,339,200,539
27,8,22,372,216,588
3,13,35,43,39,82
13,13,35,268,169,437
25,13,35,358,325,683
26,13,35,454,338,792
9,13,35,192,117,309
10,13,35,206,130,336
18,13,35,314,234,548
29,13,35,476,377,853
6,13,35,130,78,208
18,13,35,390,234,624
11,13,35,227,143,370
26,13,35,354,338,692
21,13,35,366,273,639
28,13,35,400,364,764
23,13,35,361,299,660
9,21,55,301,189,490
11,21,55,295,231,526
1,38,50,3,38,41
7,38,50,81,266,347
14,42,54,70,588,658
6,38,50,0,228,228
15,42,54,172,630,802
13,42,54,65,546,611
26,38,50,260,988,1248
15,42,54,75,630,705
11,42,54,55,462,517
1,1252,2295,722,1252,1974
1,1266,2320,752,1266,2018
1,1266,2320,1008,1266,2274
1,713,1120,138,713,851
1,487,783,194,487,681
1,2171,3578,942,2171,3113
1,2171,3578,835,2171,3006
1,1083,1701,601,1083,1684
1,344,540,174,344,518
2,344,540,165,688,853
1,2171,3578,906,2171,3077
12,26,70,352,312,664
6,26,70,209,156,365
26,3,9,123,78,201
9,3,9,43,27,70
16,2,5,47,32,79
19,2,5,56,38,94
19,13,35,312,247,559
25,13,35,410,325,735
15,13,35,246,195,441
25,1,2,25,25,50
23,11,29,327,253,580
21,2,5,40,42,82
24,2,5,67,48,115
25,2,5,70,50,120
16,2,5,30,32,62
1,1,4,3,1,4
17,1,2,17,17,34
24,1,2,24,24,48
1,2,5,3,2,5
23,2,5,68,46,114
3,2,5,9,6,15
9,1,2,7,9,16
15,1,2,11,15,26
22,1,2,20,22,42
6,1,2,6,6,12
10,9,25,128,90,218
26,9,25,332,234,566
1,1,2,1,1,2
28,1,2,27,28,55
24,8,21,241,192,433
25,8,21,252,200,452
14,8,21,141,112,253
14,2,5,25,28,53
5,1,2,3,5,8
24,1,2,15,24,39
28,2,5,59,56,115
2,2,5,4,4,8
18,1,2,17,18,35
2,1,2,2,2,4
31,8,21,377,248,625
12,8,21,146,96,242
2,461,742,369,922,1291
2,461,742,369,922,1291
9,24,64,268,216,484
30,24,64,778,720,1498
15,45,120,1053,675,1728
4,45,120,194,180,374
3,59,159,214,177,391
7,59,159,555,413,968
7,2,5,14,14,28
14,4,10,66,56,122
14,4,10,66,56,122
29,2,5,86,58,144
14,2,5,33,28,61
27,2,5,63,54,117
8,2,5,17,16,33
7,2,5,15,14,29
30,2,5,87,60,147
6,2,5,17,12,29
21,2,5,62,42,104
15,2,5,44,30,74
24,3,9,114,72,186
18,2,5,35,36,71
28,2,5,55,56,111
7,2,5,20,14,34
12,2,5,35,24,59
11,3,9,59,33,92
10,3,9,54,30,84
18,2,5,42,36,78
25,2,5,59,50,109
23,2,5,67,46,113
16,2,5,46,32,78
24,2,5,64,48,112
24,2,5,64,48,112
15,7,9,27,105,132
9,7,9,16,63,79
11,7,9,8,77,85
10,7,9,7,70,77
21,7,9,17,147,164
22,7,9,40,154,194
4,3,8,13,12,25
14,3,8,69,42,111
25,8,22,345,200,545
9,8,22,122,72,194
5,8,22,49,40,89
10,8,22,94,80,174
1,8,22,14,8,22
13,9,24,192,117,309
29,9,24,421,261,682
18,9,24,214,162,376
24,9,24,348,216,564
20,13,35,286,260,546
22,13,35,384,286,670
12,13,35,209,156,365
27,13,35,585,351,936
21,13,35,352,273,625
12,13,35,188,156,344
10,13,35,206,130,336
25,13,35,489,325,814
19,13,35,405,247,652
9,13,35,192,117,309
9,13,35,195,117,312
19,13,35,298,247,545
27,13,35,367,351,718
4,13,35,68,52,120
6,13,35,88,78,166
3,21,55,99,63,162
28,42,54,306,1176,1482
27,42,54,3,1134,1137
4,38,50,44,152,196
26,42,54,17,1092,1109
17,38,50,187,646,833
15,38,50,165,570,735
21,42,54,105,882,987
17,38,50,94,646,740
1,1898,3375,836,1898,2734
1,1898,3375,768,1898,2666
1,1266,2320,892,1266,2158
1,420,769,249,420,669
1,1266,2320,961,1266,2227
1,2171,3578,1157,2171,3328
1,1555,2443,448,1555,2003
2,2171,3578,1311,4342,5653
1,344,540,77,344,421
1,344,540,185,344,529
2,487,783,388,974,1362
3,2171,3578,4006,6513,10519
31,26,70,1321,806,2127
10,26,70,426,260,686
8,3,9,47,24,71
9,2,5,17,18,35
31,2,5,59,62,121
25,2,5,53,50,103
13,2,5,27,26,53
6,1,2,5,6,11
28,1,2,24,28,52
7,1,2,6,7,13
22,12,33,331,264,595
12,12,33,181,144,325
1,2,5,3,2,5
25,2,5,74,50,124
22,2,5,62,44,106
21,2,5,59,42,101
18,12,33,301,216,517
17,12,33,284,204,488
17,11,30,211,187,398
28,2,5,63,56,119
7,2,5,16,14,30
1,2,5,2,2,4
26,2,5,55,52,107
11,9,25,140,99,239
17,9,25,217,153,370
14,1,2,13,14,27
10,11,30,142,110,252
18,2,5,42,36,78
4,2,5,9,8,17
4,2,5,12,8,20
4,2,5,12,8,20
6,2,5,17,12,29
11,2,5,32,22,54
31,2,5,90,62,152
6,1,2,6,6,12
23,1,4,67,23,90
22,1,2,22,22,44
10,1,2,10,10,20
13,1,2,9,13,22
18,1,4,45,18,63
23,1,4,57,23,80
29,1,4,85,29,114
15,2,5,44,30,74
22,1,4,55,22,77
4,1,4,10,4,14
1,1482,2384,807,1482,2289
1,1482,2384,330,1482,1812
1,1482,2384,854,1482,2336
1,1482,2384,854,1482,2336
1,1482,2384,854,1482,2336
31,24,64,1101,744,1845
7,24,64,195,168,363
3,45,120,218,135,353
5,45,120,363,225,588
20,2,5,38,40,78
17,2,5,32,34,66
14,2,5,41,28,69
5,2,5,15,10,25
6,2,5,11,12,23
7,2,5,16,14,30
7,2,5,13,14,27
21,2,5,49,42,91
23,2,5,54,46,100
22,2,5,48,44,92
31,2,5,68,62,130
26,4,10,146,104,250
13,4,10,73,52,125
18,2,5,40,36,76
3,2,5,7,6,13
3,4,10,11,12,23
18,3,9,105,54,159
28,2,5,81,56,137
17,2,5,49,34,83
1,2,5,3,2,5
13,2,5,38,26,64
18,2,5,52,36,88
4,2,5,12,8,20
26,7,9,10,182,192
15,7,9,29,105,134
18,7,9,15,126,141
14,7,9,25,98,123
9,7,9,16,63,79
1,7,9,0,7,7
1,7,9,0,7,7
12,7,9,10,84,94
18,3,8,71,54,125
22,3,8,71,66,137
7,3,8,34,21,55
19,8,22,199,152,351
22,8,22,298,176,474
10,8,22,131,80,211
18,9,24,253,162,415
9,9,24,90,81,171
16,9,24,232,144,376
28,9,24,339,252,591
15,9,24,167,135,302
13,13,35,186,169,355
29,13,35,618,377,995
13,13,35,227,169,396
17,13,35,362,221,583
7,13,35,115,91,206
26,13,35,372,338,710
1,13,35,22,13,35
7,13,35,152,91,243
23,13,35,474,299,773
19,13,35,298,247,545
1,13,35,21,13,34
22,13,35,315,286,601
13,13,35,281,169,450
30,13,35,471,390,861
20,13,35,286,260,546
16,13,35,251,208,459
6,13,35,107,78,185
17,13,35,279,221,500
20,21,55,658,420,1078
21,21,55,702,441,1143
4,21,55,105,84,189
17,42,54,85,714,799
9,38,50,99,342,441
3,38,50,35,114,149
11,38,50,11,418,429
14,42,54,70,588,658
5,42,54,17,210,227
24,42,54,16,1008,1024
7,38,50,70,266,336
7,42,54,16,294,310
16,38,50,64,608,672
29,38,50,174,1102,1276
1,1266,2320,683,1266,1949
2,420,769,667,840,1507
1,1252,2295,997,1252,2249
1,1266,2320,1031,1266,2297
1,1266,2320,961,1266,2227
1,1252,2295,538,1252,1790
1,1266,2320,752,1266,2018
3,2171,3578,1967,6513,8480
3,2171,3578,1967,6513,8480
1,2171,3578,835,2171,3006
1,2171,3578,763,2171,2934
1,344,540,185,344,529
1,344,540,99,344,443
1,1083,1701,397,1083,1480
3,713,1120,515,2139,2654
24,26,70,1039,624,1663
7,26,70,200,182,382
8,26,70,234,208,442
23,3,9,95,69,164
4,13,35,85,52,137
7,13,35,149,91,240
12,2,5,35,24,59
3,2,5,9,6,15
30,2,5,84,60,144
22,2,5,62,44,106
8,1,2,8,8,16
14,1,2,14,14,28
4,9,25,51,36,87
23,9,25,293,207,500
17,9,25,196,153,349
1,2,5,3,2,5
15,9,25,161,135,296
1,9,25,11,9,20
24,13,35,511,312,823
5,2,5,12,10,22
30,2,5,69,60,129
31,2,5,82,62,144
7,1,2,6,7,13
6,2,5,11,12,23
14,11,30,258,154,412
26,11,30,478,286,764
28,2,5,83,56,139
6,2,5,18,12,30
24,2,5,71,48,119
1,9,25,13,9,22
16,9,25,204,144,348
16,1,2,8,16,24
8,2,5,24,16,40
11,2,5,32,22,54
21,9,25,326,189,515
10,9,25,155,90,245
27,1,2,18,27,45
29,1,2,21,29,50
17,1,2,12,17,29
26,8,21,267,208,475
1,8,21,10,8,18
23,2,5,54,46,100
21,11,30,260,231,491
25,11,30,310,275,585
25,11,30,460,275,735
27,11,30,497,297,794
2,12,33,33,24,57
18,11,29,230,198,428
24,11,29,307,264,571
7,2,5,19,14,33
19,2,5,46,38,84
15,2,5,36,30,66
23,2,5,44,46,90
15,2,5,29,30,59
5,1,2,4,5,9
7,1,2,6,7,13
2,1482,2384,1756,2964,4720
1,755,1215,436,755,1191
1,1482,2384,378,1482,1860
11,24,64,391,264,655
17,24,64,452,408,860
1,45,120,74,45,119
1,45,120,59,45,104
7,59,159,522,413,935
2,59,159,178,118,296
5,2,5,15,10,25
24,2,5,71,48,119
22,3,9,118,66,184
2,3,9,11,6,17
26,2,5,55,52,107
22,3,9,100,66,166
10,3,9,46,30,76
27,2,5,78,54,132
30,2,5,89,60,149
13,2,5,30,26,56
10,2,5,23,20,43
28,2,5,78,56,134
3,2,5,8,6,14
19,2,5,36,38,74
9,2,5,17,18,35
22,2,5,46,44,90
6,2,5,13,12,25
1,2,5,3,2,5
2,2,5,6,4,10
5,2,5,15,10,25
30,2,5,87,60,147
18,7,9,25,126,151
22,7,9,30,154,184
20,7,9,0,140,140
4,7,9,5,28,33
16,7,9,0,112,112
12,7,9,20,84,104
6,3,8,24,18,42
3,3,8,15,9,24
12,3,8,59,36,95
26,8,22,284,208,492
21,8,22,285,168,453
25,8,22,273,200,473
5,8,22,55,40,95
18,8,22,244,144,388
14,8,22,193,112,305
23,8,22,317,184,501
14,8,22,193,112,305
14,8,22,193,112,305
12,9,24,140,108,248
15,9,24,221,135,356
26,13,35,508,338,846
11,13,35,238,143,381
26,13,35,445,338,783
17,13,35,362,221,583
31,13,35,508,403,911
22,13,35,338,286,624
27,13,35,585,351,936
13,13,35,186,169,355
24,13,35,410,312,722
5,13,35,108,65,173
9,13,35,129,117,246
22,13,35,322,286,608
21,13,35,455,273,728
28,13,35,596,364,960
8,13,35,137,104,241
24,13,35,520,312,832
3,13,35,65,39,104
32,13,35,682,416,1098
21,13,35,411,273,684
13,13,35,277,169,446
3,13,35,64,39,103
25,13,35,436,325,761
5,21,55,167,105,272
17,21,55,569,357,926
27,38,50,135,1026,1161
7,42,54,16,294,310
21,38,50,242,798,1040
1,42,54,2,42,44
15,38,50,128,570,698
16,38,50,184,608,792
10,42,54,109,420,529
4,42,54,46,168,214
7,38,50,7,266,273
7,38,50,39,266,305
3,1252,2295,2165,3756,5921
1,1252,2295,1020,1252,2272
2,1266,2320,1783,2532,4315
2,1252,2295,1443,2504,3947
1,1252,2295,722,1252,1974
3,295,540,670,885,1555
1,420,769,334,420,754
1,1266,2320,1008,1266,2274
1,420,769,318,420,738
2,1252,2295,1765,2504,4269
1,1252,2295,997,1252,2249
1,420,769,211,420,631
1,1252,2295,538,1252,1790
1,2171,3578,1157,2171,3328
1,1519,2443,900,1519,2419
1,713,1120,396,713,1109
1,2171,3578,727,2171,2898
1,1083,1701,499,1083,1582
1,2171,3578,656,2171,2827
3,2171,3578,2504,6513,9017
1,344,540,120,344,464
1,713,1120,161,713,874
1,2171,3578,835,2171,3006
1,344,540,77,344,421
2,344,540,370,688,1058
1,713,1120,362,713,1075
1,1083,1701,397,1083,1480
1,713,1120,329,713,1042
24,26,70,1022,624,1646
31,26,70,1321,806,2127
5,26,70,171,130,301
11,26,70,469,286,755
16,3,9,76,48,124
7,3,9,41,21,62
11,3,9,62,33,95
27,2,5,80,54,134
30,2,5,89,60,149
9,2,5,27,18,45
1,1,2,1,1,2
16,11,30,299,176,475
14,1,2,13,14,27
7,1,2,7,7,14
1,1,2,1,1,2
11,1,2,6,11,17
29,1,2,17,29,46
25,11,29,399,275,674
29,11,29,463,319,782
20,9,25,230,180,410
6,9,25,69,54,123
2,9,25,23,18,41
10,1,4,21,10,31
31,1,2,30,31,61
18,1,2,18,18,36
14,1,2,14,14,28
23,12,33,346,276,622
11,1,2,8,11,19
20,1,2,15,20,35
28,1,2,19,28,47
21,1,2,14,21,35
2,1,4,6,2,8
3,1,4,9,3,12
8,11,30,147,88,235
17,11,30,313,187,500
8,2,5,24,16,40
8,2,5,24,16,40
12,1,2,12,12,24
2,13,35,29,26,55
15,13,35,220,195,415
11,1,4,23,11,34
2,1,4,4,2,6
29,1,2,27,29,56
24,2,5,71,48,119
26,2,5,77,52,129
9,1,4,26,9,35
22,1,4,62,22,84
9,2,5,21,18,39
6,2,5,14,12,26
3,1,4,8,3,11
6,2,5,14,12,26
17,2,5,39,34,73
12,2,5,35,24,59
5,2,5,15,10,25
3,1,2,2,3,5
16,11,29,228,176,404
16,9,25,228,144,372
20,9,25,285,180,465
14,9,25,200,126,326
8,1,4,23,8,31
18,9,25,279,162,441
10,9,25,155,90,245
1,1482,2384,473,1482,1955
1,755,1215,436,755,1191
1,1482,2384,521,1482,2003
19,24,64,565,456,1021
1,45,120,49,45,94
9,45,120,437,405,842
11,2,5,31,22,53
10,2,5,28,20,48
14,2,5,39,28,67
12,2,5,35,24,59
27,2,5,80,54,134
10,2,5,30,20,50
28,2,5,81,56,137
6,2,5,18,12,30
17,2,5,50,34,84
27,2,5,72,54,126
14,2,5,37,28,65
24,4,10,142,96,238
20,4,10,118,80,198
6,2,5,13,12,25
24,2,5,50,48,98
4,2,5,12,8,20
18,2,5,53,36,89
24,7,9,9,168,177
4,7,9,8,28,36
12,7,9,10,84,94
9,7,9,3,63,66
28,7,9,46,196,242
12,7,9,22,84,106
24,7,9,20,168,188
2,7,9,3,14,17
12,7,9,5,84,89
14,7,9,27,98,125
20,3,8,79,60,139
4,3,8,20,12,32
15,3,8,49,45,94
9,8,22,82,72,154
1,8,22,9,8,17
11,8,22,108,88,196
29,8,22,323,232,555
9,9,24,131,81,212
18,9,24,175,162,337
26,9,24,378,234,612
15,9,24,221,135,356
16,9,24,236,144,380
1,9,24,12,9,21
11,13,35,161,143,304
22,13,35,384,286,670
17,13,35,368,221,589
23,13,35,490,299,789
8,13,35,126,104,230
15,13,35,320,195,515
13,13,35,268,169,437
20,13,35,433,260,693
8,13,35,140,104,244
27,13,35,424,351,775
22,13,35,338,286,624
24,13,35,410,312,722
24,13,35,494,312,806
17,13,35,249,221,470
1,13,35,21,13,34
6,13,35,124,78,202
23,13,35,474,299,773
8,13,35,170,104,274
18,13,35,257,234,491
15,21,55,502,315,817
9,21,55,286,189,475
1,21,55,22,21,43
6,42,54,69,252,321
4,42,54,20,168,188
27,38,50,81,1026,1107
5,38,50,15,190,205
23,42,54,264,966,1230
14,38,50,35,532,567
25,38,50,138,950,1088
12,42,54,60,504,564
20,42,54,67,840,907
17,38,50,196,646,842
1,42,54,11,42,53
1,1252,2295,538,1252,1790
2,1252,2295,1765,2504,4269
1,295,540,148,295,443
2,1266,2320,1922,2532,4454
1,1266,2320,961,1266,2227
2,308,565,503,616,1119
2,2171,3578,2528,4342,6870
1,2171,3578,763,2171,2934
1,1555,2443,864,1555,2419
1,1555,2443,790,1555,2345
1,2171,3578,656,2171,2827
3,1083,1701,1803,3249,5052
1,1083,1701,397,1083,1480
1,344,540,185,344,529
1,713,1120,261,713,974
1,2171,3578,1335,2171,3506
3,713,1120,986,2139,3125
28,26,70,1212,728,1940
22,3,9,88,66,154
18,1,2,18,18,36
24,1,2,24,24,48
6,2,5,17,12,29
24,2,5,70,48,118
28,2,5,81,56,137
19,1,2,18,19,37
9,1,2,9,9,18
22,12,33,411,264,675
24,1,2,13,24,37
24,2,5,71,48,119
4,2,5,12,8,20
20,9,25,255,180,435
30,9,25,383,270,653
17,2,5,48,34,82
21,1,2,18,21,39
22,1,4,62,22,84
11,1,4,31,11,42
24,12,33,401,288,689
19,12,33,317,228,545
10,1,2,9,10,19
26,1,2,24,26,50
9,1,2,8,9,17
25,1,4,57,25,82
25,11,30,310,275,585
17,11,30,211,187,398
29,1,2,28,29,57
17,1,2,16,17,33
20,12,33,314,240,554
28,12,33,440,336,776
13,1,4,38,13,51
5,1,4,15,5,20
11,1,2,6,11,17
27,1,2,15,27,42
8,2,5,22,16,38
21,2,5,59,42,101
7,2,5,16,14,30
6,2,5,14,12,26
29,2,5,68,58,126
3,1482,2384,1204,4446,5650
3,461,742,442,1383,1825
1,755,1215,266,755,1021
3,755,1215,1307,2265,3572
1,1482,2384,473,1482,1955
1,461,742,274,461,735
1,461,742,274,461,735
2,45,120,148,90,238
16,2,5,45,32,77
10,4,10,59,40,99
5,2,5,12,10,22
7,2,5,21,14,35
25,2,5,74,50,124
14,2,5,41,28,69
18,2,5,52,36,88
2,2,5,6,4,10
12,2,5,35,24,59
11,2,5,24,22,46
11,2,5,24,22,46
1,2,5,2,2,4
21,2,5,44,42,86
20,2,5,46,40,86
15,2,5,35,30,65
2,2,5,5,4,9
30,2,5,71,60,131
27,2,5,63,54,117
16,2,5,34,32,66
2,2,5,4,4,8
27,3,9,123,81,204
10,7,9,6,70,76
2,7,9,1,14,15
10,7,9,4,70,74
6,7,9,4,42,46
14,3,8,54,42,96
5,3,8,24,15,39
22,3,8,87,66,153
10,3,8,40,30,70
14,8,22,153,112,265
10,8,22,116,80,196
1,8,22,14,8,22
22,8,22,274,176,450
26,8,22,238,208,446
1,8,22,14,8,22
19,9,24,276,171,447
4,9,24,48,36,84
8,9,24,118,72,190
1,13,35,21,13,34
5,13,35,107,65,172
8,13,35,117,104,221
22,13,35,453,286,739
13,13,35,227,169,396
26,13,35,536,338,874
1,13,35,17,13,30
6,13,35,128,78,206
1,13,35,17,13,30
11,13,35,234,143,377
8,13,35,170,104,274
10,13,35,175,130,305
2,13,35,43,26,69
24,13,35,511,312,823
26,13,35,408,338,746
21,13,35,300,273,573
19,21,55,500,399,899
3,21,55,99,63,162
32,21,55,806,672,1478
27,38,50,27,1026,1053
25,38,50,288,950,1238
9,42,54,98,378,476
11,38,50,61,418,479
17,38,50,43,646,689
26,42,54,284,1092,1376
30,42,54,328,1260,1588
2,38,50,0,76,76
1,1266,2320,799,1266,2065
1,1252,2295,1020,1252,2272
1,1252,2295,745,1252,1997
2,295,540,468,590,1058
1,2171,3578,942,2171,3113
1,1083,1701,550,1083,1633
1,2171,3578,835,2171,3006
1,713,1120,250,713,963
1,344,540,99,344,443
1,344,540,120,344,464
1,713,1120,261,713,974
3,344,540,556,1032,1588
1,713,1120,194,713,907
2,1519,2443,1799,3038,4837
1,26,70,41,26,67
24,26,70,838,624,1462
6,26,70,256,156,412
12,26,70,511,312,823
9,26,70,245,234,479
15,3,9,85,45,130
8,3,9,39,24,63
9,3,9,52,27,79
21,1,2,16,21,37
21,1,2,21,21,42
16,1,2,16,16,32
11,1,2,11,11,22
16,1,2,15,16,31
20,13,35,433,260,693
24,13,35,520,312,832
11,11,30,206,121,327
2,11,30,37,22,59
17,13,35,332,221,553
17,12,33,256,204,460
7,12,33,105,84,189
10,1,2,6,10,16
26,1,2,15,26,41
7,2,5,21,14,35
1,2,5,3,2,5
15,2,5,44,30,74
24,2,5,67,48,115
13,2,5,36,26,62
21,1,2,13,21,34
23,2,5,64,46,110
22,1,2,16,22,38
13,2,5,38,26,64
16,2,5,46,32,78
16,9,25,248,144,392
13,2,5,31,26,57
4,1,2,4,4,8
18,1,2,17,18,35
11,2,5,32,22,54
24,2,5,56,48,104
18,2,5,42,36,78
28,2,5,53,56,109
23,2,5,47,46,93
18,2,5,37,36,73
29,1,2,28,29,57
15,1,2,14,15,29
3,8,21,38,24,62
7,1,2,4,7,11
26,1,2,15,26,41
28,2,5,78,56,134
10,2,5,28,20,48
12,1,4,29,12,41
1,1482,2384,592,1482,2074
3,461,742,442,1383,1825
16,24,64,630,384,1014
1,59,159,65,59,124
4,59,159,387,236,623
19,2,5,37,38,75
14,2,5,27,28,55
12,2,5,35,24,59
12,2,5,35,24,59
2,4,10,11,8,19
26,4,10,146,104,250
12,2,5,23,24,47
25,2,5,53,50,103
13,4,10,55,52,107
26,4,10,99,104,203
18,4,10,68,72,140
26,2,5,61,52,113
29,2,5,68,58,126
6,2,5,11,12,23
6,2,5,11,12,23
3,2,5,9,6,15
28,2,5,66,56,122
6,2,5,14,12,26
27,2,5,63,54,117
5,2,5,12,10,22
7,7,9,5,49,54
28,3,8,136,84,220
2,3,8,10,6,16
7,3,8,33,21,54
23,8,22,312,184,496
14,8,22,141,112,253
2,8,22,18,16,34
11,8,22,149,88,237
23,8,22,317,184,501
24,8,22,331,192,523
21,9,24,305,189,494
12,9,24,143,108,251
6,9,24,67,54,121
9,13,35,141,117,258
9,13,35,157,117,274
17,13,35,279,221,500
10,13,35,213,130,343
14,13,35,274,182,456
13,13,35,281,169,450
22,13,35,384,286,670
12,13,35,188,156,344
21,13,35,300,273,573
16,13,35,346,208,554
13,13,35,204,169,373
26,13,35,454,338,792
26,13,35,445,338,783
1,13,35,17,13,30
17,13,35,297,221,518
1,13,35,21,13,34
14,13,35,200,182,382
25,13,35,375,325,700
2,21,55,67,42,109
22,21,55,724,462,1186
10,42,54,44,420,464
7,38,50,77,266,343
28,38,50,140,1064,1204
1,1252,2295,676,1252,1928
2,308,565,311,616,927
1,1252,2295,997,1252,2249
3,1252,2295,2991,3756,6747
1,1266,2320,636,1266,1902
3,1266,2320,3023,3798,6821
1,2171,3578,763,2171,2934
3,1519,2443,2259,4557,6816
1,2171,3578,942,2171,3113
1,2171,3578,835,2171,3006
1,2171,3578,942,2171,3113
1,344,540,77,344,421
1,1555,2443,375,1555,1930
1,1555,2443,570,1555,2125
1,344,540,77,344,421
2,713,1120,523,1426,1949
1,2171,3578,1335,2171,3506
1,1519,2443,900,1519,2419
1,1083,1701,550,1083,1633
19,26,70,517,494,1011
1,2,5,3,2,5
5,2,5,15,10,25
12,13,35,260,156,416
15,13,35,325,195,520
21,2,5,61,42,103
3,2,5,9,6,15
7,1,2,4,7,11
18,1,2,10,18,28
6,1,2,3,6,9
25,11,29,399,275,674
13,1,2,9,13,22
25,1,2,17,25,42
22,9,25,347,198,545
21,9,25,331,189,520
8,1,2,6,8,14
3,1,2,3,3,6
5,1,2,5,5,10
4,2,5,9,8,17
10,1,2,10,10,20
14,1,2,14,14,28
32,2,5,74,64,138
19,2,5,44,38,82
25,1,2,18,25,43
16,1,2,15,16,31
9,1,2,9,9,18
21,2,5,59,42,101
7,2,5,20,14,34
32,8,21,403,256,659
11,8,21,138,88,226
3,2,5,9,6,15
5,2,5,15,10,25
19,2,5,55,38,93
18,1,4,53,18,71
24,1,4,70,24,94
12,1,4,35,12,47
1,8,21,13,8,21
20,8,21,252,160,412
16,1,2,10,16,26
4,1,2,2,4,6
23,2,5,51,46,97
2,2,5,4,4,8
12,2,5,35,24,59
8,2,5,23,16,39
3,461,742,554,1383,1937
1,1482,2384,807,1482,2289
2,1482,2384,1709,2964,4673
2,1482,2384,1709,2964,4673
28,24,64,1102,672,1774
29,45,120,1931,1305,3236
1,59,159,94,59,153
16,4,10,94,64,158
12,4,10,46,48,94
28,4,10,157,112,269
10,4,10,56,40,96
1,2,5,2,2,4
10,2,5,19,20,39
7,3,9,34,21,55
7,3,9,34,21,55
1,2,5,3,2,5
13,2,5,34,26,60
21,2,5,61,42,103
11,2,5,23,22,45
4,3,9,21,12,33
10,3,9,54,30,84
3,2,5,8,6,14
29,2,5,81,58,139
27,2,5,78,54,132
28,2,5,81,56,137
18,2,5,53,36,89
4,2,5,12,8,20
5,7,9,1,35,36
12,7,9,23,84,107
27,7,9,44,189,233
30,7,9,41,210,251
22,7,9,2,154,156
1,3,8,5,3,8
15,3,8,49,45,94
17,8,22,159,136,295
12,8,22,163,96,259
13,8,22,176,104,280
25,9,24,369,225,594
1,9,24,14,9,23
10,9,24,148,90,238
27,9,24,301,243,544
15,9,24,218,135,353
18,9,24,266,162,428
1,13,35,20,13,33
10,13,35,175,130,305
7,13,35,144,91,235
23,13,35,498,299,797
15,13,35,309,195,504
24,13,35,494,312,806
31,13,35,660,403,1063
9,13,35,129,117,246
15,13,35,309,195,504
2,13,35,41,26,67
20,13,35,412,260,672
20,13,35,328,260,588
15,13,35,320,195,515
28,13,35,440,364,804
22,13,35,384,286,670
27,13,35,556,351,907
24,13,35,520,312,832
13,13,35,177,169,346
27,13,35,424,351,775
10,13,35,143,130,273
10,13,35,206,130,336
4,13,35,57,52,109
14,13,35,239,182,421
25,21,55,836,525,1361
14,42,54,138,588,726
20,42,54,13,840,853
18,42,54,177,756,933
7,38,50,21,266,287
14,38,50,14,532,546
18,38,50,207,684,891
9,38,50,90,342,432
8,42,54,18,336,354
3,42,54,13,126,139
24,42,54,120,1008,1128
23,38,50,253,874,1127
17,42,54,140,714,854
1,42,54,11,42,53
29,42,54,317,1218,1535
3,1912,3400,2322,5736,8058
1,1912,3400,1046,1912,2958
3,1266,2320,2675,3798,6473
2,1266,2320,1366,2532,3898
3,1252,2295,2854,3756,6610
1,1252,2295,997,1252,2249
1,295,540,169,295,464
2,1555,2443,1581,3110,4691
1,2171,3578,942,2171,3113
2,2171,3578,1311,4342,5653
3,2171,3578,2826,6513,9339
2,1555,2443,701,3110,3811
1,344,540,77,344,421
1,344,540,126,344,470
1,713,1120,329,713,1042
1,344,540,174,344,518
3,1083,1701,1191,3249,4440
1,713,1120,329,713,1042
1,344,540,66,344,410
28,26,70,1193,728,1921
30,3,9,175,90,265
1,9,25,11,9,20
23,2,5,44,46,90
7,2,5,13,14,27
24,2,5,46,48,94
18,2,5,34,36,70
16,1,2,15,16,31
10,1,2,9,10,19
23,2,5,64,46,110
10,2,5,28,20,48
6,1,2,6,6,12
6,11,29,101,66,167
15,11,29,253,165,418
13,1,4,31,13,44
6,2,5,13,12,25
24,2,5,50,48,98
3,2,5,6,6,12
8,12,33,126,96,222
28,12,33,440,336,776
4,1,4,9,4,13
1,13,35,15,13,28
16,1,2,16,16,32
24,1,2,22,24,46
13,2,5,38,26,64
21,2,5,61,42,103
1,2,5,3,2,5
1,2,5,3,2,5
9,2,5,27,18,45
13,8,21,134,104,238
23,8,21,236,184,420
16,9,25,204,144,348
25,9,25,319,225,544
14,9,25,179,126,305
22,2,5,40,44,84
3,2,5,5,6,11
25,11,30,460,275,735
25,11,30,460,275,735
21,1,2,15,21,36
16,2,5,45,32,77
17,2,5,48,34,82
23,2,5,67,46,113
17,2,5,49,34,83
17,1,4,48,17,65
17,1,4,48,17,65
28,2,5,53,56,109
20,2,5,38,40,78
25,1,4,73,25,98
18,1,4,53,18,71
17,1,2,10,17,27
17,1,2,16,17,33
23,1,2,22,23,45
15,1,2,14,15,29
26,1,2,25,26,51
15,1,2,15,15,30
14,1,2,14,14,28
12,1,2,12,12,24
1,1482,2384,807,1482,2289
2,755,1215,750,1510,2260
3,45,120,178,135,313
20,3,9,88,60,148
25,3,9,110,75,185
30,2,5,71,60,131
14,2,5,33,28,61
24,2,5,70,48,118
15,2,5,44,30,74
9,4,10,34,36,70
26,2,5,75,52,127
15,2,5,33,30,63
12,2,5,35,24,59
25,7,9,1,175,176
14,7,9,5,98,103
17,7,9,28,119,147
5,7,9,8,35,43
28,7,9,46,196,242
12,7,9,5,84,89
5,3,8,24,15,39
23,8,22,201,184,385
19,9,24,203,171,374
8,9,24,78,72,150
6,9,24,87,54,141
22,9,24,251,198,449
13,9,24,145,117,262
27,13,35,386,351,737
25,13,35,393,325,718
6,13,35,124,78,202
16,13,35,229,208,437
30,13,35,492,390,882
4,13,35,85,52,137
25,13,35,533,325,858
1,13,35,22,13,35
4,13,35,85,52,137
27,13,35,443,351,794
16,13,35,262,208,470
30,13,35,471,390,861
19,13,35,411,247,658
25,13,35,515,325,840
25,13,35,515,325,840
27,13,35,471,351,822
17,13,35,267,221,488
4,13,35,82,52,134
7,13,35,144,91,235
25,13,35,393,325,718
29,21,55,699,609,1308
1,21,55,33,21,54
13,21,55,270,273,543
27,21,55,591,567,1158
13,42,54,58,546,604
17,42,54,57,714,771
28,38,50,308,1064,1372
10,42,54,34,420,454
17,38,50,94,646,740
16,42,54,36,672,708
20,42,54,67,840,907
1,1898,3375,870,1898,2768
2,1252,2295,1489,2504,3993
1,1252,2295,538,1252,1790
1,1912,3400,876,1912,2788
1,420,769,211,420,631
1,1252,2295,538,1252,1790
1,1912,3400,1420,1912,3332
1,2171,3578,906,2171,3077
1,2171,3578,835,2171,3006
1,344,540,174,344,518
1,713,1120,362,713,1075
1,713,1120,205,713,918
18,26,70,565,468,1033
29,26,70,829,754,1583
25,26,70,715,650,1365
3,26,70,86,78,164
20,26,70,852,520,1372
1,26,70,43,26,69
12,3,9,55,36,91
19,3,9,112,57,169
15,2,5,29,30,59
12,1,2,12,12,24
8,1,2,8,8,16
9,9,25,115,81,196
10,9,25,128,90,218
13,2,5,36,26,62
17,1,2,17,17,34
18,1,4,38,18,56
13,1,4,28,13,41
5,2,5,14,10,24
18,2,5,50,36,86
25,2,5,70,50,120
30,12,33,620,360,980
24,12,33,496,288,784
23,1,2,21,23,44
5,1,2,3,5,8
16,1,2,11,16,27
5,2,5,15,10,25
11,2,5,32,22,54
12,1,2,12,12,24
25,1,2,16,25,41
4,12,33,60,48,108
12,12,33,181,144,325
1,12,33,15,12,27
11,11,30,196,121,317
3,1,2,2,3,5
3,1,2,2,3,5
29,8,21,261,232,493
6,1,2,6,6,12
25,11,29,356,275,631
30,11,29,427,330,757
7,2,5,20,14,34
11,2,5,31,22,53
2,1,2,1,2,3
1,1482,2384,878,1482,2360
1,1482,2384,854,1482,2336
1,1482,2384,521,1482,2003
8,45,120,427,360,787
21,2,5,59,42,101
1,2,5,3,2,5
15,3,9,87,45,132
8,3,9,47,24,71
29,2,5,84,58,142
18,2,5,52,36,88
4,2,5,11,8,19
26,2,5,55,52,107
2,2,5,4,4,8
22,3,9,90,66,156
8,3,9,33,24,57
13,2,5,27,26,53
6,7,9,11,42,53
14,7,9,12,98,110
5,7,9,2,35,37
5,3,8,17,15,32
4,3,8,19,12,31
9,3,8,30,27,57
15,8,22,164,120,284
19,8,22,262,152,414
21,9,24,280,189,469
19,9,24,203,171,374
7,13,35,144,91,235
16,13,35,229,208,437
16,13,35,330,208,538
9,13,35,195,117,312
31,13,35,639,403,1042
1,13,35,14,13,27
5,13,35,72,65,137
17,13,35,350,221,571
20,21,55,603,420,1023
21,21,55,633,441,1074
27,21,55,606,567,1173
6,21,55,197,126,323
10,38,50,30,380,410
15,38,50,83,570,653
3,38,50,35,114,149
1,1266,2320,636,1266,1902
1,1252,2295,997,1252,2249
3,1266,2320,2884,3798,6682
1,295,540,240,295,535
1,2171,3578,942,2171,3113
3,487,783,465,1461,1926
1,713,1120,385,713,1098
2,487,783,482,974,1456
1,1519,2443,606,1519,2125
2,1083,1701,794,2166,2960
2,2171,3578,2742,4342,7084
1,1083,1701,550,1083,1633
1,1083,1701,261,1083,1344
1,2171,3578,1335,2171,3506
2,2171,3578,2671,4342,7013
25,26,70,1065,650,1715
1,26,70,43,26,69
8,26,70,279,208,487
18,3,9,85,54,139
7,3,9,41,21,62
11,3,9,52,33,85
19,13,35,272,247,519
22,13,35,315,286,601
22,13,35,315,286,601
20,1,2,13,20,33
27,1,2,17,27,44
18,2,5,50,36,86
9,2,5,25,18,43
7,1,4,20,7,27
16,1,4,45,16,61
18,13,35,383,234,617
14,13,35,298,182,480
21,11,30,393,231,624
12,11,30,224,132,356
1,11,30,12,11,23
1,11,30,12,11,23
22,2,5,58,44,102
1,2,5,3,2,5
30,1,4,74,30,104
16,1,4,40,16,56
1,2,5,3,2,5
15,11,30,204,165,369
9,11,30,122,99,221
1,13,35,21,13,34
15,2,5,40,30,70
16,2,5,42,32,74
19,1,2,11,19,30
9,1,2,5,9,14
5,2,5,11,10,21
26,2,5,47,52,99
10,1,2,7,10,17
26,1,2,14,26,40
6,1,2,3,6,9
10,1,2,7,10,17
11,1,2,8,11,19
8,1,4,23,8,31
27,1,4,79,27,106
3,9,25,38,27,65
2,1,4,6,2,8
1,1482,2384,807,1482,2289
3,1482,2384,2420,4446,6866
1,755,1215,193,755,948
7,45,120,340,315,655
1,2,5,2,2,4
21,2,5,40,42,82
28,2,5,66,56,122
31,2,5,73,62,135
17,2,5,49,34,83
28,2,5,81,56,137
21,2,5,61,42,103
25,2,5,73,50,123
27,2,5,72,54,126
15,3,9,87,45,132
9,2,5,25,18,43
15,2,5,44,30,74
10,2,5,29,20,49
17,2,5,49,34,83
3,7,9,6,21,27
22,7,9,42,154,196
25,7,9,48,175,223
27,7,9,22,189,211
17,7,9,2,119,121
18,3,8,60,54,114
1,8,22,10,8,18
9,8,22,122,72,194
29,8,22,393,232,625
8,8,22,89,64,153
16,8,22,178,128,306
21,9,24,310,189,499
16,9,24,190,144,334
10,9,24,145,90,235
4,9,24,58,36,94
17,13,35,291,221,512
23,13,35,490,299,789
3,13,35,65,39,104
19,13,35,332,247,579
13,13,35,222,169,391
28,13,35,606,364,970
4,13,35,70,52,122
6,13,35,124,78,202
13,13,35,281,169,450
23,13,35,490,299,789
25,13,35,541,325,866
9,13,35,192,117,309
17,13,35,362,221,583
27,13,35,556,351,907
24,13,35,377,312,689
11,38,50,127,418,545
3,42,54,13,126,139
22,38,50,242,836,1078
9,42,54,103,378,481
19,38,50,219,722,941
15,38,50,45,570,615
14,42,54,47,588,635
16,38,50,184,608,792
27,42,54,18,1134,1152
9,38,50,50,342,392
3,1252,2295,1614,3756,5370
1,420,769,334,420,754
1,420,769,334,420,754
2,1252,2295,1352,2504,3856
1,295,540,234,295,529
1,1266,2320,1008,1266,2274
1,713,1120,396,713,1109
2,1083,1701,1100,2166,3266
1,2171,3578,656,2171,2827
2,2171,3578,1884,4342,6226
3,713,1120,1187,2139,3326
1,344,540,174,344,518
1,2171,3578,1371,2171,3542
1,1083,1701,312,1083,1395
1,1083,1701,261,1083,1344
16,26,70,693,416,1109
17,26,70,736,442,1178
20,26,70,698,520,1218
1,3,9,5,3,8
27,3,9,152,81,233
9,1,2,6,9,15
8,2,5,19,16,35
10,13,35,213,130,343
15,13,35,320,195,515
31,1,4,92,31,123
11,2,5,32,22,54
26,2,5,75,52,127
11,2,5,31,22,53
25,1,2,22,25,47
7,1,2,6,7,13
20,2,5,56,40,96
2,1,2,1,2,3
9,1,2,7,9,16
23,2,5,67,46,113
7,2,5,20,14,34
26,1,2,19,26,45
7,1,2,5,7,12
17,1,2,15,17,32
25,2,5,74,50,124
23,2,5,68,46,114
30,2,5,89,60,149
30,1,2,19,30,49
14,2,5,41,28,69
24,2,5,71,48,119
1,1,2,1,1,2
8,1,2,6,8,14
13,1,2,10,13,23
20,8,21,184,160,344
1,8,21,9,8,17
15,1,2,8,15,23
4,1,2,2,4,6
16,2,5,30,32,62
4,2,5,8,8,16
20,1,2,14,20,34
21,1,2,15,21,36
24,1,4,59,24,83
13,1,4,32,13,45
25,2,5,59,50,109
15,2,5,44,30,74
10,1,4,29,10,39
1,1482,2384,401,1482,1883
1,1482,2384,807,1482,2289
2,755,1215,483,1510,1993
5,24,64,187,120,307
9,45,120,653,405,1058
1,59,159,98,59,157
28,2,5,63,56,119
2,2,5,5,4,9
28,2,5,53,56,109
2,2,5,4,4,8
23,2,5,54,46,100
22,2,5,52,44,96
11,2,5,25,22,47
10,2,5,23,20,43
5,2,5,12,10,22
9,2,5,18,18,36
5,2,5,10,10,20
24,2,5,59,48,107
20,2,5,58,40,98
12,3,9,70,36,106
20,2,5,41,40,81
27,7,9,44,189,233
18,7,9,7,126,133
18,7,9,5,126,131
19,7,9,19,133,152
28,7,9,21,196,217
11,7,9,18,77,95
8,3,8,28,24,52
24,3,8,89,72,161
11,3,8,38,33,71
12,8,22,113,96,209
16,8,22,147,128,275
10,8,22,111,80,191
25,8,22,345,200,545
5,9,24,50,45,95
8,9,24,93,72,165
26,13,35,372,338,710
26,13,35,372,338,710
12,13,35,247,156,403
17,13,35,243,221,464
29,13,35,628,377,1005
6,13,35,94,78,172
16,13,35,341,208,549
6,13,35,130,78,208
1,13,35,21,13,34
13,13,35,281,169,450
11,13,35,238,143,381
19,13,35,405,247,652
14,13,35,244,182,426
15,13,35,262,195,457
18,13,35,371,234,605
26,13,35,454,338,792
28,13,35,479,364,843
7,21,55,188,147,335
2,42,54,22,84,106
17,42,54,11,714,725
22,38,50,242,836,1078
1,42,54,10,42,52
14,42,54,153,588,741
19,42,54,84,798,882
18,38,50,90,684,774
1,42,54,10,42,52
15,38,50,150,570,720
3,1912,3400,2322,5736,8058
1,1912,3400,944,1912,2856
1,1252,2295,607,1252,1859
1,1266,2320,544,1266,1810
1,1252,2295,722,1252,1974
1,295,540,148,295,443
2,420,769,636,840,1476
1,1252,2295,630,1252,1882
1,1555,2443,839,1555,2394
1,713,1120,385,713,1098
1,2171,3578,656,2171,2827
1,2171,3578,727,2171,2898
1,487,783,194,487,681
1,1519,2443,533,1519,2052
1,344,540,174,344,518
2,713,1120,388,1426,1814
2,713,1120,344,1426,1770
3,2171,3578,4006,6513,10519
13,26,70,445,338,783
19,26,70,650,494,1144
3,26,70,101,78,179
17,26,70,534,442,976
13,3,9,76,39,115
30,3,9,169,90,259
10,1,2,9,10,19
6,1,2,5,6,11
31,2,5,87,62,149
21,2,5,59,42,101
18,2,5,50,36,86
29,1,2,27,29,56
20,1,2,18,20,38
28,1,2,15,28,43
24,1,2,12,24,36
20,2,5,59,40,99
15,9,25,161,135,296
28,1,2,27,28,55
12,1,4,34,12,46
2,1,4,6,2,8
6,1,2,6,6,12
27,1,2,26,27,53
4,2,5,11,8,19
5,2,5,14,10,24
27,13,35,575,351,926
21,13,35,447,273,720
4,1,4,10,4,14
2,1,2,2,2,4
6,1,2,6,6,12
22,2,5,64,44,108
21,2,5,61,42,103
24,11,30,442,264,706
11,11,30,202,121,323
4,1,2,3,4,7
24,1,2,18,24,42
26,1,2,17,26,43
27,1,2,17,27,44
28,1,2,18,28,46
28,1,4,66,28,94
28,2,5,83,56,139
16,1,2,16,16,32
27,1,2,26,27,53
7,11,30,131,77,208
6,11,30,112,66,178
8,11,30,150,88,238
16,8,21,195,128,323
22,12,33,324,264,588
30,12,33,442,360,802
3,1,2,3,3,6
22,1,2,22,22,44
7,1,2,4,7,11
16,1,2,9,16,25
20,2,5,47,40,87
15,2,5,35,30,65
15,1,2,15,15,30
6,1,2,6,6,12
27,1,2,20,27,47
28,1,2,21,28,49
1,1,2,1,1,2
23,1,2,17,23,40
24,2,5,56,48,104
21,2,5,49,42,91
1,2,5,2,2,4
13,1,2,12,13,25
23,8,21,280,184,464
24,1,4,59,24,83
18,1,4,44,18,62
3,755,1215,578,2265,2843
1,755,1215,278,755,1033
1,1482,2384,854,1482,2336
1,1482,2384,592,1482,2074
5,45,120,369,225,594
17,2,5,36,34,70
25,2,5,53,50,103
27,2,5,80,54,134
18,2,5,53,36,89
20,2,5,38,40,78
13,2,5,25,26,51
25,2,5,70,50,120
24,2,5,67,48,115
18,2,5,34,36,70
11,2,5,32,22,54
17,3,9,99,51,150
17,3,9,99,51,150
24,7,9,13,168,181
24,7,9,0,168,168
2,7,9,2,14,16
9,3,8,35,27,62
20,8,22,183,160,343
29,8,22,393,232,625
24,8,22,220,192,412
3,8,22,41,24,65
9,8,22,100,72,172
19,8,22,262,152,414
20,8,22,249,160,409
21,8,22,289,168,457
16,8,22,178,128,306
6,9,24,71,54,125
13,9,24,154,117,271
1,9,24,15,9,24
1,9,24,10,9,19
1,13,35,17,13,30
7,13,35,115,91,206
22,13,35,469,286,755
10,13,35,206,130,336
20,13,35,433,260,693
19,13,35,332,247,579
19,13,35,278,247,525
3,13,35,43,39,82
8,13,35,114,104,218
7,13,35,149,91,240
11,13,35,161,143,304
21,13,35,300,273,573
29,21,55,779,609,1388
12,21,55,302,252,554
15,21,55,329,315,644
12,21,55,401,252,653
12,42,54,8,504,512
13,42,54,65,546,611
24,38,50,264,912,1176
28,38,50,28,1064,1092
22,42,54,3,924,927
12,38,50,138,456,594
10,38,50,55,380,435
19,38,50,57,722,779
23,42,54,264,966,1230
7,42,54,35,294,329
5,42,54,55,210,265
10,38,50,110,380,490
6,42,54,30,252,282
1,42,54,5,42,47
2,42,54,10,84,94
19,38,50,57,722,779
1,1898,3375,937,1898,2835
1,1266,2320,683,1266,1949
3,420,769,747,1260,2007
1,1266,2320,544,1266,1810
3,1266,2320,3092,3798,6890
1,1266,2320,961,1266,2227
1,1252,2295,538,1252,1790
1,1083,1701,550,1083,1633
1,2171,3578,727,2171,2898
3,713,1120,1154,2139,3293
1,2171,3578,620,2171,2791
1,26,70,43,26,69
16,26,70,458,416,874
27,26,70,942,702,1644
20,26,70,782,520,1302
12,3,9,48,36,84
32,3,9,186,96,282
18,1,2,13,18,31
15,2,5,44,30,74
15,2,5,44,30,74
26,9,25,410,234,644
24,1,2,24,24,48
27,1,2,14,27,41
10,1,2,5,10,15
18,9,25,207,162,369
30,9,25,345,270,615
8,9,25,86,72,158
19,9,25,204,171,375
20,1,2,14,20,34
5,9,25,79,45,124
20,9,25,315,180,495
12,1,2,10,12,22
28,2,5,66,56,122
13,2,5,31,26,57
25,1,4,59,25,84
11,1,4,26,11,37
10,11,30,178,110,288
20,11,30,356,220,576
18,11,30,320,198,518
7,2,5,16,14,30
22,2,5,52,44,96
16,2,5,47,32,79
13,2,5,38,26,64
15,11,29,240,165,405
17,11,29,271,187,458
17,1,2,17,17,34
19,1,2,19,19,38
12,1,2,12,12,24
19,1,2,19,19,38
6,1,2,3,6,9
26,1,2,15,26,41
14,12,33,285,168,453
8,12,33,163,96,259
4,2,5,8,8,16
27,1,2,19,27,46
28,1,2,20,28,48
26,2,5,55,52,107
7,1,2,7,7,14
12,1,2,12,12,24
1,461,742,266,461,727
3,461,742,554,1383,1937
3,45,120,221,135,356
9,45,120,653,405,1058
8,4,10,45,32,77
25,4,10,140,100,240
2,2,5,6,4,10
9,2,5,21,18,39
27,2,5,63,54,117
8,2,5,23,16,39
31,2,5,90,62,152
18,2,5,53,36,89
14,4,10,66,56,122
12,2,5,28,24,52
27,2,5,63,54,117
3,7,9,6,21,27
13,7,9,24,91,115
8,3,8,39,24,63
21,8,22,192,168,360
4,9,24,56,36,92
27,9,24,321,243,564
31,13,35,671,403,1074
27,13,35,575,351,926
23,13,35,401,299,700
13,13,35,281,169,450
17,13,35,350,221,571
1,13,35,22,13,35
9,13,35,176,117,293
25,13,35,436,325,761
6,13,35,124,78,202
10,13,35,175,130,305
1,21,55,33,21,54
8,38,50,80,304,384
2,38,50,11,76,87
21,38,50,21,798,819
16,38,50,88,608,696
22,38,50,121,836,957
3,308,565,466,924,1390
3,1252,2295,2854,3756,6610
1,1252,2295,951,1252,2203
1,1266,2320,752,1266,2018
1,1266,2320,544,1266,1810
1,420,769,249,420,669
1,713,1120,385,713,1098
1,1083,1701,397,1083,1480
1,713,1120,261,713,974
2,344,540,252,688,940
8,26,70,229,208,437
9,26,70,390,234,624
30,26,70,1278,780,2058
3,26,70,103,78,181
29,3,9,169,87,256
12,8,21,103,96,199
11,8,21,94,88,182
6,8,21,52,48,100
27,1,2,26,27,53
13,1,2,12,13,25
4,1,2,4,4,8
30,2,5,89,60,149
28,2,5,83,56,139
27,2,5,80,54,134
9,2,5,27,18,45
11,2,5,32,22,54
14,2,5,27,28,55
26,2,5,61,52,113
25,2,5,59,50,109
24,2,5,70,48,118
22,2,5,64,44,108
11,1,2,9,11,20
26,2,5,47,52,99
1,2,5,2,2,4
16,1,2,16,16,32
27,9,25,425,243,668
28,9,25,441,252,693
21,1,4,57,21,78
16,1,2,15,16,31
23,1,2,21,23,44
12,8,21,151,96,247
22,8,21,277,176,453
1,2,5,2,2,4
5,2,5,11,10,21
4,2,5,8,8,16
29,2,5,61,58,119
6,11,29,96,66,162
32,2,5,67,64,131
27,9,25,419,243,662
2,9,25,31,18,49
2,755,1215,604,1510,2114
2,1482,2384,1470,2964,4434
5,4,10,20,20,40
5,4,10,20,20,40
17,2,5,50,34,84
14,2,5,41,28,69
29,3,9,140,87,227
18,3,9,87,54,141
29,3,9,140,87,227
8,4,10,38,32,70
23,4,10,108,92,200
13,2,5,38,26,64
4,2,5,12,8,20
22,4,10,128,88,216
2,4,10,12,8,20
24,2,5,46,48,94
20,2,5,38,40,78
5,4,10,19,20,39
6,4,10,23,24,47
14,2,5,34,28,62
24,2,5,71,48,119
8,2,5,24,16,40
15,7,9,8,105,113
20,7,9,11,140,151
25,7,9,46,175,221
15,7,9,11,105,116
24,3,8,95,72,167
1,3,8,4,3,7
28,8,22,380,224,604
9,8,22,98,72,170
3,8,22,39,24,63
19,8,22,212,152,364
23,9,24,339,207,546
11,9,24,107,99,206
10,9,24,148,90,238
17,13,35,291,221,512
7,13,35,152,91,243
20,13,35,349,260,609
1,13,35,22,13,35
16,13,35,330,208,538
24,13,35,343,312,655
17,13,35,297,221,518
28,13,35,596,364,960
18,13,35,314,234,548
15,13,35,246,195,441
20,13,35,349,260,609
17,13,35,362,221,583
19,13,35,405,247,652
7,13,35,152,91,243
25,13,35,541,325,866
24,13,35,520,312,832
7,13,35,149,91,240
32,13,35,626,416,1042
14,13,35,200,182,382
5,38,50,58,190,248
16,38,50,184,608,792
16,42,54,80,672,752
19,42,54,95,798,893
15,42,54,75,630,705
26,42,54,59,1092,1151
1,295,540,175,295,470
1,420,769,249,420,669
1,420,769,249,420,669
3,1266,2320,3092,3798,6890
1,713,1120,205,713,918
3,2171,3578,2826,6513,9339
3,2171,3578,2504,6513,9017
3,2171,3578,2826,6513,9339
3,487,783,465,1461,1926
1,1555,2443,839,1555,2394
1,2171,3578,1335,2171,3506
1,344,540,83,344,427
1,2171,3578,1335,2171,3506
1,2171,3578,1335,2171,3506
7,26,70,298,182,480
29,3,9,169,87,256
29,8,21,371,232,603
1,2,5,3,2,5
32,13,35,693,416,1109
17,13,35,368,221,589
11,13,35,238,143,381
3,1,2,3,3,6
7,1,2,7,7,14
11,13,35,188,143,331
5,13,35,86,65,151
16,1,2,16,16,32
2,2,5,6,4,10
3,2,5,8,6,14
28,1,4,60,28,88
31,1,4,67,31,98
10,12,33,197,120,317
25,12,33,492,300,792
6,12,33,118,72,190
14,1,2,14,14,28
16,1,2,16,16,32
12,1,2,7,12,19
29,1,2,16,29,45
20,1,2,11,20,31
10,1,2,6,10,16
13,13,35,268,169,437
19,13,35,391,247,638
24,12,33,377,288,665
27,12,33,424,324,748
12,1,2,7,12,19
21,2,5,61,42,103
8,2,5,23,16,39
7,1,2,7,7,14
9,1,2,9,9,18
3,1,2,3,3,6
9,9,25,115,81,196
28,9,25,357,252,609
18,2,5,42,36,78
27,2,5,63,54,117
14,2,5,33,28,61
11,2,5,32,22,54
17,2,5,50,34,84
30,11,30,552,330,882
23,11,30,423,253,676
22,11,29,281,242,523
8,1,2,4,8,12
11,1,2,6,11,17
28,1,2,16,28,44
15,1,2,8,15,23
24,11,29,307,264,571
1,461,742,251,461,712
1,755,1215,375,755,1130
1,1482,2384,592,1482,2074
1,24,64,26,24,50
28,24,64,1084,672,1756
18,24,64,478,432,910
1,45,120,70,45,115
13,2,5,25,26,51
26,2,5,51,52,103
17,2,5,39,34,73
2,2,5,5,4,9
26,4,10,99,104,203
19,3,9,92,57,149
12,3,9,58,36,94
8,2,5,22,16,38
9,2,5,25,18,43
17,2,5,32,34,66
24,2,5,67,48,115
28,2,5,83,56,139
19,2,5,56,38,94
11,2,5,23,22,45
7,2,5,19,14,33
6,2,5,14,12,26
21,4,10,122,84,206
1,4,10,6,4,10
30,2,5,63,60,123
9,2,5,19,18,37
26,2,5,55,52,107
5,2,5,14,10,24
3,3,9,17,9,26
4,3,9,23,12,35
27,2,5,63,54,117
2,2,5,5,4,9
12,7,9,22,84,106
13,7,9,0,91,91
11,7,9,9,77,86
6,7,9,2,42,44
18,7,9,2,126,128
20,7,9,33,140,173
26,7,9,22,182,204
12,3,8,59,36,95
14,3,8,54,42,96
19,3,8,89,57,146
22,3,8,78,66,144
15,8,22,151,120,271
11,8,22,120,88,208
26,8,22,358,208,566
5,9,24,59,45,104
23,9,24,323,207,530
18,9,24,214,162,376
3,9,24,36,27,63
1,13,35,21,13,34
20,13,35,426,260,686
14,13,35,244,182,426
24,13,35,511,312,823
15,13,35,215,195,410
28,13,35,440,364,804
11,13,35,227,143,370
3,13,35,47,39,86
24,13,35,419,312,731
11,13,35,234,143,377
2,13,35,35,26,61
14,13,35,298,182,480
17,13,35,291,221,512
20,13,35,286,260,546
23,13,35,337,299,636
22,21,55,736,462,1198
12,21,55,289,252,541
6,21,55,161,126,287
27,38,50,108,1026,1134
21,42,54,105,882,987
18,42,54,90,756,846
17,42,54,39,714,753
28,38,50,322,1064,1386
14,42,54,153,588,741
24,38,50,132,912,1044
1,1252,2295,630,1252,1882
2,1252,2295,1489,2504,3993
1,1266,2320,961,1266,2227
2,487,783,247,974,1221
1,2171,3578,942,2171,3113
1,487,783,265,487,752
1,487,783,155,487,642
1,344,540,126,344,470
2,1083,1701,794,2166,2960
2,344,540,198,688,886
30,26,70,1299,780,2079
16,26,70,682,416,1098
28,1,2,16,28,44
6,1,2,3,6,9
8,2,5,21,16,37
1,2,5,3,2,5
30,9,25,375,270,645
15,9,25,188,135,323
10,1,4,30,10,40
28,1,4,83,28,111
12,2,5,34,24,58
22,1,2,21,22,43
14,1,2,13,14,27
21,2,5,49,42,91
11,2,5,26,22,48
15,2,5,33,30,63
19,2,5,53,38,91
20,2,5,56,40,96
2,1,2,1,2,3
10,1,2,6,10,16
13,2,5,36,26,62
22,2,5,62,44,106
1,1,4,3,1,4
18,1,4,51,18,69
2,9,25,26,18,44
20,9,25,255,180,435
28,2,5,81,56,137
9,2,5,26,18,44
13,1,2,10,13,23
18,1,2,13,18,31
8,2,5,23,16,39
14,2,5,41,28,69
26,12,33,529,312,841
9,12,33,183,108,291
7,1,2,4,7,11
18,1,2,10,18,28
5,8,21,61,40,101
12,12,33,169,144,313
30,1,2,29,30,59
16,1,2,15,16,31
7,1,2,6,7,13
17,2,5,40,34,74
7,2,5,16,14,30
1,1482,2384,592,1482,2074
1,1482,2384,592,1482,2074
3,1482,2384,2563,4446,7009
3,1482,2384,2563,4446,7009
3,755,1215,1307,2265,3572
3,1482,2384,1204,4446,5650
6,45,120,349,270,619
5,59,159,484,295,779
13,2,5,38,26,64
1,2,5,3,2,5
2,4,10,8,8,16
27,4,10,105,108,213
14,4,10,81,56,137
29,4,10,168,116,284
30,2,5,59,60,119
18,2,5,35,36,71
6,2,5,17,12,29
21,2,5,61,42,103
13,4,10,75,52,127
5,4,10,29,20,49
8,4,10,46,32,78
6,2,5,17,12,29
31,2,5,91,62,153
7,2,5,21,14,35
24,3,9,129,72,201
24,3,9,129,72,201
9,4,10,42,36,78
13,2,5,38,26,64
23,2,5,67,46,113
32,7,9,44,224,268
9,7,9,7,63,70
14,7,9,23,98,121
5,7,9,10,35,45
8,7,9,15,56,71
22,3,8,71,66,137
20,3,8,74,60,134
17,3,8,67,51,118
17,8,22,189,136,325
1,8,22,13,8,21
2,8,22,28,16,44
6,8,22,81,48,129
28,8,22,367,224,591
14,9,24,150,126,276
7,9,24,75,63,138
9,9,24,126,81,207
4,9,24,39,36,75
4,9,24,45,36,81
20,13,35,286,260,546
14,13,35,303,182,485
29,13,35,597,377,974
1,13,35,15,13,28
3,13,35,52,39,91
28,13,35,577,364,941
23,13,35,401,299,700
17,13,35,368,221,589
23,13,35,474,299,773
6,13,35,128,78,206
8,13,35,170,104,274
6,13,35,105,78,183
20,13,35,433,260,693
8,13,35,170,104,274
26,13,35,554,338,892
7,13,35,110,91,201
9,13,35,195,117,312
21,13,35,330,273,603
6,13,35,124,78,202
24,13,35,343,312,655
7,21,55,176,147,323
11,21,55,362,231,593
1,21,55,33,21,54
8,38,50,92,304,396
10,38,50,85,380,465
1,42,54,8,42,50
10,42,54,115,420,535
11,38,50,110,418,528
6,42,54,14,252,266
13,38,50,130,494,624
8,42,54,40,336,376
9,42,54,74,378,452
31,38,50,341,1178,1519
1,1898,3375,1342,1898,3240
1,1266,2320,1031,1266,2297
1,1252,2295,538,1252,1790
1,1252,2295,951,1252,2203
1,1266,2320,1008,1266,2274
3,1266,2320,2257,3798,6055
1,1252,2295,745,1252,1997
3,1252,2295,3060,3756,6816
1,295,540,234,295,529
3,420,769,678,1260,1938
1,295,540,223,295,518
3,1252,2295,2234,3756,5990
1,1555,2443,448,1555,2003
2,487,783,561,974,1535
1,1083,1701,312,1083,1395
1,2171,3578,656,2171,2827
1,713,1120,385,713,1098
3,1083,1701,1191,3249,4440
1,2171,3578,1335,2171,3506
31,26,70,1321,806,2127
14,3,9,68,42,110
8,13,35,137,104,241
13,1,2,13,13,26
20,2,5,38,40,78
25,13,35,541,325,866
16,2,5,45,32,77
17,12,33,335,204,539
26,12,33,512,312,824
29,11,29,514,319,833
15,11,29,266,165,431
8,2,5,15,16,31
27,2,5,78,54,132
9,2,5,26,18,44
26,2,5,49,52,101
10,2,5,19,20,39
3,2,5,8,6,14
8,2,5,22,16,38
26,1,4,64,26,90
25,1,2,25,25,50
3,1,2,3,3,6
23,1,2,23,23,46
14,2,5,39,28,67
23,2,5,64,46,110
6,2,5,14,12,26
13,2,5,31,26,57
6,2,5,14,12,26
7,9,25,100,63,163
24,1,2,22,24,46
30,1,2,28,30,58
11,13,35,180,143,323
3,13,35,49,39,88
7,13,35,115,91,206
26,2,5,75,52,127
20,2,5,58,40,98
27,1,4,77,27,104
7,1,4,20,7,27
22,2,5,52,44,96
29,2,5,68,58,126
5,1,2,5,5,10
5,1,2,5,5,10
20,1,2,20,20,40
25,11,30,310,275,585
24,1,2,13,24,37
24,1,4,70,24,94
2,1,4,6,2,8
1,1,4,3,1,4
11,12,33,224,132,356
26,1,4,76,26,102
23,1,4,67,23,90
6,1,2,6,6,12
9,1,2,9,9,18
6,2,5,18,12,30
6,2,5,18,12,30
12,8,21,103,96,199
31,8,21,266,248,514
17,8,21,175,136,311
2,8,21,21,16,37
17,2,5,49,34,83
4,2,5,9,8,17
28,1,4,68,28,96
3,1,4,7,3,10
1,461,742,251,461,712
24,24,64,929,576,1505
7,45,120,491,315,806
9,45,120,632,405,1037
7,45,120,407,315,722
10,59,159,968,590,1558
4,59,159,375,236,611
1,2,5,2,2,4
27,2,5,63,54,117
20,3,9,113,60,173
20,3,9,113,60,173
22,3,9,124,66,190
12,2,5,23,24,47
23,2,5,44,46,90
21,2,5,61,42,103
6,2,5,17,12,29
16,2,5,46,32,78
18,2,5,35,36,71
29,3,9,156,87,243
11,3,9,59,33,92
28,7,9,23,196,219
17,7,9,31,119,150
12,7,9,20,84,104
2,7,9,1,14,15
23,7,9,44,161,205
13,3,8,42,39,81
5,8,22,46,40,86
26,8,22,353,208,561
9,8,22,112,72,184
25,9,24,369,225,594
20,9,24,233,180,413
26,9,24,378,234,612
12,13,35,209,156,365
3,13,35,43,39,82
15,13,35,262,195,457
28,13,35,577,364,941
27,13,35,575,351,926
3,13,35,47,39,86
30,13,35,524,390,914
7,13,35,115,91,206
29,13,35,476,377,853
23,13,35,337,299,636
31,13,35,606,403,1009
11,13,35,238,143,381
8,13,35,173,104,277
17,13,35,362,221,583
27,13,35,575,351,926
4,13,35,78,52,130
27,13,35,386,351,737
1,13,35,14,13,27
4,21,55,90,84,174
22,42,54,252,924,1176
8,42,54,79,336,415
17,38,50,85,646,731
8,42,54,92,336,428
11,38,50,61,418,479
8,42,54,87,336,423
15,38,50,165,570,735
1,1266,2320,567,1266,1833
1,1252,2295,951,1252,2203
1,420,769,334,420,754
2,420,769,667,840,1507
2,420,769,498,840,1338
3,487,783,395,1461,1856
1,487,783,280,487,767
3,2171,3578,2504,6513,9017
1,2171,3578,656,2171,2827
1,713,1120,161,713,874
1,1555,2443,570,1555,2125
1,344,540,110,344,454
2,2171,3578,2671,4342,7013
11,26,70,376,286,662
9,26,70,383,234,617
18,26,70,527,468,995
1,26,70,43,26,69
7,1,4,21,7,28
3,2,5,6,6,12
7,2,5,13,14,27
27,1,2,15,27,42
21,1,2,12,21,33
10,1,2,6,10,16
16,2,5,42,32,74
8,2,5,21,16,37
10,2,5,24,20,44
4,2,5,9,8,17
27,2,5,63,54,117
3,1,2,3,3,6
8,1,2,7,8,15
8,2,5,15,16,31
14,2,5,27,28,55
10,2,5,19,20,39
15,2,5,29,30,59
5,1,2,5,5,10
4,1,2,4,4,8
3,1,2,3,3,6
3,2,5,7,6,13
18,2,5,42,36,78
6,2,5,11,12,23
24,2,5,46,48,94
18,1,2,12,18,30
1,1,2,1,1,2
30,8,21,258,240,498
23,8,21,198,184,382
26,8,21,223,208,431
1,1,4,2,1,3
8,1,4,18,8,26
16,1,2,12,16,28
6,2,5,18,12,30
1,2,5,3,2,5
16,2,5,47,32,79
17,1,2,16,17,33
22,1,2,20,22,42
13,1,2,13,13,26
22,1,2,22,22,44
9,2,5,21,18,39
26,2,5,60,52,112
17,1,2,16,17,33
5,1,2,5,5,10
4,1,4,11,4,15
14,1,4,40,14,54
28,1,4,82,28,110
10,1,4,29,10,39
22,1,4,60,22,82
10,1,4,27,10,37
25,1,4,68,25,93
8,1,2,4,8,12
9,9,25,113,81,194
16,9,25,200,144,344
1,1482,2384,592,1482,2074
1,1482,2384,807,1482,2289
2,1482,2384,1613,2964,4577
1,1482,2384,735,1482,2217
1,755,1215,241,755,996
1,461,742,140,461,601
28,24,64,833,672,1505
11,59,159,978,649,1627
5,59,159,468,295,763
13,3,9,65,39,104
30,3,9,150,90,240
1,2,5,3,2,5
21,2,5,61,42,103
18,2,5,41,36,77
10,2,5,28,20,48
25,2,5,70,50,120
1,2,5,2,2,4
16,2,5,46,32,78
30,2,5,87,60,147
20,3,9,116,60,176
1,3,9,6,3,9
24,3,9,140,72,212
12,2,5,34,24,58
24,2,5,67,48,115
16,2,5,46,32,78
24,2,5,70,48,118
2,2,5,4,4,8
23,2,5,51,46,97
25,2,5,49,50,99
16,2,5,31,32,63
8,7,9,15,56,71
9,7,9,0,63,63
31,7,9,56,217,273
1,7,9,1,7,8
10,7,9,16,70,86
3,7,9,0,21,21
22,3,8,106,66,172
17,3,8,67,51,118
8,3,8,26,24,50
26,8,22,353,208,561
14,9,24,139,126,265
12,9,24,134,108,242
17,9,24,190,153,343
22,13,35,399,286,685
15,13,35,220,195,415
5,13,35,108,65,173
19,13,35,391,247,638
30,13,35,440,390,830
31,13,35,660,403,1063
22,13,35,453,286,739
19,13,35,332,247,579
13,13,35,227,169,396
14,13,35,230,182,412
5,13,35,82,65,147
28,13,35,596,364,960
10,13,35,213,130,343
28,13,35,577,364,941
7,13,35,152,91,243
3,13,35,47,39,86
26,21,55,627,546,1173
3,21,55,90,63,153
8,21,55,263,168,431
6,38,50,66,228,294
24,42,54,120,1008,1128
18,42,54,197,756,953
20,38,50,110,760,870
2,1252,2295,1489,2504,3993
1,1266,2320,892,1266,2158
1,1252,2295,882,1252,2134
2,1252,2295,1352,2504,3856
2,1252,2295,1443,2504,3947
2,1252,2295,1122,2504,3626
2,2171,3578,2027,4342,6369
1,2171,3578,1264,2171,3435
1,2171,3578,835,2171,3006
1,2171,3578,942,2171,3113
1,713,1120,362,713,1075
2,1555,2443,994,3110,4104
3,344,540,556,1032,1588
1,344,540,174,344,518
1,713,1120,172,713,885
19,26,70,663,494,1157
8,26,70,274,208,482
2,26,70,87,52,139
3,26,70,130,78,208
26,8,21,333,208,541
26,1,2,17,26,43
2,9,25,22,18,40
7,9,25,75,63,138
7,1,2,5,7,12
3,1,2,2,3,5
7,1,2,7,7,14
5,1,2,5,5,10
29,1,2,28,29,57
9,2,5,26,18,44
17,2,5,49,34,83
18,2,5,41,36,77
22,1,4,55,22,77
4,1,4,10,4,14
18,9,25,230,162,392
1,11,30,15,11,26
16,1,2,9,16,25
17,1,2,10,17,27
26,1,2,15,26,41
30,2,5,87,60,147
4,1,4,11,4,15
21,1,4,60,21,81
4,1,2,3,4,7
26,1,2,17,26,43
28,1,2,18,28,46
20,9,25,255,180,435
4,9,25,51,36,87
13,11,30,161,143,304
31,11,30,384,341,725
29,1,4,71,29,100
20,1,4,49,20,69
25,1,4,71,25,96
26,2,5,60,52,112
1,1,2,1,1,2
9,1,2,9,9,18
13,2,5,38,26,64
16,8,21,148,128,276
3,1482,2384,2420,4446,6866
3,1482,2384,1776,4446,6222
1,1482,2384,854,1482,2336
1,755,1215,436,755,1191
1,755,1215,436,755,1191
1,755,1215,436,755,1191
29,24,64,826,696,1522
18,24,64,559,432,991
11,59,159,768,649,1417
13,4,10,57,52,109
20,4,10,88,80,168
13,4,10,77,52,129
26,4,10,153,104,257
14,4,10,81,56,137
1,4,10,6,4,10
22,4,10,128,88,216
2,4,10,12,8,20
15,2,5,29,30,59
17,2,5,48,34,82
5,2,5,14,10,24
17,3,9,91,51,142
19,2,5,53,38,91
14,2,5,39,28,67
26,2,5,61,52,113
17,2,5,40,34,74
24,2,5,56,48,104
30,2,5,71,60,131
13,2,5,38,26,64
27,2,5,80,54,134
7,2,5,20,14,34
24,2,5,70,48,118
24,2,5,70,48,118
20,2,5,58,40,98
5,4,10,24,20,44
11,4,10,52,44,96
15,2,5,44,30,74
15,7,9,12,105,117
23,7,9,42,161,203
5,7,9,9,35,44
8,7,9,0,56,56
3,7,9,5,21,26
22,7,9,42,154,196
20,7,9,17,140,157
23,3,8,102,69,171
6,3,8,28,18,46
3,3,8,15,9,24
18,8,22,244,144,388
16,8,22,147,128,275
27,8,22,336,216,552
25,8,22,339,200,539
8,8,22,89,64,153
17,8,22,156,136,292
7,8,22,96,56,152
24,8,22,252,192,444
26,8,22,261,208,469
19,8,22,174,152,326
19,8,22,262,152,414
7,9,24,98,63,161
4,9,24,59,36,95
29,9,24,421,261,682
22,13,35,361,286,647
17,13,35,249,221,470
2,13,35,43,26,69
18,13,35,257,234,491
6,13,35,130,78,208
3,13,35,64,39,103
20,13,35,314,260,574
25,13,35,410,325,735
25,13,35,358,325,683
24,13,35,520,312,832
12,13,35,172,156,328
22,13,35,315,286,601
23,13,35,401,299,700
5,21,55,110,105,215
17,21,55,569,357,926
17,21,55,559,357,916
10,42,54,1,420,421
1,38,50,11,38,49
5,42,54,25,210,235
16,38,50,16,608,624
3,38,50,33,114,147
13,38,50,72,494,566
22,42,54,98,924,1022
1,1252,2295,538,1252,1790
2,420,769,360,840,1200
1,1252,2295,1020,1252,2272
1,1252,2295,882,1252,2134
2,420,769,498,840,1338
1,1266,2320,961,1266,2227
2,420,769,683,840,1523
2,1266,2320,1273,2532,3805
1,1252,2295,997,1252,2249
1,1266,2320,1008,1266,2274
1,1266,2320,1008,1266,2274
1,2171,3578,942,2171,3113
1,2171,3578,656,2171,2827
3,713,1120,1087,2139,3226
1,713,1120,385,713,1098
1,344,540,77,344,421
3,2171,3578,4114,6513,10627
3,1083,1701,1191,3249,4440
1,344,540,126,344,470
7,26,70,298,182,480
6,3,9,24,18,42
26,3,9,126,78,204
14,1,4,30,14,44
4,8,21,34,32,66
28,8,21,241,224,465
18,8,21,155,144,299
6,13,35,130,78,208
15,13,35,325,195,520
2,2,5,4,4,8
22,1,2,21,22,43
2,1,4,6,2,8
18,1,4,51,18,69
1,11,30,19,11,30
1,11,30,19,11,30
10,11,30,187,110,297
12,2,5,35,24,59
3,2,5,9,6,15
7,2,5,21,14,35
12,2,5,35,24,59
18,2,5,53,36,89
26,2,5,77,52,129
25,12,33,517,300,817
2,12,33,41,24,65
9,11,30,136,99,235
22,11,30,332,242,574
25,13,35,515,325,840
21,13,35,433,273,706
4,13,35,82,52,134
1,1,2,1,1,2
22,2,5,51,44,95
4,2,5,9,8,17
2,2,5,5,4,9
4,9,25,45,36,81
16,9,25,180,144,324
8,1,4,23,8,31
9,1,2,5,9,14
1,12,33,21,12,33
18,2,5,34,36,70
28,2,5,53,56,109
18,1,2,17,18,35
21,1,2,19,21,40
21,1,4,60,21,81
28,1,4,80,28,108
19,8,21,219,152,371
19,11,29,270,209,479
18,11,29,256,198,454
2,1482,2384,1041,2964,4005
3,755,1215,1234,2265,3499
1,461,742,251,461,712
3,1482,2384,2563,4446,7009
1,1482,2384,854,1482,2336
1,24,64,26,24,50
19,24,64,736,456,1192
20,24,64,787,480,1267
23,24,64,640,552,1192
27,24,64,700,648,1348
27,24,64,855,648,1503
1,59,159,65,59,124
19,2,5,46,38,84
4,2,5,10,8,18
22,2,5,62,44,106
11,2,5,31,22,53
11,2,5,32,22,54
11,4,10,42,44,86
4,4,10,15,16,31
24,2,5,50,48,98
23,2,5,48,46,94
15,2,5,44,30,74
14,2,5,41,28,69
14,2,5,41,28,69
29,2,5,64,58,122
23,2,5,51,46,97
3,4,10,17,12,29
26,4,10,151,104,255
26,4,10,120,104,224
15,4,10,69,60,129
25,2,5,49,50,99
1,3,9,5,3,8
18,3,9,87,54,141
25,2,5,55,50,105
8,2,5,18,16,34
4,3,9,23,12,35
4,2,5,11,8,19
22,2,5,62,44,106
6,7,9,10,42,52
19,7,9,35,133,168
26,7,9,47,182,229
24,7,9,20,168,188
30,7,9,22,210,232
7,7,9,3,49,52
27,3,8,126,81,207
25,3,8,117,75,192
7,8,22,66,56,122
18,8,22,165,144,309
28,8,22,256,224,480
26,8,22,284,208,492
24,8,22,325,192,517
13,8,22,176,104,280
8,8,22,108,64,172
5,8,22,56,40,96
29,8,22,400,232,632
5,8,22,69,40,109
7,8,22,78,56,134
24,8,22,267,192,459
17,9,24,239,153,392
31,9,24,376,279,655
17,9,24,165,153,318
1,9,24,12,9,21
2,9,24,20,18,38
24,9,24,285,216,501
22,13,35,453,286,739
4,13,35,70,52,122
20,13,35,433,260,693
7,13,35,103,91,194
1,13,35,17,13,30
29,13,35,597,377,974
18,13,35,257,234,491
10,13,35,217,130,347
5,13,35,87,65,152
11,13,35,234,143,377
23,13,35,498,299,797
31,13,35,530,403,933
6,13,35,86,78,164
2,13,35,43,26,69
9,13,35,192,117,309
10,13,35,213,130,343
3,13,35,62,39,101
3,13,35,52,39,91
23,13,35,474,299,773
19,21,55,458,399,857
16,21,55,359,336,695
21,38,50,210,798,1008
16,38,50,184,608,792
21,42,54,173,882,1055
15,42,54,67,630,697
21,38,50,231,798,1029
14,42,54,9,588,597
1,38,50,1,38,39
12,38,50,12,456,468
10,38,50,115,380,495
28,42,54,139,1176,1315
13,42,54,142,546,688
21,38,50,32,798,830
17,38,50,51,646,697
6,42,54,30,252,282
29,38,50,319,1102,1421
18,42,54,90,756,846
28,42,54,94,1176,1270
17,42,54,186,714,900
4,42,54,44,168,212
10,42,54,50,420,470
2,1898,3375,2077,3796,5873
3,1898,3375,2811,5694,8505
1,1252,2295,561,1252,1813
1,1266,2320,961,1266,2227
1,1266,2320,683,1266,1949
1,1252,2295,997,1252,2249
1,308,565,184,308,492
1,308,565,184,308,492
1,295,540,148,295,443
1,1252,2295,538,1252,1790
1,1266,2320,544,1266,1810
1,487,783,280,487,767
1,1555,2443,839,1555,2394
1,344,540,185,344,529
2,344,540,241,688,929
3,344,540,361,1032,1393
1,344,540,191,344,535
1,344,540,83,344,427
1,26,70,43,26,69
12,26,70,511,312,823
9,26,70,308,234,542
1,26,70,43,26,69
28,26,70,977,728,1705
3,3,9,13,9,22
16,1,2,15,16,31
25,1,2,23,25,48
6,9,25,72,54,126
27,9,25,324,243,567
30,9,25,360,270,630
15,2,5,29,30,59
1,2,5,2,2,4
26,1,2,19,26,45
8,1,2,6,8,14
1,1,2,1,1,2
31,1,2,29,31,60
9,1,2,9,9,18
18,12,33,354,216,570
8,12,33,157,96,253
7,12,33,138,84,222
20,1,4,59,20,79
14,11,30,262,154,416
9,11,30,168,99,267
25,11,30,468,275,743
19,1,2,11,19,30
25,1,2,14,25,39
9,1,2,5,9,14
21,2,5,48,42,90
8,2,5,18,16,34
25,9,25,388,225,613
13,1,4,35,13,48
24,1,4,65,24,89
23,1,4,63,23,86
23,2,5,64,46,110
11,2,5,31,22,53
12,2,5,34,24,58
14,2,5,27,28,55
7,2,5,19,14,33
9,2,5,24,18,42
10,2,5,27,20,47
8,1,2,6,8,14
18,1,2,13,18,31
11,2,5,32,22,54
27,2,5,80,54,134
9,9,25,135,81,216
21,9,25,315,189,504
26,8,21,240,208,448
8,1,4,22,8,30
16,2,5,38,32,70
25,1,2,25,25,50
14,2,5,41,28,69
16,1,2,12,16,28
26,1,2,15,26,41
8,1,2,5,8,13
13,2,5,36,26,62
22,1,4,64,22,86
2,1,4,6,2,8
14,1,4,41,14,55
13,2,5,36,26,62
32,2,5,90,64,154
13,2,5,36,26,62
5,2,5,12,10,22
27,2,5,63,54,117
13,1,4,30,13,43
15,2,5,42,30,72
1,1482,2384,616,1482,2098
1,755,1215,411,755,1166
3,1482,2384,1133,4446,5579
2,1482,2384,1709,2964,4673
2,755,1215,385,1510,1895
1,755,1215,436,755,1191
1,1482,2384,807,1482,2289
3,2,5,6,6,12
23,2,5,48,46,94
16,4,10,94,64,158
7,4,10,41,28,69
12,2,5,35,24,59
21,2,5,62,42,104
32,2,5,94,64,158
8,2,5,23,16,39
24,2,5,70,48,118
11,4,10,62,44,106
10,4,10,56,40,96
27,3,9,109,81,190
4,3,9,16,12,28
12,4,10,71,48,119
27,4,10,159,108,267
16,2,5,45,32,77
20,2,5,56,40,96
19,7,9,35,133,168
3,7,9,5,21,26
1,7,9,0,7,7
27,7,9,44,189,233
11,8,22,149,88,237
26,8,22,358,208,566
28,8,22,386,224,610
11,8,22,103,88,191
24,8,22,315,192,507
23,8,22,302,184,486
5,9,24,74,45,119
12,9,24,177,108,285
22,9,24,309,198,507
17,9,24,239,153,392
25,9,24,243,225,468
25,9,24,291,225,516
10,9,24,116,90,206
1,13,35,14,13,27
23,13,35,353,299,652
14,13,35,298,182,480
25,13,35,358,325,683
6,13,35,88,78,166
3,13,35,62,39,101
5,13,35,103,65,168
15,13,35,236,195,431
32,13,35,659,416,1075
13,13,35,281,169,450
22,13,35,476,286,762
20,13,35,433,260,693
10,13,35,217,130,347
21,13,35,447,273,720
4,13,35,82,52,134
12,13,35,205,156,361
8,38,50,24,304,328
23,38,50,265,874,1139
1,38,50,1,38,39
4,42,54,20,168,188
26,38,50,260,988,1248
22,38,50,220,836,1056
29,38,50,319,1102,1421
24,38,50,24,912,936
17,38,50,187,646,833
5,42,54,55,210,265
15,42,54,148,630,778
1,42,54,11,42,53
1,42,54,11,42,53
7,38,50,70,266,336
10,38,50,50,380,430
1,1252,2295,630,1252,1882
2,1266,2320,2015,2532,4547
1,295,540,234,295,529
1,1266,2320,1008,1266,2274
1,1519,2443,387,1519,1906
3,713,1120,1154,2139,3293
1,1555,2443,790,1555,2345
2,487,783,576,974,1550
1,2171,3578,835,2171,3006
1,713,1120,396,713,1109
2,344,540,370,688,1058
1,487,783,194,487,681
1,713,1120,205,713,918
12,26,70,511,312,823
25,2,5,48,50,98
20,2,5,38,40,78
31,2,5,59,62,121
27,13,35,462,351,813
19,2,5,39,38,77
27,2,5,62,54,116
14,1,2,8,14,22
21,1,4,62,21,83
1,2,5,2,2,4
10,2,5,30,20,50
19,2,5,56,38,94
1,2,5,2,2,4
10,2,5,28,20,48
12,2,5,34,24,58
13,2,5,38,26,64
5,1,2,3,5,8
11,1,2,7,11,18
14,1,2,9,14,23
8,1,2,5,8,13
18,2,5,38,36,74
24,1,2,24,24,48
22,11,30,411,242,653
3,1,2,3,3,6
21,2,5,40,42,82
3,2,5,6,6,12
10,2,5,19,20,39
7,1,2,4,7,11
17,2,5,50,34,84
1,2,5,3,2,5
20,12,33,275,240,515
11,12,33,151,132,283
10,1,4,24,10,34
16,2,5,37,32,69
2,1,4,6,2,8
3,8,21,36,24,60
18,8,21,219,144,363
19,12,33,261,228,489
18,2,5,50,36,86
8,2,5,22,16,38
6,1,4,14,6,20
4,8,21,50,32,82
9,8,21,113,72,185
25,1,2,25,25,50
28,1,2,27,28,55
3,1482,2384,2420,4446,6866
1,1482,2384,854,1482,2336
2,1482,2384,946,2964,3910
2,1482,2384,1613,2964,4577
2,755,1215,823,1510,2333
8,2,5,19,16,35
6,2,5,14,12,26
15,4,10,57,60,117
1,3,9,5,3,8
21,3,9,96,63,159
27,2,5,57,54,111
22,2,5,46,44,90
3,2,5,6,6,12
27,2,5,51,54,105
26,2,5,75,52,127
2,2,5,6,4,10
16,2,5,30,32,62
31,2,5,90,62,152
11,2,5,32,22,54
1,2,5,2,2,4
9,2,5,21,18,39
6,2,5,17,12,29
29,2,5,84,58,142
6,4,10,25,24,49
11,4,10,46,44,90
18,2,5,34,36,70
21,2,5,40,42,82
7,4,10,41,28,69
15,4,10,87,60,147
9,2,5,21,18,39
5,3,9,29,15,44
22,3,9,128,66,194
27,3,9,157,81,238
13,3,9,76,39,115
12,2,5,32,24,56
27,3,9,152,81,233
16,7,9,26,112,138
10,7,9,7,70,77
20,7,9,36,140,176
10,7,9,8,70,78
13,7,9,11,91,102
30,7,9,9,210,219
20,3,8,97,60,157
13,3,8,63,39,102
7,8,22,78,56,134
11,8,22,120,88,208
22,8,22,298,176,474
5,8,22,69,40,109
21,8,22,285,168,453
24,8,22,331,192,523
14,8,22,193,112,305
27,8,22,372,216,588
27,8,22,271,216,487
3,8,22,30,24,54
6,8,22,83,48,131
9,9,24,133,81,214
2,9,24,21,18,39
19,9,24,267,171,438
13,9,24,154,117,271
1,9,24,11,9,20
26,9,24,290,234,524
8,9,24,118,72,190
13,13,35,281,169,450
14,13,35,220,182,402
3,13,35,62,39,101
22,13,35,384,286,670
29,13,35,597,377,974
24,13,35,511,312,823
1,13,35,17,13,30
16,13,35,229,208,437
6,13,35,128,78,206
24,13,35,419,312,731
30,13,35,650,390,1040
26,13,35,454,338,792
29,13,35,618,377,995
22,13,35,469,286,755
4,13,35,87,52,139
1,13,35,21,13,34
7,13,35,152,91,243
8,13,35,140,104,244
1,13,35,16,13,29
4,13,35,66,52,118
28,21,55,629,588,1217
25,21,55,836,525,1361
17,21,55,559,357,916
32,38,50,368,1216,1584
2,42,54,23,84,107
5,42,54,11,210,221
10,38,50,110,380,490
2,42,54,10,84,94
8,42,54,1,336,337
26,42,54,256,1092,1348
15,42,54,123,630,753
4,38,50,10,152,162
19,42,54,84,798,882
1,1252,2295,722,1252,1974
2,1266,2320,1134,2532,3666
1,1252,2295,745,1252,1997
3,1252,2295,2991,3756,6747
3,420,769,1001,1260,2261
1,420,769,334,420,754
3,1266,2320,1631,3798,5429
2,1252,2295,1352,2504,3856
1,1252,2295,538,1252,1790
1,308,565,155,308,463
1,295,540,234,295,529
3,1252,2295,1890,3756,5646
1,2171,3578,1264,2171,3435
1,1555,2443,790,1555,2345
3,2171,3578,1967,6513,8480
3,2171,3578,2504,6513,9017
3,2171,3578,2826,6513,9339
1,2171,3578,942,2171,3113
1,713,1120,161,713,874
1,2171,3578,942,2171,3113
1,713,1120,340,713,1053
1,1083,1701,550,1083,1633
1,344,540,185,344,529
3,713,1120,583,2139,2722
1,2171,3578,1371,2171,3542
6,26,70,260,156,416
26,26,70,889,676,1565
19,26,70,543,494,1037
24,3,9,142,72,214
14,3,9,79,42,121
28,3,9,165,84,249
6,3,9,35,18,53
21,2,5,61,42,103
30,2,5,87,60,147
2,2,5,6,4,10
11,2,5,21,22,43
1,2,5,2,2,4
28,1,2,21,28,49
16,1,2,12,16,28
31,1,4,92,31,123
23,2,5,68,46,114
12,2,5,35,24,59
2,2,5,6,4,10
24,2,5,71,48,119
13,1,2,10,13,23
4,1,2,3,4,7
18,1,2,12,18,30
9,1,2,6,9,15
22,1,2,21,22,43
29,1,2,28,29,57
27,1,2,20,27,47
11,1,4,25,11,36
1,1,4,2,1,3
28,1,4,64,28,92
13,2,5,31,26,57
6,2,5,14,12,26
27,2,5,63,54,117
9,1,2,6,9,15
10,12,33,157,120,277
1,12,33,16,12,28
24,1,4,57,24,81
8,1,2,7,8,15
7,1,2,6,7,13
17,2,5,49,34,83
19,2,5,45,38,83
1,2,5,3,2,5
12,2,5,28,24,52
13,2,5,31,26,57
27,1,2,20,27,47
21,1,2,16,21,37
12,2,5,34,24,58
25,1,2,23,25,48
6,1,2,6,6,12
15,2,5,35,30,65
5,2,5,12,10,22
19,1,2,14,19,33
4,1,2,3,4,7
2,2,5,4,4,8
15,2,5,29,30,59
31,2,5,90,62,152
30,2,5,87,60,147
8,2,5,23,16,39
29,2,5,84,58,142
10,2,5,29,20,49
19,2,5,55,38,93
5,1,4,11,5,16
3,1,4,6,3,9
2,1482,2384,946,2964,3910
1,755,1215,266,755,1021
1,461,742,162,461,623
1,461,742,185,461,646
1,755,1215,436,755,1191
3,1482,2384,2563,4446,7009
17,24,64,658,408,1066
15,24,64,475,360,835
21,24,64,813,504,1317
27,24,64,1011,648,1659
12,45,120,713,540,1253
2,59,159,149,118,267
13,2,5,36,26,62
20,2,5,56,40,96
14,4,10,74,56,130
8,2,5,24,16,40
23,2,5,68,46,114
21,2,5,48,42,90
21,2,5,48,42,90
17,2,5,33,34,67
17,2,5,33,34,67
3,2,5,9,6,15
17,2,5,50,34,84
22,4,10,84,88,172
12,4,10,46,48,94
4,2,5,8,8,16
17,2,5,33,34,67
10,2,5,19,20,39
16,2,5,45,32,77
11,2,5,31,22,53
9,2,5,26,18,44
14,2,5,41,28,69
9,3,9,53,27,80
15,3,9,89,45,134
28,2,5,83,56,139
12,2,5,35,24,59
28,2,5,81,56,137
23,2,5,67,46,113
15,4,10,71,60,131
14,4,10,66,56,122
7,7,9,11,49,60
7,7,9,13,49,62
3,7,9,2,21,23
4,7,9,8,28,36
8,7,9,3,56,59
28,7,9,51,196,247
11,7,9,-2,77,75
31,7,9,3,217,220
20,3,8,97,60,157
6,8,22,81,48,129
16,8,22,217,128,345
3,8,22,31,24,55
25,8,22,229,200,429
19,9,24,189,171,360
5,9,24,70,45,115
23,13,35,498,299,797
8,13,35,140,104,244
9,13,35,176,117,293
27,13,35,396,351,747
19,13,35,411,247,658
17,13,35,279,221,500
6,13,35,124,78,202
30,13,35,513,390,903
8,13,35,165,104,269
7,13,35,110,91,201
3,13,35,62,39,101
16,13,35,346,208,554
12,13,35,197,156,353
15,21,55,452,315,767
16,21,55,350,336,686
13,38,50,150,494,644
18,38,50,180,684,864
26,42,54,-25,1092,1067
19,38,50,76,722,798
25,42,54,246,1050,1296
32,38,50,32,1216,1248
12,42,54,27,504,531
24,42,54,236,1008,1244
5,42,54,41,210,251
1,1898,3375,1342,1898,3240
3,1266,2320,3023,3798,6821
1,1252,2295,745,1252,1997
1,1266,2320,497,1266,1763
1,1266,2320,683,1266,1949
1,420,769,318,420,738
3,1266,2320,3023,3798,6821
2,1519,2443,1653,3038,4691
1,344,540,158,344,502
25,26,70,1030,650,1680
1,26,70,34,26,60
24,9,25,258,216,474
29,9,25,312,261,573
25,1,2,24,25,49
17,1,2,16,17,33
2,1,2,1,2,3
30,1,2,17,30,47
30,2,5,89,60,149
14,2,5,41,28,69
2,2,5,6,4,10
3,2,5,9,6,15
3,9,25,45,27,72
9,9,25,135,81,216
21,2,5,48,42,90
25,1,2,24,25,49
11,1,2,11,11,22
15,1,2,14,15,29
27,9,25,385,243,628
10,1,2,9,10,19
14,1,2,13,14,27
26,1,4,77,26,103
10,1,4,30,10,40
2,1,2,1,2,3
5,1,2,5,5,10
16,1,2,16,16,32
23,1,4,67,23,90
23,1,4,67,23,90
20,2,5,38,40,78
23,2,5,44,46,90
28,2,5,53,56,109
20,1,2,16,20,36
15,1,2,12,15,27
26,1,2,20,26,46
20,8,21,205,160,365
19,8,21,195,152,347
12,8,21,123,96,219
12,2,5,35,24,59
23,2,5,67,46,113
2,1,2,2,2,4
3,1,2,3,3,6
7,1,2,7,7,14
5,1,2,5,5,10
28,1,2,27,28,55
6,8,21,75,48,123
13,9,25,202,117,319
3,9,25,47,27,74
25,1,4,71,25,96
5,1,4,14,5,19
9,1,4,26,9,35
10,1,4,29,10,39
30,9,25,345,270,615
2,9,25,23,18,41
2,9,25,23,18,41
19,1,4,55,19,74
4,1,4,12,4,16
1,461,742,274,461,735
3,755,1215,797,2265,3062
1,1482,2384,473,1482,1955
1,461,742,274,461,735
1,1482,2384,854,1482,2336
1,461,742,251,461,712
2,461,742,532,922,1454
1,461,742,251,461,712
1,1482,2384,401,1482,1883
3,24,64,116,72,188
13,24,64,503,312,815
1,45,120,49,45,94
2,45,120,145,90,235
3,59,159,214,177,391
21,2,5,49,42,91
12,2,5,28,24,52
12,4,10,71,48,119
15,2,5,44,30,74
8,2,5,23,16,39
7,3,9,28,21,49
1,3,9,4,3,7
14,2,5,32,28,60
17,2,5,39,34,73
23,2,5,53,46,99
13,2,5,38,26,64
5,2,5,15,10,25
20,2,5,38,40,78
16,2,5,30,32,62
5,2,5,13,10,23
7,2,5,20,14,34
19,2,5,53,38,91
6,2,5,11,12,23
15,2,5,27,30,57
20,2,5,56,40,96
1,2,5,3,2,5
17,3,9,99,51,150
16,3,9,93,48,141
2,3,9,8,6,14
11,3,9,45,33,78
15,7,9,12,105,117
28,7,9,46,196,242
11,7,9,18,77,95
16,7,9,22,112,134
23,7,9,19,161,180
20,7,9,0,140,140
19,3,8,92,57,149
15,3,8,59,45,104
5,3,8,16,15,31
5,3,8,20,15,35
17,8,22,156,136,292
12,8,22,163,96,259
5,8,22,55,40,95
22,8,22,298,176,474
7,8,22,95,56,151
13,8,22,171,104,275
23,8,22,287,184,471
1,9,24,15,9,24
6,9,24,71,54,125
4,9,24,39,36,75
30,9,24,436,270,706
11,13,35,227,143,370
13,13,35,281,169,450
9,13,35,195,117,312
19,13,35,391,247,638
3,13,35,64,39,103
23,13,35,498,299,797
4,13,35,57,52,109
25,13,35,489,325,814
2,13,35,39,26,65
31,13,35,660,403,1063
9,13,35,129,117,246
16,13,35,251,208,459
24,21,55,644,504,1148
3,21,55,79,63,142
24,21,55,578,504,1082
14,38,50,140,532,672
25,38,50,250,950,1200
7,42,54,80,294,374
12,38,50,132,456,588
2,42,54,0,84,84
1,38,50,11,38,49
12,42,54,131,504,635
3,1252,2295,1477,3756,5233
1,1266,2320,961,1266,2227
1,1266,2320,961,1266,2227
1,1266,2320,752,1266,2018
1,1252,2295,722,1252,1974
3,420,769,1024,1260,2284
1,1252,2295,745,1252,1997
3,1252,2295,2991,3756,6747
1,344,540,174,344,518
1,487,783,280,487,767
1,2171,3578,942,2171,3113
1,2171,3578,835,2171,3006
1,713,1120,362,713,1075
2,713,1120,321,1426,1747
2,1083,1701,1168,2166,3334
10,26,70,433,260,693
30,26,70,1299,780,2079
22,1,2,21,22,43
12,1,2,12,12,24
6,2,5,18,12,30
28,2,5,83,56,139
8,2,5,24,16,40
15,2,5,44,30,74
2,2,5,6,4,10
2,9,25,22,18,40
1,2,5,3,2,5
2,2,5,6,4,10
17,2,5,50,34,84
8,11,30,121,88,209
18,11,30,272,198,470
2,1,2,2,2,4
15,1,4,41,15,56
18,1,2,10,18,28
14,8,21,117,112,229
15,13,35,236,195,431
13,13,35,204,169,373
4,13,35,63,52,115
21,1,2,12,21,33
25,9,25,319,225,544
29,1,2,16,29,45
14,1,4,32,14,46
13,1,4,35,13,48
21,1,4,57,21,78
2,11,30,37,22,59
1,11,30,18,11,29
15,8,21,154,120,274
19,8,21,195,152,347
8,8,21,82,64,146
10,8,21,103,80,183
14,8,21,170,112,282
30,8,21,365,240,605
27,2,5,78,54,132
22,2,5,64,44,108
3,8,21,28,24,52
21,1,2,12,21,33
25,1,2,24,25,49
8,1,2,8,8,16
5,2,5,11,10,21
18,1,2,17,18,35
15,1,2,14,15,29
1,1,2,1,1,2
2,1,2,1,2,3
1,755,1215,193,755,948
13,24,64,404,312,716
4,59,159,324,236,560
8,4,10,46,32,78
10,4,10,58,40,98
1,2,5,3,2,5
5,2,5,12,10,22
18,2,5,41,36,77
16,2,5,45,32,77
22,2,5,62,44,106
1,2,5,2,2,4
4,2,5,8,8,16
26,2,5,57,52,109
10,2,5,22,20,42
15,2,5,40,30,70
16,2,5,42,32,74
1,2,5,3,2,5
2,2,5,6,4,10
21,2,5,62,42,104
18,2,5,53,36,89
15,2,5,44,30,74
21,2,5,44,42,86
3,2,5,6,6,12
17,7,9,32,119,151
6,7,9,11,42,53
20,7,9,36,140,176
24,7,9,44,168,212
17,3,8,82,51,133
28,8,22,306,224,530
2,8,22,27,16,43
7,8,22,92,56,148
7,8,22,96,56,152
19,9,24,203,171,374
29,13,35,628,377,1005
8,13,35,137,104,241
4,13,35,85,52,137
15,13,35,309,195,504
28,13,35,596,364,960
30,13,35,524,390,914
18,13,35,383,234,617
6,13,35,117,78,195
23,13,35,377,299,676
14,13,35,244,182,426
14,13,35,303,182,485
18,13,35,264,234,498
9,13,35,132,117,249
11,21,55,350,231,581
30,38,50,30,1140,1170
15,42,54,34,630,664
21,38,50,84,798,882
8,42,54,27,336,363
13,38,50,130,494,624
29,38,50,44,1102,1146
3,42,54,33,126,159
22,38,50,242,836,1078
9,38,50,99,342,441
11,38,50,121,418,539
1,1252,2295,1020,1252,2272
1,1252,2295,768,1252,2020
1,1898,3375,937,1898,2835
1,1266,2320,729,1266,1995
2,1252,2295,1489,2504,3993
1,1266,2320,961,1266,2227
1,1266,2320,892,1266,2158
1,295,540,223,295,518
1,308,565,251,308,559
2,344,540,381,688,1069
1,1555,2443,546,1555,2101
1,713,1120,385,713,1098
2,487,783,561,974,1535
1,487,783,124,487,611
1,2171,3578,835,2171,3006
1,713,1120,396,713,1109
1,1555,2443,570,1555,2125
19,26,70,809,494,1303
4,26,70,114,104,218
17,26,70,724,442,1166
8,11,30,123,88,211
1,11,30,15,11,26
24,11,29,321,264,585
2,11,29,27,22,49
9,9,25,97,81,178
9,9,25,97,81,178
7,1,4,17,7,24
5,1,4,12,5,17
21,1,2,20,21,41
19,1,2,18,19,37
3,1,2,3,3,6
17,2,5,49,34,83
25,2,5,73,50,123
27,1,4,57,27,84
16,1,4,34,16,50
2,2,5,4,4,8
21,2,5,49,42,91
26,2,5,61,52,113
22,12,33,310,264,574
22,12,33,310,264,574
6,2,5,13,12,25
9,2,5,20,18,38
2,1,4,6,2,8
10,1,4,28,10,38
28,1,4,80,28,108
19,13,35,391,247,638
25,13,35,515,325,840
1,13,35,21,13,34
19,11,30,321,209,530
28,11,30,473,308,781
19,11,30,355,209,564
25,11,30,468,275,743
19,1,2,14,19,33
13,1,2,9,13,22
10,1,2,7,10,17
17,1,4,50,17,67
15,8,21,189,120,309
22,9,25,341,198,539
17,9,25,264,153,417
19,9,25,295,171,466
1,1482,2384,521,1482,2003
3,1482,2384,1562,4446,6008
1,755,1215,241,755,996
1,1482,2384,854,1482,2336
1,755,1215,436,755,1191
7,24,64,181,168,349
3,59,159,290,177,467
13,2,5,34,26,60
2,2,5,5,4,9
5,4,10,21,20,41
14,4,10,59,56,115
4,2,5,11,8,19
15,4,10,69,60,129
11,4,10,64,44,108
14,4,10,53,56,109
23,4,10,87,92,179
11,2,5,32,22,54
11,2,5,32,22,54
22,2,5,65,44,109
25,3,9,101,75,176
4,3,9,16,12,28
24,7,9,20,168,188
5,3,8,19,15,34
25,8,22,328,200,528
27,8,22,283,216,499
26,8,22,353,208,561
26,9,24,384,234,618
3,9,24,32,27,59
23,9,24,224,207,431
5,9,24,68,45,113
20,13,35,426,260,686
12,13,35,197,156,353
13,13,35,204,169,373
18,13,35,314,234,548
1,13,35,22,13,35
6,13,35,130,78,208
13,13,35,268,169,437
19,13,35,278,247,525
29,13,35,394,377,771
28,13,35,547,364,911
23,13,35,490,299,789
29,13,35,628,377,1005
2,13,35,34,26,60
30,13,35,440,390,830
26,13,35,536,338,874
1,13,35,16,13,29
6,13,35,86,78,164
23,13,35,490,299,789
26,13,35,563,338,901
23,13,35,490,299,789
3,13,35,62,39,101
30,21,55,806,630,1436
7,21,55,223,147,370
20,42,54,229,840,1069
31,42,54,305,1302,1607
18,42,54,90,756,846
5,42,54,1,210,211
18,42,54,197,756,953
2,42,54,10,84,94
7,38,50,70,266,336
3,1252,2295,2854,3756,6610
3,1266,2320,2048,3798,5846
1,308,565,234,308,542
1,1266,2320,1031,1266,2297
1,1252,2295,882,1252,2134
1,1252,2295,997,1252,2249
1,2171,3578,763,2171,2934
3,2171,3578,2289,6513,8802
1,2171,3578,942,2171,3113
1,1555,2443,448,1555,2003
2,2171,3578,1884,4342,6226
1,2171,3578,942,2171,3113
1,487,783,155,487,642
1,344,540,77,344,421
1,344,540,126,344,470
3,344,540,296,1032,1328
1,344,540,174,344,518
11,26,70,476,286,762
16,26,70,682,416,1098
5,3,9,28,15,43
2,13,35,43,26,69
14,13,35,298,182,480
19,1,4,54,19,73
30,2,5,63,60,123
30,1,2,22,30,52
5,1,2,4,5,9
1,2,5,3,2,5
15,2,5,44,30,74
9,2,5,16,18,34
15,2,5,27,30,57
2,2,5,6,4,10
20,2,5,56,40,96
22,2,5,62,44,106
27,2,5,76,54,130
16,2,5,34,32,66
27,8,21,272,216,488
20,8,21,201,160,361
10,1,4,28,10,38
25,1,4,71,25,96
9,1,4,26,9,35
4,1,2,2,4,6
23,1,2,13,23,36
8,2,5,19,16,35
21,2,5,44,42,86
25,2,5,53,50,103
1,2,5,2,2,4
21,1,2,19,21,40
18,1,2,17,18,35
1,2,5,3,2,5
12,2,5,35,24,59
11,2,5,31,22,53
11,2,5,31,22,53
11,1,4,31,11,42
21,1,4,60,21,81
2,2,5,6,4,10
9,2,5,26,18,44
16,1,2,16,16,32
10,1,2,10,10,20
13,1,2,13,13,26
12,8,21,151,96,247
5,1,2,3,5,8
10,1,2,6,10,16
13,1,2,11,13,24
17,1,2,15,17,32
12,2,5,28,24,52
25,2,5,59,50,109
1,461,742,162,461,623
3,755,1215,1344,2265,3609
1,755,1215,193,755,948
1,24,64,30,24,54
9,45,120,535,405,940
3,59,159,281,177,458
14,2,5,29,28,57
11,4,10,64,44,108
6,4,10,35,24,59
11,4,10,65,44,109
16,4,10,94,64,158
8,4,10,46,32,78
8,2,5,23,16,39
8,2,5,23,16,39
20,2,5,58,40,98
5,2,5,15,10,25
2,2,5,5,4,9
7,2,5,16,14,30
20,2,5,38,40,78
9,2,5,17,18,35
1,2,5,3,2,5
25,2,5,74,50,124
7,2,5,13,14,27
26,3,9,154,78,232
1,3,9,6,3,9
19,7,9,16,133,149
23,7,9,19,161,180
18,7,9,15,126,141
21,7,9,34,147,181
28,3,8,138,84,222
2,3,8,10,6,16
11,8,22,123,88,211
17,9,24,182,153,335
23,9,24,334,207,541
17,13,35,267,221,488
16,13,35,346,208,554
10,13,35,147,130,277
14,13,35,298,182,480
3,13,35,64,39,103
5,13,35,108,65,173
9,13,35,195,117,312
1,13,35,17,13,30
3,13,35,64,39,103
7,13,35,100,91,191
14,21,55,468,294,762
26,21,55,627,546,1173
23,21,55,757,483,1240
24,21,55,644,504,1148
32,38,50,368,1216,1584
10,42,54,7,420,427
27,42,54,18,1134,1152
10,42,54,50,420,470
28,42,54,139,1176,1315
25,42,54,273,1050,1323
28,38,50,28,1064,1092
6,38,50,66,228,294
1,42,54,2,42,44
2,1252,2295,1994,2504,4498
3,1266,2320,1631,3798,5429
1,1266,2320,636,1266,1902
3,1266,2320,1909,3798,5707
1,420,769,334,420,754
3,420,769,1001,1260,2261
1,1266,2320,1008,1266,2274
1,1519,2443,387,1519,1906
1,1519,2443,900,1519,2419
1,1083,1701,601,1083,1684
1,1555,2443,790,1555,2345
2,2171,3578,1311,4342,5653
1,2171,3578,942,2171,3113
1,713,1120,161,713,874
3,1555,2443,1491,4665,6156
3,344,540,556,1032,1588
1,713,1120,261,713,974
23,3,9,136,69,205
17,3,9,82,51,133
30,2,5,57,60,117
23,13,35,490,299,789
19,13,35,405,247,652
15,11,29,266,165,431
20,11,29,354,220,574
29,1,2,28,29,57
15,1,2,14,15,29
26,2,5,77,52,129
25,2,5,74,50,124
16,2,5,45,32,77
6,2,5,17,12,29
17,2,5,48,34,82
24,2,5,46,48,94
28,2,5,53,56,109
25,2,5,48,50,98
24,2,5,71,48,119
2,2,5,6,4,10
26,2,5,49,52,101
1,2,5,2,2,4
1,1,2,1,1,2
25,1,2,23,25,48
15,1,2,15,15,30
18,2,5,53,36,89
5,2,5,15,10,25
25,2,5,74,50,124
21,2,5,61,42,103
2,2,5,6,4,10
17,2,5,49,34,83
7,2,5,20,14,34
20,11,30,374,220,594
26,11,30,486,286,772
7,2,5,16,14,30
20,2,5,47,40,87
6,1,2,6,6,12
22,1,2,22,22,44
14,1,2,14,14,28
3,9,25,32,27,59
9,1,2,9,9,18
1,1,2,1,1,2
19,2,5,36,38,74
14,1,2,13,14,27
27,1,2,26,27,53
1,1482,2384,735,1482,2217
1,1482,2384,854,1482,2336
1,755,1215,411,755,1166
15,24,64,475,360,835
10,45,120,486,450,936
5,2,5,12,10,22
6,2,5,14,12,26
25,3,9,148,75,223
16,2,5,31,32,63
6,2,5,12,12,24
26,4,10,146,104,250
9,2,5,25,18,43
2,2,5,6,4,10
5,2,5,15,10,25
6,2,5,17,12,29
20,2,5,58,40,98
22,2,5,64,44,108
16,2,5,46,32,78
22,2,5,64,44,108
17,2,5,50,34,84
3,2,5,9,6,15
4,2,5,12,8,20
5,2,5,15,10,25
21,7,9,40,147,187
14,7,9,25,98,123
31,7,9,59,217,276
20,7,9,0,140,140
23,3,8,76,69,145
13,3,8,48,39,87
1,3,8,3,3,6
4,8,22,37,32,69
3,8,22,33,24,57
9,8,22,82,72,154
30,8,22,314,240,554
11,9,24,162,99,261
13,9,24,129,117,246
6,9,24,87,54,141
27,9,24,392,243,635
21,13,35,308,273,581
1,13,35,15,13,28
8,13,35,140,104,244
20,13,35,349,260,609
1,13,35,21,13,34
28,13,35,577,364,941
27,13,35,575,351,926
15,13,35,325,195,520
27,13,35,575,351,926
13,13,35,227,169,396
5,13,35,107,65,172
8,13,35,173,104,277
3,13,35,64,39,103
27,13,35,585,351,936
24,13,35,469,312,781
9,13,35,195,117,312
22,21,55,494,462,956
31,38,50,31,1178,1209
27,38,50,270,1026,1296
13,42,54,2,546,548
15,42,54,67,630,697
12,42,54,60,504,564
27,42,54,295,1134,1429
21,38,50,242,798,1040
15,42,54,172,630,802
18,42,54,90,756,846
7,38,50,7,266,273
31,38,50,171,1178,1349
1,1912,3400,1046,1912,2958
3,1252,2295,2234,3756,5990
3,1266,2320,3023,3798,6821
2,420,769,667,840,1507
1,1266,2320,544,1266,1810
2,487,783,561,974,1535
1,487,783,186,487,673
1,487,783,124,487,611
3,2171,3578,1967,6513,8480
1,2171,3578,835,2171,3006
3,344,540,232,1032,1264
1,2171,3578,835,2171,3006
2,344,540,316,688,1004
2,2171,3578,2742,4342,7084
3,1555,2443,2591,4665,7256
1,2171,3578,1335,2171,3506
25,26,70,1083,650,1733
25,26,70,1083,650,1733
9,26,70,308,234,542
9,26,70,257,234,491
8,26,70,274,208,482
9,26,70,314,234,548
21,3,9,101,63,164
16,3,9,77,48,125
13,13,35,281,169,450
2,13,35,43,26,69
13,13,35,277,169,446
6,13,35,128,78,206
25,13,35,541,325,866
30,13,35,650,390,1040
4,13,35,87,52,139
23,1,2,22,23,45
21,1,4,52,21,73
22,2,5,43,44,87
26,2,5,51,52,103
4,2,5,12,8,20
22,2,5,65,44,109
13,2,5,38,26,64
30,2,5,87,60,147
24,9,25,360,216,576
21,9,25,315,189,504
7,1,2,6,7,13
24,1,2,22,24,46
19,1,2,13,19,32
23,1,2,16,23,39
28,1,2,27,28,55
7,1,2,7,7,14
16,1,4,36,16,52
11,1,4,25,11,36
14,8,21,161,112,273
24,1,4,51,24,75
18,1,4,38,18,56
16,1,4,34,16,50
22,1,2,21,22,43
7,1,4,20,7,27
19,2,5,45,38,83
10,2,5,24,20,44
22,1,2,16,22,38
2,1,2,1,2,3
3,1,2,2,3,5
8,1,4,16,8,24
20,1,4,41,20,61
4,11,29,70,44,114
15,11,29,261,165,426
25,2,5,73,50,123
25,2,5,48,50,98
17,2,5,32,34,66
26,2,5,49,52,101
15,2,5,29,30,59
12,2,5,32,24,56
7,2,5,19,14,33
9,2,5,24,18,42
1,755,1215,411,755,1166
1,461,742,274,461,735
3,1482,2384,2563,4446,7009
3,1482,2384,2563,4446,7009
1,755,1215,436,755,1191
1,461,742,229,461,690
1,461,742,274,461,735
1,1482,2384,592,1482,2074
1,24,64,39,24,63
9,59,159,585,531,1116
1,59,159,94,59,153
8,4,10,47,32,79
31,4,10,174,124,298
16,4,10,90,64,154
16,2,5,45,32,77
20,2,5,56,40,96
18,2,5,48,36,84
5,2,5,13,10,23
23,2,5,67,46,113
29,2,5,84,58,142
14,2,5,41,28,69
29,4,10,122,116,238
5,4,10,21,20,41
20,4,10,76,80,156
31,4,10,118,124,242
14,2,5,27,28,55
11,2,5,21,22,43
16,2,5,43,32,75
10,2,5,23,20,43
27,2,5,57,54,111
8,2,5,17,16,33
24,3,9,140,72,212
12,3,9,70,36,106
5,3,9,29,15,44
13,3,9,76,39,115
18,2,5,52,36,88
4,2,5,9,8,17
28,2,5,66,56,122
16,2,5,47,32,79
7,2,5,21,14,35
20,3,9,82,60,142
16,3,9,66,48,114
27,2,5,57,54,111
15,2,5,32,30,62
27,7,9,49,189,238
25,7,9,41,175,216
22,7,9,8,154,162
13,7,9,24,91,115
13,7,9,1,91,92
22,3,8,78,66,144
27,3,8,131,81,212
22,3,8,71,66,137
13,8,22,171,104,275
3,8,22,39,24,63
13,8,22,119,104,223
22,8,22,221,176,397
28,8,22,367,224,591
3,8,22,41,24,65
25,9,24,351,225,576
31,9,24,368,279,647
10,9,24,107,90,197
6,9,24,87,54,141
18,9,24,244,162,406
28,9,24,272,252,524
27,9,24,262,243,505
22,9,24,261,198,459
5,9,24,73,45,118
14,13,35,303,182,485
25,13,35,358,325,683
12,13,35,260,156,416
21,13,35,300,273,573
28,13,35,410,364,774
14,13,35,244,182,426
8,13,35,137,104,241
15,13,35,293,195,488
7,13,35,100,91,191
5,13,35,103,65,168
25,13,35,428,325,753
17,13,35,362,221,583
4,13,35,70,52,122
27,13,35,575,351,926
26,13,35,554,338,892
9,13,35,154,117,271
21,21,55,564,441,1005
30,21,55,987,630,1617
27,42,54,266,1134,1400
24,42,54,275,1008,1283
15,38,50,150,570,720
13,38,50,39,494,533
24,38,50,264,912,1176
28,38,50,308,1064,1372
3,1252,2295,3060,3756,6816
2,1252,2295,1076,2504,3580
1,1266,2320,1008,1266,2274
1,1266,2320,1008,1266,2274
1,1252,2295,951,1252,2203
3,308,565,703,924,1627
3,308,565,534,924,1458
1,1519,2443,484,1519,2003
1,1519,2443,753,1519,2272
2,344,540,154,688,842
1,1083,1701,584,1083,1667
1,1083,1701,584,1083,1667
2,1083,1701,522,2166,2688
3,1555,2443,2591,4665,7256
7,26,70,288,182,470
28,3,9,158,84,242
25,3,9,114,75,189
5,9,25,79,45,124
21,9,25,331,189,520
8,2,5,15,16,31
1,2,5,2,2,4
11,1,2,11,11,22
28,1,2,27,28,55
27,13,35,575,351,926
13,2,5,38,26,64
6,12,33,118,72,190
9,12,33,177,108,285
5,2,5,15,10,25
16,2,5,47,32,79
1,13,35,21,13,34
26,13,35,554,338,892
18,1,2,17,18,35
6,1,2,6,6,12
4,13,35,85,52,137
25,13,35,533,325,858
20,1,4,50,20,70
30,2,5,69,60,129
23,2,5,53,46,99
1,1,2,1,1,2
1,2,5,2,2,4
19,1,2,16,19,35
4,11,30,60,44,104
12,11,30,181,132,313
18,2,5,34,36,70
6,2,5,11,12,23
10,2,5,19,20,39
16,2,5,30,32,62
19,2,5,36,38,74
22,1,2,16,22,38
7,2,5,20,14,34
15,1,4,34,15,49
10,1,2,9,10,19
1,1,2,1,1,2
14,2,5,27,28,55
18,2,5,34,36,70
28,2,5,53,56,109
15,1,2,8,15,23
25,1,2,14,25,39
17,2,5,45,34,79
3,2,5,8,6,14
21,1,2,12,21,33
23,1,2,13,23,36
5,1,4,15,5,20
1,1,4,3,1,4
1,1,4,3,1,4
8,1,4,23,8,31
2,1,4,6,2,8
18,1,4,53,18,71
4,2,5,8,8,16
27,2,5,51,54,105
3,1,4,7,3,10
6,1,4,15,6,21
1,1482,2384,473,1482,1955
1,461,742,125,461,586
1,1482,2384,735,1482,2217
1,755,1215,448,755,1203
1,1482,2384,401,1482,1883
1,1482,2384,592,1482,2074
3,1482,2384,1562,4446,6008
20,24,64,749,480,1229
21,24,64,652,504,1156
12,3,9,55,36,91
4,3,9,18,12,30
7,2,5,20,14,34
18,2,5,52,36,88
23,2,5,67,46,113
18,4,10,104,72,176
3,4,10,17,12,29
2,2,5,4,4,8
18,2,5,35,36,71
28,2,5,81,56,137
28,2,5,83,56,139
22,7,9,12,154,166
23,7,9,19,161,180
23,7,9,0,161,161
28,7,9,16,196,212
6,7,9,11,42,53
5,7,9,9,35,44
5,7,9,8,35,43
18,7,9,34,126,160
27,3,8,133,81,214
5,8,22,68,40,108
1,8,22,10,8,18
16,8,22,168,128,296
10,8,22,136,80,216
16,9,24,232,144,376
10,13,35,213,130,343
12,13,35,197,156,353
9,13,35,154,117,271
19,13,35,405,247,652
21,13,35,447,273,720
22,21,55,736,462,1198
28,38,50,308,1064,1372
25,38,50,250,950,1200
1,38,50,3,38,41
12,38,50,120,456,576
9,42,54,30,378,408
15,42,54,164,630,794
19,42,54,207,798,1005
1,1252,2295,676,1252,1928
2,1252,2295,1994,2504,4498
1,1252,2295,951,1252,2203
1,1266,2320,1031,1266,2297
1,1266,2320,1008,1266,2274
2,2171,3578,2528,4342,6870
3,487,783,841,1461,2302
2,487,783,561,974,1535
3,1083,1701,1650,3249,4899
2,1519,2443,822,3038,3860
5,26,70,213,130,343
23,26,70,722,598,1320
28,3,9,163,84,247
7,3,9,41,21,62
13,3,9,76,39,115
14,13,35,239,182,421
1,13,35,17,13,30
5,2,5,14,10,24
16,2,5,45,32,77
23,1,2,22,23,45
14,9,25,179,126,305
3,1,2,3,3,6
11,1,2,10,11,21
15,1,2,14,15,29
26,2,5,75,52,127
9,9,25,97,81,178
9,13,35,192,117,309
7,1,2,7,7,14
18,1,2,17,18,35
4,1,2,4,4,8
23,1,4,68,23,91
17,11,30,313,187,500
6,1,2,6,6,12
27,1,2,26,27,53
10,2,5,22,20,42
20,2,5,56,40,96
20,2,5,56,40,96
24,11,30,355,264,619
14,11,30,207,154,361
24,1,2,13,24,37
1,1,2,1,1,2
22,11,29,390,242,632
3,1,4,6,3,9
28,1,4,57,28,85
17,2,5,48,34,82
17,2,5,48,34,82
17,8,21,214,136,350
3,8,21,38,24,62
1,1482,2384,330,1482,1812
1,1482,2384,854,1482,2336
1,1482,2384,854,1482,2336
2,755,1215,385,1510,1895
3,1482,2384,1562,4446,6008
24,3,9,109,72,181
27,3,9,123,81,204
27,2,5,80,54,134
13,2,5,27,26,53
20,2,5,42,40,82
5,2,5,14,10,24
25,2,5,70,50,120
2,4,10,12,8,20
9,2,5,27,18,45
5,2,5,15,10,25
29,4,10,168,116,284
2,3,9,8,6,14
1,3,9,4,3,7
1,3,9,5,3,8
21,3,9,113,63,176
19,2,5,45,38,83
10,2,5,24,20,44
25,7,9,41,175,216
4,7,9,7,28,35
9,3,8,29,27,56
20,3,8,98,60,158
28,3,8,136,84,220
28,3,8,100,84,184
24,3,8,118,72,190
11,8,22,123,88,211
13,8,22,176,104,280
4,8,22,40,32,72
23,8,22,302,184,486
14,9,24,163,126,289
9,9,24,107,81,188
21,9,24,249,189,438
13,13,35,186,169,355
9,13,35,157,117,274
1,13,35,21,13,34
12,13,35,247,156,403
1,13,35,21,13,34
23,13,35,474,299,773
3,13,35,52,39,91
1,13,35,17,13,30
19,13,35,405,247,652
5,13,35,72,65,137
32,13,35,558,416,974
11,21,55,368,231,599
1,21,55,33,21,54
15,42,54,75,630,705
9,38,50,14,342,356
1,42,54,0,42,42
16,42,54,157,672,829
1,1266,2320,636,1266,1902
1,1266,2320,961,1266,2227
1,1252,2295,676,1252,1928
1,1252,2295,745,1252,1997
1,420,769,249,420,669
1,308,565,178,308,486
1,420,769,249,420,669
1,1266,2320,961,1266,2227
1,2171,3578,763,2171,2934
2,2171,3578,1884,4342,6226
1,2171,3578,942,2171,3113
1,2171,3578,942,2171,3113
1,2171,3578,727,2171,2898
2,1555,2443,701,3110,3811
3,2171,3578,2826,6513,9339
1,344,540,126,344,470
1,713,1120,205,713,918
3,487,783,512,1461,1973
1,2171,3578,1371,2171,3542
12,26,70,419,312,731
3,26,70,130,78,208
23,26,70,722,598,1320
24,3,9,142,72,214
16,3,9,69,48,117
13,3,9,76,39,115
28,2,5,66,56,122
20,1,4,42,20,62
7,9,25,89,63,152
12,9,25,153,108,261
20,8,21,172,160,332
4,8,21,34,32,66
18,1,2,18,18,36
5,1,2,5,5,10
4,11,30,75,44,119
29,11,30,542,319,861
32,11,30,598,352,950
6,2,5,17,12,29
23,2,5,64,46,110
2,2,5,6,4,10
13,1,2,8,13,21
22,1,2,14,22,36
11,9,25,124,99,223
4,9,25,45,36,81
31,1,2,20,31,51
18,1,2,12,18,30
1,2,5,3,2,5
29,9,25,370,261,631
11,9,25,140,99,239
24,12,33,377,288,665
12,1,2,11,12,23
23,1,2,21,23,44
17,11,30,252,187,439
18,1,2,17,18,35
22,8,21,189,176,365
5,8,21,43,40,83
28,1,2,27,28,55
4,1,2,4,4,8
7,2,5,21,14,35
12,2,5,35,24,59
22,2,5,64,44,108
14,9,25,179,126,305
29,1,2,28,29,57
5,9,25,78,45,123
25,9,25,388,225,613
17,1,2,10,17,27
19,1,2,11,19,30
18,9,25,279,162,441
32,1,4,93,32,125
16,1,4,47,16,63
3,461,742,554,1383,1937
1,461,742,229,461,690
13,24,64,370,312,682
11,24,64,426,264,690
7,45,120,508,315,823
9,59,159,714,531,1245
24,2,5,50,48,98
16,4,10,67,64,131
16,2,5,34,32,66
21,2,5,49,42,91
5,2,5,12,10,22
26,2,5,61,52,113
26,2,5,77,52,129
14,2,5,41,28,69
10,3,9,41,30,71
14,3,9,58,42,100
9,2,5,21,18,39
7,2,5,16,14,30
14,2,5,33,28,61
31,7,9,1,217,218
15,7,9,12,105,117
1,7,9,2,7,9
16,7,9,13,112,125
4,7,9,7,28,35
20,7,9,17,140,157
25,7,9,48,175,223
31,7,9,51,217,268
16,3,8,79,48,127
22,3,8,106,66,172
19,8,22,207,152,359
15,8,22,203,120,323
26,8,22,353,208,561
17,8,22,234,136,370
27,8,22,271,216,487
16,8,22,147,128,275
1,9,24,15,9,24
9,9,24,133,81,214
8,9,24,118,72,190
29,9,24,421,261,682
3,13,35,62,39,101
27,13,35,556,351,907
9,13,35,195,117,312
12,13,35,235,156,391
4,13,35,57,52,109
9,13,35,157,117,274
4,13,35,85,52,137
10,13,35,206,130,336
27,13,35,471,351,822
3,13,35,64,39,103
20,13,35,440,260,700
20,13,35,433,260,693
13,13,35,281,169,450
8,13,35,170,104,274
8,13,35,117,104,221
6,21,55,201,126,327
1,21,55,27,21,48
19,21,55,458,399,857
5,21,55,121,105,226
12,42,54,53,504,557
17,38,50,17,646,663
25,38,50,213,950,1163
14,38,50,14,532,546
16,38,50,160,608,768
16,38,50,24,608,632
1,1898,3375,768,1898,2666
3,1912,3400,3138,5736,8874
1,1266,2320,961,1266,2227
1,1252,2295,722,1252,1974
1,1266,2320,683,1266,1949
2,420,769,498,840,1338
3,295,540,379,885,1264
1,2171,3578,942,2171,3113
3,487,783,841,1461,2302
3,487,783,841,1461,2302
1,1555,2443,351,1555,1906
1,2171,3578,942,2171,3113
2,2171,3578,1669,4342,6011
1,1083,1701,550,1083,1633
1,344,540,185,344,529
1,344,540,99,344,443
1,1083,1701,261,1083,1344
15,26,70,650,390,1040
1,26,70,43,26,69
30,26,70,1278,780,2058
12,26,70,410,312,722
12,26,70,343,312,655
9,3,9,39,27,66
25,3,9,146,75,221
9,3,9,43,27,70
19,2,5,55,38,93
30,2,5,87,60,147
26,1,2,25,26,51
22,1,2,21,22,43
29,1,2,28,29,57
19,1,2,18,19,37
12,1,2,9,12,21
26,1,2,19,26,45
25,1,2,19,25,44
7,11,30,131,77,208
15,13,35,325,195,520
3,13,35,65,39,104
9,2,5,24,18,42
9,2,5,27,18,45
1,2,5,3,2,5
10,2,5,19,20,39
15,2,5,29,30,59
27,2,5,51,54,105
10,9,25,128,90,218
6,9,25,77,54,131
26,12,33,537,312,849
26,2,5,55,52,107
21,2,5,44,42,86
3,1,2,2,3,5
3,1,2,2,3,5
1,1,2,1,1,2
10,2,5,30,20,50
3,2,5,9,6,15
8,1,2,8,8,16
10,1,4,25,10,35
3,2,5,9,6,15
11,2,5,32,22,54
12,1,4,35,12,47
3,1,4,9,3,12
17,1,4,50,17,67
11,1,2,6,11,17
23,1,2,13,23,36
8,1,2,6,8,14
20,1,2,19,20,39
13,1,2,12,13,25
6,2,5,18,12,30
14,2,5,41,28,69
28,2,5,81,56,137
5,1,2,4,5,9
1,1,2,1,1,2
12,1,2,10,12,22
1,461,742,266,461,727
1,755,1215,193,755,948
1,1482,2384,854,1482,2336
1,461,742,274,461,735
2,1482,2384,1184,2964,4148
1,755,1215,411,755,1166
6,24,64,232,144,376
14,24,64,363,336,699
11,24,64,313,264,577
6,59,159,590,354,944
1,59,159,71,59,130
13,3,9,73,39,112
20,3,9,107,60,167
13,3,9,70,39,109
24,2,5,55,48,103
14,2,5,32,28,60
15,2,5,29,30,59
15,2,5,29,30,59
23,2,5,45,46,91
10,4,10,58,40,98
17,4,10,99,68,167
20,2,5,58,40,98
3,2,5,9,6,15
18,3,9,87,54,141
1,3,9,5,3,8
27,2,5,80,54,134
14,2,5,41,28,69
21,2,5,49,42,91
28,2,5,66,56,122
14,2,5,33,28,61
2,2,5,5,4,9
23,7,9,19,161,180
25,7,9,3,175,178
19,3,8,63,57,120
12,3,8,53,36,89
19,8,22,249,152,401
26,8,22,358,208,566
15,8,22,203,120,323
18,8,22,201,144,345
23,9,24,306,207,513
13,9,24,154,117,271
11,13,35,238,143,381
1,13,35,17,13,30
32,13,35,659,416,1075
13,13,35,268,169,437
10,13,35,157,130,287
16,13,35,262,208,470
26,13,35,454,338,792
1,13,35,21,13,34
20,13,35,286,260,546
13,13,35,190,169,359
21,13,35,433,273,706
27,13,35,396,351,747
8,21,55,241,168,409
22,38,50,121,836,957
23,38,50,35,874,909
23,42,54,264,966,1230
11,38,50,11,418,429
3,38,50,33,114,147
24,38,50,276,912,1188
26,38,50,260,988,1248
1,1252,2295,882,1252,2134
3,1252,2295,2991,3756,6747
3,1266,2320,3092,3798,6890
1,1266,2320,752,1266,2018
1,1252,2295,722,1252,1974
1,420,769,318,420,738
1,1252,2295,882,1252,2134
1,308,565,184,308,492
1,1252,2295,997,1252,2249
1,2171,3578,942,2171,3113
1,2171,3578,942,2171,3113
1,1519,2443,826,1519,2345
1,2171,3578,656,2171,2827
1,344,540,174,344,518
1,344,540,174,344,518
1,713,1120,228,713,941
1,344,540,174,344,518
1,713,1120,172,713,885
31,26,70,1321,806,2127
25,1,2,19,25,44
6,1,2,4,6,10
13,1,2,8,13,21
2,1,2,1,2,3
15,2,5,44,30,74
12,2,5,35,24,59
13,9,25,150,117,267
9,9,25,104,81,185
22,1,2,21,22,43
12,1,2,12,12,24
16,1,2,15,16,31
9,2,5,19,18,37
27,1,4,73,27,100
18,1,4,49,18,67
3,1,4,8,3,11
11,2,5,23,22,45
28,2,5,59,56,115
23,8,21,212,184,396
24,12,33,488,288,776
21,12,33,427,252,679
10,12,33,203,120,323
4,1,2,4,4,8
9,1,2,9,9,18
28,1,2,27,28,55
5,2,5,15,10,25
30,2,5,57,60,117
4,2,5,8,8,16
14,1,2,13,14,27
8,2,5,22,16,38
24,2,5,67,48,115
18,2,5,50,36,86
9,1,4,26,9,35
7,1,4,20,7,27
12,2,5,26,24,50
16,2,5,35,32,67
1,1482,2384,521,1482,2003
2,755,1215,896,1510,2406
1,1482,2384,807,1482,2289
2,461,742,532,922,1454
1,755,1215,193,755,948
1,1482,2384,592,1482,2074
6,45,120,436,270,706
4,59,159,317,236,553
19,4,10,110,76,186
25,2,5,70,50,120
21,2,5,59,42,101
15,2,5,44,30,74
16,2,5,46,32,78
25,2,5,73,50,123
6,2,5,18,12,30
1,2,5,2,2,4
25,2,5,59,50,109
6,3,9,34,18,52
15,3,9,85,45,130
9,7,9,15,63,78
28,7,9,23,196,219
5,3,8,24,15,39
25,3,8,83,75,158
5,3,8,20,15,35
22,3,8,85,66,151
14,3,8,68,42,110
1,3,8,5,3,8
29,8,22,380,232,612
30,8,22,301,240,541
5,8,22,68,40,108
1,8,22,11,8,19
6,8,22,79,48,127
20,8,22,223,160,383
25,8,22,279,200,479
7,8,22,64,56,120
18,9,24,175,162,337
16,9,24,159,144,303
6,13,35,86,78,164
14,13,35,298,182,480
23,13,35,401,299,700
20,13,35,412,260,672
16,13,35,346,208,554
10,13,35,206,130,336
21,13,35,447,273,720
5,13,35,79,65,144
23,13,35,490,299,789
23,13,35,474,299,773
21,13,35,366,273,639
16,13,35,341,208,549
1,13,35,22,13,35
18,13,35,371,234,605
25,13,35,366,325,691
21,13,35,300,273,573
15,13,35,309,195,504
24,13,35,511,312,823
19,13,35,272,247,519
19,13,35,332,247,579
18,21,55,404,378,782
10,21,55,241,210,451
6,21,55,161,126,287
27,38,50,297,1026,1323
22,42,54,252,924,1176
17,42,54,85,714,799
16,38,50,160,608,768
7,42,54,35,294,329
2,1266,2320,2015,2532,4547
2,420,769,636,840,1476
1,420,769,334,420,754
3,1252,2295,2854,3756,6610
1,1266,2320,636,1266,1902
1,487,783,280,487,767
2,344,540,370,688,1058
1,2171,3578,656,2171,2827
1,2171,3578,942,2171,3113
1,344,540,174,344,518
1,344,540,174,344,518
13,26,70,563,338,901
6,2,5,11,12,23
26,2,5,49,52,101
15,1,2,8,15,23
16,1,2,9,16,25
11,1,2,11,11,22
27,2,5,80,54,134
18,2,5,53,36,89
20,1,2,18,20,38
6,1,2,4,6,10
25,1,2,16,25,41
7,2,5,21,14,35
3,2,5,9,6,15
16,13,35,341,208,549
27,1,4,77,27,104
30,1,4,85,30,115
18,2,5,53,36,89
12,1,2,12,12,24
26,1,2,25,26,51
1,1,2,1,1,2
13,1,2,13,13,26
28,1,2,18,28,46
1,2,5,2,2,4
14,2,5,33,28,61
29,2,5,84,58,142
14,2,5,41,28,69
21,2,5,48,42,90
22,2,5,51,44,95
6,1,2,6,6,12
5,1,2,5,5,10
26,1,2,25,26,51
5,9,25,75,45,120
1,9,25,15,9,24
6,1,4,17,6,23
12,9,25,153,108,261
8,9,25,102,72,174
24,9,25,306,216,522
17,1,2,16,17,33
9,1,2,8,9,17
25,2,5,55,50,105
20,2,5,44,40,84
29,2,5,64,58,122
9,1,2,9,9,18
26,1,2,25,26,51
23,2,5,68,46,114
1,11,30,15,11,26
1,11,30,15,11,26
6,11,29,96,66,162
20,1,4,58,20,78
2,1,4,6,2,8
14,2,5,32,28,60
22,2,5,51,44,95
17,2,5,39,34,73
2,1,2,1,2,3
7,1,2,4,7,11
27,2,5,63,54,117
19,2,5,45,38,83
15,2,5,35,30,65
10,2,5,24,20,44
15,2,5,44,30,74
1,461,742,185,461,646
19,24,64,711,456,1167
26,24,64,674,624,1298
1,45,120,70,45,115
4,59,159,387,236,623
18,2,5,53,36,89
15,3,9,85,45,130
27,3,9,152,81,233
1,2,5,3,2,5
12,2,5,35,24,59
21,2,5,61,42,103
21,2,5,46,42,88
17,2,5,37,34,71
19,2,5,42,38,80
19,2,5,53,38,91
22,2,5,62,44,106
11,2,5,32,22,54
3,2,5,9,6,15
5,7,9,3,35,38
19,7,9,0,133,133
20,7,9,38,140,178
15,7,9,8,105,113
22,3,8,108,66,174
20,3,8,66,60,126
11,3,8,44,33,77
5,8,22,68,40,108
6,8,22,66,48,114
6,8,22,55,48,103
23,8,22,317,184,501
26,8,22,341,208,549
7,8,22,96,56,152
20,9,24,295,180,475
27,9,24,314,243,557
27,9,24,379,243,622
1,9,24,14,9,23
15,13,35,325,195,520
2,13,35,43,26,69
27,13,35,556,351,907
28,13,35,606,364,970
16,13,35,262,208,470
21,13,35,455,273,728
1,13,35,17,13,30
15,13,35,236,195,431
1,13,35,15,13,28
10,13,35,206,130,336
5,13,35,108,65,173
16,13,35,341,208,549
23,13,35,498,299,797
9,13,35,192,117,309
7,13,35,110,91,201
23,13,35,361,299,660
21,13,35,344,273,617
15,21,55,494,315,809
26,42,54,256,1092,1348
19,38,50,19,722,741
11,38,50,44,418,462
29,42,54,129,1218,1347
22,42,54,110,924,1034
15,42,54,10,630,640
26,42,54,87,1092,1179
10,38,50,85,380,465
1,1266,2320,752,1266,2018
3,1252,2295,2165,3756,5921
1,1266,2320,729,1266,1995
1,420,769,318,420,738
1,308,565,234,308,542
1,344,540,191,344,535
1,2171,3578,942,2171,3113
1,2171,3578,1264,2171,3435
3,1555,2443,2591,4665,7256
1,1555,2443,570,1555,2125
1,2171,3578,656,2171,2827
1,2171,3578,656,2171,2827
1,713,1120,385,713,1098
1,713,1120,385,713,1098
1,1555,2443,448,1555,2003
1,344,540,185,344,529
1,344,540,99,344,443
3,1083,1701,1038,3249,4287
16,26,70,682,416,1098
4,26,70,170,104,274
15,26,70,429,390,819
12,3,9,51,36,87
10,3,9,58,30,88
26,3,9,119,78,197
24,3,9,140,72,212
16,1,2,15,16,31
17,1,2,17,17,34
25,1,2,25,25,50
18,1,2,11,18,29
11,1,2,8,11,19
14,2,5,39,28,67
9,2,5,25,18,43
20,2,5,56,40,96
18,11,30,337,198,535
24,2,5,53,48,101
22,2,5,48,44,92
25,2,5,58,50,108
6,2,5,14,12,26
5,1,4,12,5,17
1,1,4,2,1,3
10,2,5,29,20,49
17,2,5,37,34,71
7,9,25,75,63,138
31,9,25,333,279,612
12,1,2,12,12,24
24,1,2,23,24,47
7,1,2,4,7,11
9,1,2,6,9,15
22,2,5,48,44,92
28,2,5,62,56,118
10,2,5,30,20,50
9,2,5,27,18,45
27,11,30,408,297,705
19,11,30,287,209,496
30,1,4,68,30,98
24,1,4,55,24,79
17,1,2,16,17,33
21,1,2,19,21,40
12,1,4,29,12,41
4,1,4,9,4,13
8,1,4,18,8,26
11,8,21,138,88,226
1,1,2,1,1,2
14,1,2,10,14,24
7,1,2,5,7,12
3,1482,2384,2420,4446,6866
1,1482,2384,521,1482,2003
4,59,159,311,236,547
19,2,5,36,38,74
1,2,5,2,2,4
25,2,5,73,50,123
14,2,5,29,28,57
8,2,5,17,16,33
23,2,5,54,46,100
24,2,5,56,48,104
4,2,5,11,8,19
9,2,5,25,18,43
9,2,5,17,18,35
15,2,5,44,30,74
23,2,5,67,46,113
1,2,5,3,2,5
3,4,10,11,12,23
4,4,10,15,16,31
7,2,5,16,14,30
19,2,5,53,38,91
4,2,5,11,8,19
12,2,5,34,24,58
18,2,5,50,36,86
17,2,5,50,34,84
23,4,10,97,92,189
17,4,10,71,68,139
10,2,5,22,20,42
17,2,5,37,34,71
9,7,9,0,63,63
6,7,9,1,42,43
11,7,9,21,77,98
5,3,8,17,15,32
9,3,8,32,27,59
15,3,8,74,45,119
19,3,8,75,57,132
23,8,22,226,184,410
1,8,22,9,8,17
13,8,22,176,104,280
8,8,22,100,64,164
1,8,22,9,8,17
11,8,22,101,88,189
27,8,22,366,216,582
25,8,22,345,200,545
31,9,24,458,279,737
18,9,24,192,162,354
24,9,24,337,216,553
20,9,24,238,180,418
23,9,24,246,207,453
17,9,24,190,153,343
22,9,24,246,198,444
2,9,24,22,18,40
3,13,35,43,39,82
8,13,35,170,104,274
27,13,35,471,351,822
28,13,35,430,364,794
15,13,35,215,195,410
14,13,35,244,182,426
6,13,35,98,78,176
5,13,35,107,65,172
20,13,35,426,260,686
22,13,35,476,286,762
2,13,35,29,26,55
18,13,35,390,234,624
10,13,35,143,130,273
16,13,35,229,208,437
21,13,35,433,273,706
1,13,35,14,13,27
26,13,35,563,338,901
22,13,35,322,286,608
10,13,35,154,130,284
1,13,35,21,13,34
18,13,35,390,234,624
16,13,35,330,208,538
26,13,35,563,338,901
30,13,35,545,390,935
18,13,35,295,234,529
13,21,55,428,273,701
13,21,55,435,273,708
25,21,55,630,525,1155
16,42,54,28,672,700
20,42,54,218,840,1058
6,42,54,66,252,318
5,38,50,55,190,245
24,38,50,240,912,1152
22,38,50,22,836,858
19,38,50,29,722,751
30,42,54,68,1260,1328
1,1898,3375,768,1898,2666
2,1252,2295,1214,2504,3718
2,1266,2320,1134,2532,3666
1,1252,2295,951,1252,2203
3,1266,2320,2675,3798,6473
1,1266,2320,636,1266,1902
1,1252,2295,561,1252,1813
1,1252,2295,951,1252,2203
1,1266,2320,1008,1266,2274
1,1555,2443,351,1555,1906
2,713,1120,321,1426,1747
3,487,783,841,1461,2302
1,487,783,280,487,767
1,2171,3578,942,2171,3113
2,713,1120,769,1426,2195
3,1083,1701,1191,3249,4440
1,487,783,171,487,658
28,26,70,1212,728,1940
13,26,70,426,338,764
7,26,70,205,182,387
6,26,70,256,156,412
15,3,9,81,45,126
16,1,2,9,16,25
13,1,2,7,13,20
1,13,35,14,13,27
15,13,35,215,195,410
30,1,2,19,30,49
1,2,5,2,2,4
21,2,5,49,42,91
8,1,2,7,8,15
21,8,21,180,168,348
15,8,21,129,120,249
27,8,21,232,216,448
10,13,35,217,130,347
9,1,2,9,9,18
28,1,2,27,28,55
21,2,5,56,42,98
18,2,5,48,36,84
4,1,4,11,4,15
1,1,4,3,1,4
3,1,4,7,3,10
5,2,5,11,10,21
12,2,5,25,24,49
15,1,2,15,15,30
11,1,2,11,11,22
10,2,5,30,20,50
9,2,5,27,18,45
7,2,5,21,14,35
1,1,2,1,1,2
1,1,2,1,1,2
23,1,4,68,23,91
26,8,21,223,208,431
10,8,21,86,80,166
15,1,2,9,15,24
18,1,2,10,18,28
3,1,2,2,3,5
28,1,2,17,28,45
32,11,30,570,352,922
18,11,30,320,198,518
19,1,2,14,19,33
19,1,2,14,19,33
1,1,2,1,1,2
16,1,2,15,16,31
24,1,2,13,24,37
16,1,2,10,16,26
24,1,2,15,24,39
4,1,2,3,4,7
22,1,2,16,22,38
15,1,2,11,15,26
17,1,2,12,17,29
25,2,5,59,50,109
27,2,5,63,54,117
1,1,2,1,1,2
25,1,2,19,25,44
1,1482,2384,473,1482,1955
1,1482,2384,378,1482,1860
3,1482,2384,1133,4446,5579
3,461,742,353,1383,1736
2,1482,2384,1041,2964,4005
12,24,64,380,288,668
2,45,120,112,90,202
9,45,120,653,405,1058
9,59,159,871,531,1402
10,3,9,56,30,86
1,3,9,6,3,9
20,2,5,58,40,98
30,2,5,87,60,147
1,2,5,3,2,5
18,2,5,48,36,84
31,2,5,82,62,144
19,2,5,56,38,94
11,4,10,51,44,95
22,4,10,101,88,189
16,4,10,83,64,147
8,4,10,42,32,74
1,2,5,3,2,5
17,2,5,40,34,74
12,2,5,28,24,52
24,2,5,43,48,91
2,2,5,6,4,10
21,2,5,61,42,103
28,2,5,81,56,137
4,2,5,11,8,19
9,2,5,24,18,42
7,3,9,34,21,55
24,3,9,116,72,188
26,4,10,153,104,257
20,3,9,97,60,157
14,3,9,68,42,110
19,7,9,7,133,140
29,7,9,-5,203,198
2,7,9,1,14,15
27,7,9,44,189,233
28,7,9,23,196,219
8,7,9,15,56,71
15,7,9,25,105,130
1,7,9,0,7,7
20,7,9,33,140,173
8,3,8,28,24,52
27,3,8,131,81,212
24,3,8,118,72,190
25,8,22,273,200,473
26,8,22,353,208,561
27,8,22,372,216,588
30,8,22,407,240,647
12,8,22,131,96,227
9,8,22,122,72,194
9,8,22,82,72,154
13,8,22,171,104,275
8,8,22,84,64,148
16,9,24,232,144,376
28,13,35,489,364,853
22,13,35,430,286,716
29,13,35,618,377,995
9,13,35,129,117,246
26,13,35,372,338,710
20,13,35,286,260,546
3,13,35,43,39,82
29,13,35,597,377,974
18,13,35,371,234,605
20,13,35,349,260,609
25,13,35,393,325,718
3,13,35,52,39,91
20,13,35,433,260,693
20,13,35,272,260,532
4,13,35,82,52,134
6,13,35,86,78,164
20,13,35,314,260,574
24,21,55,790,504,1294
1,21,55,32,21,53
15,21,55,403,315,718
12,21,55,401,252,653
1,42,54,0,42,42
2,38,50,17,76,93
2,42,54,15,84,99
18,42,54,41,756,797
24,38,50,264,912,1176
1,42,54,2,42,44
24,42,54,236,1008,1244
21,38,50,116,798,914
21,38,50,116,798,914
2,1266,2320,2015,2532,4547
2,1252,2295,1994,2504,4498
1,1252,2295,722,1252,1974
3,420,769,1001,1260,2261
1,295,540,223,295,518
1,295,540,234,295,529
1,308,565,184,308,492
1,1252,2295,997,1252,2249
1,1266,2320,636,1266,1902
1,1555,2443,717,1555,2272
1,713,1120,385,713,1098
2,713,1120,769,1426,2195
1,2171,3578,1121,2171,3292
1,1555,2443,790,1555,2345
1,1083,1701,244,1083,1327
3,1083,1701,1752,3249,5001
1,713,1120,340,713,1053
1,344,540,174,344,518
1,713,1120,261,713,974
14,3,9,81,42,123
10,3,9,44,30,74
26,3,9,151,78,229
4,1,4,12,4,16
13,8,21,109,104,213
7,8,21,59,56,115
24,2,5,71,48,119
2,2,5,6,4,10
11,2,5,32,22,54
28,2,5,83,56,139
10,2,5,19,20,39
3,11,30,38,33,71
1,2,5,2,2,4
8,2,5,15,16,31
16,11,30,242,176,418
30,1,2,20,30,50
13,1,2,9,13,22
2,1,2,1,2,3
3,1,2,2,3,5
13,1,2,10,13,23
19,1,2,17,19,36
23,1,2,21,23,44
3,2,5,9,6,15
18,2,5,52,36,88
2,2,5,6,4,10
1,1,2,1,1,2
12,1,2,7,12,19
7,1,2,4,7,11
5,2,5,12,10,22
17,2,5,40,34,74
3,12,33,61,36,97
6,1,4,14,6,20
10,1,4,24,10,34
15,12,33,305,180,485
5,12,33,102,60,162
9,12,33,183,108,291
12,9,25,126,108,234
13,1,2,12,13,25
21,1,2,20,21,41
1,1482,2384,592,1482,2074
1,1482,2384,807,1482,2289
1,1482,2384,592,1482,2074
2,1482,2384,1041,2964,4005
16,24,64,415,384,799
1,4,10,4,4,8
1,4,10,4,4,8
15,2,5,44,30,74
16,2,5,34,32,66
24,2,5,50,48,98
29,2,5,77,58,135
23,2,5,44,46,90
12,2,5,23,24,47
21,2,5,46,42,88
17,2,5,37,34,71
7,2,5,15,14,29
15,7,9,27,105,132
22,8,22,298,176,474
9,8,22,122,72,194
24,8,22,331,192,523
13,8,22,122,104,226
14,8,22,156,112,268
3,9,24,44,27,71
18,9,24,192,162,354
12,9,24,134,108,242
15,9,24,149,135,284
28,9,24,312,252,564
6,13,35,130,78,208
18,13,35,383,234,617
6,13,35,130,78,208
23,13,35,498,299,797
31,13,35,454,403,857
13,13,35,277,169,446
10,13,35,206,130,336
17,13,35,297,221,518
5,13,35,73,65,138
23,13,35,498,299,797
15,13,35,236,195,431
12,21,55,263,252,515
21,42,54,71,882,953
8,42,54,79,336,415
1,1252,2295,951,1252,2203
1,1252,2295,538,1252,1790
1,1083,1701,550,1083,1633
1,713,1120,385,713,1098
1,1083,1701,312,1083,1395
2,344,540,165,688,853
1,26,70,41,26,67
26,26,70,1108,676,1784
30,26,70,858,780,1638
6,26,70,172,156,328
1,26,70,43,26,69
4,26,70,170,104,274
15,3,9,87,45,132
7,3,9,28,21,49
8,2,5,18,16,34
4,2,5,9,8,17
30,1,2,29,30,59
15,1,2,14,15,29
3,1,2,2,3,5
17,1,2,11,17,28
22,2,5,65,44,109
5,2,5,15,10,25
16,2,5,47,32,79
22,2,5,65,44,109
7,1,2,4,7,11
16,1,2,9,16,25
19,1,2,11,19,30
9,1,2,9,9,18
13,9,25,205,117,322
29,9,25,457,261,718
19,13,35,272,247,519
32,13,35,458,416,874
10,2,5,30,20,50
6,2,5,13,12,25
24,1,2,24,24,48
1,1,2,1,1,2
12,1,2,11,12,23
1,2,5,2,2,4
28,2,5,66,56,122
13,2,5,38,26,64
22,2,5,64,44,108
22,2,5,65,44,109
1,2,5,3,2,5
30,2,5,89,60,149
26,1,4,59,26,85
27,1,4,62,27,89
26,1,2,25,26,51
17,11,30,211,187,398
3,12,33,41,36,77
22,12,33,302,264,566
6,1,4,18,6,24
30,1,4,89,30,119
19,1,4,56,19,75
14,11,29,179,154,333
28,11,29,358,308,666
14,11,29,179,154,333
25,1,2,16,25,41
14,1,2,10,14,24
9,9,25,104,81,185
1,9,25,12,9,21
16,9,25,184,144,328
25,1,4,61,25,86
22,11,29,281,242,523
12,11,29,153,132,285
2,461,742,295,922,1217
1,461,742,274,461,735
2,1482,2384,946,2964,3910
12,24,64,465,288,753
9,45,120,653,405,1058
9,45,120,653,405,1058
6,45,120,421,270,691
3,59,159,238,177,415
8,2,5,23,16,39
10,2,5,30,20,50
8,2,5,24,16,40
3,4,10,18,12,30
16,4,10,94,64,158
20,2,5,56,40,96
8,2,5,15,16,31
1,2,5,2,2,4
22,2,5,62,44,106
24,2,5,53,48,101
6,2,5,13,12,25
30,4,10,132,120,252
17,4,10,75,68,143
13,7,9,21,91,112
8,7,9,13,56,69
12,7,9,22,84,106
8,7,9,15,56,71
25,7,9,34,175,209
20,7,9,11,140,151
23,3,8,102,69,171
14,3,8,68,42,110
26,8,22,290,208,498
22,8,22,298,176,474
25,8,22,339,200,539
8,8,22,105,64,169
15,8,22,207,120,327
29,8,22,304,232,536
22,13,35,453,286,739
30,13,35,650,390,1040
15,13,35,220,195,415
23,13,35,329,299,628
4,13,35,87,52,139
10,13,35,213,130,343
26,13,35,381,338,719
10,13,35,206,130,336
15,13,35,320,195,515
17,13,35,362,221,583
21,13,35,366,273,639
29,13,35,618,377,995
11,13,35,161,143,304
23,21,55,757,483,1240
3,38,50,30,114,144
25,38,50,250,950,1200
27,38,50,297,1026,1323
1,38,50,9,38,47
6,42,54,66,252,318
2,1266,2320,2015,2532,4547
1,1252,2295,1020,1252,2272
1,420,769,334,420,754
1,1252,2295,745,1252,1997
3,1266,2320,2048,3798,5846
1,308,565,234,308,542
3,295,540,379,885,1264
1,2171,3578,1335,2171,3506
1,1555,2443,839,1555,2394
1,2171,3578,656,2171,2827
3,2171,3578,2504,6513,9017
1,344,540,99,344,443
1,344,540,185,344,529
1,1083,1701,261,1083,1344
1,344,540,110,344,454
5,26,70,213,130,343
22,3,9,100,66,166
20,2,5,53,40,93
9,2,5,24,18,42
4,13,35,85,52,137
14,13,35,298,182,480
26,13,35,554,338,892
3,13,35,64,39,103
4,13,35,85,52,137
2,1,2,2,2,4
16,1,2,15,16,31
23,1,2,22,23,45
15,1,2,14,15,29
2,1,2,2,2,4
24,13,35,511,312,823
28,13,35,596,364,960
5,11,30,94,55,149
26,2,5,61,52,113
24,1,2,24,24,48
13,2,5,36,26,62
16,2,5,45,32,77
14,2,5,39,28,67
24,2,5,67,48,115
7,1,4,17,7,24
2,1,2,1,2,3
19,1,2,14,19,33
3,2,5,7,6,13
1,2,5,2,2,4
27,1,4,80,27,107
18,1,4,53,18,71
16,1,2,9,16,25
1,1,2,1,1,2
25,1,2,22,25,47
7,1,2,6,7,13
10,2,5,30,20,50
26,2,5,75,52,127
12,2,5,35,24,59
25,8,21,231,200,431
24,8,21,221,192,413
24,1,2,13,24,37
15,1,2,8,15,23
19,1,4,55,19,74
19,1,4,55,19,74
20,1,4,54,20,74
18,1,4,49,18,67
1,9,25,12,9,21
5,1,2,5,5,10
22,1,2,21,22,43
31,1,4,88,31,119
14,1,4,40,14,54
24,1,4,68,24,92
9,2,5,26,18,44
16,2,5,46,32,78
25,8,21,304,200,504
1,1482,2384,854,1482,2336
1,1482,2384,401,1482,1883
25,24,64,984,600,1584
14,24,64,399,336,735
18,24,64,536,432,968
25,24,64,968,600,1568
10,45,120,534,450,984
3,59,159,290,177,467
15,4,10,71,60,131
3,4,10,14,12,26
11,3,9,62,33,95
1,2,5,3,2,5
5,2,5,14,10,24
3,2,5,9,6,15
29,2,5,81,58,139
20,4,10,94,80,174
5,4,10,24,20,44
6,2,5,17,12,29
18,2,5,52,36,88
13,2,5,31,26,57
9,2,5,21,18,39
7,2,5,16,14,30
11,2,5,25,22,47
16,2,5,42,32,74
19,2,5,50,38,88
24,2,5,53,48,101
18,4,10,68,72,140
1,4,10,4,4,8
23,7,9,42,161,203
21,7,9,8,147,155
20,7,9,33,140,173
25,7,9,41,175,216
28,7,9,1,196,197
12,7,9,22,84,106
12,3,8,56,36,92
18,3,8,60,54,114
6,8,22,55,48,103
20,8,22,271,160,431
10,8,22,136,80,216
24,8,22,325,192,517
17,8,22,156,136,292
20,8,22,262,160,422
1,8,22,12,8,20
11,9,24,117,99,216
30,9,24,436,270,706
6,9,24,71,54,125
22,9,24,309,198,507
11,9,24,123,99,222
21,13,35,411,273,684
7,13,35,122,91,213
2,13,35,43,26,69
9,13,35,185,117,302
26,13,35,536,338,874
14,13,35,298,182,480
13,13,35,204,169,373
21,13,35,300,273,573
11,13,35,192,143,335
16,13,35,341,208,549
20,13,35,328,260,588
28,13,35,596,364,960
13,13,35,190,169,359
1,13,35,15,13,28
4,13,35,85,52,137
23,13,35,490,299,789
26,13,35,372,338,710
12,13,35,247,156,403
28,13,35,596,364,960
14,21,55,461,294,755
20,21,55,504,420,924
10,42,54,109,420,529
6,38,50,6,228,234
27,38,50,297,1026,1323
1,38,50,9,38,47
7,38,50,39,266,305
8,38,50,88,304,392
11,42,54,1,462,463
28,38,50,308,1064,1372
7,38,50,77,266,343
16,38,50,176,608,784
1,1912,3400,1046,1912,2958
1,1252,2295,745,1252,1997
1,1266,2320,1008,1266,2274
2,1252,2295,1765,2504,4269
1,1252,2295,951,1252,2203
1,1252,2295,997,1252,2249
1,1252,2295,538,1252,1790
1,420,769,334,420,754
1,1252,2295,676,1252,1928
2,1252,2295,1076,2504,3580
1,1266,2320,1008,1266,2274
1,2171,3578,763,2171,2934
1,487,783,124,487,611
1,2171,3578,942,2171,3113
2,1083,1701,1168,2166,3334
1,2171,3578,763,2171,2934
1,344,540,77,344,421
1,344,540,110,344,454
2,344,540,349,688,1037
9,26,70,257,234,491
19,26,70,809,494,1303
12,26,70,511,312,823
24,26,70,1039,624,1663
2,3,9,12,6,18
7,3,9,32,21,53
1,1,2,1,1,2
17,1,2,17,17,34
21,1,2,21,21,42
15,1,4,43,15,58
15,1,2,10,15,25
12,11,29,213,132,345
22,11,29,390,242,632
10,1,4,22,10,32
3,2,5,8,6,14
27,1,2,16,27,43
6,1,2,6,6,12
28,1,2,27,28,55
9,11,30,122,99,221
11,11,30,150,121,271
23,1,2,22,23,45
12,1,2,12,12,24
18,1,2,13,18,31
4,1,2,4,4,8
21,1,2,19,21,40
31,1,2,18,31,49
14,1,4,41,14,55
20,1,4,47,20,67
6,1,4,14,6,20
27,1,4,64,27,91
22,8,21,203,176,379
2,8,21,18,16,34
9,1,2,8,9,17
27,13,35,396,351,747
25,1,4,53,25,78
17,1,4,36,17,53
29,1,2,20,29,49
7,1,2,5,7,12
29,1,4,85,29,114
26,1,4,76,26,102
7,2,5,20,14,34
8,2,5,23,16,39
5,2,5,15,10,25
26,2,5,75,52,127
18,2,5,35,36,71
9,2,5,18,18,36
9,11,30,114,99,213
24,11,30,305,264,569
27,1,2,15,27,42
10,1,2,6,10,16
25,1,2,24,25,49
29,1,2,28,29,57
7,8,21,60,56,116
29,8,21,249,232,481
16,1,2,15,16,31
1,1,2,1,1,2
9,1,2,6,9,15
10,1,2,9,10,19
11,1,2,9,11,20
16,9,25,168,144,312
16,9,25,168,144,312
7,1,4,17,7,24
19,1,4,47,19,66
3,755,1215,1234,2265,3499
1,1482,2384,807,1482,2289
3,461,742,376,1383,1759
1,1482,2384,592,1482,2074
1,45,120,50,45,95
4,45,120,238,180,418
7,59,159,555,413,968
25,3,9,103,75,178
16,3,9,66,48,114
2,2,5,4,4,8
28,2,5,55,56,111
16,2,5,31,32,63
27,4,10,151,108,259
15,4,10,84,60,144
10,2,5,24,20,44
7,2,5,20,14,34
20,2,5,56,40,96
24,2,5,67,48,115
22,2,5,52,44,96
18,2,5,42,36,78
10,7,9,18,70,88
15,7,9,27,105,132
1,7,9,1,7,8
22,7,9,42,154,196
1,7,9,1,7,8
16,3,8,75,48,123
1,8,22,9,8,17
11,8,22,149,88,237
10,8,22,125,80,205
23,8,22,312,184,496
9,8,22,124,72,196
26,8,22,290,208,498
20,9,24,238,180,418
10,9,24,100,90,190
7,9,24,70,63,133
8,9,24,116,72,188
18,9,24,253,162,415
21,9,24,305,189,494
4,13,35,82,52,134
30,13,35,650,390,1040
26,13,35,426,338,764
20,13,35,426,260,686
6,13,35,105,78,183
19,13,35,278,247,525
24,13,35,469,312,781
14,13,35,298,182,480
28,13,35,596,364,960
20,13,35,349,260,609
22,21,55,494,462,956
22,21,55,700,462,1162
13,38,50,150,494,644
20,38,50,220,760,980
4,38,50,34,152,186
1,42,54,11,42,53
3,38,50,35,114,149
19,42,54,95,798,893
1,1898,3375,768,1898,2666
1,1252,2295,882,1252,2134
1,420,769,249,420,669
3,1252,2295,2234,3756,5990
2,295,540,468,590,1058
1,1266,2320,1008,1266,2274
1,713,1120,362,713,1075
1,1083,1701,601,1083,1684
1,344,540,77,344,421
1,1083,1701,397,1083,1480
1,344,540,174,344,518
1,713,1120,261,713,974
1,487,783,132,487,619
19,26,70,823,494,1317
19,26,70,823,494,1317
21,3,9,113,63,176
26,3,9,105,78,183
18,3,9,72,54,126
9,1,2,9,9,18
13,1,2,12,13,25
24,1,2,23,24,47
3,1,2,3,3,6
17,1,2,16,17,33
6,1,2,6,6,12
30,1,2,29,30,59
9,1,2,9,9,18
6,13,35,124,78,202
24,13,35,494,312,806
10,13,35,206,130,336
1,2,5,2,2,4
16,2,5,31,32,63
31,13,35,660,403,1063
19,13,35,405,247,652
23,1,2,13,23,36
11,1,2,8,11,19
24,1,2,18,24,42
3,1,4,7,3,10
5,1,2,4,5,9
18,1,4,53,18,71
14,2,5,27,28,55
18,2,5,34,36,70
3,1,4,9,3,12
5,1,4,14,5,19
6,1,2,3,6,9
5,1,2,3,5,8
16,2,5,46,32,78
12,2,5,35,24,59
1,1482,2384,401,1482,1883
2,1482,2384,1470,2964,4434
1,1482,2384,854,1482,2336
3,461,742,554,1383,1937
25,24,64,968,600,1568
10,3,9,44,30,74
21,3,9,92,63,155
15,3,9,85,45,130
26,3,9,147,78,225
15,3,9,89,45,134
10,2,5,28,20,48
7,2,5,20,14,34
11,2,5,21,22,43
19,2,5,37,38,75
19,2,5,45,38,83
32,2,5,75,64,139
1,7,9,0,7,7
18,7,9,30,126,156
28,7,9,51,196,247
14,7,9,5,98,103
26,7,9,50,182,232
12,3,8,43,36,79
21,8,22,285,168,453
16,8,22,217,128,345
13,8,22,171,104,275
8,8,22,73,64,137
13,8,22,179,104,283
5,9,24,74,45,119
1,9,24,12,9,21
29,13,35,618,377,995
27,13,35,471,351,822
14,13,35,288,182,470
21,13,35,455,273,728
4,13,35,63,52,115
17,13,35,297,221,518
21,13,35,447,273,720
16,13,35,262,208,470
28,13,35,606,364,970
8,13,35,165,104,269
28,13,35,577,364,941
10,42,54,44,420,464
23,38,50,253,874,1127
22,38,50,220,836,1056
4,42,54,20,168,188
14,42,54,153,588,741
2,42,54,0,84,84
25,38,50,100,950,1050
14,42,54,70,588,658
18,42,54,60,756,816
28,42,54,276,1176,1452
3,1252,2295,1614,3756,5370
2,1266,2320,2015,2532,4547
1,1266,2320,961,1266,2227
1,2171,3578,1264,2171,3435
1,2171,3578,763,2171,2934
2,1555,2443,1141,3110,4251
1,1083,1701,244,1083,1327
3,2171,3578,2504,6513,9017
2,2171,3578,1884,4342,6226
1,2171,3578,835,2171,3006
1,344,540,185,344,529
1,1555,2443,570,1555,2125
2,1083,1701,692,2166,2858
2,487,783,263,974,1237
1,2171,3578,620,2171,2791
2,2171,3578,2671,4342,7013
28,26,70,977,728,1705
25,26,70,1083,650,1733
29,26,70,992,754,1746
1,26,70,34,26,60
7,26,70,230,182,412
18,26,70,565,468,1033
18,3,9,87,54,141
11,3,9,52,33,85
13,3,9,52,39,91
27,13,35,575,351,926
28,13,35,596,364,960
3,13,35,51,39,90
20,13,35,342,260,602
4,1,2,4,4,8
16,1,2,15,16,31
11,2,5,31,22,53
15,2,5,42,30,72
17,1,2,13,17,30
6,1,2,4,6,10
29,1,2,21,29,50
15,1,2,14,15,29
23,2,5,67,46,113
18,2,5,52,36,88
2,2,5,6,4,10
13,1,2,9,13,22
1,2,5,3,2,5
14,2,5,41,28,69
29,11,30,438,319,757
5,11,30,76,55,131
29,1,4,68,29,97
7,1,4,17,7,24
5,1,4,11,5,16
12,1,4,27,12,39
15,13,35,220,195,415
22,13,35,322,286,608
7,13,35,103,91,194
23,2,5,68,46,114
22,2,5,65,44,109
19,1,2,12,19,31
32,2,5,74,64,138
22,2,5,42,44,86
13,2,5,36,26,62
31,9,25,465,279,744
8,9,25,120,72,192
19,1,4,43,19,62
26,2,5,51,52,103
3,2,5,6,6,12
12,2,5,35,24,59
15,2,5,44,30,74
23,2,5,64,46,110
24,2,5,46,48,94
24,9,25,372,216,588
21,9,25,326,189,515
1,755,1215,411,755,1166
1,461,742,251,461,712
1,461,742,118,461,579
1,461,742,147,461,608
23,24,64,861,552,1413
12,24,64,357,288,645
3,59,159,195,177,372
13,3,9,63,39,102
21,3,9,84,63,147
1,2,5,3,2,5
20,2,5,58,40,98
15,2,5,29,30,59
11,2,5,21,22,43
6,2,5,14,12,26
13,2,5,38,26,64
24,2,5,71,48,119
6,3,9,35,18,53
15,2,5,42,30,72
19,2,5,55,38,93
10,2,5,29,20,49
23,7,9,38,161,199
7,7,9,11,49,60
2,7,9,3,14,17
14,7,9,23,98,121
8,7,9,7,56,63
22,7,9,30,154,184
26,3,8,84,78,162
14,3,8,46,42,88
20,3,8,79,60,139
3,8,22,33,24,57
6,8,22,55,48,103
1,8,22,14,8,22
7,8,22,76,56,132
11,8,22,137,88,225
12,9,24,143,108,251
20,9,24,290,180,470
10,9,24,145,90,235
10,13,35,175,130,305
18,13,35,308,234,542
12,13,35,188,156,344
10,13,35,213,130,343
1,13,35,21,13,34
16,13,35,313,208,521
2,13,35,29,26,55
24,21,55,803,504,1307
11,21,55,247,231,478
17,21,55,475,357,832
21,42,54,241,882,1123
17,38,50,187,646,833
27,38,50,230,1026,1256
1,1898,3375,768,1898,2666
1,1898,3375,1038,1898,2936
1,1266,2320,567,1266,1833
1,1266,2320,729,1266,1995
1,1898,3375,735,1898,2633
2,1252,2295,1076,2504,3580
1,487,783,280,487,767
1,1555,2443,790,1555,2345
1,713,1120,250,713,963
1,2171,3578,942,2171,3113
2,2171,3578,1669,4342,6011
1,1083,1701,499,1083,1582
3,344,540,248,1032,1280
1,2171,3578,1335,2171,3506
1,26,70,33,26,59
24,26,70,1039,624,1663
21,26,70,689,546,1235
15,26,70,618,390,1008
3,3,9,16,9,25
6,3,9,27,18,45
18,1,2,17,18,35
17,1,2,16,17,33
22,13,35,469,286,755
18,13,35,383,234,617
1,1,2,1,1,2
3,1,2,3,3,6
31,1,2,30,31,61
23,1,2,22,23,45
19,1,2,18,19,37
27,2,5,78,54,132
1,1,2,1,1,2
21,1,2,21,21,42
3,1,2,2,3,5
1,1,2,1,1,2
11,1,2,7,11,18
18,2,5,35,36,71
16,2,5,46,32,78
2,2,5,4,4,8
13,2,5,27,26,53
3,2,5,6,6,12
14,2,5,27,28,55
6,1,2,4,6,10
29,1,2,20,29,49
26,1,2,18,26,44
9,9,25,104,81,185
18,9,25,207,162,369
4,2,5,8,8,16
25,2,5,59,50,109
6,1,2,6,6,12
1,1,2,1,1,2
17,12,33,234,204,438
21,12,33,289,252,541
11,12,33,224,132,356
28,12,33,570,336,906
12,1,2,7,12,19
21,1,2,12,21,33
3,1,2,2,3,5
22,1,2,12,22,34
19,1,2,16,19,35
26,1,2,22,26,48
9,1,2,7,9,16
13,1,2,10,13,23
5,8,21,51,40,91
12,8,21,123,96,219
9,2,5,26,18,44
9,2,5,26,18,44
26,11,29,302,286,588
1,11,29,12,11,23
23,11,29,267,253,520
1,2,5,2,2,4
1,1482,2384,807,1482,2289
1,461,742,274,461,735
5,24,64,149,120,269
8,59,159,775,472,1247
3,2,5,8,6,14
15,2,5,29,30,59
15,2,5,29,30,59
24,2,5,49,48,97
11,2,5,23,22,45
5,2,5,13,10,23
9,2,5,24,18,42
12,4,10,67,48,115
26,4,10,146,104,250
30,2,5,89,60,149
12,4,10,71,48,119
19,2,5,45,38,83
6,2,5,14,12,26
20,2,5,46,40,86
22,2,5,51,44,95
10,2,5,23,20,43
25,2,5,58,50,108
26,2,5,73,52,125
23,2,5,64,46,110
24,3,9,105,72,177
26,3,9,114,78,192
12,7,9,23,84,107
9,7,9,15,63,78
17,7,9,28,119,147
24,3,8,107,72,179
1,3,8,4,3,7
11,3,8,36,33,69
25,3,8,117,75,192
3,8,22,41,24,65
23,8,22,302,184,486
9,9,24,120,81,201
14,9,24,197,126,323
30,13,35,639,390,1029
16,13,35,262,208,470
1,13,35,17,13,30
23,13,35,450,299,749
30,13,35,618,390,1008
9,13,35,141,117,258
6,13,35,92,78,170
2,13,35,35,26,61
25,13,35,428,325,753
11,13,35,188,143,331
18,13,35,314,234,548
23,13,35,490,299,789
5,13,35,107,65,172
31,13,35,454,403,857
8,13,35,131,104,235
17,13,35,362,221,583
20,13,35,286,260,546
19,13,35,391,247,638
11,13,35,173,143,316
12,13,35,188,156,344
8,21,55,254,168,422
2,42,54,20,84,104
21,42,54,229,882,1111
1,38,50,10,38,48
21,42,54,105,882,987
21,42,54,105,882,987
12,38,50,132,456,588
17,38,50,51,646,697
1,38,50,11,38,49
1,1898,3375,1342,1898,3240
3,1266,2320,2257,3798,6055
1,1266,2320,567,1266,1833
3,1252,2295,1821,3756,5577
1,1266,2320,961,1266,2227
1,420,769,334,420,754
1,420,769,249,420,669
1,420,769,249,420,669
1,295,540,159,295,454
1,1555,2443,839,1555,2394
1,2171,3578,1157,2171,3328
1,2171,3578,835,2171,3006
2,487,783,529,974,1503
3,2171,3578,2826,6513,9339
1,2171,3578,835,2171,3006
2,2171,3578,2671,4342,7013
1,344,540,120,344,464
2,344,540,349,688,1037
1,487,783,194,487,681
3,713,1120,616,2139,2755
25,26,70,1083,650,1733
6,26,70,209,156,365
24,26,70,1022,624,1646
4,26,70,170,104,274
8,3,9,47,24,71
6,1,4,18,6,24
26,1,4,77,26,103
5,13,35,107,65,172
12,12,33,201,144,345
1,12,33,15,12,27
3,11,29,48,33,81
23,1,2,21,23,44
18,1,4,53,18,71
3,2,5,9,6,15
25,2,5,73,50,123
2,1,2,2,2,4
28,11,30,356,308,664
4,2,5,12,8,20
17,2,5,49,34,83
4,2,5,12,8,20
20,8,21,205,160,365
8,8,21,82,64,146
8,2,5,21,16,37
3,2,5,8,6,14
11,2,5,32,22,54
25,2,5,73,50,123
11,2,5,32,22,54
24,2,5,46,48,94
20,2,5,38,40,78
11,1,2,11,11,22
20,1,2,19,20,39
2,8,21,25,16,41
1,8,21,13,8,21
17,1,2,16,17,33
21,1,2,20,21,41
1,1482,2384,473,1482,1955
1,461,742,147,461,608
1,1482,2384,592,1482,2074
1,461,742,118,461,579
17,24,64,636,408,1044
25,4,10,145,100,245
12,4,10,70,48,118
23,4,10,133,92,225
10,2,5,29,20,49
7,2,5,20,14,34
5,2,5,15,10,25
13,2,5,38,26,64
20,2,5,42,40,82
8,2,5,17,16,33
25,2,5,66,50,116
30,2,5,80,60,140
4,2,5,11,8,19
8,2,5,22,16,38
5,2,5,15,10,25
23,7,9,9,161,170
28,7,9,38,196,234
20,7,9,36,140,176
19,7,9,31,133,164
15,7,9,27,105,132
1,7,9,2,7,9
25,7,9,10,175,185
3,7,9,6,21,27
19,3,8,92,57,149
23,8,22,216,184,400
1,8,22,14,8,22
23,8,22,211,184,395
8,8,22,110,64,174
21,8,22,289,168,457
3,8,22,33,24,57
23,13,35,474,299,773
22,13,35,453,286,739
2,13,35,31,26,57
10,13,35,147,130,277
14,13,35,274,182,456
27,13,35,575,351,926
3,13,35,52,39,91
30,13,35,650,390,1040
9,13,35,154,117,271
3,13,35,47,39,86
13,13,35,277,169,446
4,13,35,87,52,139
21,13,35,308,273,581
19,13,35,405,247,652
1,13,35,20,13,33
14,13,35,298,182,480
14,13,35,288,182,470
7,13,35,110,91,201
17,42,54,2,714,716
3,38,50,35,114,149
2,38,50,10,76,86
1,38,50,6,38,44
19,38,50,209,722,931
4,38,50,44,152,196
12,42,54,8,504,512
24,42,54,55,1008,1063
1,1898,3375,768,1898,2666
1,1252,2295,951,1252,2203
1,1252,2295,538,1252,1790
2,1252,2295,1765,2504,4269
3,295,540,379,885,1264
3,308,565,737,924,1661
3,487,783,465,1461,1926
1,713,1120,385,713,1098
1,487,783,155,487,642
1,1555,2443,570,1555,2125
1,1083,1701,499,1083,1582
3,487,783,583,1461,2044
1,1555,2443,864,1555,2419
1,713,1120,172,713,885
1,2171,3578,1335,2171,3506
7,26,70,288,182,470
12,26,70,520,312,832
24,3,9,116,72,188
29,3,9,169,87,256
6,3,9,32,18,50
11,1,2,11,11,22
14,1,2,13,14,27
15,1,2,14,15,29
26,13,35,536,338,874
21,2,5,44,42,86
14,13,35,303,182,485
28,13,35,547,364,911
16,13,35,313,208,521
7,12,33,131,84,215
9,2,5,26,18,44
11,2,5,25,22,47
5,1,2,5,5,10
3,1,2,3,3,6
5,1,2,3,5,8
7,9,25,110,63,173
20,1,4,59,20,79
8,1,2,7,8,15
25,1,2,25,25,50
31,1,2,30,31,61
5,1,2,3,5,8
23,1,2,22,23,45
27,1,2,16,27,43
20,1,2,14,20,34
12,1,2,9,12,21
4,1,2,3,4,7
20,13,35,293,260,553
15,13,35,220,195,415
15,13,35,220,195,415
22,11,29,281,242,523
19,11,29,243,209,452
6,2,5,17,12,29
20,2,5,56,40,96
25,2,5,70,50,120
3,2,5,9,6,15
17,2,5,49,34,83
23,2,5,54,46,100
13,2,5,31,26,57
24,2,5,56,48,104
17,1,4,42,17,59
13,1,4,32,13,45
1,1482,2384,592,1482,2074
1,1482,2384,807,1482,2289
2,1482,2384,1613,2964,4577
1,1482,2384,378,1482,1860
2,1482,2384,1709,2964,4673
3,1482,2384,1419,4446,5865
12,4,10,47,48,95
14,4,10,55,56,111
13,4,10,60,52,112
8,4,10,37,32,69
23,2,5,68,46,114
3,2,5,9,6,15
21,2,5,62,42,104
15,2,5,44,30,74
20,2,5,59,40,99
10,4,10,46,40,86
6,4,10,28,24,52
4,2,5,12,8,20
28,2,5,55,56,111
10,2,5,20,20,40
10,2,5,24,20,44
1,2,5,3,2,5
13,2,5,36,26,62
23,2,5,67,46,113
21,2,5,61,42,103
15,7,9,29,105,134
13,7,9,25,91,116
29,7,9,53,203,256
12,7,9,20,84,104
9,7,9,0,63,63
12,3,8,58,36,94
18,3,8,64,54,118
25,8,22,339,200,539
18,8,22,244,144,388
3,8,22,41,24,65
11,8,22,115,88,203
21,8,22,289,168,457
16,8,22,147,128,275
16,9,24,159,144,303
13,9,24,173,117,290
12,9,24,128,108,236
12,9,24,143,108,251
7,9,24,103,63,166
15,13,35,215,195,410
24,13,35,394,312,706
14,13,35,303,182,485
14,13,35,254,182,436
21,13,35,447,273,720
17,13,35,279,221,500
27,13,35,462,351,813
8,13,35,140,104,244
19,13,35,272,247,519
10,13,35,213,130,343
6,13,35,130,78,208
28,13,35,400,364,764
19,13,35,298,247,545
7,42,54,24,294,318
10,38,50,110,380,490
18,42,54,206,756,962
24,42,54,16,1008,1024
28,42,54,124,1176,1300
14,42,54,47,588,635
21,42,54,3,882,885
2,1266,2320,2015,2532,4547
1,295,540,234,295,529
1,1266,2320,1031,1266,2297
3,2171,3578,2826,6513,9339
1,1083,1701,584,1083,1667
1,2171,3578,656,2171,2827
2,2171,3578,1669,4342,6011
1,1519,2443,411,1519,1930
1,344,540,185,344,529
1,344,540,185,344,529
1,1519,2443,484,1519,2003
3,1555,2443,1125,4665,5790
1,1083,1701,550,1083,1633
1,487,783,171,487,658
1,344,540,174,344,518
28,26,70,1212,728,1940
4,26,70,117,104,221
13,2,5,25,26,51
25,2,5,48,50,98
10,8,21,126,80,206
29,8,21,365,232,597
14,9,25,221,126,347
22,1,2,22,22,44
29,1,2,28,29,57
28,1,2,16,28,44
13,2,5,31,26,57
16,2,5,38,32,70
22,1,4,60,22,82
5,1,4,15,5,20
2,2,5,6,4,10
8,9,25,114,72,186
7,2,5,13,14,27
15,2,5,29,30,59
4,2,5,8,8,16
24,1,2,24,24,48
6,2,5,14,12,26
15,2,5,35,30,65
12,9,25,138,108,246
6,1,4,18,6,24
30,1,4,89,30,119
3,1,2,2,3,5
12,1,2,8,12,20
13,1,2,8,13,21
30,1,2,29,30,59
21,1,2,20,21,41
30,1,2,29,30,59
30,1,2,29,30,59
26,1,2,25,26,51
20,2,5,59,40,99
8,1,4,23,8,31
26,1,4,76,26,102
12,1,4,35,12,47
28,1,4,82,28,110
10,1,2,6,10,16
23,11,29,294,253,547
1,461,742,199,461,660
1,1482,2384,378,1482,1860
3,1482,2384,2563,4446,7009
9,24,64,348,216,564
6,24,64,232,144,376
1,24,64,31,24,55
11,24,64,292,264,556
4,59,159,387,236,623
7,2,5,15,14,29
30,2,5,63,60,123
29,2,5,86,58,144
11,2,5,32,22,54
12,4,10,53,48,101
20,3,9,82,60,142
5,3,9,21,15,36
28,2,5,78,56,134
12,2,5,34,24,58
18,4,10,104,72,176
17,2,5,32,34,66
2,3,9,9,6,15
16,2,5,46,32,78
14,2,5,37,28,65
17,2,5,45,34,79
18,2,5,42,36,78
1,2,5,3,2,5
1,2,5,3,2,5
24,2,5,70,48,118
27,2,5,78,54,132
4,7,9,8,28,36
10,7,9,8,70,78
6,3,8,29,18,47
17,3,8,67,51,118
27,8,22,283,216,499
17,8,22,186,136,322
11,8,22,149,88,237
25,8,22,345,200,545
19,9,24,203,171,374
5,9,24,52,45,97
26,9,24,365,234,599
2,9,24,30,18,48
24,9,24,279,216,495
18,13,35,295,234,529
25,13,35,436,325,761
26,13,35,381,338,719
23,13,35,474,299,773
16,13,35,262,208,470
1,13,35,21,13,34
21,13,35,322,273,595
23,13,35,401,299,700
21,13,35,411,273,684
22,13,35,430,286,716
3,13,35,65,39,104
12,13,35,205,156,361
22,13,35,322,286,608
14,13,35,239,182,421
28,21,55,752,588,1340
16,42,54,11,672,683
10,42,54,23,420,443
11,38,50,28,418,446
28,38,50,280,1064,1344
10,42,54,44,420,464
1,1912,3400,774,1912,2686
1,1252,2295,1020,1252,2272
1,1266,2320,636,1266,1902
3,1266,2320,1700,3798,5498
3,1266,2320,2048,3798,5846
1,1252,2295,722,1252,1974
1,1252,2295,997,1252,2249
1,1252,2295,997,1252,2249
3,420,769,609,1260,1869
1,420,769,241,420,661
1,308,565,155,308,463
1,295,540,234,295,529
1,2171,3578,1157,2171,3328
1,1555,2443,717,1555,2272
1,1083,1701,550,1083,1633
26,26,70,816,676,1492
26,26,70,889,676,1565
5,26,70,171,130,301
21,26,70,895,546,1441
19,3,9,107,57,164
30,1,2,29,30,59
12,1,2,12,12,24
4,11,29,51,44,95
8,1,2,7,8,15
1,13,35,21,13,34
27,1,2,16,27,43
22,2,5,42,44,86
2,2,5,4,4,8
27,1,2,20,27,47
1,1,2,1,1,2
15,13,35,309,195,504
9,13,35,185,117,302
20,1,4,54,20,74
11,12,33,162,132,294
15,12,33,221,180,401
19,11,30,350,209,559
3,11,30,55,33,88
26,1,2,25,26,51
13,2,5,38,26,64
7,2,5,21,14,35
20,2,5,56,40,96
11,1,4,23,11,34
29,1,4,61,29,90
27,1,4,57,27,84
10,1,4,24,10,34
25,1,4,61,25,86
27,1,4,66,27,93
7,2,5,20,14,34
31,2,5,87,62,149
7,12,33,142,84,226
27,12,33,549,324,873
17,1,2,12,17,29
17,1,2,12,17,29
14,1,2,14,14,28
5,1,2,4,5,9
16,1,2,12,16,28
13,2,5,38,26,64
30,2,5,87,60,147
17,2,5,49,34,83
29,2,5,86,58,144
4,2,5,12,8,20
7,2,5,20,14,34
14,2,5,41,28,69
6,1,4,15,6,21
5,1,4,12,5,17
16,2,5,45,32,77
1,1482,2384,592,1482,2074
2,461,742,503,922,1425
1,1482,2384,592,1482,2074
1,1482,2384,807,1482,2289
2,1482,2384,1136,2964,4100
3,24,64,93,72,165
12,59,159,799,708,1507
20,2,5,59,40,99
13,2,5,38,26,64
25,2,5,48,50,98
11,2,5,21,22,43
18,2,5,52,36,88
3,2,5,6,6,12
6,2,5,13,12,25
16,2,5,46,32,78
18,2,5,52,36,88
5,2,5,15,10,25
22,2,5,64,44,108
11,3,9,50,33,83
9,3,9,41,27,68
21,2,5,41,42,83
29,2,5,57,58,115
6,4,10,23,24,47
20,4,10,76,80,156
5,2,5,15,10,25
5,2,5,15,10,25
5,2,5,12,10,22
15,2,5,35,30,65
3,3,9,12,9,21
13,3,9,52,39,91
9,3,9,48,27,75
14,3,9,75,42,117
9,4,10,53,36,89
29,2,5,68,58,126
14,2,5,33,28,61
14,7,9,27,98,125
4,7,9,0,28,28
9,7,9,0,63,63
25,7,9,46,175,221
7,7,9,0,49,49
28,7,9,16,196,212
14,7,9,27,98,125
24,7,9,20,168,188
5,7,9,10,35,45
5,3,8,25,15,40
23,3,8,111,69,180
20,3,8,97,60,157
7,3,8,34,21,55
13,3,8,43,39,82
15,8,22,137,120,257
20,8,22,271,160,431
24,8,22,262,192,454
32,8,22,434,256,690
17,8,22,231,136,367
15,8,22,207,120,327
28,8,22,386,224,610
3,9,24,44,27,71
7,9,24,68,63,131
20,9,24,295,180,475
22,9,24,219,198,417
1,13,35,22,13,35
10,13,35,143,130,273
18,13,35,264,234,498
13,13,35,281,169,450
22,13,35,476,286,762
27,13,35,585,351,936
5,13,35,72,65,137
16,13,35,234,208,442
13,13,35,190,169,359
20,13,35,328,260,588
11,13,35,234,143,377
21,13,35,455,273,728
26,13,35,563,338,901
11,13,35,238,143,381
14,13,35,298,182,480
3,13,35,47,39,86
25,13,35,533,325,858
22,13,35,476,286,762
8,13,35,137,104,241
20,13,35,426,260,686
12,13,35,172,156,328
22,21,55,724,462,1186
5,42,54,1,210,211
19,42,54,218,798,1016
1,38,50,1,38,39
14,38,50,161,532,693
24,42,54,120,1008,1128
10,38,50,40,380,420
20,42,54,100,840,940
1,1266,2320,1031,1266,2297
3,1252,2295,2165,3756,5921
1,1266,2320,1008,1266,2274
1,1266,2320,1031,1266,2297
1,420,769,180,420,600
1,1266,2320,1008,1266,2274
1,1252,2295,997,1252,2249
3,1519,2443,2259,4557,6816
2,1519,2443,969,3038,4007
3,2171,3578,1967,6513,8480
1,2171,3578,942,2171,3113
1,1083,1701,601,1083,1684
1,2171,3578,835,2171,3006
1,2171,3578,835,2171,3006
1,2171,3578,656,2171,2827
2,2171,3578,1311,4342,5653
1,2171,3578,656,2171,2827
1,1555,2443,497,1555,2052
1,1519,2443,533,1519,2052
1,713,1120,172,713,885
3,1555,2443,2591,4665,7256
1,1519,2443,900,1519,2419
1,2171,3578,1335,2171,3506
2,2171,3578,1240,4342,5582
3,2171,3578,1860,6513,8373
15,26,70,440,390,830
13,26,70,381,338,719
17,26,70,724,442,1166
17,26,70,724,442,1166
20,26,70,866,520,1386
28,26,70,977,728,1705
18,3,9,105,54,159
10,3,9,47,30,77
5,1,2,5,5,10
9,1,2,9,9,18
21,9,25,331,189,520
5,9,25,79,45,124
5,1,2,5,5,10
27,1,2,26,27,53
9,1,2,9,9,18
10,2,5,29,20,49
26,2,5,75,52,127
23,1,2,13,23,36
30,13,35,650,390,1040
24,13,35,520,312,832
29,1,2,28,29,57
25,1,2,24,25,49
28,2,5,64,56,120
1,2,5,2,2,4
10,9,25,108,90,198
4,9,25,43,36,79
29,1,2,28,29,57
27,1,2,26,27,53
20,2,5,39,40,79
15,2,5,29,30,59
9,1,2,6,9,15
19,1,2,12,19,31
21,1,2,12,21,33
26,1,2,15,26,41
12,1,2,9,12,21
27,1,2,20,27,47
20,12,33,413,240,653
30,12,33,620,360,980
31,1,4,73,31,104
20,1,4,47,20,67
30,1,2,20,30,50
21,1,2,14,21,35
16,1,2,12,16,28
6,1,2,4,6,10
25,2,5,49,50,99
9,2,5,18,18,36
13,1,2,9,13,22
9,1,2,6,9,15
8,1,2,4,8,12
10,1,2,6,10,16
2,1,2,1,2,3
3,1,2,2,3,5
5,12,33,102,60,162
25,12,33,509,300,809
3,1,2,3,3,6
20,2,5,58,40,98
24,11,29,335,264,599
9,11,29,125,99,224
20,1,2,11,20,31
17,1,2,10,17,27
11,1,4,32,11,43
2,1482,2384,1041,2964,4005
1,1482,2384,401,1482,1883
1,755,1215,302,755,1057
1,1482,2384,592,1482,2074
3,1482,2384,2563,4446,7009
3,1482,2384,2563,4446,7009
2,24,64,53,48,101
26,24,64,1007,624,1631
24,24,64,929,576,1505
1,45,120,63,45,108
17,2,5,32,34,66
14,2,5,27,28,55
31,3,9,183,93,276
20,3,9,118,60,178
17,2,5,50,34,84
6,2,5,18,12,30
26,4,10,151,104,255
6,2,5,17,12,29
27,2,5,78,54,132
26,2,5,77,52,129
17,2,5,49,34,83
6,2,5,17,12,29
7,3,9,32,21,53
17,3,9,78,51,129
8,2,5,18,16,34
26,2,5,57,52,109
6,2,5,12,12,24
24,3,9,96,72,168
32,2,5,70,64,134
14,2,5,31,28,59
18,7,9,30,126,156
15,7,9,11,105,116
1,7,9,2,7,9
29,7,9,53,203,256
1,3,8,4,3,7
15,8,22,137,120,257
12,8,22,126,96,222
29,8,22,317,232,549
26,8,22,353,208,561
28,8,22,386,224,610
8,8,22,105,64,169
23,8,22,317,184,501
16,9,24,156,144,300
24,9,24,348,216,564
31,13,35,487,403,890
14,13,35,200,182,382
7,13,35,152,91,243
6,13,35,124,78,202
6,13,35,94,78,172
14,13,35,230,182,412
26,13,35,563,338,901
9,13,35,129,117,246
2,13,35,35,26,61
9,13,35,129,117,246
21,13,35,366,273,639
22,13,35,361,286,647
17,13,35,362,221,583
9,13,35,192,117,309
15,13,35,236,195,431
12,13,35,209,156,365
20,13,35,426,260,686
19,13,35,272,247,519
28,13,35,400,364,764
11,21,55,277,231,508
7,42,54,80,294,374
20,38,50,110,760,870
6,42,54,27,252,279
14,42,54,32,588,620
18,38,50,72,684,756
23,38,50,253,874,1127
16,38,50,16,608,624
2,38,50,20,76,96
20,38,50,220,760,980
3,1266,2320,2048,3798,5846
1,1252,2295,538,1252,1790
2,295,540,263,590,853
2,420,769,683,840,1523
3,295,540,379,885,1264
1,2171,3578,1335,2171,3506
1,1555,2443,839,1555,2394
1,2171,3578,656,2171,2827
1,713,1120,161,713,874
1,2171,3578,835,2171,3006
1,1083,1701,312,1083,1395
1,344,540,99,344,443
6,26,70,172,156,328
26,26,70,744,676,1420
6,3,9,24,18,42
19,1,4,56,19,75
18,13,35,283,234,517
18,13,35,283,234,517
13,1,2,12,13,25
2,1,2,2,2,4
21,1,2,20,21,41
11,2,5,32,22,54
12,2,5,35,24,59
29,2,5,86,58,144
9,12,33,150,108,258
14,1,2,8,14,22
9,1,2,5,9,14
20,1,2,11,20,31
9,1,4,21,9,30
10,1,4,24,10,34
19,1,2,19,19,38
27,1,2,26,27,53
4,2,5,12,8,20
21,2,5,61,42,103
21,13,35,447,273,720
30,1,4,71,30,101
30,1,4,64,30,94
29,1,2,19,29,48
23,1,2,15,23,38
23,1,2,21,23,44
24,2,5,56,48,104
20,2,5,47,40,87
23,1,4,68,23,91
27,1,4,80,27,107
9,1,2,7,9,16
13,1,2,10,13,23
27,2,5,63,54,117
25,2,5,59,50,109
8,1,2,6,8,14
13,1,2,10,13,23
18,2,5,35,36,71
10,2,5,20,20,40
12,1,4,36,12,48
2,1,4,6,2,8
28,1,4,83,28,111
27,8,21,249,216,465
15,8,21,138,120,258
23,8,21,236,184,420
14,8,21,144,112,256
8,2,5,22,16,38
11,2,5,32,22,54
6,2,5,17,12,29
9,8,21,113,72,185
27,2,5,51,54,105
3,2,5,6,6,12
11,1,2,11,11,22
3,2,5,6,6,12
22,2,5,42,44,86
1,1482,2384,521,1482,2003
3,1482,2384,1419,4446,5865
2,755,1215,823,1510,2333
3,461,742,554,1383,1937
1,1482,2384,854,1482,2336
1,1482,2384,854,1482,2336
15,24,64,389,360,749
19,24,64,736,456,1192
7,45,120,407,315,722
9,59,159,714,531,1245
27,4,10,113,108,221
19,4,10,80,76,156
20,4,10,94,80,174
19,2,5,55,38,93
25,2,5,48,50,98
16,2,5,30,32,62
25,2,5,73,50,123
19,3,9,111,57,168
28,3,9,163,84,247
1,2,5,3,2,5
20,2,5,58,40,98
17,2,5,49,34,83
19,3,9,87,57,144
4,3,9,18,12,30
2,2,5,4,4,8
22,2,5,46,44,90
26,2,5,55,52,107
23,7,9,42,161,203
31,7,9,51,217,268
17,3,8,55,51,106
13,3,8,50,39,89
19,8,22,174,152,326
11,8,22,115,88,203
20,8,22,276,160,436
16,9,24,232,144,376
23,13,35,490,299,789
27,13,35,575,351,926
24,13,35,494,312,806
8,13,35,114,104,218
5,13,35,108,65,173
8,13,35,165,104,269
14,13,35,298,182,480
14,13,35,205,182,387
19,13,35,405,247,652
12,13,35,260,156,416
24,13,35,520,312,832
14,13,35,298,182,480
17,13,35,261,221,482
13,13,35,268,169,437
27,13,35,575,351,926
16,13,35,229,208,437
4,13,35,85,52,137
4,13,35,85,52,137
9,13,35,129,117,246
1,21,55,33,21,54
11,21,55,362,231,593
13,21,55,428,273,701
14,42,54,153,588,741
11,42,54,1,462,463
1,38,50,10,38,48
13,38,50,52,494,546
1,42,54,0,42,42
4,42,54,0,168,168
21,38,50,105,798,903
2,1252,2295,1076,2504,3580
2,1266,2320,2015,2532,4547
2,1266,2320,2015,2532,4547
2,420,769,667,840,1507
2,420,769,590,840,1430
1,420,769,341,420,761
1,1266,2320,1008,1266,2274
2,1266,2320,1134,2532,3666
1,420,769,249,420,669
1,1266,2320,544,1266,1810
1,2171,3578,1335,2171,3506
1,344,540,185,344,529
3,344,540,523,1032,1555
3,1083,1701,1038,3249,4287
1,487,783,194,487,681
2,344,540,349,688,1037
1,344,540,99,344,443
12,26,70,511,312,823
11,3,9,64,33,97
17,3,9,96,51,147
10,1,2,10,10,20
7,1,2,7,7,14
12,1,2,12,12,24
3,2,5,9,6,15
9,2,5,27,18,45
1,1,2,1,1,2
9,2,5,26,18,44
9,2,5,26,18,44
1,1,4,3,1,4
24,1,4,71,24,95
26,2,5,75,52,127
26,2,5,75,52,127
28,2,5,66,56,122
29,2,5,55,58,113
21,2,5,59,42,101
14,2,5,41,28,69
16,11,30,242,176,418
23,11,30,347,253,600
23,11,30,423,253,676
13,11,30,239,143,382
1,2,5,3,2,5
19,2,5,53,38,91
23,9,25,362,207,569
10,1,2,6,10,16
27,1,2,17,27,44
11,2,5,29,22,51
7,1,4,20,7,27
29,1,4,85,29,114
7,1,2,5,7,12
15,1,2,10,15,25
25,2,5,48,50,98
6,2,5,11,12,23
9,1,2,6,9,15
18,2,5,53,36,89
1,1,2,1,1,2
7,1,4,20,7,27
13,1,4,28,13,41
23,1,4,49,23,72
13,8,21,158,104,262
2,1482,2384,755,2964,3719
1,755,1215,436,755,1191
8,24,64,253,192,445
13,24,64,512,312,824
4,45,120,290,180,470
14,3,9,68,42,110
3,2,5,9,6,15
21,2,5,61,42,103
19,4,10,84,76,160
26,4,10,114,104,218
18,2,5,50,36,86
22,2,5,64,44,108
4,2,5,12,8,20
18,2,5,53,36,89
8,2,5,19,16,35
23,2,5,54,46,100
18,2,5,53,36,89
7,2,5,21,14,35
22,3,9,106,66,172
12,3,9,58,36,94
13,3,9,53,39,92
31,3,9,127,93,220
28,3,9,123,84,207
14,3,9,61,42,103
5,7,9,4,35,39
13,7,9,24,91,115
7,3,8,28,21,49
12,3,8,48,36,84
11,3,8,44,33,77
9,3,8,28,27,55
9,8,22,98,72,170
15,8,22,137,120,257
15,8,22,203,120,323
21,8,22,234,168,402
10,8,22,136,80,216
32,9,24,342,288,630
4,9,24,58,36,94
19,9,24,226,171,397
16,9,24,171,144,315
9,9,24,96,81,177
30,13,35,650,390,1040
27,13,35,414,351,765
27,13,35,471,351,822
31,13,35,508,403,911
13,13,35,277,169,446
21,13,35,366,273,639
12,13,35,172,156,328
6,13,35,86,78,164
12,13,35,256,156,412
15,13,35,320,195,515
5,13,35,79,65,144
22,13,35,430,286,716
2,21,55,54,42,96
25,21,55,823,525,1348
27,38,50,27,1026,1053
27,38,50,81,1026,1107
8,38,50,20,304,324
10,38,50,40,380,420
9,42,54,6,378,384
18,38,50,153,684,837
9,38,50,99,342,441
1,38,50,10,38,48
21,42,54,48,882,930
2,1898,3375,2077,3796,5873
1,1252,2295,997,1252,2249
3,1912,3400,3138,5736,8874
1,1266,2320,1031,1266,2297
1,1252,2295,1020,1252,2272
1,1252,2295,1020,1252,2272
2,344,540,252,688,940
2,713,1120,769,1426,2195
1,1555,2443,448,1555,2003
1,1555,2443,570,1555,2125
1,2171,3578,835,2171,3006
1,2171,3578,835,2171,3006
1,713,1120,385,713,1098
1,2171,3578,656,2171,2827
2,344,540,219,688,907
1,344,540,174,344,518
3,344,540,523,1032,1555
3,26,70,94,78,172
1,26,70,43,26,69
6,26,70,256,156,412
1,26,70,29,26,55
19,26,70,663,494,1157
17,3,9,81,51,132
6,3,9,35,18,53
12,11,30,224,132,356
28,11,30,524,308,832
14,1,2,10,14,24
27,2,5,78,54,132
14,2,5,41,28,69
16,2,5,45,32,77
3,9,25,35,27,62
6,1,2,4,6,10
8,1,4,19,8,27
9,2,5,21,18,39
6,2,5,14,12,26
15,1,2,10,15,25
25,1,2,16,25,41
15,1,2,11,15,26
14,1,2,10,14,24
12,1,2,9,12,21
16,1,4,40,16,56
6,1,4,15,6,21
5,1,2,4,5,9
11,1,2,8,11,19
5,1,2,4,5,9
17,1,4,37,17,54
5,1,4,11,5,16
6,1,4,13,6,19
32,1,2,31,32,63
25,1,4,73,25,98
12,1,4,35,12,47
5,1,4,15,5,20
4,11,29,46,44,90
4,2,5,7,8,15
21,2,5,38,42,80
1,2,5,3,2,5
2,2,5,6,4,10
23,2,5,67,46,113
6,2,5,14,12,26
27,2,5,63,54,117
13,8,21,103,104,207
27,8,21,215,216,431
1,1482,2384,854,1482,2336
1,755,1215,436,755,1191
1,755,1215,436,755,1191
2,1482,2384,1470,2964,4434
8,3,9,47,24,71
8,3,9,47,24,71
26,4,10,153,104,257
19,4,10,112,76,188
5,2,5,15,10,25
29,2,5,86,58,144
24,2,5,67,48,115
18,2,5,50,36,86
13,2,5,38,26,64
6,2,5,17,12,29
7,3,9,34,21,55
11,3,9,53,33,86
8,2,5,23,16,39
24,2,5,70,48,118
9,4,10,38,36,74
27,4,10,113,108,221
16,2,5,31,32,63
7,2,5,14,14,28
10,3,9,54,30,84
5,3,9,27,15,42
1,2,5,2,2,4
25,3,9,101,75,176
21,3,9,84,63,147
4,7,9,8,28,36
7,7,9,13,49,62
4,7,9,3,28,31
5,7,9,10,35,45
1,3,8,4,3,7
6,3,8,20,18,38
27,8,22,366,216,582
29,8,22,400,232,632
16,8,22,220,128,348
9,8,22,124,72,196
6,8,22,83,48,131
32,8,22,300,256,556
9,9,24,133,81,214
24,9,24,251,216,467
28,9,24,393,252,645
12,13,35,235,156,391
26,13,35,554,338,892
3,13,35,59,39,98
19,13,35,278,247,525
18,13,35,352,234,586
17,13,35,332,221,553
6,13,35,86,78,164
18,13,35,383,234,617
1,13,35,22,13,35
20,13,35,286,260,546
16,13,35,346,208,554
6,13,35,105,78,183
20,13,35,286,260,546
18,13,35,390,234,624
12,13,35,247,156,403
22,13,35,345,286,631
12,13,35,260,156,416
23,13,35,401,299,700
28,13,35,596,364,960
19,13,35,391,247,638
1,13,35,21,13,34
9,13,35,129,117,246
17,21,55,382,357,739
6,38,50,69,228,297
1,42,54,11,42,53
9,42,54,89,378,467
14,38,50,77,532,609
12,38,50,30,456,486
9,42,54,45,378,423
10,38,50,110,380,490
19,42,54,13,798,811
3,42,54,2,126,128
1,1266,2320,567,1266,1833
2,1252,2295,2040,2504,4544
1,1266,2320,729,1266,1995
1,1252,2295,745,1252,1997
1,1252,2295,997,1252,2249
2,1252,2295,1122,2504,3626
1,308,565,251,308,559
2,1252,2295,1260,2504,3764
2,1266,2320,1922,2532,4454
1,2171,3578,1335,2171,3506
1,2171,3578,1157,2171,3328
2,1519,2443,1506,3038,4544
3,2171,3578,2826,6513,9339
3,2171,3578,2826,6513,9339
1,2171,3578,835,2171,3006
1,713,1120,385,713,1098
1,344,540,77,344,421
2,2171,3578,2671,4342,7013
1,2171,3578,1335,2171,3506
28,26,70,1193,728,1921
2,26,70,59,52,111
31,2,5,65,62,127
18,2,5,38,36,74
1,2,5,3,2,5
23,2,5,67,46,113
18,2,5,52,36,88
1,9,25,12,9,21
12,9,25,144,108,252
26,1,2,15,26,41
25,1,2,14,25,39
8,1,2,8,8,16
9,1,2,9,9,18
13,13,35,281,169,450
12,13,35,260,156,416
24,1,2,17,24,41
13,1,2,9,13,22
6,1,2,4,6,10
21,13,35,411,273,684
13,1,2,10,13,23
32,1,2,24,32,56
6,2,5,12,12,24
13,2,5,27,26,53
22,11,30,411,242,653
7,1,2,7,7,14
25,1,2,24,25,49
19,1,2,18,19,37
10,2,5,30,20,50
24,1,2,14,24,38
1,1,2,1,1,2
19,1,2,13,19,32
8,2,5,24,16,40
21,2,5,62,42,104
20,2,5,59,40,99
17,1,2,16,17,33
29,1,4,86,29,115
29,1,4,86,29,115
14,1,2,13,14,27
1,1,2,1,1,2
26,1,2,19,26,45
28,1,4,59,28,87
9,1,4,19,9,28
25,1,2,25,25,50
8,1,4,20,8,28
3,1,4,7,3,10
29,12,33,398,348,746
24,12,33,330,288,618
23,2,5,64,46,110
14,2,5,39,28,67
23,2,5,64,46,110
21,2,5,61,42,103
7,2,5,20,14,34
22,2,5,64,44,108
25,1,4,54,25,79
13,1,4,28,13,41
11,1,4,23,11,34
2,2,5,4,4,8
9,1,4,26,9,35
8,1,4,23,8,31
19,1,2,14,19,33
32,1,2,24,32,56
8,1,2,6,8,14
22,2,5,62,44,106
14,2,5,39,28,67
1,461,742,274,461,735
1,755,1215,436,755,1191
1,755,1215,193,755,948
27,24,64,1045,648,1693
3,45,120,160,135,295
9,2,5,24,18,42
13,2,5,34,26,60
28,2,5,81,56,137
23,2,5,67,46,113
1,2,5,3,2,5
4,2,5,12,8,20
27,2,5,62,54,116
7,2,5,16,14,30
29,2,5,68,58,126
26,2,5,61,52,113
4,2,5,9,8,17
8,2,5,18,16,34
18,2,5,42,36,78
3,2,5,8,6,14
18,2,5,50,36,86
25,2,5,48,50,98
10,2,5,29,20,49
10,2,5,29,20,49
5,7,9,9,35,44
17,7,9,14,119,133
23,7,9,0,161,161
15,8,22,137,120,257
16,8,22,185,128,313
23,8,22,312,184,496
20,8,22,183,160,343
15,9,24,160,135,295
28,9,24,333,252,585
1,13,35,14,13,27
7,13,35,149,91,240
4,13,35,78,52,130
14,13,35,303,182,485
32,13,35,659,416,1075
7,13,35,149,91,240
9,13,35,185,117,302
2,13,35,34,26,60
8,13,35,173,104,277
18,13,35,314,234,548
6,13,35,105,78,183
4,13,35,85,52,137
4,13,35,85,52,137
24,13,35,343,312,655
28,13,35,577,364,941
18,21,55,572,378,950
20,42,54,218,840,1058
10,38,50,10,380,390
27,38,50,297,1026,1323
28,42,54,139,1176,1315
4,42,54,18,168,186
12,42,54,27,504,531
18,42,54,41,756,797
9,38,50,23,342,365
1,1912,3400,774,1912,2686
1,1252,2295,1020,1252,2272
3,420,769,955,1260,2215
1,420,769,334,420,754
3,1252,2295,2372,3756,6128
1,1519,2443,387,1519,1906
1,487,783,280,487,767
2,1555,2443,897,3110,4007
3,2171,3578,2826,6513,9339
2,2171,3578,1884,4342,6226
1,2171,3578,656,2171,2827
1,2171,3578,1335,2171,3506
18,26,70,779,468,1247
12,26,70,377,312,689
20,26,70,866,520,1386
22,26,70,691,572,1263
27,3,9,130,81,211
15,13,35,215,195,410
29,13,35,415,377,792
25,13,35,358,325,683
27,13,35,556,351,907
28,13,35,577,364,941
5,2,5,14,10,24
30,13,35,639,390,1029
8,13,35,170,104,274
6,13,35,128,78,206
17,9,25,255,153,408
27,9,25,405,243,648
18,13,35,383,234,617
3,13,35,64,39,103
24,9,25,372,216,588
21,1,2,20,21,41
22,1,2,21,22,43
9,9,25,135,81,216
27,9,25,405,243,648
21,2,5,40,42,82
7,2,5,13,14,27
29,9,25,457,261,718
16,9,25,252,144,396
25,9,25,388,225,613
10,9,25,155,90,245
1,1,2,1,1,2
1,2,5,3,2,5
2,2,5,6,4,10
1,1482,2384,592,1482,2074
1,1482,2384,807,1482,2289
1,461,742,251,461,712
1,1482,2384,449,1482,1931
8,24,64,310,192,502
25,24,64,824,600,1424
8,45,120,466,360,826
1,59,159,94,59,153
17,3,9,100,51,151
20,3,9,118,60,178
14,2,5,41,28,69
23,2,5,68,46,114
2,2,5,6,4,10
7,2,5,20,14,34
22,2,5,65,44,109
28,2,5,53,56,109
21,2,5,40,42,82
17,2,5,33,34,67
8,2,5,16,16,32
28,3,9,133,84,217
19,3,9,90,57,147
12,2,5,28,24,52
11,2,5,21,22,43
17,2,5,32,34,66
1,2,5,3,2,5
16,2,5,38,32,70
23,2,5,54,46,100
26,2,5,73,52,125
2,2,5,6,4,10
31,7,9,59,217,276
31,7,9,51,217,268
30,7,9,49,210,259
5,7,9,9,35,44
14,7,9,-2,98,96
28,3,8,91,84,175
26,8,22,358,208,566
7,8,22,96,56,152
21,8,22,192,168,360
28,8,22,380,224,604
9,8,22,98,72,170
16,8,22,220,128,348
19,8,22,212,152,364
4,9,24,58,36,94
4,9,24,59,36,95
15,13,35,236,195,431
12,13,35,247,156,403
15,13,35,309,195,504
18,13,35,371,234,605
10,13,35,171,130,301
13,13,35,222,169,391
8,13,35,140,104,244
27,13,35,386,351,737
20,13,35,349,260,609
14,13,35,190,182,372
1,13,35,14,13,27
23,13,35,377,299,676
8,21,55,215,168,383
16,42,54,2,672,674
31,42,54,355,1302,1657
8,38,50,88,304,392
27,38,50,297,1026,1323
24,38,50,276,912,1188
1,38,50,11,38,49
29,38,50,145,1102,1247
11,38,50,94,418,512
19,38,50,19,722,741
1,1266,2320,1031,1266,2297
2,1252,2295,2040,2504,4544
1,1252,2295,745,1252,1997
1,1252,2295,1020,1252,2272
1,1266,2320,544,1266,1810
1,1266,2320,1031,1266,2297
1,1266,2320,636,1266,1902
2,2171,3578,2671,4342,7013
2,1083,1701,488,2166,2654
1,2171,3578,656,2171,2827
1,2171,3578,942,2171,3113
1,344,540,77,344,421
2,2171,3578,2671,4342,7013
1,2171,3578,1335,2171,3506
1,713,1120,261,713,974
2,2171,3578,1240,4342,5582
1,1555,2443,864,1555,2419
16,26,70,682,416,1098
16,3,9,76,48,124
16,3,9,95,48,143
9,3,9,51,27,78
14,1,2,14,14,28
9,1,2,9,9,18
31,1,2,30,31,61
13,2,5,36,26,62
22,2,5,62,44,106
16,2,5,45,32,77
19,2,5,40,38,78
5,2,5,11,10,21
17,2,5,36,34,70
24,1,4,57,24,81
7,1,4,17,7,24
31,1,2,30,31,61
28,1,2,27,28,55
14,1,2,14,14,28
5,2,5,14,10,24
25,9,25,394,225,619
11,9,25,173,99,272
31,1,2,30,31,61
31,1,2,30,31,61
9,1,2,9,9,18
15,2,5,44,30,74
30,1,2,29,30,59
28,1,2,27,28,55
6,1,2,3,6,9
27,1,2,15,27,42
14,1,2,8,14,22
13,11,29,230,143,373
23,11,29,407,253,660
17,11,30,211,187,398
2,1,2,2,2,4
9,2,5,25,18,43
18,1,4,38,18,56
12,2,5,35,24,59
26,2,5,75,52,127
29,2,5,84,58,142
1,1482,2384,807,1482,2289
1,755,1215,411,755,1166
1,461,742,274,461,735
1,1482,2384,807,1482,2289
2,1482,2384,1613,2964,4577
3,755,1215,906,2265,3171
1,755,1215,168,755,923
1,461,742,177,461,638
1,1482,2384,807,1482,2289
14,24,64,551,336,887
9,45,120,437,405,842
4,59,159,387,236,623
1,59,159,75,59,134
22,3,9,130,66,196
7,3,9,41,21,62
25,4,10,148,100,248
24,4,10,142,96,238
8,2,5,19,16,35
24,2,5,56,48,104
8,2,5,16,16,32
4,3,9,23,12,35
22,2,5,42,44,86
1,2,5,2,2,4
26,2,5,75,52,127
13,2,5,38,26,64
15,2,5,35,30,65
16,2,5,34,32,66
24,2,5,50,48,98
32,7,9,52,224,276
10,7,9,8,70,78
2,7,9,3,14,17
22,7,9,42,154,196
4,3,8,19,12,31
29,3,8,140,87,227
27,3,8,87,81,168
4,8,22,37,32,69
25,8,22,339,200,539
3,8,22,27,24,51
4,8,22,54,32,86
15,8,22,197,120,317
17,8,22,189,136,325
5,8,22,46,40,86
10,8,22,138,80,218
9,9,24,87,81,168
7,9,24,103,63,166
25,9,24,249,225,474
3,9,24,36,27,63
22,13,35,361,286,647
16,13,35,251,208,459
18,13,35,383,234,617
12,13,35,260,156,416
15,13,35,262,195,457
3,13,35,65,39,104
22,13,35,338,286,624
1,13,35,17,13,30
23,13,35,450,299,749
29,13,35,628,377,1005
12,13,35,256,156,412
30,13,35,429,390,819
17,13,35,362,221,583
10,13,35,213,130,343
13,13,35,268,169,437
27,21,55,888,567,1455
1,21,55,33,21,54
3,21,55,99,63,162
14,38,50,42,532,574
15,42,54,75,630,705
14,42,54,9,588,597
2,42,54,10,84,94
12,38,50,132,456,588
3,38,50,8,114,122
22,42,54,240,924,1164
29,38,50,247,1102,1349
15,42,54,164,630,794
1,38,50,1,38,39
21,42,54,229,882,1111
4,38,50,46,152,198
25,42,54,206,1050,1256
27,42,54,295,1134,1429
3,1266,2320,1631,3798,5429
1,1252,2295,538,1252,1790
1,1266,2320,613,1266,1879
1,1252,2295,538,1252,1790
2,1252,2295,1994,2504,4498
3,420,769,955,1260,2215
3,1266,2320,3023,3798,6821
3,1252,2295,2647,3756,6403
3,1266,2320,3092,3798,6890
1,2171,3578,763,2171,2934
1,713,1120,385,713,1098
1,1555,2443,448,1555,2003
1,344,540,77,344,421
1,1083,1701,499,1083,1582
1,1083,1701,499,1083,1582
1,2171,3578,656,2171,2827
2,713,1120,769,1426,2195
1,2171,3578,835,2171,3006
2,2171,3578,1884,4342,6226
3,344,540,556,1032,1588
1,344,540,83,344,427
1,713,1120,228,713,941
28,1,2,21,28,49
10,1,2,7,10,17
18,2,5,53,36,89
9,12,33,186,108,294
16,2,5,47,32,79
24,1,2,18,24,42
15,1,2,11,15,26
4,2,5,12,8,20
24,2,5,70,48,118
6,2,5,18,12,30
20,1,4,50,20,70
12,1,4,30,12,42
9,2,5,17,18,35
24,2,5,46,48,94
6,2,5,14,12,26
3,2,5,7,6,13
26,2,5,57,52,109
1,12,33,16,12,28
20,12,33,314,240,554
24,2,5,56,48,104
16,13,35,234,208,442
22,2,5,64,44,108
24,11,30,449,264,713
11,11,30,206,121,327
15,2,5,44,30,74
12,2,5,28,24,52
14,2,5,33,28,61
25,11,30,310,275,585
20,11,30,248,220,468
20,1,2,19,20,39
9,1,2,9,9,18
27,1,4,79,27,106
5,1,4,15,5,20
16,1,4,47,16,63
26,2,5,75,52,127
23,2,5,67,46,113
27,2,5,78,54,132
2,2,5,6,4,10
17,2,5,49,34,83
31,1,2,30,31,61
4,2,5,12,8,20
14,2,5,41,28,69
5,2,5,15,10,25
1,1482,2384,521,1482,2003
1,1482,2384,592,1482,2074
1,1482,2384,807,1482,2289
1,1482,2384,854,1482,2336
1,1482,2384,592,1482,2074
25,24,64,648,600,1248
23,45,120,1697,1035,2732
9,59,159,714,531,1245
9,59,159,843,531,1374
20,2,5,38,40,78
16,2,5,30,32,62
17,2,5,40,34,74
30,2,5,71,60,131
5,3,9,28,15,43
6,7,9,4,42,46
15,7,9,0,105,105
1,7,9,0,7,7
13,3,8,58,39,97
13,8,22,119,104,223
26,8,22,284,208,492
2,8,22,18,16,34
10,8,22,138,80,218
18,9,24,175,162,337
30,13,35,492,390,882
18,13,35,308,234,542
18,13,35,257,234,491
17,13,35,368,221,589
16,13,35,330,208,538
20,13,35,349,260,609
10,13,35,217,130,347
31,13,35,671,403,1074
19,13,35,278,247,525
14,13,35,288,182,470
8,13,35,165,104,269
27,13,35,386,351,737
28,13,35,596,364,960
20,38,50,200,760,960
23,38,50,253,874,1127
18,42,54,41,756,797
5,38,50,55,190,245
27,42,54,91,1134,1225
24,42,54,120,1008,1128
7,42,54,69,294,363
2,1266,2320,1458,2532,3990
2,1252,2295,1902,2504,4406
1,1252,2295,997,1252,2249
1,2171,3578,763,2171,2934
1,713,1120,396,713,1109
2,713,1120,724,1426,2150
23,26,70,787,598,1385
13,26,70,372,338,710
29,26,70,992,754,1746
23,3,9,136,69,205
19,2,5,56,38,94
20,2,5,56,40,96
18,13,35,383,234,617
12,13,35,256,156,412
5,13,35,82,65,147
15,13,35,246,195,441
6,1,2,6,6,12
14,1,2,14,14,28
10,1,2,9,10,19
27,1,2,25,27,52
6,1,2,6,6,12
1,11,29,17,11,28
10,11,29,168,110,278
20,11,29,337,220,557
10,1,2,7,10,17
25,1,2,19,25,44
1,1,2,1,1,2
12,2,5,35,24,59
7,1,2,7,7,14
26,1,2,25,26,51
3,1,2,3,3,6
12,1,2,10,12,22
1,11,30,18,11,29
23,11,30,409,253,662
3,9,25,45,27,72
22,2,5,43,44,87
9,2,5,18,18,36
15,2,5,29,30,59
24,1,2,13,24,37
19,9,25,242,171,413
20,9,25,255,180,435
22,9,25,281,198,479
28,2,5,53,56,109
3,2,5,6,6,12
1,1482,2384,592,1482,2074
1,755,1215,436,755,1191
1,1482,2384,854,1482,2336
15,24,64,562,360,922
9,59,159,714,531,1245
19,2,5,50,38,88
30,3,9,123,90,213
5,3,9,21,15,36
28,4,10,109,112,221
6,4,10,23,24,47
7,3,9,32,21,53
2,3,9,9,6,15
9,2,5,27,18,45
25,2,5,74,50,124
23,2,5,48,46,94
20,2,5,42,40,82
5,2,5,15,10,25
23,2,5,67,46,113
9,2,5,25,18,43
20,2,5,56,40,96
13,7,9,25,91,116
19,7,9,36,133,169
1,3,8,5,3,8
28,3,8,131,84,215
17,3,8,67,51,118
15,3,8,73,45,118
17,8,22,231,136,367
1,8,22,10,8,18
25,8,22,339,200,539
31,8,22,345,248,593
8,8,22,75,64,139
16,9,24,156,144,300
31,9,24,331,279,610
1,13,35,14,13,27
15,13,35,262,195,457
5,13,35,72,65,137
26,13,35,563,338,901
21,13,35,455,273,728
26,13,35,454,338,792
21,13,35,447,273,720
21,13,35,447,273,720
27,13,35,556,351,907
25,13,35,436,325,761
18,13,35,352,234,586
18,13,35,352,234,586
18,13,35,383,234,617
13,13,35,268,169,437
26,13,35,554,338,892
3,13,35,51,39,90
25,13,35,366,325,691
22,13,35,453,286,739
22,21,55,700,462,1162
3,21,55,100,63,163
19,21,55,510,399,909
18,38,50,198,684,882
7,38,50,81,266,347
24,38,50,240,912,1152
17,42,54,186,714,900
13,42,54,65,546,611
1,1912,3400,774,1912,2686
2,420,769,667,840,1507
3,1266,2320,3023,3798,6821
1,1252,2295,951,1252,2203
1,1266,2320,1008,1266,2274
3,1266,2320,2048,3798,5846
1,420,769,318,420,738
1,420,769,249,420,669
1,308,565,234,308,542
1,2171,3578,763,2171,2934
1,713,1120,385,713,1098
1,1555,2443,790,1555,2345
2,713,1120,769,1426,2195
2,1555,2443,1678,3110,4788
1,2171,3578,942,2171,3113
3,344,540,556,1032,1588
1,713,1120,172,713,885
1,1555,2443,864,1555,2419
28,26,70,1193,728,1921
3,26,70,124,78,202
8,3,9,45,24,69
17,3,9,96,51,147
1,3,9,6,3,9
28,1,2,21,28,49
17,2,5,49,34,83
8,2,5,23,16,39
19,1,2,11,19,30
26,2,5,77,52,129
1,2,5,3,2,5
7,12,33,145,84,229
13,2,5,27,26,53
8,2,5,16,16,32
8,1,2,8,8,16
5,13,35,107,65,172
9,13,35,192,117,309
5,2,5,15,10,25
19,2,5,56,38,94
18,1,4,53,18,71
15,1,4,44,15,59
14,1,4,41,14,55
1,1,2,1,1,2
7,1,2,5,7,12
23,1,2,13,23,36
11,1,2,6,11,17
1,2,5,3,2,5
13,2,5,36,26,62
9,2,5,25,18,43
22,1,2,16,22,38
17,1,2,13,17,30
19,1,2,17,19,36
1,2,5,3,2,5
9,1,2,5,9,14
20,1,2,12,20,32
17,1,2,10,17,27
13,1,2,12,13,25
13,1,2,12,13,25
20,2,5,58,40,98
8,2,5,23,16,39
14,2,5,41,28,69
1,1,2,1,1,2
14,2,5,41,28,69
16,2,5,46,32,78
14,1,4,30,14,44
28,1,4,59,28,87
9,1,4,19,9,28
32,1,2,31,32,63
32,1,2,31,32,63
7,1,2,7,7,14
1,1,4,3,1,4
18,2,5,42,36,78
1,2,5,2,2,4
6,2,5,14,12,26
5,2,5,12,10,22
20,1,4,54,20,74
23,1,4,63,23,86
3,1482,2384,2634,4446,7080
1,755,1215,375,755,1130
1,755,1215,375,755,1130
1,1482,2384,878,1482,2360
3,1482,2384,2563,4446,7009
16,24,64,507,384,891
7,45,120,340,315,655
4,59,159,317,236,553
5,59,159,468,295,763
2,2,5,5,4,9
1,2,5,2,2,4
12,2,5,35,24,59
15,4,10,69,60,129
15,4,10,69,60,129
2,2,5,4,4,8
6,2,5,11,12,23
23,3,9,111,69,180
15,4,10,87,60,147
1,4,10,4,4,8
23,4,10,87,92,179
30,4,10,114,120,234
18,4,10,68,72,140
11,3,9,65,33,98
26,3,9,154,78,232
23,7,9,44,161,205
9,7,9,16,63,79
21,7,9,16,147,163
11,7,9,0,77,77
30,7,9,49,210,259
28,7,9,1,196,197
21,7,9,12,147,159
9,7,9,3,63,66
14,7,9,19,98,117
9,7,9,16,63,79
6,3,8,19,18,37
4,3,8,16,12,28
11,3,8,53,33,86
6,8,22,83,48,131
1,8,22,9,8,17
27,8,22,372,216,588
1,9,24,15,9,24
7,9,24,83,63,146
28,9,24,413,252,665
7,13,35,144,91,235
32,13,35,525,416,941
11,13,35,192,143,335
13,13,35,204,169,373
18,13,35,314,234,548
11,13,35,234,143,377
4,13,35,82,52,134
16,13,35,262,208,470
9,13,35,185,117,302
21,13,35,366,273,639
1,13,35,22,13,35
1,13,35,18,13,31
7,13,35,149,91,240
20,13,35,412,260,672
29,21,55,779,609,1388
6,21,55,131,126,257
12,21,55,263,252,515
1,38,50,12,38,50
12,38,50,12,456,468
26,42,54,17,1092,1109
1,1252,2295,630,1252,1882
3,1252,2295,1890,3756,5646
1,1266,2320,752,1266,2018
1,1266,2320,729,1266,1995
3,1266,2320,3092,3798,6890
1,1252,2295,745,1252,1997
1,420,769,180,420,600
1,420,769,341,420,761
1,308,565,189,308,497
3,2171,3578,2826,6513,9339
2,2171,3578,1669,4342,6011
1,2171,3578,656,2171,2827
1,1555,2443,839,1555,2394
2,713,1120,523,1426,1949
2,344,540,370,688,1058
6,26,70,172,156,328
2,26,70,82,52,134
1,26,70,41,26,67
3,3,9,18,9,27
17,1,2,16,17,33
16,1,2,15,16,31
18,1,2,17,18,35
22,1,2,20,22,42
9,13,35,141,117,258
25,13,35,393,325,718
16,13,35,251,208,459
22,1,2,14,22,36
10,13,35,213,130,343
18,13,35,383,234,617
2,8,21,24,16,40
1,8,21,12,8,20
8,2,5,23,16,39
22,2,5,43,44,87
23,2,5,45,46,91
1,1,2,1,1,2
3,1,2,3,3,6
30,1,2,17,30,47
14,1,2,8,14,22
4,1,2,4,4,8
24,1,2,24,24,48
1,1,2,1,1,2
12,12,33,248,144,392
12,2,5,23,24,47
19,1,2,17,19,36
14,1,2,10,14,24
23,1,2,16,23,39
8,2,5,18,16,34
16,2,5,35,32,67
3,2,5,7,6,13
29,2,5,64,58,122
8,1,2,7,8,15
5,1,4,14,5,19
22,1,4,62,22,84
12,1,2,12,12,24
28,2,5,83,56,139
1,8,21,9,8,17
32,1,2,31,32,63
1,2,5,3,2,5
19,1,2,18,19,37
15,1,2,14,15,29
10,2,5,22,20,42
13,9,25,137,117,254
5,9,25,53,45,98
17,1,2,17,17,34
6,1,2,6,6,12
15,1,2,15,15,30
21,11,29,244,231,475
3,11,29,35,33,68
3,11,29,35,33,68
16,1,2,16,16,32
11,1,2,11,11,22
21,2,5,40,42,82
24,2,5,46,48,94
25,2,5,66,50,116
13,2,5,34,26,60
12,2,5,25,24,49
24,2,5,50,48,98
1,755,1215,411,755,1166
1,461,742,162,461,623
2,1482,2384,1756,2964,4720
1,1482,2384,378,1482,1860
2,755,1215,483,1510,1993
27,24,64,1063,648,1711
2,2,5,5,4,9
12,2,5,28,24,52
13,4,10,73,52,125
6,2,5,13,12,25
5,2,5,11,10,21
27,2,5,78,54,132
9,2,5,26,18,44
1,2,5,3,2,5
16,2,5,45,32,77
8,2,5,19,16,35
15,2,5,35,30,65
20,4,10,76,80,156
30,4,10,114,120,234
10,2,5,19,20,39
22,2,5,42,44,86
17,2,5,33,34,67
22,2,5,43,44,87
22,2,5,62,44,106
25,2,5,70,50,120
1,7,9,2,7,9
18,7,9,30,126,156
25,7,9,14,175,189
28,7,9,46,196,242
3,7,9,2,21,23
20,7,9,8,140,148
10,7,9,8,70,78
19,7,9,31,133,164
31,3,8,153,93,246
31,3,8,120,93,213
21,3,8,68,63,131
9,8,22,118,72,190
26,8,22,341,208,549
1,8,22,11,8,19
18,8,22,165,144,309
27,8,22,295,216,511
20,8,22,276,160,436
9,8,22,118,72,190
29,8,22,272,232,504
23,9,24,323,207,530
20,9,24,214,180,394
17,9,24,239,153,392
8,9,24,118,72,190
27,9,24,262,243,505
1,9,24,12,9,21
18,9,24,261,162,423
28,13,35,577,364,941
5,13,35,79,65,144
1,13,35,21,13,34
24,13,35,419,312,731
10,13,35,206,130,336
29,13,35,506,377,883
4,13,35,82,52,134
20,13,35,412,260,672
12,13,35,256,156,412
16,13,35,330,208,538
3,13,35,65,39,104
3,13,35,51,39,90
23,13,35,337,299,636
17,13,35,362,221,583
16,13,35,251,208,459
12,13,35,172,156,328
28,13,35,489,364,853
7,21,55,169,147,316
29,38,50,189,1102,1291
21,38,50,105,798,903
19,38,50,219,722,941
4,42,54,39,168,207
4,42,54,48,168,216
8,38,50,80,304,384
14,42,54,70,588,658
13,38,50,130,494,624
19,42,54,43,798,841
4,42,54,3,168,171
14,42,54,70,588,658
23,38,50,115,874,989
1,38,50,3,38,41
1,1898,3375,1038,1898,2936
2,1898,3375,2077,3796,5873
1,1252,2295,722,1252,1974
3,420,769,955,1260,2215
2,308,565,469,616,1085
1,1252,2295,951,1252,2203
1,1252,2295,722,1252,1974
1,2171,3578,763,2171,2934
1,2171,3578,942,2171,3113
1,1083,1701,618,1083,1701
1,1083,1701,244,1083,1327
3,713,1120,616,2139,2755
2,2171,3578,1884,4342,6226
3,344,540,232,1032,1264
3,1555,2443,1711,4665,6376
1,344,540,185,344,529
1,1083,1701,550,1083,1633
1,713,1120,205,713,918
1,713,1120,362,713,1075
1,713,1120,228,713,941
1,344,540,174,344,518
1,344,540,99,344,443
3,2171,3578,4006,6513,10519
1,26,70,36,26,62
7,26,70,303,182,485
21,26,70,601,546,1147
21,3,9,84,63,147
17,3,9,74,51,125
31,3,9,180,93,273
8,3,9,45,24,69
22,1,2,22,22,44
22,1,2,22,22,44
1,1,2,1,1,2
7,1,2,5,7,12
18,1,2,18,18,36
28,1,2,27,28,55
7,1,2,7,7,14
21,9,25,263,189,452
26,9,25,325,234,559
28,9,25,350,252,602
2,2,5,6,4,10
10,11,30,136,110,246
18,11,30,245,198,443
26,2,5,77,52,129
23,2,5,68,46,114
15,1,2,8,15,23
23,2,5,54,46,100
1,9,25,16,9,25
14,1,4,33,14,47
5,1,4,12,5,17
8,1,4,23,8,31
28,2,5,81,56,137
8,9,25,120,72,192
5,2,5,15,10,25
3,2,5,7,6,13
28,11,29,333,308,641
12,11,29,143,132,275
4,12,33,81,48,129
27,12,33,549,324,873
16,2,5,31,32,63
6,2,5,17,12,29
22,2,5,42,44,86
10,2,5,19,20,39
7,2,5,16,14,30
4,2,5,9,8,17
10,1,4,23,10,33
5,1,4,11,5,16
19,8,21,175,152,327
8,2,5,22,16,38
3,1482,2384,1776,4446,6222
1,1482,2384,807,1482,2289
1,1482,2384,854,1482,2336
1,755,1215,302,755,1057
2,1482,2384,1184,2964,4148
21,24,64,665,504,1169
10,24,64,394,240,634
6,45,120,436,270,706
9,59,159,871,531,1402
6,59,159,476,354,830
3,2,5,6,6,12
19,2,5,36,38,74
22,3,9,118,66,184
22,3,9,118,66,184
21,2,5,61,42,103
6,4,10,35,24,59
12,4,10,70,48,118
2,2,5,4,4,8
25,2,5,48,50,98
19,2,5,40,38,78
10,2,5,21,20,41
11,7,9,18,77,95
14,7,9,27,98,125
14,7,9,5,98,103
22,8,22,202,176,378
21,8,22,285,168,453
5,8,22,55,40,95
20,8,22,271,160,431
1,9,24,14,9,23
14,9,24,136,126,262
6,9,24,89,54,143
10,9,24,148,90,238
23,9,24,323,207,530
5,9,24,53,45,98
16,9,24,232,144,376
32,9,24,319,288,607
15,13,35,215,195,410
9,13,35,185,117,302
2,13,35,43,26,69
12,13,35,256,156,412
12,13,35,176,156,332
14,13,35,298,182,480
6,13,35,130,78,208
19,13,35,391,247,638
16,13,35,229,208,437
7,13,35,115,91,206
1,13,35,16,13,29
21,13,35,455,273,728
7,13,35,110,91,201
17,13,35,243,221,464
7,13,35,149,91,240
8,13,35,170,104,274
5,13,35,107,65,172
13,13,35,222,169,391
24,21,55,631,504,1135
12,21,55,289,252,541
13,21,55,363,273,636
21,42,54,241,882,1123
29,38,50,29,1102,1131
8,42,54,5,336,341
5,38,50,58,190,248
28,42,54,124,1176,1300
1,38,50,10,38,48
25,42,54,246,1050,1296
27,42,54,3,1134,1137
13,38,50,143,494,637
13,38,50,39,494,533
24,42,54,55,1008,1063
1,1252,2295,722,1252,1974
2,1912,3400,1548,3824,5372
1,1266,2320,729,1266,1995
1,1266,2320,1031,1266,2297
2,1252,2295,2040,2504,4544
1,420,769,241,420,661
2,1266,2320,2015,2532,4547
1,420,769,318,420,738
3,1083,1701,731,3249,3980
1,1083,1701,499,1083,1582
2,713,1120,724,1426,2150
1,2171,3578,835,2171,3006
2,2171,3578,1311,4342,5653
2,344,540,370,688,1058
1,2171,3578,620,2171,2791
1,487,783,171,487,658
28,26,70,958,728,1686
26,26,70,1126,676,1802
28,26,70,820,728,1548
11,26,70,476,286,762
22,26,70,953,572,1525
8,3,9,47,24,71
10,3,9,41,30,71
16,2,5,30,32,62
10,2,5,19,20,39
21,2,5,40,42,82
26,1,2,15,26,41
27,1,2,27,27,54
11,13,35,234,143,377
21,2,5,61,42,103
9,2,5,26,18,44
1,1,2,1,1,2
24,1,2,24,24,48
10,1,2,6,10,16
21,2,5,56,42,98
16,13,35,341,208,549
7,13,35,149,91,240
9,13,35,192,117,309
8,1,2,8,8,16
29,1,2,28,29,57
14,9,25,221,126,347
18,9,25,284,162,446
1,9,25,16,9,25
8,2,5,16,16,32
13,2,5,25,26,51
1,2,5,3,2,5
19,2,5,56,38,94
14,2,5,29,28,57
10,2,5,21,20,41
32,1,4,91,32,123
7,1,4,20,7,27
8,2,5,19,16,35
16,2,5,38,32,70
4,2,5,9,8,17
26,1,2,15,26,41
10,1,2,6,10,16
10,12,33,157,120,277
32,12,33,503,384,887
9,2,5,19,18,37
15,2,5,32,30,62
11,2,5,31,22,53
15,9,25,233,135,368
20,9,25,310,180,490
2,9,25,31,18,49
30,1,2,29,30,59
3,1,2,3,3,6
18,1,4,53,18,71
28,1,4,82,28,110
26,11,30,486,286,772
16,11,30,299,176,475
31,2,5,76,62,138
29,1,2,28,29,57
16,1,2,15,16,31
18,1,2,17,18,35
3,2,5,9,6,15
32,2,5,94,64,158
16,2,5,47,32,79
26,2,5,77,52,129
4,8,21,50,32,82
3,1,2,2,3,5
7,2,5,15,14,29
10,1,4,29,10,39
3,1482,2384,1776,4446,6222
1,1482,2384,735,1482,2217
3,461,742,754,1383,2137
1,755,1215,436,755,1191
1,755,1215,436,755,1191
3,461,742,442,1383,1825
1,1482,2384,854,1482,2336
2,1482,2384,755,2964,3719
2,461,742,295,922,1217
19,2,5,40,38,78
29,2,5,61,58,119
18,2,5,38,36,74
16,2,5,34,32,66
3,4,10,17,12,29
25,4,10,145,100,245
22,2,5,42,44,86
7,2,5,13,14,27
10,3,9,48,30,78
12,3,9,58,36,94
1,3,9,4,3,7
2,3,9,9,6,15
1,2,5,3,2,5
5,2,5,14,10,24
13,7,9,11,91,102
26,7,9,47,182,229
20,7,9,0,140,140
21,3,8,98,63,161
4,8,22,50,32,82
5,8,22,50,40,90
9,8,22,122,72,194
16,8,22,178,128,306
22,8,22,245,176,421
11,9,24,160,99,259
3,9,24,33,27,60
3,9,24,32,27,59
4,9,24,58,36,94
9,13,35,132,117,249
5,13,35,87,65,152
29,13,35,618,377,995
16,13,35,346,208,554
9,13,35,157,117,274
21,13,35,366,273,639
13,13,35,227,169,396
20,13,35,426,260,686
2,13,35,29,26,55
21,13,35,433,273,706
7,13,35,110,91,201
19,13,35,411,247,658
13,13,35,277,169,446
6,13,35,86,78,164
29,13,35,597,377,974
4,13,35,70,52,122
17,13,35,297,221,518
30,21,55,806,630,1436
27,38,50,149,1026,1175
30,42,54,149,1260,1409
17,38,50,187,646,833
9,42,54,45,378,423
15,42,54,50,630,680
9,38,50,9,342,351
16,42,54,175,672,847
25,38,50,100,950,1050
1,1898,3375,1038,1898,2936
3,1266,2320,1631,3798,5429
2,1252,2295,1765,2504,4269
1,1266,2320,752,1266,2018
1,1252,2295,630,1252,1882
2,420,769,498,840,1338
1,1266,2320,636,1266,1902
1,1252,2295,1020,1252,2272
3,2171,3578,4006,6513,10519
1,2171,3578,1264,2171,3435
1,1555,2443,839,1555,2394
1,2171,3578,942,2171,3113
1,1555,2443,351,1555,1906
1,344,540,185,344,529
1,344,540,83,344,427
2,344,540,198,688,886
1,2171,3578,1335,2171,3506
7,26,70,230,182,412
17,26,70,736,442,1178
9,1,2,7,9,16
27,1,2,20,27,47
27,1,2,20,27,47
14,13,35,298,182,480
21,13,35,447,273,720
2,13,35,43,26,69
17,2,5,49,34,83
4,2,5,11,8,19
6,13,35,130,78,208
8,13,35,173,104,277
1,13,35,22,13,35
4,2,5,9,8,17
9,2,5,21,18,39
14,1,2,14,14,28
14,1,4,30,14,44
22,1,4,47,22,69
8,1,4,17,8,25
9,13,35,192,117,309
23,13,35,490,299,789
9,1,4,19,9,28
27,1,4,58,27,85
22,2,5,42,44,86
12,2,5,34,24,58
12,2,5,28,24,52
15,2,5,35,30,65
17,2,5,45,34,79
20,2,5,53,40,93
25,2,5,66,50,116
20,2,5,59,40,99
5,2,5,15,10,25
15,1,4,37,15,52
27,1,4,67,27,94
27,2,5,63,54,117
11,2,5,26,22,48
17,1,2,17,17,34
28,1,2,27,28,55
28,1,2,27,28,55
4,2,5,12,8,20
12,2,5,35,24,59
1,2,5,3,2,5
18,8,21,185,144,329
29,8,21,298,232,530
1,1482,2384,473,1482,1955
1,755,1215,193,755,948
1,755,1215,436,755,1191
5,24,64,194,120,314
14,45,120,1033,630,1663
4,59,159,260,236,496
7,2,5,21,14,35
26,2,5,77,52,129
1,2,5,3,2,5
12,2,5,35,24,59
15,3,9,68,45,113
16,3,9,73,48,121
21,2,5,48,42,90
8,2,5,18,16,34
29,2,5,61,58,119
1,2,5,2,2,4
13,2,5,31,26,57
5,3,9,27,15,42
16,3,9,86,48,134
17,3,9,99,51,150
12,3,9,70,36,106
17,2,5,49,34,83
5,3,9,29,15,44
8,4,10,37,32,69
17,4,10,78,68,146
30,2,5,71,60,131
6,2,5,14,12,26
23,2,5,68,46,114
8,2,5,24,16,40
18,7,9,33,126,159
13,7,9,18,91,109
8,7,9,15,56,71
14,7,9,25,98,123
2,3,8,6,6,12
21,3,8,98,63,161
15,3,8,58,45,103
11,8,22,120,88,208
11,8,22,149,88,237
3,8,22,39,24,63
4,8,22,52,32,84
1,8,22,14,8,22
28,8,22,386,224,610
8,9,24,116,72,188
13,9,24,154,117,271
4,13,35,85,52,137
28,13,35,459,364,823
32,13,35,682,416,1098
14,13,35,303,182,485
2,13,35,29,26,55
7,13,35,137,91,228
11,13,35,215,143,358
21,13,35,447,273,720
14,13,35,239,182,421
8,13,35,140,104,244
2,13,35,43,26,69
17,13,35,267,221,488
28,13,35,596,364,960
12,13,35,205,156,361
14,13,35,288,182,470
1,13,35,21,13,34
10,13,35,206,130,336
16,13,35,341,208,549
29,13,35,628,377,1005
18,13,35,283,234,517
11,21,55,265,231,496
15,21,55,452,315,767
3,21,55,100,63,163
14,21,55,445,294,739
19,21,55,479,399,878
10,42,54,115,420,535
28,38,50,238,1064,1302
11,38,50,127,418,545
2,38,50,17,76,93
18,38,50,198,684,882
1,1252,2295,676,1252,1928
1,1252,2295,630,1252,1882
1,1252,2295,997,1252,2249
1,1252,2295,951,1252,2203
1,1252,2295,722,1252,1974
1,308,565,234,308,542
3,308,565,754,924,1678
1,713,1120,385,713,1098
1,344,540,185,344,529
1,487,783,155,487,642
2,2171,3578,1884,4342,6226
1,344,540,120,344,464
2,1083,1701,624,2166,2790
1,1083,1701,499,1083,1582
1,2171,3578,1371,2171,3542
3,713,1120,1087,2139,3226
1,1555,2443,864,1555,2419
1,713,1120,329,713,1042
3,344,540,248,1032,1280
2,2171,3578,1812,4342,6154
1,2171,3578,1335,2171,3506
3,26,70,130,78,208
25,3,9,148,75,223
4,3,9,24,12,36
26,3,9,154,78,232
9,3,9,51,27,78
13,3,9,76,39,115
4,1,2,4,4,8
8,2,5,24,16,40
7,2,5,21,14,35
4,2,5,12,8,20
31,2,5,91,62,153
6,2,5,18,12,30
1,2,5,3,2,5
19,13,35,405,247,652
6,1,2,3,6,9
12,2,5,35,24,59
12,2,5,35,24,59
20,1,2,19,20,39
7,2,5,19,14,33
12,2,5,32,24,56
7,2,5,19,14,33
23,2,5,54,46,100
31,11,30,552,341,893
19,11,30,338,209,547
23,2,5,53,46,99
2,2,5,5,4,9
23,12,33,430,276,706
12,12,33,224,144,368
32,1,2,22,32,54
6,11,30,74,66,140
27,9,25,405,243,648
26,9,25,390,234,624
22,11,29,281,242,523
19,9,25,285,171,456
28,9,25,420,252,672
30,2,5,87,60,147
23,2,5,67,46,113
26,2,5,75,52,127
15,1,2,9,15,24
13,1,2,8,13,21
20,1,2,19,20,39
12,1,2,12,12,24
12,9,25,186,108,294
20,1,4,49,20,69
1,1482,2384,401,1482,1883
2,755,1215,750,1510,2260
1,1482,2384,878,1482,2360
1,1482,2384,854,1482,2336
1,1482,2384,592,1482,2074
3,755,1215,1307,2265,3572
16,24,64,630,384,1014
23,24,64,905,552,1457
6,59,159,447,354,801
1,59,159,71,59,130
1,2,5,3,2,5
15,4,10,87,60,147
11,4,10,64,44,108
17,2,5,50,34,84
19,2,5,55,38,93
28,2,5,81,56,137
17,2,5,32,34,66
2,2,5,5,4,9
27,2,5,62,54,116
12,2,5,35,24,59
5,2,5,15,10,25
24,2,5,71,48,119
27,2,5,80,54,134
6,2,5,18,12,30
1,2,5,3,2,5
8,3,9,47,24,71
22,3,9,130,66,196
10,3,9,59,30,89
30,3,9,177,90,267
21,7,9,40,147,187
19,7,9,-3,133,130
16,7,9,31,112,143
10,7,9,4,70,74
30,7,9,55,210,265
23,7,9,44,161,205
19,7,9,35,133,168
17,7,9,31,119,150
19,7,9,31,133,164
6,7,9,10,42,52
29,3,8,140,87,227
14,3,8,69,42,111
24,8,22,325,192,517
3,8,22,41,24,65
9,8,22,124,72,196
8,8,22,110,64,174
10,8,22,138,80,218
2,8,22,22,16,38
25,9,24,243,225,468
28,9,24,279,252,531
5,9,24,74,45,119
13,13,35,277,169,446
16,13,35,279,208,487
27,13,35,396,351,747
19,13,35,411,247,658
18,13,35,390,234,624
10,13,35,182,130,312
18,13,35,308,234,542
21,13,35,359,273,632
2,13,35,43,26,69
20,13,35,412,260,672
13,13,35,277,169,446
18,13,35,390,234,624
2,13,35,43,26,69
12,13,35,256,156,412
2,13,35,31,26,57
7,13,35,125,91,216
10,13,35,147,130,277
22,13,35,315,286,601
20,13,35,433,260,693
1,13,35,15,13,28
3,21,55,95,63,158
26,38,50,0,988,988
25,38,50,288,950,1238
29,38,50,29,1102,1131
10,38,50,65,380,445
9,42,54,89,378,467
11,38,50,121,418,539
23,38,50,253,874,1127
2,42,54,1,84,85
6,42,54,66,252,318
23,38,50,253,874,1127
1,1266,2320,961,1266,2227
3,1252,2295,2234,3756,5990
3,420,769,1001,1260,2261
2,1252,2295,1581,2504,4085
2,1266,2320,2015,2532,4547
1,308,565,251,308,559
3,420,769,747,1260,2007
1,295,540,234,295,529
1,1252,2295,1020,1252,2272
1,308,565,251,308,559
3,1266,2320,3023,3798,6821
3,2171,3578,2933,6513,9446
1,2171,3578,1264,2171,3435
1,2171,3578,1264,2171,3435
1,344,540,120,344,464
1,1083,1701,550,1083,1633
1,2171,3578,1335,2171,3506
12,26,70,511,312,823
19,1,2,11,19,30
11,2,5,26,22,48
1,2,5,2,2,4
12,2,5,34,24,58
28,2,5,66,56,122
30,2,5,71,60,131
22,2,5,52,44,96
29,2,5,68,58,126
7,1,2,7,7,14
14,1,4,41,14,55
6,1,4,18,6,24
27,11,29,455,297,752
23,11,29,387,253,640
25,11,30,468,275,743
6,9,25,65,54,119
5,9,25,54,45,99
28,1,2,27,28,55
22,1,2,22,22,44
2,1,2,2,2,4
12,9,25,171,108,279
7,9,25,100,63,163
4,2,5,12,8,20
25,2,5,74,50,124
27,2,5,80,54,134
26,2,5,77,52,129
20,2,5,59,40,99
16,2,5,38,32,70
14,2,5,37,28,65
31,2,5,91,62,153
27,2,5,80,54,134
20,1,4,59,20,79
15,2,5,44,30,74
17,2,5,49,34,83
18,2,5,53,36,89
15,8,21,189,120,309
8,8,21,101,64,165
14,9,25,179,126,305
8,9,25,102,72,174
26,1,4,76,26,102
12,1,4,35,12,47
23,1,2,23,23,46
1,1,2,1,1,2
13,1,2,13,13,26
1,2,5,2,2,4
26,2,5,60,52,112
25,1,4,57,25,82
1,1,4,2,1,3
15,1,4,35,15,50
8,1,4,19,8,27
24,2,5,67,48,115
5,2,5,14,10,24
18,1,2,13,18,31
21,1,4,45,21,66
21,1,4,45,21,66
19,1,2,11,19,30
13,1,2,7,13,20
23,1,4,65,23,88
11,1,4,31,11,42
23,1,4,65,23,88
5,2,5,14,10,24
9,1,2,5,9,14
26,1,2,15,26,41
14,1,4,32,14,46
26,11,29,332,286,618
28,11,29,358,308,666
1,1482,2384,401,1482,1883
1,1482,2384,473,1482,1955
1,461,742,229,461,690
1,461,742,274,461,735
1,1482,2384,854,1482,2336
2,461,742,503,922,1425
16,24,64,507,384,891
14,24,64,444,336,780
9,45,120,535,405,940
3,45,120,218,135,353
8,59,159,775,472,1247
22,2,5,65,44,109
24,2,5,71,48,119
1,2,5,3,2,5
28,2,5,78,56,134
10,2,5,30,20,50
5,3,9,21,15,36
7,2,5,20,14,34
4,2,5,8,8,16
1,2,5,3,2,5
6,4,10,35,24,59
4,3,9,16,12,28
19,3,9,78,57,135
27,4,10,113,108,221
12,4,10,50,48,98
2,4,10,8,8,16
9,4,10,34,36,70
4,2,5,11,8,19
13,2,5,36,26,62
4,4,10,18,16,34
6,4,10,23,24,47
14,4,10,55,56,111
6,7,9,11,42,53
4,7,9,2,28,30
10,7,9,7,70,77
26,7,9,1,182,183
5,7,9,-1,35,34
29,7,9,3,203,206
23,3,8,108,69,177
14,3,8,45,42,87
18,8,22,197,144,341
15,8,22,203,120,323
15,8,22,151,120,271
20,8,22,210,160,370
6,8,22,60,48,108
10,8,22,94,80,174
3,9,24,44,27,71
17,9,24,202,153,355
4,9,24,56,36,92
1,9,24,15,9,24
10,9,24,145,90,235
6,9,24,58,54,112
9,13,35,192,117,309
25,13,35,436,325,761
14,13,35,288,182,470
7,13,35,110,91,201
13,13,35,213,169,382
4,13,35,57,52,109
26,13,35,372,338,710
5,13,35,87,65,152
11,13,35,238,143,381
22,13,35,345,286,631
26,13,35,563,338,901
16,13,35,346,208,554
10,13,35,213,130,343
19,13,35,312,247,559
18,13,35,295,234,529
18,13,35,308,234,542
4,13,35,82,52,134
11,13,35,227,143,370
5,13,35,68,65,133
24,13,35,377,312,689
9,13,35,192,117,309
17,21,55,456,357,813
5,21,55,112,105,217
30,21,55,806,630,1436
21,38,50,84,798,882
9,42,54,89,378,467
19,42,54,207,798,1005
22,38,50,253,836,1089
1,1912,3400,1352,1912,3264
3,1912,3400,2322,5736,8058
3,1912,3400,3138,5736,8874
3,1266,2320,2884,3798,6682
1,1252,2295,745,1252,1997
3,1266,2320,3023,3798,6821
1,1252,2295,951,1252,2203
2,420,769,498,840,1338
2,420,769,375,840,1215
1,1252,2295,630,1252,1882
3,2171,3578,1860,6513,8373
3,713,1120,1154,2139,3293
3,2171,3578,1967,6513,8480
2,2171,3578,1884,4342,6226
2,1555,2443,994,3110,4104
1,1083,1701,312,1083,1395
1,2171,3578,1371,2171,3542
1,487,783,132,487,619
12,26,70,511,312,823
25,26,70,785,650,1435
16,26,70,693,416,1109
1,3,9,5,3,8
1,3,9,5,3,8
4,3,9,18,12,30
22,3,9,130,66,196
30,13,35,429,390,819
14,13,35,298,182,480
12,13,35,256,156,412
12,13,35,256,156,412
3,9,25,36,27,63
16,9,25,192,144,336
3,2,5,8,6,14
4,2,5,11,8,19
12,1,2,9,12,21
13,1,2,10,13,23
8,1,2,6,8,14
17,1,4,50,17,67
17,1,4,50,17,67
23,1,2,17,23,40
18,1,2,13,18,31
13,2,5,30,26,56
6,2,5,14,12,26
6,1,2,4,6,10
15,1,2,11,15,26
7,11,29,118,77,195
13,11,29,219,143,362
24,13,35,343,312,655
24,13,35,343,312,655
19,13,35,272,247,519
18,1,2,10,18,28
1,1,2,1,1,2
18,1,2,10,18,28
3,9,25,45,27,72
15,9,25,225,135,360
6,2,5,17,12,29
6,2,5,17,12,29
15,2,5,44,30,74
17,1,2,10,17,27
18,1,2,17,18,35
18,1,2,17,18,35
26,1,2,25,26,51
18,1,2,17,18,35
20,2,5,59,40,99
28,2,5,83,56,139
27,2,5,80,54,134
1,2,5,3,2,5
28,1,4,68,28,96
5,1,4,12,5,17
8,1,4,18,8,26
14,1,4,32,14,46
23,2,5,54,46,100
9,9,25,95,81,176
20,2,5,59,40,99
19,2,5,56,38,94
17,1,2,17,17,34
30,1,2,29,30,59
31,1,4,76,31,107
12,1,4,29,12,41
16,1,4,39,16,55
27,1,2,14,27,41
26,1,2,14,26,40
16,8,21,164,128,292
25,1,2,19,25,44
17,1,2,13,17,30
1,1482,2384,878,1482,2360
2,461,742,295,922,1217
6,4,10,35,24,59
6,4,10,35,24,59
23,4,10,136,92,228
10,4,10,59,40,99
32,2,5,94,64,158
21,2,5,62,42,104
28,2,5,83,56,139
6,2,5,18,12,30
8,2,5,24,16,40
23,2,5,54,46,100
22,2,5,52,44,96
8,2,5,19,16,35
16,2,5,30,32,62
12,2,5,23,24,47
13,2,5,25,26,51
5,2,5,10,10,20
10,2,5,29,20,49
16,2,5,46,32,78
25,7,9,46,175,221
22,7,9,36,154,190
19,7,9,35,133,168
27,3,8,90,81,171
20,9,24,295,180,475
14,9,24,197,126,323
1,9,24,12,9,21
1,13,35,22,13,35
20,13,35,426,260,686
26,13,35,563,338,901
27,13,35,471,351,822
4,13,35,57,52,109
16,21,55,386,336,722
15,21,55,337,315,652
1,21,55,22,21,43
6,38,50,66,228,294
11,42,54,126,462,588
13,38,50,20,494,514
1,42,54,8,42,50
9,38,50,104,342,446
10,38,50,110,380,490
12,38,50,120,456,576
13,42,54,30,546,576
1,1252,2295,905,1252,2157
2,1252,2295,1260,2504,3764
2,420,769,375,840,1215
1,1252,2295,768,1252,2020
1,1266,2320,544,1266,1810
1,1083,1701,601,1083,1684
1,1519,2443,753,1519,2272
3,713,1120,1187,2139,3326
1,344,540,185,344,529
1,713,1120,396,713,1109
2,344,540,154,688,842
1,344,540,185,344,529
3,344,540,523,1032,1555
1,487,783,194,487,681
1,344,540,174,344,518
2,2171,3578,2671,4342,7013
25,26,70,1030,650,1680
1,26,70,43,26,69
8,26,70,341,208,549
16,3,9,93,48,141
2,3,9,8,6,14
25,1,2,24,25,49
12,1,2,12,12,24
15,2,5,29,30,59
13,1,2,12,13,25
15,2,5,29,30,59
13,1,4,32,13,45
12,13,35,247,156,403
30,13,35,618,390,1008
29,8,21,243,232,475
5,2,5,15,10,25
11,2,5,32,22,54
4,1,2,4,4,8
25,1,2,25,25,50
1,1,2,1,1,2
13,1,2,12,13,25
16,2,5,45,32,77
29,11,30,534,319,853
1,1,4,2,1,3
27,1,4,62,27,89
10,1,2,9,10,19
9,1,2,8,9,17
24,1,2,22,24,46
1,1482,2384,807,1482,2289
3,1482,2384,1133,4446,5579
5,24,64,197,120,317
7,24,64,181,168,349
9,24,64,354,216,570
7,45,120,491,315,806
7,59,159,689,413,1102
24,2,5,56,48,104
19,4,10,112,76,188
6,4,10,35,24,59
12,4,10,71,48,119
29,2,5,86,58,144
22,2,5,65,44,109
1,2,5,3,2,5
12,3,9,55,36,91
23,3,9,105,69,174
23,2,5,61,46,107
13,2,5,34,26,60
6,2,5,17,12,29
30,2,5,87,60,147
25,3,9,134,75,209
1,3,9,5,3,8
12,2,5,28,24,52
8,2,5,19,16,35
15,7,9,8,105,113
27,7,9,15,189,204
11,7,9,20,77,97
4,7,9,2,28,30
6,7,9,5,42,47
2,7,9,0,14,14
10,8,22,138,80,218
9,8,22,122,72,194
12,8,22,165,96,261
14,8,22,190,112,302
9,8,22,98,72,170
1,8,22,14,8,22
13,8,22,179,104,283
2,8,22,21,16,37
12,8,22,165,96,261
27,9,24,392,243,635
19,9,24,226,171,397
28,9,24,272,252,524
4,9,24,59,36,95
13,13,35,281,169,450
6,13,35,86,78,164
29,13,35,415,377,792
25,13,35,533,325,858
4,13,35,82,52,134
30,13,35,524,390,914
8,13,35,173,104,277
9,13,35,148,117,265
11,13,35,238,143,381
27,13,35,575,351,926
22,13,35,384,286,670
19,13,35,272,247,519
6,13,35,98,78,176
10,13,35,143,130,273
29,13,35,476,377,853
1,13,35,22,13,35
7,13,35,144,91,235
12,13,35,235,156,391
22,13,35,476,286,762
3,13,35,65,39,104
11,13,35,227,143,370
3,13,35,46,39,85
4,13,35,85,52,137
5,21,55,165,105,270
23,42,54,115,966,1081
6,38,50,24,228,252
11,42,54,55,462,517
23,38,50,23,874,897
24,42,54,107,1008,1115
1,1252,2295,561,1252,1813
1,1252,2295,997,1252,2249
1,1266,2320,1031,1266,2297
1,1252,2295,745,1252,1997
2,1266,2320,2015,2532,4547
1,1252,2295,538,1252,1790
1,1266,2320,544,1266,1810
1,1266,2320,961,1266,2227
1,420,769,249,420,669
1,1252,2295,1020,1252,2272
1,2171,3578,620,2171,2791
3,2171,3578,2504,6513,9017
1,2171,3578,942,2171,3113
1,1083,1701,244,1083,1327
1,487,783,265,487,752
1,344,540,185,344,529
2,1083,1701,692,2166,2858
1,344,540,174,344,518
1,344,540,174,344,518
12,26,70,520,312,832
23,26,70,754,598,1352
1,3,9,5,3,8
8,1,2,4,8,12
8,1,2,4,8,12
22,1,2,12,22,34
5,1,2,3,5,8
2,1,2,1,2,3
15,1,2,11,15,26
29,13,35,618,377,995
14,13,35,298,182,480
1,2,5,3,2,5
27,2,5,80,54,134
12,2,5,25,24,49
19,2,5,40,38,78
6,2,5,13,12,25
23,1,4,68,23,91
26,1,4,77,26,103
5,1,4,15,5,20
5,1,4,14,5,19
7,1,4,20,7,27
4,1,2,2,4,6
21,1,2,11,21,32
25,1,2,13,25,38
1,2,5,3,2,5
1,2,5,3,2,5
18,13,35,390,234,624
7,2,5,13,14,27
23,2,5,44,46,90
24,2,5,46,48,94
21,2,5,40,42,82
6,2,5,11,12,23
24,2,5,46,48,94
31,2,5,56,62,118
7,2,5,13,14,27
23,2,5,54,46,100
19,2,5,45,38,83
26,1,2,15,26,41
15,1,2,9,15,24
24,8,21,246,192,438
1,8,21,10,8,18
11,8,21,113,88,201
15,1,4,35,15,50
4,1,4,9,4,13
25,1,2,24,25,49
17,2,5,49,34,83
26,2,5,75,52,127
31,1,2,30,31,61
5,1,2,5,5,10
9,2,5,26,18,44
6,8,21,75,48,123
5,8,21,63,40,103
19,8,21,239,152,391
15,2,5,35,30,65
11,2,5,24,22,46
19,2,5,42,38,80
26,2,5,53,52,105
20,2,5,41,40,81
3,1,4,7,3,10
1,755,1215,448,755,1203
1,1482,2384,735,1482,2217
2,1482,2384,1709,2964,4673
3,461,742,554,1383,1937
24,24,64,622,576,1198
3,24,64,118,72,190
6,45,120,421,270,691
24,2,5,71,48,119
20,2,5,59,40,99
20,2,5,59,40,99
23,2,5,68,46,114
9,3,9,41,27,68
1,3,9,5,3,8
4,2,5,12,8,20
11,2,5,32,22,54
1,2,5,3,2,5
2,4,10,12,8,20
12,3,9,53,36,89
15,3,9,66,45,111
32,4,10,150,128,278
21,4,10,99,84,183
1,3,9,6,3,9
15,3,9,85,45,130
20,3,9,107,60,167
4,3,9,21,12,33
28,2,5,78,56,134
26,4,10,151,104,255
4,4,10,23,16,39
23,2,5,64,46,110
24,2,5,56,48,104
9,2,5,21,18,39
32,2,5,93,64,157
19,2,5,55,38,93
9,7,9,12,63,75
14,7,9,0,98,98
23,7,9,9,161,170
21,7,9,34,147,181
25,3,8,121,75,196
23,3,8,113,69,182
28,3,8,91,84,175
20,3,8,94,60,154
2,3,8,6,6,12
10,8,22,136,80,216
14,8,22,147,112,259
10,8,22,92,80,172
30,8,22,275,240,515
9,8,22,124,72,196
25,8,22,339,200,539
9,8,22,118,72,190
14,8,22,156,112,268
1,9,24,15,9,24
24,9,24,354,216,570
2,9,24,30,18,48
3,9,24,42,27,69
20,13,35,293,260,553
1,13,35,21,13,34
1,13,35,22,13,35
26,13,35,563,338,901
1,13,35,20,13,33
6,13,35,130,78,208
7,13,35,149,91,240
29,13,35,618,377,995
27,13,35,528,351,879
12,13,35,247,156,403
2,13,35,35,26,61
12,13,35,172,156,328
5,13,35,103,65,168
16,13,35,330,208,538
11,13,35,238,143,381
13,13,35,254,169,423
27,13,35,556,351,907
28,13,35,596,364,960
8,13,35,173,104,277
20,13,35,314,260,574
9,13,35,157,117,274
19,13,35,391,247,638
1,13,35,17,13,30
7,13,35,144,91,235
1,21,55,27,21,48
8,21,55,263,168,431
19,42,54,187,798,985
14,42,54,70,588,658
21,42,54,71,882,953
10,38,50,0,380,380
3,42,54,0,126,126
27,38,50,230,1026,1256
9,38,50,9,342,351
30,38,50,300,1140,1440
1,42,54,2,42,44
1,1266,2320,497,1266,1763
1,1252,2295,538,1252,1790
1,1252,2295,997,1252,2249
1,1252,2295,882,1252,2134
2,1266,2320,1366,2532,3898
1,1252,2295,676,1252,1928
1,1266,2320,1008,1266,2274
1,1252,2295,951,1252,2203
2,1266,2320,1505,2532,4037
1,1252,2295,745,1252,1997
1,308,565,234,308,542
1,295,540,234,295,529
1,1266,2320,544,1266,1810
2,713,1120,769,1426,2195
1,487,783,280,487,767
1,1083,1701,601,1083,1684
3,1519,2443,2479,4557,7036
1,1083,1701,499,1083,1582
2,1083,1701,998,2166,3164
2,2171,3578,1884,4342,6226
1,713,1120,362,713,1075
1,713,1120,161,713,874
3,1519,2443,1819,4557,6376
1,1519,2443,411,1519,1930
1,344,540,158,344,502
1,1083,1701,312,1083,1395
3,344,540,523,1032,1555
1,487,783,194,487,681
1,344,540,83,344,427
2,344,540,349,688,1037
18,26,70,515,468,983
11,26,70,469,286,755
13,26,70,381,338,719
3,3,9,14,9,23
4,3,9,16,12,28
17,3,9,91,51,142
20,3,9,97,60,157
29,3,9,171,87,258
4,1,2,4,4,8
30,1,2,29,30,59
19,13,35,272,247,519
17,1,2,17,17,34
25,2,5,48,50,98
15,2,5,29,30,59
10,2,5,19,20,39
20,1,2,20,20,40
11,1,2,11,11,22
23,1,2,23,23,46
3,1,2,3,3,6
15,12,33,295,180,475
8,13,35,173,104,277
26,13,35,563,338,901
11,13,35,238,143,381
27,13,35,585,351,936
32,13,35,693,416,1109
23,13,35,393,299,692
4,13,35,68,52,120
21,1,2,21,21,42
15,1,2,14,15,29
18,1,2,17,18,35
24,2,5,67,48,115
16,2,5,45,32,77
17,2,5,48,34,82
17,2,5,48,34,82
7,1,2,7,7,14
18,1,2,17,18,35
11,9,25,140,99,239
9,9,25,115,81,196
8,9,25,114,72,186
8,2,5,24,16,40
3,2,5,9,6,15
3,2,5,7,6,13
24,2,5,55,48,103
17,1,2,10,17,27
14,1,2,8,14,22
26,1,2,15,26,41
16,2,5,31,32,63
4,2,5,8,8,16
13,1,2,10,13,23
15,1,2,14,15,29
8,1,2,8,8,16
20,1,2,19,20,39
12,2,5,23,24,47
1,9,25,16,9,25
3,755,1215,906,2265,3171
1,461,742,125,461,586
3,1482,2384,1133,4446,5579
3,1482,2384,1419,4446,5865
28,24,64,995,672,1667
15,24,64,389,360,749
15,2,5,42,30,72
10,2,5,28,20,48
10,2,5,28,20,48
11,2,5,21,22,43
1,2,5,2,2,4
31,2,5,90,62,152
18,2,5,52,36,88
22,4,10,101,88,189
14,4,10,64,56,120
1,2,5,3,2,5
27,4,10,103,108,211
4,4,10,15,16,31
14,4,10,53,56,109
27,3,9,111,81,192
26,3,9,107,78,185
31,4,10,118,124,242
16,4,10,61,64,125
7,3,9,41,21,62
25,3,9,146,75,221
3,3,9,13,9,22
20,3,9,88,60,148
12,2,5,23,24,47
23,2,5,44,46,90
30,7,9,1,210,211
21,7,9,8,147,155
13,3,8,50,39,89
12,3,8,59,36,95
8,3,8,39,24,63
9,8,22,94,72,166
9,8,22,100,72,172
5,8,22,69,40,109
29,8,22,291,232,523
13,9,24,192,117,309
27,9,24,269,243,512
21,13,35,447,273,720
20,13,35,426,260,686
4,13,35,70,52,122
5,13,35,103,65,168
20,13,35,314,260,574
6,13,35,105,78,183
26,13,35,381,338,719
21,13,35,433,273,706
31,13,35,671,403,1074
13,13,35,277,169,446
23,21,55,731,483,1214
18,21,55,434,378,812
4,21,55,96,84,180
20,21,55,526,420,946
20,42,54,197,840,1037
26,42,54,256,1092,1348
26,42,54,115,1092,1207
2,38,50,3,76,79
20,42,54,218,840,1058
23,38,50,127,874,1001
26,38,50,286,988,1274
2,1266,2320,1922,2532,4454
2,1252,2295,1902,2504,4406
1,1266,2320,683,1266,1949
3,1266,2320,2257,3798,6055
1,1266,2320,683,1266,1949
1,1266,2320,1031,1266,2297
1,1252,2295,997,1252,2249
1,420,769,249,420,669
1,2171,3578,1335,2171,3506
2,713,1120,500,1426,1926
1,344,540,126,344,470
1,344,540,77,344,421
1,1083,1701,550,1083,1633
2,487,783,263,974,1237
26,26,70,1126,676,1802
24,26,70,838,624,1462
9,26,70,383,234,617
5,3,9,28,15,43
21,3,9,122,63,185
3,1,2,2,3,5
18,1,2,18,18,36
9,1,2,9,9,18
9,1,2,9,9,18
27,1,2,26,27,53
24,2,5,70,48,118
22,1,4,65,22,87
2,1,2,1,2,3
14,12,33,211,168,379
27,1,2,19,27,46
8,1,2,6,8,14
4,2,5,9,8,17
23,1,4,52,23,75
15,11,29,253,165,418
26,11,29,438,286,724
6,9,25,69,54,123
9,9,25,104,81,185
26,1,2,15,26,41
13,1,2,8,13,21
24,1,2,22,24,46
5,1,2,5,5,10
26,1,2,15,26,41
29,2,5,86,58,144
25,2,5,74,50,124
1,12,33,14,12,26
17,12,33,234,204,438
15,12,33,206,180,386
3,1,4,9,3,12
25,1,4,73,25,98
4,2,5,9,8,17
14,2,5,33,28,61
12,2,5,28,24,52
27,1,4,79,27,106
22,1,4,64,22,86
29,1,4,85,29,114
15,1,4,44,15,59
16,1,2,15,16,31
23,1,2,22,23,45
1,461,742,251,461,712
1,1482,2384,592,1482,2074
1,1482,2384,473,1482,1955
2,1482,2384,1709,2964,4673
1,755,1215,193,755,948
1,755,1215,436,755,1191
1,461,742,147,461,608
8,24,64,228,192,420
5,24,64,130,120,250
8,45,120,590,360,950
12,45,120,713,540,1253
1,45,120,73,45,118
11,59,159,1065,649,1714
3,59,159,290,177,467
10,2,5,21,20,41
25,2,5,53,50,103
8,2,5,22,16,38
26,2,5,73,52,125
20,2,5,38,40,78
7,2,5,13,14,27
10,2,5,21,20,41
11,2,5,23,22,45
18,4,10,106,72,178
4,4,10,24,16,40
15,2,5,44,30,74
18,2,5,52,36,88
5,2,5,11,10,21
6,2,5,17,12,29
16,2,5,30,32,62
13,2,5,25,26,51
22,7,9,2,154,156
13,7,9,25,91,116
25,7,9,14,175,189
7,7,9,11,49,60
5,7,9,4,35,39
4,7,9,0,28,28
18,7,9,7,126,133
8,7,9,3,56,59
30,7,9,57,210,267
19,3,8,92,57,149
7,3,8,34,21,55
29,3,8,108,87,195
13,8,22,113,104,217
25,8,22,339,200,539
11,8,22,152,88,240
18,8,22,224,144,368
22,8,22,298,176,474
11,8,22,144,88,232
29,8,22,266,232,498
14,8,22,141,112,253
12,8,22,163,96,259
21,8,22,289,168,457
16,9,24,156,144,300
17,9,24,239,153,392
16,9,24,156,144,300
18,9,24,210,162,372
5,9,24,49,45,94
22,13,35,322,286,608
14,13,35,288,182,470
3,13,35,47,39,86
3,13,35,59,39,98
1,13,35,16,13,29
24,13,35,343,312,655
25,13,35,358,325,683
5,13,35,107,65,172
4,13,35,59,52,111
5,13,35,107,65,172
26,13,35,554,338,892
32,13,35,458,416,874
24,13,35,520,312,832
9,13,35,192,117,309
14,13,35,239,182,421
9,13,35,129,117,246
27,13,35,386,351,737
12,13,35,247,156,403
15,13,35,220,195,415
3,21,55,67,63,130
22,42,54,15,924,939
16,42,54,183,672,855
29,42,54,317,1218,1535
5,38,50,50,190,240
17,38,50,170,646,816
9,42,54,1,378,379
13,38,50,150,494,644
20,38,50,110,760,870
7,38,50,81,266,347
8,42,54,40,336,376
8,42,54,18,336,354
1,1912,3400,774,1912,2686
1,1912,3400,1352,1912,3264
2,1252,2295,1994,2504,4498
1,1266,2320,497,1266,1763
2,1266,2320,1783,2532,4315
1,1252,2295,951,1252,2203
1,1252,2295,997,1252,2249
2,1266,2320,1087,2532,3619
1,420,769,341,420,761
2,420,769,421,840,1261
1,1252,2295,722,1252,1974
2,1266,2320,2015,2532,4547
3,1266,2320,3092,3798,6890
1,1252,2295,951,1252,2203
1,1266,2320,544,1266,1810
1,1252,2295,997,1252,2249
2,1266,2320,2015,2532,4547
2,2171,3578,1526,4342,5868
1,1555,2443,864,1555,2419
1,2171,3578,620,2171,2791
3,2171,3578,1860,6513,8373
3,2171,3578,2504,6513,9017
2,1083,1701,1100,2166,3266
1,1555,2443,570,1555,2125
1,344,540,158,344,502
2,487,783,263,974,1237
2,2171,3578,2671,4342,7013
2,344,540,349,688,1037
20,26,70,572,520,1092
1,3,9,5,3,8
24,1,2,23,24,47
26,1,2,25,26,51
28,1,2,27,28,55
6,9,25,95,54,149
25,1,2,25,25,50
22,13,35,469,286,755
27,13,35,575,351,926
10,2,5,21,20,41
2,2,5,4,4,8
12,1,2,8,12,20
11,1,2,7,11,18
18,11,29,287,198,485
7,11,29,112,77,189
1,9,25,13,9,22
16,2,5,47,32,79
13,2,5,38,26,64
26,2,5,77,52,129
11,1,2,6,11,17
15,9,25,161,135,296
31,9,25,333,279,612
28,9,25,322,252,574
24,1,2,24,24,48
20,1,2,20,20,40
20,1,2,20,20,40
6,1,2,6,6,12
26,1,2,25,26,51
3,1,2,3,3,6
19,2,5,53,38,91
31,2,5,87,62,149
27,12,33,558,324,882
12,12,33,248,144,392
18,1,2,17,18,35
18,1,2,17,18,35
25,1,2,24,25,49
16,2,5,47,32,79
27,11,30,497,297,794
9,11,30,166,99,265
7,11,30,89,77,166
31,11,30,394,341,735
17,1,2,12,17,29
1,1,2,1,1,2
17,2,5,40,34,74
6,2,5,14,12,26
27,2,5,63,54,117
20,2,5,58,40,98
30,2,5,87,60,147
16,1,2,15,16,31
8,1,2,8,8,16
8,1,2,8,8,16
8,1,2,8,8,16
9,2,5,24,18,42
7,2,5,19,14,33
8,2,5,21,16,37
12,2,5,23,24,47
18,2,5,34,36,70
21,2,5,44,42,86
12,2,5,25,24,49
11,1,2,6,11,17
17,1,2,10,17,27
1,8,21,10,8,18
18,2,5,34,36,70
2,9,25,25,18,43
5,9,25,63,45,108
27,2,5,78,54,132
2,2,5,6,4,10
25,1,4,71,25,96
20,1,4,57,20,77
16,1,4,45,16,61
19,1,4,54,19,73
3,8,21,35,24,59
3,1482,2384,1204,4446,5650
3,755,1215,797,2265,3062
1,1482,2384,568,1482,2050
1,461,742,229,461,690
20,24,64,518,480,998
28,24,64,1084,672,1756
7,45,120,416,315,731
5,59,159,492,295,787
4,2,5,10,8,18
26,2,5,64,52,116
25,2,5,53,50,103
26,2,5,55,52,107
15,2,5,35,30,65
19,2,5,44,38,82
16,2,5,47,32,79
18,2,5,42,36,78
21,2,5,49,42,91
24,3,9,109,72,181
9,3,9,41,27,68
24,3,9,135,72,207
1,3,9,6,3,9
10,7,9,8,70,78
18,7,9,15,126,141
5,3,8,25,15,40
22,3,8,82,66,148
2,8,22,27,16,43
32,9,24,472,288,760
21,9,24,255,189,444
29,13,35,628,377,1005
21,13,35,455,273,728
25,13,35,393,325,718
29,13,35,415,377,792
24,13,35,410,312,722
6,13,35,117,78,195
11,13,35,161,143,304
14,13,35,249,182,431
29,13,35,506,377,883
21,13,35,433,273,706
6,21,55,201,126,327
24,21,55,790,504,1294
20,21,55,504,420,924
27,21,55,725,567,1292
25,38,50,38,950,988
24,38,50,276,912,1188
12,42,54,1,504,505
12,38,50,18,456,474
13,38,50,143,494,637
4,42,54,20,168,188
17,38,50,51,646,697
5,38,50,28,190,218
31,38,50,155,1178,1333
2,1898,3375,1874,3796,5670
1,1266,2320,961,1266,2227
1,1252,2295,722,1252,1974
1,1266,2320,683,1266,1949
1,1252,2295,951,1252,2203
1,1252,2295,997,1252,2249
2,1252,2295,1994,2504,4498
1,1555,2443,619,1555,2174
1,2171,3578,763,2171,2934
2,344,540,370,688,1058
3,1519,2443,2479,4557,7036
1,2171,3578,942,2171,3113
1,1555,2443,717,1555,2272
2,2171,3578,1311,4342,5653
1,1555,2443,570,1555,2125
1,713,1120,205,713,918
1,713,1120,261,713,974
6,26,70,260,156,416
22,1,2,22,22,44
3,1,2,3,3,6
3,1,2,3,3,6
16,1,2,16,16,32
18,1,2,18,18,36
23,1,2,23,23,46
19,1,2,19,19,38
2,2,5,6,4,10
29,2,5,81,58,139
15,8,21,129,120,249
14,8,21,120,112,232
25,2,5,59,50,109
8,2,5,19,16,35
13,2,5,38,26,64
24,2,5,71,48,119
18,1,4,53,18,71
30,1,2,29,30,59
12,1,2,12,12,24
6,1,4,13,6,19
11,1,4,23,11,34
27,13,35,396,351,747
5,13,35,73,65,138
4,1,2,4,4,8
30,1,2,29,30,59
18,1,4,51,18,69
25,1,4,71,25,96
4,1,4,9,4,13
25,2,5,59,50,109
16,2,5,38,32,70
17,2,5,40,34,74
11,1,2,6,11,17
10,1,4,29,10,39
26,2,5,62,52,114
27,2,5,76,54,130
27,2,5,76,54,130
24,2,5,56,48,104
19,2,5,56,38,94
16,2,5,47,32,79
12,1,4,35,12,47
26,1,4,76,26,102
6,1,4,15,6,21
15,1,4,32,15,47
1,1482,2384,401,1482,1883
3,1482,2384,2563,4446,7009
1,1482,2384,807,1482,2289
8,45,120,590,360,950
8,45,120,590,360,950
24,2,5,47,48,95
11,2,5,21,22,43
15,4,10,84,60,144
14,4,10,78,56,134
3,2,5,6,6,12
21,2,5,40,42,82
12,2,5,35,24,59
10,2,5,29,20,49
16,2,5,38,32,70
11,2,5,24,22,46
23,2,5,51,46,97
1,2,5,2,2,4
31,2,5,65,62,127
8,3,9,47,24,71
23,2,5,64,46,110
4,2,5,11,8,19
18,2,5,50,36,86
12,2,5,26,24,50
23,2,5,51,46,97
27,7,9,44,189,233
6,7,9,1,42,43
29,7,9,24,203,227
19,7,9,31,133,164
22,7,9,40,154,194
23,7,9,0,161,161
3,3,8,15,9,24
5,3,8,24,15,39
14,3,8,55,42,97
7,8,22,80,56,136
26,8,22,238,208,446
13,8,22,131,104,235
12,8,22,165,96,261
6,9,24,73,54,127
14,9,24,166,126,292
26,9,24,384,234,618
18,9,24,222,162,384
15,13,35,309,195,504
4,13,35,57,52,109
16,13,35,234,208,442
19,13,35,338,247,585
31,13,35,487,403,890
16,13,35,330,208,538
27,13,35,575,351,926
21,13,35,433,273,706
23,13,35,377,299,676
23,13,35,377,299,676
24,13,35,394,312,706
27,13,35,585,351,936
2,13,35,34,26,60
22,13,35,453,286,739
15,42,54,164,630,794
17,38,50,187,646,833
10,38,50,100,380,480
8,42,54,18,336,354
6,38,50,6,228,234
24,38,50,264,912,1176
7,38,50,39,266,305
1,38,50,4,38,42
2,38,50,10,76,86
19,42,54,187,798,985
16,38,50,160,608,768
26,42,54,284,1092,1376
24,42,54,81,1008,1089
1,1912,3400,774,1912,2686
1,1898,3375,937,1898,2835
1,1252,2295,882,1252,2134
1,1266,2320,567,1266,1833
1,1252,2295,538,1252,1790
3,295,540,443,885,1328
3,1252,2295,2854,3756,6610
2,1252,2295,1489,2504,3993
1,420,769,318,420,738
1,308,565,234,308,542
3,2171,3578,3792,6513,10305
3,1555,2443,2517,4665,7182
1,713,1120,205,713,918
12,26,70,494,312,806
22,26,70,953,572,1525
31,26,70,1321,806,2127
28,26,70,977,728,1705
10,3,9,56,30,86
7,3,9,34,21,55
20,2,5,58,40,98
6,2,5,17,12,29
18,1,2,10,18,28
12,1,2,7,12,19
18,1,2,10,18,28
18,1,2,10,18,28
10,1,2,6,10,16
1,1,2,1,1,2
11,1,2,10,11,21
19,1,2,17,19,36
4,1,2,4,4,8
17,2,5,39,34,73
23,1,2,21,23,44
27,1,2,25,27,52
30,1,2,28,30,58
18,1,2,15,18,33
27,1,2,23,27,50
15,1,2,13,15,28
26,2,5,49,52,101
20,2,5,38,40,78
15,2,5,42,30,72
5,2,5,14,10,24
20,2,5,56,40,96
10,2,5,28,20,48
7,11,30,125,77,202
27,2,5,59,54,113
7,2,5,15,14,29
18,1,2,18,18,36
26,1,2,25,26,51
16,8,21,164,128,292
14,8,21,144,112,256
24,8,21,246,192,438
3,9,25,36,27,63
22,1,2,22,22,44
15,1,2,15,15,30
14,2,5,41,28,69
19,2,5,56,38,94
21,1,4,54,21,75
1,1,4,3,1,4
4,2,5,8,8,16
19,2,5,40,38,78
5,9,25,78,45,123
1,1482,2384,807,1482,2289
3,1482,2384,2420,4446,6866
1,1482,2384,473,1482,1955
2,461,742,399,922,1321
1,1482,2384,807,1482,2289
1,1482,2384,592,1482,2074
1,461,742,185,461,646
1,1482,2384,854,1482,2336
1,1482,2384,521,1482,2003
21,24,64,813,504,1317
26,24,64,1023,624,1647
10,45,120,726,450,1176
9,3,9,35,27,62
24,4,10,101,96,197
22,4,10,92,88,180
16,2,5,38,32,70
22,2,5,52,44,96
32,2,5,90,64,154
22,2,5,62,44,106
18,2,5,50,36,86
8,2,5,21,16,37
27,2,5,72,54,126
23,2,5,68,46,114
8,2,5,24,16,40
24,2,5,55,48,103
25,2,5,58,50,108
18,2,5,52,36,88
2,2,5,6,4,10
9,3,9,41,27,68
29,3,9,132,87,219
5,2,5,15,10,25
8,2,5,23,16,39
27,3,9,152,81,233
13,2,5,36,26,62
15,2,5,42,30,72
12,2,5,23,24,47
6,2,5,17,12,29
5,2,5,14,10,24
15,3,9,89,45,134
15,7,9,12,105,117
28,7,9,46,196,242
29,7,9,3,203,206
21,7,9,38,147,185
14,7,9,25,98,123
22,7,9,12,154,166
10,7,9,16,70,86
14,7,9,5,98,103
20,7,9,17,140,157
17,3,8,84,51,135
15,8,22,203,120,323
27,8,22,366,216,582
11,8,22,152,88,240
13,9,24,189,117,306
16,9,24,190,144,334
17,9,24,239,153,392
31,9,24,458,279,737
10,9,24,97,90,187
16,9,24,236,144,380
10,13,35,143,130,273
17,13,35,350,221,571
7,13,35,110,91,201
9,13,35,195,117,312
1,13,35,21,13,34
24,13,35,419,312,731
22,13,35,469,286,755
12,13,35,256,156,412
28,13,35,440,364,804
3,13,35,65,39,104
6,13,35,128,78,206
16,13,35,229,208,437
2,13,35,41,26,67
25,38,50,100,950,1050
29,42,54,332,1218,1550
2,42,54,23,84,107
2,42,54,1,84,85
25,42,54,125,1050,1175
21,42,54,207,882,1089
17,38,50,170,646,816
20,42,54,218,840,1058
1,308,565,121,308,429
1,1898,3375,937,1898,2835
1,1252,2295,951,1252,2203
1,1252,2295,722,1252,1974
1,1266,2320,1008,1266,2274
3,1252,2295,1614,3756,5370
1,1266,2320,683,1266,1949
3,1266,2320,2884,3798,6682
1,1266,2320,1031,1266,2297
1,1266,2320,752,1266,2018
1,1252,2295,745,1252,1997
1,2171,3578,1264,2171,3435
1,2171,3578,1264,2171,3435
1,2171,3578,763,2171,2934
2,1519,2443,1799,3038,4837
2,1083,1701,1168,2166,3334
1,1555,2443,717,1555,2272
1,2171,3578,656,2171,2827
3,713,1120,482,2139,2621
1,713,1120,396,713,1109
1,1555,2443,570,1555,2125
1,344,540,185,344,529
1,2171,3578,1335,2171,3506
2,344,540,252,688,940
16,26,70,682,416,1098
31,26,70,1342,806,2148
1,26,70,29,26,55
11,3,9,64,33,97
30,2,5,87,60,147
12,2,5,35,24,59
21,1,2,12,21,33
29,1,2,16,29,45
26,11,30,486,286,772
14,11,30,262,154,416
12,11,30,224,132,356
3,13,35,64,39,103
27,13,35,575,351,926
1,1,2,1,1,2
4,2,5,12,8,20
1,2,5,3,2,5
21,2,5,40,42,82
14,2,5,27,28,55
24,2,5,46,48,94
13,1,2,13,13,26
15,1,2,15,15,30
29,1,4,72,29,101
1,1,2,1,1,2
22,1,2,21,22,43
14,1,2,13,14,27
24,2,5,64,48,112
19,1,4,45,19,64
22,2,5,64,44,108
25,2,5,73,50,123
18,1,2,12,18,30
12,1,2,8,12,20
17,11,30,318,187,505
16,2,5,47,32,79
21,2,5,62,42,104
12,2,5,35,24,59
21,2,5,48,42,90
29,2,5,67,58,125
22,11,30,279,242,521
15,11,30,191,165,356
27,11,30,343,297,640
4,2,5,12,8,20
24,2,5,71,48,119
32,2,5,67,64,131
24,11,29,418,264,682
28,1,4,66,28,94
16,1,4,38,16,54
1,1,4,2,1,3
23,2,5,44,46,90
9,2,5,26,18,44
26,2,5,75,52,127
9,1,4,19,9,28
4,2,5,12,8,20
9,2,5,26,18,44
15,2,5,35,30,65
7,1,4,20,7,27
1,1,4,3,1,4
3,8,21,31,24,55
5,8,21,51,40,91
14,2,5,41,28,69
14,2,5,41,28,69
3,1482,2384,1562,4446,6008
3,1482,2384,1776,4446,6222
2,1482,2384,1470,2964,4434
3,461,742,353,1383,1736
1,755,1215,241,755,996
19,24,64,736,456,1192
12,45,120,698,540,1238
9,45,120,437,405,842
7,45,120,340,315,655
6,59,159,390,354,744
31,3,9,136,93,229
25,2,5,59,50,109
12,2,5,28,24,52
8,2,5,22,16,38
1,2,5,3,2,5
28,2,5,81,56,137
16,2,5,37,32,69
11,4,10,64,44,108
1,4,10,6,4,10
3,3,9,12,9,21
6,3,9,24,18,42
22,4,10,128,88,216
10,4,10,58,40,98
18,2,5,38,36,74
12,2,5,35,24,59
24,2,5,55,48,103
23,2,5,53,46,99
23,2,5,64,46,110
17,2,5,48,34,82
11,2,5,26,22,48
16,2,5,38,32,70
4,2,5,9,8,17
23,2,5,54,46,100
27,7,9,49,189,238
5,7,9,2,35,37
26,7,9,47,182,229
5,7,9,4,35,39
5,7,9,8,35,43
26,7,9,24,182,206
15,7,9,25,105,130
3,3,8,15,9,24
17,3,8,84,51,135
24,3,8,78,72,150
24,8,22,267,192,459
26,8,22,353,208,561
3,8,22,41,24,65
26,8,22,284,208,492
13,8,22,171,104,275
22,8,22,303,176,479
6,8,22,67,48,115
13,8,22,179,104,283
19,8,22,262,152,414
7,9,24,81,63,144
7,9,24,103,63,166
12,9,24,143,108,251
3,9,24,29,27,56
1,9,24,10,9,19
25,13,35,436,325,761
7,13,35,144,91,235
19,13,35,391,247,638
8,13,35,170,104,274
6,13,35,124,78,202
11,13,35,192,143,335
5,13,35,87,65,152
1,13,35,22,13,35
1,13,35,16,13,29
11,13,35,192,143,335
28,13,35,606,364,970
17,13,35,362,221,583
1,13,35,21,13,34
30,13,35,534,390,924
5,13,35,98,65,163
26,13,35,554,338,892
13,13,35,213,169,382
7,13,35,110,91,201
1,13,35,14,13,27
30,13,35,618,390,1008
14,13,35,298,182,480
2,13,35,33,26,59
27,21,55,725,567,1292
25,38,50,38,950,988
3,38,50,15,114,129
17,42,54,186,714,900
2,42,54,23,84,107
21,38,50,210,798,1008
11,42,54,55,462,517
3,1252,2295,2854,3756,6610
1,1252,2295,997,1252,2249
1,1252,2295,538,1252,1790
1,1266,2320,636,1266,1902
1,1252,2295,745,1252,1997
1,1252,2295,951,1252,2203
1,1252,2295,951,1252,2203
3,295,540,508,885,1393
1,1266,2320,1008,1266,2274
1,1555,2443,351,1555,1906
1,713,1120,385,713,1098
2,2171,3578,1884,4342,6226
3,1083,1701,1650,3249,4899
1,2171,3578,942,2171,3113
1,2171,3578,835,2171,3006
1,1083,1701,244,1083,1327
3,713,1120,1154,2139,3293
1,713,1120,161,713,874
1,344,540,120,344,464
1,713,1120,194,713,907
1,487,783,171,487,658
2,26,70,87,52,139
16,26,70,469,416,885
15,3,9,87,45,132
23,1,2,22,23,45
14,2,5,39,28,67
22,2,5,64,44,108
9,1,2,9,9,18
2,1,2,2,2,4
27,11,29,478,297,775
26,11,29,332,286,618
28,12,33,468,336,804
23,1,2,15,23,38
19,2,5,53,38,91
11,2,5,31,22,53
12,1,2,12,12,24
7,1,2,7,7,14
5,1,2,4,5,9
5,2,5,15,10,25
22,2,5,64,44,108
28,1,2,19,28,47
27,9,25,351,243,594
12,1,2,10,12,22
24,1,2,21,24,45
13,1,2,10,13,23
28,1,2,21,28,49
26,1,2,19,26,45
10,1,2,7,10,17
6,8,21,75,48,123
25,8,21,315,200,515
29,8,21,365,232,597
23,8,21,193,184,377
2,2,5,5,4,9
10,2,5,24,20,44
8,1,2,6,8,14
23,1,2,17,23,40
2,2,5,4,4,8
2,2,5,6,4,10
7,1,4,19,7,26
6,1,4,13,6,19
15,12,33,206,180,386
32,12,33,440,384,824
19,12,33,261,228,489
6,2,5,14,12,26
6,1,4,17,6,23
7,1,4,20,7,27
7,1,4,15,7,22
26,1,4,55,26,81
15,1,4,32,15,47
24,2,5,67,48,115
24,2,5,67,48,115
2,1482,2384,1041,2964,4005
3,1482,2384,2420,4446,6866
1,461,742,185,461,646
1,1482,2384,473,1482,1955
1,1482,2384,807,1482,2289
1,1482,2384,854,1482,2336
1,461,742,251,461,712
1,1482,2384,592,1482,2074
21,24,64,813,504,1317
15,2,5,44,30,74
3,2,5,9,6,15
20,4,10,112,80,192
8,4,10,45,32,77
32,2,5,62,64,126
13,2,5,25,26,51
9,2,5,25,18,43
4,2,5,11,8,19
1,2,5,3,2,5
18,2,5,52,36,88
13,2,5,30,26,56
11,2,5,25,22,47
9,2,5,21,18,39
6,2,5,14,12,26
29,3,9,137,87,224
15,3,9,71,45,116
13,2,5,38,26,64
18,2,5,52,36,88
9,2,5,26,18,44
16,2,5,42,32,74
19,2,5,50,38,88
30,2,5,84,60,144
18,2,5,50,36,86
27,2,5,63,54,117
11,2,5,32,22,54
29,2,5,81,58,139
30,7,9,57,210,267
5,7,9,4,35,39
30,7,9,22,210,232
12,7,9,22,84,106
26,7,9,10,182,192
17,7,9,10,119,129
25,7,9,34,175,209
14,3,8,68,42,110
19,3,8,92,57,149
10,3,8,40,30,70
22,3,8,106,66,172
1,8,22,9,8,17
25,8,22,339,200,539
4,8,22,54,32,86
18,8,22,197,144,341
13,8,22,179,104,283
18,8,22,248,144,392
24,8,22,331,192,523
5,9,24,50,45,95
6,9,24,84,54,138
25,9,24,363,225,588
19,9,24,189,171,360
2,13,35,29,26,55
23,13,35,490,299,789
17,13,35,243,221,464
26,13,35,563,338,901
16,13,35,341,208,549
15,13,35,320,195,515
25,13,35,393,325,718
5,13,35,107,65,172
24,13,35,511,312,823
29,13,35,567,377,944
6,13,35,88,78,166
26,21,55,870,546,1416
2,21,55,60,42,102
4,38,50,44,152,196
27,38,50,41,1026,1067
2,42,54,1,84,85
6,42,54,27,252,279
23,42,54,102,966,1068
6,42,54,66,252,318
9,38,50,90,342,432
2,1266,2320,1087,2532,3619
1,1252,2295,997,1252,2249
1,420,769,188,420,608
1,1252,2295,997,1252,2249
2,344,540,370,688,1058
1,2171,3578,763,2171,2934
1,713,1120,385,713,1098
1,487,783,124,487,611
1,2171,3578,1157,2171,3328
1,2171,3578,1264,2171,3435
1,487,783,186,487,673
3,344,540,556,1032,1588
2,2171,3578,1669,4342,6011
1,2171,3578,942,2171,3113
1,2171,3578,656,2171,2827
1,344,540,185,344,529
1,344,540,158,344,502
3,344,540,556,1032,1588
1,344,540,185,344,529
1,2171,3578,1371,2171,3542
1,344,540,126,344,470
1,344,540,110,344,454
1,1555,2443,864,1555,2419
1,1083,1701,550,1083,1633
1,344,540,174,344,518
2,1555,2443,1434,3110,4544
3,344,540,523,1032,1555
1,2171,3578,1335,2171,3506
1,11,29,17,11,28
20,11,29,348,220,568
6,8,21,52,48,100
15,13,35,220,195,415
25,13,35,366,325,691
9,1,2,5,9,14
23,13,35,490,299,789
19,13,35,405,247,652
11,13,35,234,143,377
24,1,2,22,24,46
3,1,2,3,3,6
5,1,2,5,5,10
13,2,5,27,26,53
31,9,25,372,279,651
15,9,25,180,135,315
28,1,2,27,28,55
16,13,35,341,208,549
1,13,35,21,13,34
12,11,30,224,132,356
3,1,2,3,3,6
9,1,2,9,9,18
1,1,2,1,1,2
23,1,2,22,23,45
7,1,2,7,7,14
3,2,5,8,6,14
2,9,25,22,18,40
11,9,25,118,99,217
19,9,25,204,171,375
17,9,25,183,153,336
25,1,2,25,25,50
26,1,2,25,26,51
26,2,5,49,52,101
6,2,5,11,12,23
9,13,35,176,117,293
22,13,35,430,286,716
1,1,4,2,1,3
29,2,5,81,58,139
15,2,5,42,30,72
10,2,5,24,20,44
23,2,5,54,46,100
28,1,4,66,28,94
24,1,4,57,24,81
13,1,2,10,13,23
16,1,2,11,16,27
12,1,2,8,12,20
18,1,2,12,18,30
26,1,2,17,26,43
6,1,2,4,6,10
23,8,21,193,184,377
10,9,25,143,90,233
5,9,25,71,45,116
1,9,25,14,9,23
30,11,30,552,330,882
15,12,33,305,180,485
23,1,2,13,23,36
11,1,2,6,11,17
14,2,5,41,28,69
22,2,5,64,44,108
3,461,742,487,1383,1870
1,1482,2384,878,1482,2360
1,1482,2384,807,1482,2289
1,755,1215,266,755,1021
3,1482,2384,2563,4446,7009
1,461,742,147,461,608
13,2,5,27,26,53
23,2,5,48,46,94
17,4,10,100,68,168
26,2,5,77,52,129
25,2,5,74,50,124
23,2,5,67,46,113
31,2,5,65,62,127
2,2,5,4,4,8
27,2,5,78,54,132
15,2,5,44,30,74
13,3,9,53,39,92
7,2,5,16,14,30
21,2,5,49,42,91
3,2,5,8,6,14
1,2,5,3,2,5
13,3,9,70,39,109
3,3,9,16,9,25
14,2,5,41,28,69
18,2,5,52,36,88
17,7,9,28,119,147
19,7,9,0,133,133
5,7,9,9,35,44
28,7,9,46,196,242
27,7,9,49,189,238
6,7,9,0,42,42
25,3,8,121,75,196
18,8,22,248,144,392
11,8,22,152,88,240
20,8,22,271,160,431
1,9,24,15,9,24
13,9,24,173,117,290
9,13,35,132,117,249
2,13,35,41,26,67
4,13,35,87,52,139
15,13,35,325,195,520
6,13,35,130,78,208
26,13,35,563,338,901
6,13,35,128,78,206
1,13,35,17,13,30
25,13,35,541,325,866
9,13,35,154,117,271
12,13,35,256,156,412
11,13,35,234,143,377
14,13,35,298,182,480
8,13,35,173,104,277
16,13,35,330,208,538
17,13,35,243,221,464
29,13,35,618,377,995
29,13,35,415,377,792
16,13,35,251,208,459
16,13,35,330,208,538
21,13,35,433,273,706
12,13,35,180,156,336
1,42,54,11,42,53
22,38,50,242,836,1078
1,42,54,0,42,42
7,42,54,80,294,374
18,38,50,198,684,882
15,38,50,165,570,735
21,42,54,229,882,1111
1,38,50,9,38,47
27,42,54,3,1134,1137
7,42,54,1,294,295
16,38,50,176,608,784
1,42,54,11,42,53
1,1912,3400,774,1912,2686
2,1252,2295,1902,2504,4406
3,1252,2295,2854,3756,6610
1,1252,2295,745,1252,1997
1,1252,2295,538,1252,1790
1,295,540,234,295,529
2,295,540,414,590,1004
1,1266,2320,544,1266,1810
1,1266,2320,1008,1266,2274
3,713,1120,784,2139,2923
1,487,783,280,487,767
1,2171,3578,942,2171,3113
1,1083,1701,499,1083,1582
1,1555,2443,448,1555,2003
3,344,540,361,1032,1393
1,487,783,288,487,775
16,26,70,682,416,1098
14,26,70,400,364,764
16,26,70,682,416,1098
14,26,70,400,364,764
9,26,70,283,234,517
15,3,9,87,45,132
25,8,21,215,200,415
6,1,2,6,6,12
2,1,2,2,2,4
15,1,2,11,15,26
25,1,2,19,25,44
27,13,35,575,351,926
21,13,35,447,273,720
22,1,4,62,22,84
5,1,4,14,5,19
19,1,2,18,19,37
7,1,2,7,7,14
6,2,5,11,12,23
23,1,4,54,23,77
3,1,4,7,3,10
13,1,4,31,13,44
20,1,2,20,20,40
10,1,2,10,10,20
17,12,33,351,204,555
12,12,33,248,144,392
28,1,2,26,28,54
2,1,2,2,2,4
7,1,2,7,7,14
16,1,2,15,16,31
8,1,2,8,8,16
16,1,2,10,16,26
29,1,4,66,29,95
23,2,5,67,46,113
9,2,5,26,18,44
19,2,5,55,38,93
15,2,5,44,30,74
23,2,5,67,46,113
12,2,5,35,24,59
19,8,21,199,152,351
28,8,21,293,224,517
12,1,2,12,12,24
14,1,2,14,14,28
12,1,2,7,12,19
6,1,2,3,6,9
13,11,30,196,143,339
17,12,33,234,204,438
5,12,33,69,60,129
23,12,33,316,276,592
6,9,25,86,54,140
29,11,30,534,319,853
21,11,30,386,231,617
25,2,5,70,50,120
2,2,5,6,4,10
5,8,21,63,40,103
22,8,21,277,176,453
22,2,5,64,44,108
20,2,5,58,40,98
1,1,2,1,1,2
26,1,4,74,26,100
29,1,4,82,29,111
1,755,1215,375,755,1130
1,1482,2384,735,1482,2217
1,1482,2384,378,1482,1860
1,1482,2384,854,1482,2336
2,755,1215,871,1510,2381
3,1482,2384,2563,4446,7009
2,461,742,265,922,1187
30,24,64,778,720,1498
20,24,64,570,480,1050
25,24,64,968,600,1568
17,24,64,604,408,1012
6,45,120,421,270,691
6,59,159,581,354,935
4,2,5,11,8,19
23,2,5,61,46,107
10,2,5,24,20,44
1,2,5,2,2,4
26,4,10,122,104,226
14,4,10,66,56,122
8,2,5,22,16,38
23,4,10,97,92,189
25,4,10,105,100,205
14,4,10,59,56,115
15,4,10,63,60,123
9,2,5,25,18,43
21,2,5,59,42,101
25,2,5,53,50,103
6,2,5,13,12,25
28,2,5,81,56,137
6,2,5,17,12,29
22,3,9,128,66,194
14,3,9,81,42,123
20,3,9,80,60,140
5,3,9,21,15,36
31,3,9,127,93,220
23,2,5,48,46,94
2,2,5,5,4,9
1,2,5,3,2,5
25,2,5,66,50,116
25,7,9,41,175,216
27,7,9,37,189,226
2,7,9,0,14,14
20,7,9,8,140,148
14,7,9,2,98,100
20,7,9,-3,140,137
6,7,9,8,42,50
14,7,9,23,98,121
21,3,8,102,63,165
5,8,22,68,40,108
4,8,22,54,32,86
12,8,22,163,96,259
22,8,22,202,176,378
2,8,22,22,16,38
14,8,22,190,112,302
30,8,22,413,240,653
17,8,22,234,136,370
10,9,24,145,90,235
17,9,24,251,153,404
17,9,24,247,153,400
20,13,35,293,260,553
4,13,35,87,52,139
23,13,35,450,299,749
1,13,35,17,13,30
27,13,35,585,351,936
14,13,35,190,182,372
18,13,35,371,234,605
13,13,35,190,169,359
19,13,35,391,247,638
29,13,35,628,377,1005
18,13,35,383,234,617
10,13,35,196,130,326
6,13,35,128,78,206
7,13,35,103,91,194
17,13,35,267,221,488
22,13,35,453,286,739
12,13,35,197,156,353
14,13,35,200,182,382
6,13,35,105,78,183
25,13,35,533,325,858
15,13,35,320,195,515
9,13,35,141,117,258
5,13,35,79,65,144
8,13,35,173,104,277
21,13,35,411,273,684
17,21,55,541,357,898
15,21,55,494,315,809
10,42,54,98,420,518
18,42,54,2,756,758
11,42,54,108,462,570
11,38,50,17,418,435
27,42,54,295,1134,1429
31,38,50,341,1178,1519
21,38,50,231,798,1029
29,38,50,319,1102,1421
19,42,54,95,798,893
2,1266,2320,1922,2532,4454
1,1266,2320,544,1266,1810
1,420,769,318,420,738
1,1266,2320,961,1266,2227
2,1266,2320,2015,2532,4547
1,420,769,211,420,631
1,1266,2320,1008,1266,2274
2,1266,2320,2062,2532,4594
3,1252,2295,2854,3756,6610
1,1252,2295,997,1252,2249
1,1555,2443,717,1555,2272
1,487,783,124,487,611
3,2171,3578,2289,6513,8802
1,1083,1701,584,1083,1667
1,1083,1701,550,1083,1633
3,713,1120,616,2139,2755
1,713,1120,385,713,1098
1,713,1120,385,713,1098
2,2171,3578,1311,4342,5653
2,487,783,482,974,1456
1,2171,3578,763,2171,2934
3,344,540,556,1032,1588
1,1083,1701,261,1083,1344
1,344,540,158,344,502
1,487,783,132,487,619
1,713,1120,228,713,941
2,713,1120,344,1426,1770
1,344,540,158,344,502
28,26,70,801,728,1529
8,3,9,47,24,71
31,3,9,175,93,268
13,11,30,200,143,343
2,11,30,31,22,53
18,2,5,50,36,86
9,2,5,25,18,43
11,9,25,118,99,217
3,9,25,32,27,59
8,1,4,24,8,32
13,1,2,7,13,20
13,2,5,27,26,53
4,2,5,8,8,16
25,12,33,492,300,792
8,12,33,157,96,253
7,1,2,7,7,14
22,1,2,21,22,43
20,1,2,20,20,40
11,1,2,11,11,22
22,9,25,330,198,528
11,9,25,165,99,264
3,9,25,45,27,72
12,11,30,221,132,353
1,11,30,18,11,29
18,1,4,49,18,67
14,1,4,38,14,52
28,1,2,18,28,46
5,1,2,3,5,8
13,11,29,166,143,309
18,11,29,230,198,428
19,1,4,55,19,74
18,1,4,53,18,71
20,1,4,58,20,78
27,2,5,53,54,107
6,2,5,12,12,24
28,8,21,241,224,465
17,8,21,146,136,282
26,2,5,75,52,127
30,2,5,87,60,147
26,1,2,25,26,51
16,1,2,16,16,32
9,1,4,19,9,28
1,11,29,18,11,29
4,9,25,62,36,98
28,9,25,434,252,686
20,1,2,15,20,35
1,1482,2384,807,1482,2289
3,461,742,754,1383,2137
1,461,742,251,461,712
1,1482,2384,592,1482,2074
3,1482,2384,1133,4446,5579
2,755,1215,483,1510,1993
2,755,1215,871,1510,2381
3,461,742,442,1383,1825
1,1482,2384,807,1482,2289
1,461,742,125,461,586
11,24,64,433,264,697
4,24,64,157,96,253
5,59,159,444,295,739
26,2,5,61,52,113
20,2,5,47,40,87
27,2,5,76,54,130
25,2,5,70,50,120
23,2,5,67,46,113
24,2,5,71,48,119
7,2,5,21,14,35
17,2,5,49,34,83
9,2,5,26,18,44
9,2,5,26,18,44
29,2,5,84,58,142
7,2,5,19,14,33
16,2,5,42,32,74
25,4,10,148,100,248
9,4,10,53,36,89
30,2,5,66,60,126
17,2,5,37,34,71
3,2,5,9,6,15
23,2,5,67,46,113
18,2,5,52,36,88
28,2,5,81,56,137
17,4,10,100,68,168
28,4,10,165,112,277
1,2,5,3,2,5
27,3,9,123,81,204
26,3,9,119,78,197
9,7,9,5,63,68
19,7,9,2,133,135
6,7,9,11,42,53
12,7,9,16,84,100
5,7,9,4,35,39
7,7,9,4,49,53
27,7,9,52,189,241
22,7,9,36,154,190
6,7,9,11,42,53
25,7,9,14,175,189
18,3,8,70,54,124
12,3,8,39,36,75
9,3,8,32,27,59
11,8,22,149,88,237
28,8,22,380,224,604
32,8,22,434,256,690
17,8,22,234,136,370
19,8,22,262,152,414
14,8,22,131,112,243
28,9,24,407,252,659
17,13,35,243,221,464
8,13,35,126,104,230
10,13,35,213,130,343
16,13,35,341,208,549
9,13,35,141,117,258
6,13,35,117,78,195
24,13,35,494,312,806
14,13,35,244,182,426
2,13,35,31,26,57
19,13,35,278,247,525
7,13,35,120,91,211
22,13,35,361,286,647
24,13,35,469,312,781
1,13,35,21,13,34
11,13,35,192,143,335
20,13,35,426,260,686
4,13,35,68,52,120
21,13,35,366,273,639
9,21,55,286,189,475
15,21,55,494,315,809
22,42,54,15,924,939
17,38,50,187,646,833
1,38,50,12,38,50
27,38,50,297,1026,1323
1,38,50,11,38,49
14,38,50,140,532,672
2,38,50,22,76,98
1,42,54,11,42,53
6,42,54,1,252,253
3,38,50,33,114,147
12,38,50,120,456,576
6,38,50,66,228,294
1,1266,2320,1008,1266,2274
2,1252,2295,1902,2504,4406
1,420,769,334,420,754
1,1266,2320,1008,1266,2274
3,1266,2320,3023,3798,6821
2,2171,3578,2528,4342,6870
1,2171,3578,1157,2171,3328
1,713,1120,138,713,851
1,1555,2443,790,1555,2345
1,1083,1701,244,1083,1327
3,1555,2443,2151,4665,6816
1,2171,3578,835,2171,3006
1,344,540,77,344,421
3,344,540,296,1032,1328
3,1519,2443,1379,4557,5936
3,344,540,572,1032,1604
1,2171,3578,1371,2171,3542
1,1083,1701,346,1083,1429
1,713,1120,228,713,941
3,2171,3578,4006,6513,10519
2,2171,3578,2671,4342,7013
30,26,70,1299,780,2079
26,26,70,1071,676,1747
25,26,70,1030,650,1680
14,26,70,606,364,970
17,26,70,486,442,928
17,26,70,724,442,1166
5,3,9,20,15,35
13,3,9,76,39,115
2,1,2,2,2,4
32,1,2,31,32,63
26,1,2,19,26,45
15,1,2,11,15,26
18,9,25,216,162,378
15,9,25,180,135,315
21,13,35,359,273,632
16,13,35,274,208,482
31,13,35,530,403,933
7,1,2,7,7,14
19,1,2,18,19,37
7,1,2,4,7,11
27,1,2,26,27,53
28,1,2,27,28,55
18,1,2,15,18,33
13,11,30,243,143,386
23,1,2,15,23,38
5,1,2,3,5,8
19,1,2,19,19,38
8,1,2,8,8,16
9,1,2,9,9,18
14,1,2,10,14,24
10,1,2,7,10,17
2,1,2,2,2,4
5,1,2,4,5,9
18,1,2,15,18,33
18,2,5,34,36,70
18,2,5,34,36,70
16,2,5,46,32,78
14,2,5,41,28,69
18,2,5,52,36,88
17,1,4,39,17,56
10,1,4,23,10,33
9,11,30,152,99,251
11,11,30,186,121,307
24,8,21,221,192,413
29,8,21,267,232,499
11,1,2,11,11,22
22,2,5,64,44,108
12,2,5,35,24,59
15,2,5,44,30,74
6,1,4,18,6,24
21,1,4,61,21,82
16,1,2,12,16,28
7,1,2,5,7,12
28,1,2,20,28,48
15,1,2,10,15,25
7,1,2,4,7,11
1,8,21,12,8,20
21,8,21,255,168,423
29,8,21,353,232,585
5,1,2,5,5,10
3,1,2,3,3,6
25,8,21,315,200,515
1,2,5,3,2,5
13,2,5,36,26,62
1,1482,2384,592,1482,2074
1,1482,2384,473,1482,1955
2,1482,2384,1041,2964,4005
2,1482,2384,1184,2964,4148
1,1482,2384,401,1482,1883
1,1482,2384,521,1482,2003
1,1482,2384,854,1482,2336
1,1482,2384,854,1482,2336
3,755,1215,870,2265,3135
2,461,742,325,922,1247
1,45,120,56,45,101
4,59,159,298,236,534
2,2,5,6,4,10
16,2,5,46,32,78
29,2,5,81,58,139
23,2,5,64,46,110
22,2,5,64,44,108
9,2,5,26,18,44
27,2,5,76,54,130
25,2,5,70,50,120
5,4,10,30,20,50
2,2,5,6,4,10
27,2,5,76,54,130
23,3,9,130,69,199
23,4,10,122,92,214
16,2,5,46,32,78
18,2,5,52,36,88
13,2,5,34,26,60
20,2,5,53,40,93
9,4,10,48,36,84
21,4,10,111,84,195
15,2,5,44,30,74
23,2,5,67,46,113
17,2,5,49,34,83
5,2,5,15,10,25
14,2,5,41,28,69
10,2,5,29,20,49
20,2,5,58,40,98
3,2,5,6,6,12
13,2,5,27,26,53
22,2,5,64,44,108
15,2,5,44,30,74
4,3,9,23,12,35
20,3,9,116,60,176
10,4,10,38,40,78
5,4,10,19,20,39
26,2,5,75,52,127
32,2,5,93,64,157
21,4,10,122,84,206
30,4,10,174,120,294
8,2,5,23,16,39
3,2,5,9,6,15
19,3,9,76,57,133
6,3,9,24,18,42
20,3,9,91,60,151
4,3,9,18,12,30
7,2,5,16,14,30
19,2,5,45,38,83
11,7,9,18,77,95
8,7,9,13,56,69
4,7,9,7,28,35
26,7,9,22,182,204
22,7,9,40,154,194
14,8,22,128,112,240
23,8,22,211,184,395
23,8,22,231,184,415
10,8,22,136,80,216
23,8,22,287,184,471
12,9,24,168,108,276
8,9,24,116,72,188
15,9,24,221,135,356
23,9,24,306,207,513
21,9,24,249,189,438
9,13,35,129,117,246
13,13,35,186,169,355
21,13,35,447,273,720
20,13,35,286,260,546
1,13,35,21,13,34
16,13,35,251,208,459
20,13,35,314,260,574
6,13,35,128,78,206
1,13,35,20,13,33
14,13,35,298,182,480
27,13,35,556,351,907
23,13,35,490,299,789
28,13,35,596,364,960
8,13,35,173,104,277
4,13,35,85,52,137
9,13,35,192,117,309
10,13,35,213,130,343
11,13,35,238,143,381
17,13,35,350,221,571
14,21,55,376,294,670
6,21,55,145,126,271
24,42,54,236,1008,1244
27,42,54,266,1134,1400
16,42,54,80,672,752
24,38,50,72,912,984
9,38,50,90,342,432
23,38,50,253,874,1127
32,42,54,263,1344,1607
3,38,50,12,114,126
18,42,54,90,756,846
24,38,50,132,912,1044
1,1266,2320,1008,1266,2274
1,1252,2295,882,1252,2134
3,1266,2320,2884,3798,6682
1,1266,2320,752,1266,2018
2,1252,2295,2040,2504,4544
1,420,769,334,420,754
1,295,540,234,295,529
3,420,769,955,1260,2215
1,420,769,334,420,754
1,308,565,234,308,542
1,1252,2295,1020,1252,2272
1,308,565,234,308,542
3,1912,3400,2220,5736,7956
1,1252,2295,997,1252,2249
3,1252,2295,2991,3756,6747
1,1252,2295,538,1252,1790
1,1252,2295,997,1252,2249
1,2171,3578,620,2171,2791
1,487,783,280,487,767
1,1519,2443,753,1519,2272
3,1519,2443,2479,4557,7036
3,2171,3578,1967,6513,8480
1,713,1120,205,713,918
3,713,1120,1154,2139,3293
1,713,1120,385,713,1098
3,1519,2443,1819,4557,6376
1,1555,2443,570,1555,2125
3,1555,2443,1491,4665,6156
2,1555,2443,1727,3110,4837
2,2171,3578,2671,4342,7013
14,26,70,596,364,960
24,3,9,99,72,171
16,3,9,93,48,141
1,1,2,1,1,2
5,1,2,3,5,8
27,1,2,15,27,42
8,13,35,170,104,274
19,13,35,411,247,658
23,13,35,498,299,797
3,13,35,65,39,104
15,13,35,325,195,520
24,11,30,326,264,590
18,11,30,245,198,443
4,2,5,12,8,20
14,2,5,41,28,69
17,1,2,10,17,27
27,1,4,80,27,107
18,1,4,53,18,71
20,1,4,58,20,78
2,1,4,6,2,8
3,1,2,2,3,5
26,1,2,15,26,41
11,1,2,6,11,17
13,2,5,38,26,64
8,1,2,8,8,16
10,2,5,19,20,39
5,2,5,10,10,20
4,1,4,11,4,15
21,1,4,60,21,81
25,1,4,71,25,96
11,2,5,32,22,54
18,2,5,52,36,88
13,8,21,164,104,268
14,8,21,176,112,288
1,2,5,2,2,4
6,2,5,13,12,25
8,1,4,23,8,31
23,1,4,67,23,90
7,1,4,20,7,27
19,1,4,55,19,74
1,1482,2384,878,1482,2360
1,755,1215,266,755,1021
1,1482,2384,735,1482,2217
1,1482,2384,854,1482,2336
1,1482,2384,854,1482,2336
1,755,1215,436,755,1191
2,755,1215,604,1510,2114
1,461,742,266,461,727
1,1482,2384,854,1482,2336
1,461,742,266,461,727
23,24,64,891,552,1443
24,24,64,760,576,1336
5,24,64,194,120,314
7,24,64,181,168,349
17,3,9,74,51,125
6,2,5,16,12,28
4,2,5,11,8,19
2,2,5,4,4,8
15,4,10,80,60,140
32,4,10,186,128,314
16,4,10,93,64,157
1,2,5,3,2,5
1,2,5,3,2,5
22,2,5,51,44,95
6,2,5,14,12,26
19,4,10,89,76,165
17,4,10,80,68,148
21,2,5,50,42,92
21,2,5,50,42,92
22,3,9,130,66,196
20,2,5,53,40,93
26,3,9,112,78,190
6,3,9,26,18,44
23,2,5,54,46,100
16,2,5,38,32,70
9,2,5,27,18,45
25,2,5,74,50,124
18,2,5,50,36,86
24,2,5,67,48,115
31,2,5,91,62,153
21,2,5,62,42,104
18,7,9,7,126,133
13,7,9,5,91,96
20,7,9,38,140,178
29,7,9,40,203,243
3,7,9,5,21,26
1,7,9,1,7,8
30,7,9,11,210,221
17,7,9,14,119,133
3,7,9,1,21,22
14,7,9,12,98,110
13,7,9,25,91,116
23,7,9,19,161,180
1,3,8,4,3,7
19,3,8,84,57,141
13,3,8,61,39,100
7,8,22,78,56,134
21,8,22,192,168,360
1,8,22,10,8,18
23,8,22,287,184,471
21,9,24,204,189,393
27,9,24,392,243,635
22,13,35,315,286,601
23,13,35,401,299,700
8,13,35,131,104,235
25,13,35,489,325,814
17,13,35,332,221,553
6,13,35,124,78,202
23,13,35,450,299,749
8,13,35,156,104,260
12,13,35,188,156,344
1,13,35,20,13,33
2,13,35,31,26,57
9,13,35,132,117,249
2,13,35,31,26,57
3,13,35,65,39,104
9,13,35,195,117,312
31,13,35,639,403,1042
25,13,35,436,325,761
16,13,35,251,208,459
1,13,35,21,13,34
2,13,35,43,26,69
5,13,35,79,65,144
20,13,35,412,260,672
11,21,55,368,231,599
29,21,55,954,609,1563
1,21,55,33,21,54
29,21,55,763,609,1372
1,42,54,2,42,44
14,38,50,91,532,623
13,42,54,44,546,590
16,42,54,175,672,847
11,38,50,11,418,429
7,42,54,35,294,329
22,38,50,198,836,1034
12,42,54,138,504,642
1,38,50,10,38,48
22,42,54,3,924,927
7,38,50,39,266,305
13,38,50,150,494,644
1,1252,2295,997,1252,2249
1,1252,2295,630,1252,1882
2,1252,2295,1765,2504,4269
3,420,769,886,1260,2146
1,420,769,264,420,684
1,420,769,295,420,715
1,1252,2295,951,1252,2203
1,1266,2320,636,1266,1902
2,295,540,414,590,1004
2,295,540,414,590,1004
1,308,565,133,308,441
1,1266,2320,1008,1266,2274
1,1266,2320,1008,1266,2274
1,1266,2320,892,1266,2158
3,1266,2320,1631,3798,5429
1,487,783,280,487,767
1,1083,1701,397,1083,1480
1,713,1120,205,713,918
1,713,1120,161,713,874
1,2171,3578,942,2171,3113
2,487,783,529,974,1503
1,713,1120,161,713,874
2,1555,2443,1141,3110,4251
1,2171,3578,1371,2171,3542
1,1083,1701,414,1083,1497
1,713,1120,205,713,918
3,713,1120,583,2139,2722
1,487,783,194,487,681
20,26,70,852,520,1372
27,26,70,1150,702,1852
13,26,70,554,338,892
5,26,70,213,130,343
26,3,9,151,78,229
15,3,9,89,45,134
18,3,9,105,54,159
1,1,2,1,1,2
22,1,2,12,22,34
9,9,25,142,81,223
12,9,25,189,108,297
27,9,25,425,243,668
15,1,2,13,15,28
11,9,25,157,99,256
14,1,2,9,14,23
16,1,4,40,16,56
20,9,25,315,180,495
4,12,33,60,48,108
8,12,33,120,96,216
12,1,2,12,12,24
23,1,2,22,23,45
20,1,2,18,20,38
24,1,2,22,24,46
19,1,2,10,19,29
22,2,5,42,44,86
14,2,5,27,28,55
1,13,35,14,13,27
27,13,35,386,351,737
3,13,35,43,39,82
2,1,2,2,2,4
16,1,2,14,16,30
7,2,5,13,14,27
8,2,5,15,16,31
6,8,21,52,48,100
7,8,21,60,56,116
18,2,5,48,36,84
27,1,2,17,27,44
9,1,2,6,9,15
5,1,4,11,5,16
9,1,4,21,9,30
19,2,5,55,38,93
4,2,5,12,8,20
10,2,5,29,20,49
19,2,5,36,38,74
6,1,2,6,6,12
14,2,5,41,28,69
24,8,21,302,192,494
26,8,21,327,208,535
1,1,2,1,1,2
27,1,2,26,27,53
27,1,2,25,27,52
6,2,5,14,12,26
5,1,2,3,5,8
3,1482,2384,1776,4446,6222
2,1482,2384,803,2964,3767
2,461,742,503,922,1425
1,1482,2384,854,1482,2336
1,755,1215,436,755,1191
2,1482,2384,1184,2964,4148
1,1482,2384,854,1482,2336
1,1482,2384,807,1482,2289
8,45,120,389,360,749
5,59,159,484,295,779
2,2,5,6,4,10
5,2,5,14,10,24
9,2,5,25,18,43
2,2,5,6,4,10
4,2,5,9,8,17
11,2,5,32,22,54
14,2,5,41,28,69
5,2,5,10,10,20
18,2,5,35,36,71
5,2,5,15,10,25
2,2,5,6,4,10
10,2,5,19,20,39
1,2,5,2,2,4
14,2,5,32,28,60
7,2,5,21,14,35
8,2,5,24,16,40
13,3,9,76,39,115
20,3,9,116,60,176
7,2,5,20,14,34
22,2,5,62,44,106
27,2,5,59,54,113
5,2,5,11,10,21
9,7,9,17,63,80
12,7,9,0,84,84
1,7,9,0,7,7
26,7,9,3,182,185
28,7,9,53,196,249
24,7,9,44,168,212
30,7,9,25,210,235
15,7,9,25,105,130
13,3,8,43,39,82
5,3,8,23,15,38
28,3,8,100,84,184
19,8,22,258,152,410
31,8,22,420,248,668
22,8,22,298,176,474
2,8,22,25,16,41
30,8,22,275,240,515
25,8,22,345,200,545
1,8,22,14,8,22
32,8,22,441,256,697
14,8,22,184,112,296
32,9,24,426,288,714
14,13,35,303,182,485
30,13,35,639,390,1029
28,13,35,547,364,911
23,13,35,490,299,789
17,13,35,362,221,583
18,13,35,257,234,491
6,13,35,124,78,202
4,13,35,73,52,125
25,13,35,515,325,840
9,13,35,185,117,302
7,13,35,110,91,201
28,13,35,596,364,960
11,13,35,157,143,300
1,13,35,21,13,34
8,13,35,173,104,277
29,13,35,597,377,974
24,13,35,520,312,832
24,13,35,494,312,806
22,13,35,399,286,685
10,13,35,175,130,305
18,13,35,390,234,624
26,21,55,870,546,1416
12,21,55,395,252,647
10,38,50,110,380,490
16,38,50,184,608,792
24,38,50,204,912,1116
7,38,50,77,266,343
24,38,50,240,912,1152
1,42,54,3,42,45
17,38,50,187,646,833
1,1898,3375,1038,1898,2936
1,1266,2320,1008,1266,2274
1,1252,2295,538,1252,1790
1,1266,2320,1008,1266,2274
1,1252,2295,997,1252,2249
3,1266,2320,3023,3798,6821
1,420,769,295,420,715
3,1266,2320,1631,3798,5429
3,420,769,1001,1260,2261
1,1266,2320,1031,1266,2297
1,1252,2295,1020,1252,2272
3,1252,2295,2991,3756,6747
1,295,540,240,295,535
2,1266,2320,2015,2532,4547
3,487,783,395,1461,1856
2,1519,2443,1799,3038,4837
2,2171,3578,1669,4342,6011
1,1083,1701,397,1083,1480
1,2171,3578,656,2171,2827
1,2171,3578,942,2171,3113
1,487,783,265,487,752
1,1083,1701,550,1083,1633
1,1555,2443,570,1555,2125
1,713,1120,205,713,918
1,487,783,194,487,681
1,2171,3578,1371,2171,3542
3,2171,3578,4006,6513,10519
23,26,70,980,598,1578
11,26,70,469,286,755
22,26,70,937,572,1509
17,26,70,593,442,1035
11,3,9,64,33,97
5,3,9,20,15,35
17,1,2,17,17,34
15,1,2,15,15,30
13,1,2,13,13,26
27,1,2,26,27,53
10,1,2,7,10,17
24,1,2,16,24,40
4,12,33,79,48,127
3,12,33,59,36,95
19,2,5,56,38,94
28,2,5,83,56,139
19,2,5,47,38,85
27,11,30,367,297,664
7,11,30,95,77,172
5,13,35,107,65,172
30,2,5,63,60,123
12,2,5,25,24,49
20,1,2,12,20,32
25,1,2,16,25,41
5,1,2,3,5,8
6,2,5,17,12,29
28,2,5,81,56,137
27,2,5,80,54,134
17,2,5,50,34,84
3,2,5,6,6,12
17,2,5,32,34,66
18,2,5,34,36,70
5,1,4,11,5,16
6,1,4,14,6,20
1,1,4,2,1,3
7,8,21,85,56,141
29,8,21,353,232,585
11,2,5,27,22,49
5,1,2,4,5,9
4,2,5,9,8,17
10,2,5,23,20,43
13,2,5,30,26,56
3,2,5,9,6,15
11,2,5,32,22,54
8,8,21,102,64,166
20,8,21,256,160,416
1,2,5,2,2,4
1,2,5,2,2,4
27,1,4,57,27,84
7,1,4,15,7,22
1,1,4,2,1,3
16,9,25,248,144,392
19,9,25,295,171,466
8,1,4,17,8,25
19,1,4,40,19,59
17,2,5,49,34,83
24,2,5,70,48,118
3,461,742,554,1383,1937
1,461,742,118,461,579
2,1482,2384,1470,2964,4434
1,1482,2384,807,1482,2289
3,1482,2384,2420,4446,6866
1,1482,2384,378,1482,1860
1,755,1215,193,755,948
3,1482,2384,2420,4446,6866
9,45,120,437,405,842
2,2,5,6,4,10
24,2,5,67,48,115
24,2,5,46,48,94
20,2,5,38,40,78
3,2,5,8,6,14
1,4,10,4,4,8
17,4,10,65,68,133
3,2,5,9,6,15
7,2,5,19,14,33
11,2,5,29,22,51
13,2,5,29,26,55
22,2,5,48,44,92
24,2,5,70,48,118
29,2,5,84,58,142
6,2,5,18,12,30
12,4,10,50,48,98
7,4,10,29,28,57
1,2,5,3,2,5
20,2,5,53,40,93
22,2,5,64,44,108
6,2,5,17,12,29
26,2,5,73,52,125
20,2,5,58,40,98
11,2,5,32,22,54
24,2,5,71,48,119
9,2,5,25,18,43
29,2,5,81,58,139
27,7,9,52,189,241
21,7,9,34,147,181
1,7,9,1,7,8
3,7,9,2,21,23
10,7,9,16,70,86
32,7,9,58,224,282
18,7,9,30,126,156
3,7,9,0,21,21
4,3,8,13,12,25
19,3,8,74,57,131
21,3,8,98,63,161
18,3,8,84,54,138
26,8,22,290,208,498
26,8,22,353,208,561
16,8,22,147,128,275
25,8,22,229,200,429
18,8,22,248,144,392
24,8,22,315,192,507
16,8,22,220,128,348
3,8,22,41,24,65
19,9,24,276,171,447
20,9,24,281,180,461
5,9,24,53,45,98
7,9,24,102,63,165
10,13,35,213,130,343
16,13,35,251,208,459
31,13,35,671,403,1074
26,13,35,426,338,764
19,13,35,391,247,638
25,13,35,393,325,718
17,13,35,368,221,589
17,13,35,279,221,500
24,13,35,511,312,823
13,13,35,277,169,446
24,13,35,494,312,806
11,13,35,192,143,335
2,13,35,39,26,65
22,13,35,345,286,631
25,13,35,393,325,718
13,13,35,277,169,446
11,13,35,238,143,381
4,13,35,63,52,115
23,13,35,490,299,789
20,13,35,286,260,546
26,13,35,554,338,892
12,13,35,247,156,403
17,21,55,456,357,813
27,21,55,859,567,1426
27,21,55,903,567,1470
3,42,54,7,126,133
2,38,50,3,76,79
5,38,50,13,190,203
28,42,54,18,1176,1194
9,42,54,30,378,408
22,42,54,74,924,998
4,38,50,40,152,192
10,42,54,7,420,427
14,38,50,70,532,602
1,1898,3375,1038,1898,2936
1,1252,2295,997,1252,2249
2,1252,2295,1076,2504,3580
2,420,769,636,840,1476
1,1252,2295,538,1252,1790
1,295,540,240,295,535
2,1266,2320,1783,2532,4315
1,308,565,246,308,554
1,1252,2295,630,1252,1882
2,1252,2295,2040,2504,4544
1,2171,3578,763,2171,2934
3,344,540,556,1032,1588
3,2171,3578,2289,6513,8802
1,2171,3578,835,2171,3006
3,2171,3578,2826,6513,9339
1,344,540,158,344,502
2,1555,2443,1141,3110,4251
1,713,1120,228,713,941
2,1083,1701,1100,2166,3266
1,1083,1701,261,1083,1344
3,487,783,395,1461,1856
1,487,783,132,487,619
1,344,540,174,344,518
1,344,540,174,344,518
1,344,540,174,344,518
27,26,70,942,702,1644
29,26,70,1235,754,1989
10,26,70,349,260,609
18,3,9,97,54,151
4,3,9,20,12,32
29,2,5,64,58,122
15,2,5,33,30,63
23,8,21,294,184,478
22,8,21,281,176,457
13,8,21,166,104,270
29,2,5,84,58,142
1,2,5,3,2,5
15,1,2,15,15,30
25,1,2,15,25,40
29,13,35,496,377,873
28,13,35,479,364,843
21,13,35,359,273,632
17,13,35,291,221,512
1,13,35,21,13,34
27,13,35,575,351,926
17,13,35,362,221,583
6,2,5,17,12,29
19,2,5,53,38,91
8,2,5,23,16,39
30,2,5,87,60,147
11,1,2,7,11,18
6,1,2,4,6,10
1,13,35,22,13,35
20,13,35,433,260,693
13,1,2,8,13,21
15,11,30,281,165,446
6,11,30,112,66,178
11,11,30,206,121,327
24,1,4,71,24,95
26,1,4,77,26,103
30,1,4,89,30,119
19,2,5,53,38,91
28,2,5,78,56,134
24,2,5,67,48,115
26,2,5,73,52,125
26,2,5,73,52,125
23,1,2,22,23,45
3,1,2,3,3,6
4,2,5,12,8,20
20,11,30,254,220,474
11,11,30,140,121,261
17,1,2,17,17,34
22,1,2,20,22,42
16,1,2,15,16,31
11,9,25,140,99,239
16,9,25,204,144,348
24,1,2,18,24,42
20,1,2,15,20,35
19,8,21,195,152,347
11,8,21,113,88,201
20,8,21,205,160,365
12,1,2,7,12,19
17,1,2,10,17,27
27,2,5,57,54,111
17,2,5,36,34,70
26,1,2,25,26,51
18,1,2,17,18,35
1,1,2,1,1,2
5,1,2,5,5,10
8,1,2,7,8,15
19,2,5,55,38,93
26,2,5,75,52,127
2,1,4,6,2,8
1,1,4,3,1,4
1,1482,2384,473,1482,1955
1,1482,2384,807,1482,2289
1,1482,2384,521,1482,2003
1,461,742,162,461,623
1,1482,2384,807,1482,2289
1,1482,2384,592,1482,2074
1,461,742,274,461,735
1,1482,2384,878,1482,2360
2,461,742,547,922,1469
1,1482,2384,568,1482,2050
1,1482,2384,854,1482,2336
1,755,1215,436,755,1191
1,755,1215,436,755,1191
1,1482,2384,473,1482,1955
2,1482,2384,1709,2964,4673
3,755,1215,943,2265,3208
1,755,1215,375,755,1130
1,1482,2384,378,1482,1860
1,1482,2384,568,1482,2050
4,24,64,127,96,223
7,24,64,276,168,444
22,45,120,1175,990,2165
2,59,159,155,118,273
1,59,159,65,59,124
1,2,5,2,2,4
30,2,5,71,60,131
1,2,5,3,2,5
12,2,5,28,24,52
14,2,5,33,28,61
22,3,9,130,66,196
3,4,10,18,12,30
17,2,5,32,34,66
18,2,5,34,36,70
27,4,10,103,108,211
30,4,10,114,120,234
13,2,5,38,26,64
25,2,5,74,50,124
3,2,5,8,6,14
14,2,5,39,28,67
26,2,5,73,52,125
29,2,5,81,58,139
1,4,10,6,4,10
26,4,10,151,104,255
3,2,5,9,6,15
26,2,5,75,52,127
12,2,5,35,24,59
7,2,5,21,14,35
16,2,5,34,32,66
23,2,5,48,46,94
14,3,9,75,42,117
30,3,9,161,90,251
15,2,5,35,30,65
17,2,5,50,34,84
19,2,5,55,38,93
27,2,5,78,54,132
23,7,9,42,161,203
27,7,9,22,189,211
1,7,9,2,7,9
28,7,9,11,196,207
3,7,9,0,21,21
19,7,9,31,133,164
12,7,9,7,84,91
23,7,9,32,161,193
23,7,9,42,161,203
1,3,8,5,3,8
21,3,8,68,63,131
7,3,8,23,21,44
18,3,8,71,54,125
24,3,8,116,72,188
11,3,8,44,33,77
1,8,22,10,8,18
7,8,22,95,56,151
6,8,22,55,48,103
15,8,22,187,120,307
1,8,22,11,8,19
27,8,22,301,216,517
11,8,22,144,88,232
27,8,22,235,216,451
20,9,24,295,180,475
7,9,24,102,63,165
22,9,24,325,198,523
1,9,24,10,9,19
24,9,24,285,216,501
4,9,24,37,36,73
22,9,24,325,198,523
32,9,24,380,288,668
9,9,24,100,81,181
21,9,24,305,189,494
5,9,24,73,45,118
28,13,35,489,364,853
11,13,35,238,143,381
7,13,35,122,91,213
2,13,35,29,26,55
14,13,35,244,182,426
7,13,35,144,91,235
24,13,35,494,312,806
13,13,35,281,169,450
15,13,35,215,195,410
13,13,35,227,169,396
14,13,35,230,182,412
13,13,35,277,169,446
8,13,35,140,104,244
23,13,35,490,299,789
1,13,35,16,13,29
1,13,35,21,13,34
13,13,35,227,169,396
18,13,35,352,234,586
27,13,35,462,351,813
8,13,35,170,104,274
24,13,35,511,312,823
1,13,35,21,13,34
18,13,35,257,234,491
7,13,35,149,91,240
22,13,35,361,286,647
21,13,35,366,273,639
28,13,35,400,364,764
31,21,55,1037,651,1688
24,21,55,763,504,1267
8,38,50,24,304,328
10,38,50,55,380,435
20,38,50,200,760,960
11,38,50,121,418,539
17,42,54,195,714,909
13,38,50,65,494,559
20,38,50,80,760,840
1,38,50,3,38,41
7,42,54,35,294,329
13,38,50,130,494,624
5,42,54,49,210,259
6,38,50,0,228,228
9,42,54,6,378,384
13,38,50,143,494,637
12,38,50,66,456,522
19,42,54,156,798,954
15,38,50,128,570,698
15,42,54,75,630,705
17,42,54,2,714,716
1,1252,2295,722,1252,1974
1,1266,2320,1008,1266,2274
1,1252,2295,745,1252,1997
2,1252,2295,1765,2504,4269
2,1252,2295,1076,2504,3580
3,1252,2295,3060,3756,6816
2,420,769,667,840,1507
1,295,540,126,295,421
1,420,769,318,420,738
1,420,769,318,420,738
1,1252,2295,951,1252,2203
1,295,540,148,295,443
3,295,540,508,885,1393
1,1252,2295,630,1252,1882
1,1555,2443,717,1555,2272
1,487,783,124,487,611
1,1555,2443,839,1555,2394
1,2171,3578,835,2171,3006
3,487,783,465,1461,1926
1,2171,3578,835,2171,3006
1,2171,3578,763,2171,2934
3,1083,1701,1497,3249,4746
3,344,540,523,1032,1555
3,344,540,232,1032,1264
1,344,540,185,344,529
1,1083,1701,346,1083,1429
1,344,540,77,344,421
1,344,540,126,344,470
2,344,540,165,688,853
1,1083,1701,499,1083,1582
1,713,1120,205,713,918
3,1555,2443,2591,4665,7256
1,713,1120,261,713,974
1,487,783,194,487,681
1,1083,1701,550,1083,1633
1,487,783,194,487,681
2,487,783,263,974,1237
1,713,1120,172,713,885
2,344,540,349,688,1037
1,2171,3578,620,2171,2791
1,26,70,43,26,69
5,26,70,217,130,347
20,26,70,852,520,1372
22,26,70,768,572,1340
19,26,70,663,494,1157
13,26,70,381,338,719
7,26,70,303,182,485
17,3,9,68,51,119
5,3,9,28,15,43
21,3,9,92,63,155
18,3,9,102,54,156
28,3,9,135,84,219
16,13,35,274,208,482
24,13,35,410,312,722
19,2,5,55,38,93
7,2,5,20,14,34
29,1,2,21,29,50
13,1,2,9,13,22
32,1,2,31,32,63
26,1,2,25,26,51
16,1,2,16,16,32
22,1,2,20,22,42
8,13,35,173,104,277
16,13,35,346,208,554
22,1,2,21,22,43
6,1,2,6,6,12
14,1,2,9,14,23
23,1,2,15,23,38
9,1,2,6,9,15
31,1,2,17,31,48
10,1,2,6,10,16
5,2,5,15,10,25
26,8,21,300,208,508
19,8,21,219,152,371
22,1,2,15,22,37
5,1,2,3,5,8
21,1,2,18,21,39
26,1,2,22,26,48
26,12,33,434,312,746
7,12,33,117,84,201
24,2,5,53,48,101
1,2,5,2,2,4
9,1,4,26,9,35
28,1,4,80,28,108
28,1,2,21,28,49
21,1,2,16,21,37
4,8,21,37,32,69
8,8,21,74,64,138
17,2,5,32,34,66
14,2,5,27,28,55
28,2,5,53,56,109
25,2,5,48,50,98
1,2,5,3,2,5
22,2,5,62,44,106
1,12,33,14,12,26
11,12,33,151,132,283
9,1,4,26,9,35
7,1,4,20,7,27
17,1,4,39,17,56
20,1,4,58,20,78
13,1,4,38,13,51
5,1,2,3,5,8
5,11,29,71,55,126
15,11,29,213,165,378
29,1,4,72,29,101
22,1,4,55,22,77
19,1,4,47,19,66
26,1,4,76,26,102
8,1,4,23,8,31
22,9,25,341,198,539
13,1,4,32,13,45
16,1,4,36,16,52
1,1482,2384,592,1482,2074
1,1482,2384,592,1482,2074
1,1482,2384,473,1482,1955
1,461,742,185,461,646
1,1482,2384,854,1482,2336
1,461,742,266,461,727
3,1482,2384,2563,4446,7009
1,1482,2384,854,1482,2336
3,1482,2384,1133,4446,5579
3,1482,2384,2420,4446,6866
18,24,64,570,432,1002
19,24,64,748,456,1204
20,24,64,710,480,1190
3,45,120,178,135,313
1,59,159,65,59,124
1,59,159,94,59,153
14,2,5,41,28,69
1,2,5,3,2,5
28,2,5,81,56,137
6,3,9,34,18,52
20,2,5,56,40,96
17,4,10,99,68,167
11,4,10,64,44,108
6,4,10,35,24,59
19,4,10,110,76,186
27,2,5,63,54,117
19,2,5,45,38,83
30,3,9,175,90,265
13,3,9,76,39,115
18,3,9,97,54,151
10,3,9,54,30,84
27,3,9,111,81,192
19,3,9,78,57,135
21,2,5,49,42,91
16,2,5,38,32,70
3,7,9,6,21,27
4,7,9,7,28,35
8,7,9,3,56,59
13,7,9,10,91,101
17,7,9,28,119,147
20,7,9,17,140,157
18,3,8,58,54,112
26,8,22,238,208,446
26,8,22,284,208,492
12,8,22,163,96,259
26,8,22,353,208,561
24,8,22,331,192,523
9,8,22,118,72,190
13,8,22,119,104,223
24,8,22,331,192,523
6,9,24,67,54,121
10,9,24,145,90,235
12,9,24,168,108,276
9,9,24,131,81,212
23,9,24,334,207,541
4,13,35,57,52,109
6,13,35,128,78,206
17,13,35,362,221,583
18,13,35,283,234,517
20,13,35,412,260,672
2,13,35,31,26,57
3,13,35,65,39,104
28,13,35,577,364,941
10,13,35,164,130,294
7,13,35,122,91,213
16,13,35,346,208,554
11,13,35,234,143,377
28,13,35,596,364,960
21,13,35,300,273,573
17,13,35,362,221,583
9,13,35,195,117,312
4,13,35,59,52,111
7,13,35,149,91,240
18,13,35,314,234,548
1,13,35,21,13,34
10,13,35,147,130,277
12,21,55,382,252,634
19,21,55,625,399,1024
30,21,55,954,630,1584
1,42,54,1,42,43
25,38,50,25,950,975
5,38,50,55,190,245
15,42,54,67,630,697
5,42,54,49,210,259
16,42,54,80,672,752
2,42,54,22,84,106
24,38,50,264,912,1176
24,38,50,240,912,1152
29,42,54,144,1218,1362
2,1266,2320,1783,2532,4315
1,1252,2295,951,1252,2203
1,420,769,318,420,738
2,1252,2295,1489,2504,3993
3,1266,2320,1631,3798,5429
3,420,769,1001,1260,2261
1,295,540,234,295,529
1,1266,2320,729,1266,1995
1,1252,2295,538,1252,1790
1,344,540,66,344,410
1,2171,3578,763,2171,2934
1,1555,2443,790,1555,2345
1,2171,3578,835,2171,3006
2,2171,3578,1884,4342,6226
1,1555,2443,839,1555,2394
1,2171,3578,656,2171,2827
1,2171,3578,835,2171,3006
3,344,540,556,1032,1588
1,1555,2443,570,1555,2125
1,344,540,185,344,529
1,2171,3578,620,2171,2791
1,1555,2443,570,1555,2125
21,26,70,909,546,1455
19,26,70,809,494,1303
10,26,70,426,260,686
21,3,9,84,63,147
6,3,9,34,18,52
7,2,5,13,14,27
1,2,5,2,2,4
29,13,35,496,377,873
24,2,5,71,48,119
30,2,5,89,60,149
20,2,5,56,40,96
7,2,5,20,14,34
5,1,4,15,5,20
24,1,4,71,24,95
29,1,4,82,29,111
22,1,4,62,22,84
11,9,25,127,99,226
21,11,30,260,231,491
18,11,30,223,198,421
18,1,2,17,18,35
20,1,2,19,20,39
9,1,2,9,9,18
1,2,5,2,2,4
20,2,5,46,40,86
18,2,5,41,36,77
21,2,5,48,42,90
28,2,5,66,56,122
4,1,2,2,4,6
14,1,2,8,14,22
18,2,5,53,36,89
8,2,5,24,16,40
15,1,2,15,15,30
5,1,2,5,5,10
18,1,2,18,18,36
12,1,2,8,12,20
6,1,2,4,6,10
3,1,2,2,3,5
15,13,35,309,195,504
20,1,2,15,20,35
6,1,2,4,6,10
31,13,35,508,403,911
20,11,30,356,220,576
18,1,2,13,18,31
8,12,33,113,96,209
2,12,33,28,24,52
26,8,21,316,208,524
16,1,2,16,16,32
30,11,30,552,330,882
1,11,30,19,11,30
1,1,4,3,1,4
26,12,33,357,312,669
21,12,33,289,252,541
2,1,4,5,2,7
1,1,4,3,1,4
15,1,2,15,15,30
27,2,5,63,54,117
14,1,4,41,14,55
23,1,4,67,23,90
1,755,1215,411,755,1166
1,461,742,185,461,646
1,755,1215,241,755,996
1,461,742,251,461,712
2,1482,2384,1613,2964,4577
3,1482,2384,2563,4446,7009
1,1482,2384,854,1482,2336
1,755,1215,436,755,1191
3,45,120,178,135,313
1,59,159,75,59,134
7,2,5,15,14,29
19,2,5,42,38,80
19,2,5,34,38,72
21,2,5,38,42,80
8,3,9,36,24,60
29,2,5,57,58,115
24,2,5,56,48,104
17,2,5,40,34,74
10,2,5,28,20,48
32,2,5,90,64,154
28,2,5,53,56,109
4,2,5,8,8,16
4,2,5,8,8,16
16,2,5,34,32,66
20,3,9,97,60,157
1,3,9,5,3,8
23,4,10,133,92,225
28,4,10,162,112,274
9,2,5,17,18,35
8,2,5,23,16,39
10,2,5,29,20,49
16,2,5,29,32,61
8,3,9,43,24,67
22,3,9,118,66,184
14,2,5,33,28,61
5,2,5,12,10,22
7,2,5,16,14,30
14,2,5,33,28,61
24,2,5,71,48,119
27,2,5,59,54,113
8,2,5,15,16,31
23,7,9,-4,161,157
13,7,9,24,91,115
12,7,9,1,84,85
5,7,9,9,35,44
26,3,8,103,78,181
30,3,8,119,90,209
4,3,8,13,12,25
25,3,8,121,75,196
23,9,24,257,207,464
22,9,24,325,198,523
28,9,24,279,252,531
29,13,35,425,377,802
17,13,35,231,221,452
3,13,35,59,39,98
19,13,35,325,247,572
27,13,35,471,351,822
22,13,35,345,286,631
12,13,35,256,156,412
2,13,35,41,26,67
8,13,35,140,104,244
4,13,35,54,52,106
10,13,35,206,130,336
4,13,35,85,52,137
19,13,35,411,247,658
7,13,35,137,91,228
19,13,35,312,247,559
13,13,35,186,169,355
31,13,35,671,403,1074
7,13,35,122,91,213
1,13,35,15,13,28
6,21,55,197,126,323
11,21,55,362,231,593
18,21,55,543,378,921
15,42,54,123,630,753
1,38,50,11,38,49
23,42,54,139,966,1105
15,42,54,67,630,697
14,38,50,0,532,532
4,42,54,39,168,207
3,1266,2320,1492,3798,5290
3,1252,2295,2647,3756,6403
2,1252,2295,1443,2504,3947
2,1252,2295,1076,2504,3580
3,1252,2295,1614,3756,5370
3,1252,2295,1890,3756,5646
1,1252,2295,882,1252,2134
1,295,540,234,295,529
2,1266,2320,1922,2532,4454
1,2171,3578,1335,2171,3506
2,1555,2443,1727,3110,4837
1,1519,2443,753,1519,2272
1,1083,1701,431,1083,1514
1,2171,3578,656,2171,2827
1,2171,3578,942,2171,3113
1,2171,3578,942,2171,3113
2,2171,3578,1884,4342,6226
1,344,540,191,344,535
1,713,1120,261,713,974
1,1555,2443,864,1555,2419
3,344,540,329,1032,1361
1,2171,3578,1335,2171,3506
21,26,70,601,546,1147
22,26,70,937,572,1509
25,26,70,1065,650,1715
16,26,70,693,416,1109
13,3,9,76,39,115
21,8,21,180,168,348
2,8,21,17,16,33
29,1,2,25,29,54
29,1,2,25,29,54
14,1,2,14,14,28
21,1,2,21,21,42
16,2,5,46,32,78
15,13,35,320,195,515
9,1,4,21,9,30
20,1,4,47,20,67
27,1,2,20,27,47
4,1,2,3,4,7
1,2,5,2,2,4
10,2,5,24,20,44
2,2,5,5,4,9
28,1,2,19,28,47
26,1,2,18,26,44
21,1,2,14,21,35
27,1,2,18,27,45
12,1,2,8,12,20
6,2,5,17,12,29
20,2,5,59,40,99
26,11,30,439,286,725
5,12,33,102,60,162
19,12,33,386,228,614
20,12,33,407,240,647
21,1,4,57,21,78
26,1,4,71,26,97
11,12,33,151,132,283
4,12,33,55,48,103
30,2,5,89,60,149
29,2,5,86,58,144
16,1,4,45,16,61
23,1,2,17,23,40
4,1,4,12,4,16
18,1,4,53,18,71
19,2,5,55,38,93
18,2,5,52,36,88
16,1,2,14,16,30
8,1,4,23,8,31
24,1,4,68,24,92
2,1482,2384,1041,2964,4005
1,755,1215,266,755,1021
2,461,742,369,922,1291
1,1482,2384,854,1482,2336
1,1482,2384,592,1482,2074
1,1482,2384,568,1482,2050
1,461,742,125,461,586
17,24,64,669,408,1077
9,2,5,27,18,45
3,4,10,18,12,30
2,2,5,6,4,10
5,2,5,15,10,25
3,4,10,11,12,23
14,2,5,31,28,59
9,2,5,20,18,38
19,3,9,111,57,168
28,4,10,129,112,241
25,4,10,115,100,215
26,2,5,60,52,112
31,2,5,71,62,133
2,4,10,9,8,17
29,4,10,133,116,249
2,4,10,9,8,17
10,4,10,44,40,84
29,7,9,1,203,204
24,7,9,18,168,186
19,3,8,74,57,131
20,8,22,183,160,343
21,8,22,197,168,365
7,8,22,95,56,151
25,8,22,229,200,429
16,8,22,217,128,345
31,8,22,291,248,539
18,8,22,236,144,380
22,8,22,298,176,474
18,9,24,261,162,423
5,9,24,50,45,95
5,9,24,74,45,119
21,9,24,305,189,494
2,13,35,43,26,69
18,13,35,283,234,517
16,13,35,330,208,538
13,13,35,281,169,450
26,13,35,563,338,901
11,13,35,227,143,370
24,13,35,469,312,781
21,13,35,411,273,684
21,13,35,330,273,603
10,13,35,217,130,347
10,13,35,164,130,294
24,13,35,419,312,731
2,13,35,43,26,69
27,13,35,556,351,907
17,21,55,541,357,898
3,21,55,79,63,142
27,38,50,311,1026,1337
12,38,50,138,456,594
23,38,50,69,874,943
16,38,50,160,608,768
3,38,50,5,114,119
4,42,54,20,168,188
14,42,54,32,588,620
14,42,54,62,588,650
13,38,50,13,494,507
1,1898,3375,768,1898,2666
2,1252,2295,2040,2504,4544
2,1266,2320,1273,2532,3805
1,420,769,334,420,754
1,295,540,234,295,529
1,1266,2320,961,1266,2227
1,1252,2295,538,1252,1790
1,713,1120,362,713,1075
1,344,540,185,344,529
2,344,540,241,688,929
18,26,70,779,468,1247
8,26,70,341,208,549
10,26,70,412,260,672
2,26,70,57,52,109
26,3,9,151,78,229
3,1,2,3,3,6
28,1,2,24,28,52
15,1,2,13,15,28
12,1,2,12,12,24
20,1,2,20,20,40
19,13,35,411,247,658
8,13,35,173,104,277
13,13,35,281,169,450
21,1,4,62,21,83
1,2,5,3,2,5
11,1,4,33,11,44
31,9,25,333,279,612
24,12,33,361,288,649
23,12,33,346,276,622
3,2,5,6,6,12
17,1,2,17,17,34
6,1,2,6,6,12
26,2,5,77,52,129
1,2,5,3,2,5
5,1,2,5,5,10
5,2,5,13,10,23
1,2,5,3,2,5
5,2,5,15,10,25
5,2,5,15,10,25
3,1,4,9,3,12
29,1,4,86,29,115
14,1,2,9,14,23
21,9,25,331,189,520
11,9,25,173,99,272
12,2,5,34,24,58
25,2,5,70,50,120
24,12,33,488,288,776
16,12,33,325,192,517
11,1,4,26,11,37
24,1,4,57,24,81
13,1,2,7,13,20
6,1,2,3,6,9
10,1,2,6,10,16
13,2,5,36,26,62
17,2,5,48,34,82
6,2,5,17,12,29
24,1,2,13,24,37
2,1482,2384,1184,2964,4148
1,461,742,251,461,712
1,755,1215,205,755,960
1,1482,2384,854,1482,2336
2,461,742,458,922,1380
1,1482,2384,473,1482,1955
3,461,742,376,1383,1759
24,24,64,745,576,1321
6,24,64,156,144,300
12,45,120,742,540,1282
26,2,5,77,52,129
12,2,5,35,24,59
16,2,5,47,32,79
6,2,5,17,12,29
6,2,5,17,12,29
7,4,10,41,28,69
7,4,10,41,28,69
15,2,5,42,30,72
19,2,5,53,38,91
28,2,5,53,56,109
29,2,5,55,58,113
8,2,5,15,16,31
17,2,5,48,34,82
17,2,5,48,34,82
1,2,5,3,2,5
18,2,5,52,36,88
11,2,5,31,22,53
18,2,5,50,36,86
9,3,9,52,27,79
22,2,5,64,44,108
21,2,5,61,42,103
7,3,9,33,21,54
10,3,9,47,30,77
21,2,5,59,42,101
11,2,5,31,22,53
16,2,5,33,32,65
15,2,5,31,30,61
28,2,5,81,56,137
5,2,5,15,10,25
23,3,9,105,69,174
9,7,9,12,63,75
3,7,9,6,21,27
31,7,9,3,217,220
5,7,9,0,35,35
12,7,9,16,84,100
10,7,9,0,70,70
28,7,9,16,196,212
21,7,9,17,147,164
16,3,8,52,48,100
10,3,8,47,30,77
17,3,8,67,51,118
23,3,8,75,69,144
1,3,8,4,3,7
18,3,8,67,54,121
8,8,22,73,64,137
4,8,22,54,32,86
26,8,22,238,208,446
20,8,22,249,160,409
20,8,22,183,160,343
18,8,22,236,144,380
16,8,22,220,128,348
5,8,22,69,40,109
18,9,24,175,162,337
12,9,24,174,108,282
22,9,24,261,198,459
19,13,35,391,247,638
5,13,35,103,65,168
10,13,35,213,130,343
9,13,35,192,117,309
23,13,35,393,299,692
29,13,35,415,377,792
24,13,35,494,312,806
28,13,35,489,364,853
15,13,35,325,195,520
2,13,35,29,26,55
14,13,35,288,182,470
3,13,35,44,39,83
22,13,35,476,286,762
7,13,35,149,91,240
4,13,35,82,52,134
10,13,35,217,130,347
13,13,35,254,169,423
23,13,35,490,299,789
28,13,35,596,364,960
12,13,35,247,156,403
1,13,35,15,13,28
4,13,35,82,52,134
2,21,55,66,42,108
14,42,54,9,588,597
19,42,54,218,798,1016
27,38,50,230,1026,1256
8,42,54,79,336,415
10,38,50,115,380,495
26,38,50,286,988,1274
16,38,50,176,608,784
24,42,54,3,1008,1011
3,42,54,0,126,126
22,42,54,3,924,927
20,42,54,46,840,886
31,38,50,341,1178,1519
25,42,54,246,1050,1296
21,38,50,21,798,819
11,38,50,61,418,479
2,1252,2295,2040,2504,4544
2,1266,2320,1087,2532,3619
1,1266,2320,544,1266,1810
1,1252,2295,722,1252,1974
1,1252,2295,745,1252,1997
1,1266,2320,1008,1266,2274
2,1252,2295,1443,2504,3947
1,1266,2320,799,1266,2065
1,1252,2295,538,1252,1790
3,1266,2320,2884,3798,6682
1,1252,2295,722,1252,1974
1,344,540,174,344,518
3,1555,2443,2591,4665,7256
3,2171,3578,3792,6513,10305
1,487,783,280,487,767
2,2171,3578,1884,4342,6226
1,344,540,120,344,464
1,1083,1701,346,1083,1429
3,2171,3578,4114,6513,10627
1,1083,1701,295,1083,1378
2,1083,1701,794,2166,2960
1,713,1120,261,713,974
2,487,783,388,974,1362
2,344,540,349,688,1037
1,487,783,132,487,619
1,344,540,110,344,454
3,2171,3578,4114,6513,10627
31,26,70,1082,806,1888
16,26,70,659,416,1075
22,26,70,752,572,1324
18,26,70,767,468,1235
5,3,9,29,15,44
27,3,9,109,81,190
6,1,2,6,6,12
31,1,2,30,31,61
5,1,2,5,5,10
29,2,5,67,58,125
14,2,5,32,28,60
6,11,30,112,66,178
5,1,2,4,5,9
29,2,5,86,58,144
28,2,5,83,56,139
6,13,35,128,78,206
10,12,33,197,120,317
15,11,30,222,165,387
4,1,2,4,4,8
18,1,2,17,18,35
15,1,2,14,15,29
17,2,5,32,34,66
22,2,5,42,44,86
31,2,5,59,62,121
8,2,5,22,16,38
30,2,5,84,60,144
5,9,25,54,45,99
8,1,2,7,8,15
1,1,4,2,1,3
3,1,4,7,3,10
2,1,2,1,2,3
27,1,2,17,27,44
19,1,2,12,19,31
14,1,4,38,14,52
9,8,21,83,72,155
1,1,2,1,1,2
25,1,2,19,25,44
17,1,2,16,17,33
10,2,5,19,20,39
11,8,21,138,88,226
19,1,2,14,19,33
19,1,4,40,19,59
13,1,2,12,13,25
8,1,2,8,8,16
27,1,4,77,27,104
19,1,4,54,19,73
1,461,742,251,461,712
3,1482,2384,2420,4446,6866
1,1482,2384,854,1482,2336
1,1482,2384,378,1482,1860
1,1482,2384,854,1482,2336
1,1482,2384,854,1482,2336
1,1482,2384,568,1482,2050
3,1482,2384,2563,4446,7009
2,461,742,369,922,1291
11,24,64,412,264,676
16,24,64,497,384,881
21,2,5,44,42,86
16,2,5,34,32,66
23,2,5,68,46,114
11,4,10,52,44,96
5,2,5,14,10,24
12,2,5,34,24,58
1,4,10,6,4,10
2,4,10,11,8,19
17,4,10,100,68,168
5,4,10,30,20,50
4,2,5,9,8,17
26,2,5,60,52,112
12,4,10,71,48,119
28,4,10,165,112,277
3,4,10,17,12,29
10,2,5,30,20,50
5,2,5,15,10,25
20,2,5,58,40,98
27,2,5,80,54,134
29,2,5,86,58,144
8,4,10,38,32,70
20,2,5,46,40,86
5,2,5,12,10,22
32,2,5,93,64,157
4,2,5,9,8,17
6,2,5,14,12,26
18,2,5,52,36,88
1,3,9,6,3,9
29,3,9,169,87,256
18,3,9,82,54,136
6,3,9,27,18,45
16,2,5,38,32,70
27,7,9,49,189,238
8,7,9,15,56,71
28,7,9,51,196,247
7,7,9,3,49,52
19,7,9,14,133,147
18,3,8,89,54,143
13,3,8,63,39,102
8,8,22,110,64,174
26,8,22,353,208,561
4,8,22,37,32,69
12,8,22,163,96,259
17,8,22,186,136,322
16,8,22,147,128,275
14,8,22,184,112,296
12,8,22,163,96,259
14,8,22,184,112,296
31,8,22,427,248,675
28,9,24,279,252,531
27,9,24,262,243,505
24,9,24,348,216,564
13,9,24,189,117,306
28,13,35,410,364,774
18,13,35,383,234,617
28,13,35,489,364,853
3,13,35,47,39,86
25,13,35,428,325,753
1,13,35,21,13,34
23,13,35,498,299,797
27,13,35,585,351,936
2,13,35,43,26,69
4,13,35,85,52,137
18,13,35,257,234,491
27,13,35,386,351,737
30,13,35,440,390,830
16,13,35,341,208,549
20,13,35,391,260,651
19,13,35,411,247,658
8,13,35,173,104,277
22,13,35,399,286,685
6,13,35,128,78,206
28,13,35,596,364,960
9,13,35,195,117,312
5,13,35,73,65,138
17,13,35,267,221,488
13,13,35,281,169,450
32,13,35,682,416,1098
6,13,35,130,78,208
8,13,35,140,104,244
26,13,35,554,338,892
18,21,55,572,378,950
29,21,55,731,609,1340
13,21,55,428,273,701
27,38,50,149,1026,1175
30,38,50,30,1140,1170
10,42,54,23,420,443
28,42,54,321,1176,1497
2,42,54,12,84,96
7,42,54,80,294,374
8,38,50,24,304,328
17,38,50,170,646,816
3,1266,2320,1909,3798,5707
1,420,769,180,420,600
3,1266,2320,2257,3798,6055
2,1266,2320,1505,2532,4037
1,1252,2295,1020,1252,2272
1,1252,2295,951,1252,2203
1,1252,2295,951,1252,2203
3,1252,2295,2165,3756,5921
1,1266,2320,1031,1266,2297
1,1266,2320,892,1266,2158
1,420,769,334,420,754
3,1266,2320,1631,3798,5429
1,1266,2320,1008,1266,2274
1,420,769,188,420,608
1,1266,2320,1008,1266,2274
1,308,565,178,308,486
1,308,565,246,308,554
1,1266,2320,961,1266,2227
1,420,769,249,420,669
1,2171,3578,1157,2171,3328
2,487,783,561,974,1535
1,1083,1701,346,1083,1429
1,1555,2443,839,1555,2394
1,2171,3578,656,2171,2827
1,1083,1701,244,1083,1327
1,2171,3578,942,2171,3113
1,1083,1701,550,1083,1633
2,2171,3578,1884,4342,6226
3,1555,2443,1125,4665,5790
3,344,540,556,1032,1588
1,487,783,132,487,619
1,487,783,132,487,619
1,2171,3578,1335,2171,3506
1,2171,3578,1335,2171,3506
1,2171,3578,620,2171,2791
24,26,70,1039,624,1663
28,26,70,820,728,1548
25,1,2,14,25,39
7,1,2,4,7,11
28,1,2,16,28,44
11,8,21,94,88,182
25,8,21,215,200,415
7,8,21,60,56,116
25,11,29,334,275,609
21,11,29,281,231,512
15,11,29,192,165,357
19,11,29,243,209,452
20,13,35,433,260,693
3,13,35,65,39,104
5,2,5,12,10,22
28,2,5,66,56,122
15,2,5,44,30,74
22,9,25,237,198,435
28,9,25,301,252,553
31,9,25,333,279,612
21,11,30,286,231,517
8,1,2,4,8,12
24,1,4,65,24,89
11,1,4,30,11,41
4,1,4,11,4,15
24,9,25,360,216,576
14,9,25,210,126,336
3,1,2,2,3,5
7,1,2,4,7,11
13,1,2,8,13,21
2,9,25,29,18,47
19,9,25,271,171,442
31,1,2,29,31,60
3,1,2,3,3,6
16,1,2,12,16,28
4,1,2,3,4,7
24,9,25,276,216,492
26,9,25,299,234,533
28,9,25,434,252,686
10,9,25,155,90,245
16,11,30,299,176,475
22,11,30,411,242,653
17,11,30,318,187,505
8,2,5,24,16,40
4,2,5,12,8,20
3,1,4,7,3,10
10,1,4,23,10,33
21,2,5,41,42,83
13,2,5,25,26,51
18,1,4,51,18,69
6,1,4,18,6,24
19,1,4,55,19,74
16,9,25,248,144,392
8,9,25,124,72,196
7,9,25,109,63,172
1,1482,2384,401,1482,1883
2,755,1215,896,1510,2406
1,461,742,177,461,638
1,1482,2384,854,1482,2336
1,755,1215,193,755,948
1,1482,2384,854,1482,2336
6,24,64,225,144,369
10,59,159,666,590,1256
22,2,5,65,44,109
29,2,5,86,58,144
9,2,5,21,18,39
13,3,9,70,39,109
16,3,9,86,48,134
5,4,10,30,20,50
13,4,10,77,52,129
23,2,5,68,46,114
17,2,5,50,34,84
26,2,5,73,52,125
1,2,5,3,2,5
5,2,5,14,10,24
12,2,5,34,24,58
12,2,5,35,24,59
15,2,5,44,30,74
26,2,5,55,52,107
12,3,9,68,36,104
1,3,9,6,3,9
9,3,9,43,27,70
20,3,9,95,60,155
19,2,5,37,38,75
7,2,5,20,14,34
12,2,5,35,24,59
1,2,5,2,2,4
1,3,9,6,3,9
4,3,9,23,12,35
1,7,9,2,7,9
27,7,9,52,189,241
15,7,9,21,105,126
8,7,9,3,56,59
2,7,9,2,14,16
26,7,9,43,182,225
13,3,8,64,39,103
13,3,8,63,39,102
23,3,8,108,69,177
16,3,8,63,48,111
28,8,22,380,224,604
5,8,22,55,40,95
22,8,22,202,176,378
27,8,22,336,216,552
14,8,22,184,112,296
23,8,22,256,184,440
27,8,22,372,216,588
27,9,24,360,243,603
6,9,24,87,54,141
20,9,24,194,180,374
10,9,24,100,90,190
19,9,24,276,171,447
4,9,24,39,36,75
2,13,35,39,26,65
9,13,35,157,117,274
15,13,35,320,195,515
30,13,35,650,390,1040
11,13,35,188,143,331
1,13,35,15,13,28
12,13,35,172,156,328
22,13,35,453,286,739
1,13,35,21,13,34
17,13,35,350,221,571
22,13,35,322,286,608
20,13,35,433,260,693
4,13,35,87,52,139
1,13,35,17,13,30
22,13,35,299,286,585
12,13,35,188,156,344
26,13,35,563,338,901
9,13,35,132,117,249
7,13,35,149,91,240
18,13,35,390,234,624
19,13,35,391,247,638
10,13,35,213,130,343
17,13,35,297,221,518
6,13,35,86,78,164
14,13,35,239,182,421
6,13,35,128,78,206
4,13,35,70,52,122
2,13,35,31,26,57
16,13,35,279,208,487
3,13,35,52,39,91
4,13,35,66,52,118
13,13,35,227,169,396
19,21,55,416,399,815
13,21,55,428,273,701
19,42,54,218,798,1016
29,38,50,73,1102,1175
24,42,54,120,1008,1128
9,38,50,50,342,392
8,38,50,44,304,348
29,38,50,290,1102,1392
1,1266,2320,544,1266,1810
1,1898,3375,870,1898,2768
2,1252,2295,1994,2504,4498
1,1252,2295,538,1252,1790
1,420,769,188,420,608
1,1252,2295,882,1252,2134
1,420,769,180,420,600
2,420,769,667,840,1507
3,420,769,955,1260,2215
2,420,769,590,840,1430
1,1266,2320,1008,1266,2274
1,420,769,318,420,738
1,1912,3400,740,1912,2652
1,1252,2295,997,1252,2249
3,2171,3578,3792,6513,10305
1,713,1120,138,713,851
1,2171,3578,942,2171,3113
3,1083,1701,1650,3249,4899
1,1083,1701,312,1083,1395
1,1519,2443,606,1519,2125
1,344,540,174,344,518
1,713,1120,362,713,1075
1,344,540,120,344,464
3,1083,1701,1650,3249,4899
1,344,540,83,344,427
1,487,783,194,487,681
2,1083,1701,1100,2166,3266
1,344,540,83,344,427
1,344,540,191,344,535
3,2171,3578,4006,6513,10519
1,344,540,126,344,470
3,26,70,88,78,166
17,3,9,70,51,121
5,3,9,24,15,39
4,2,5,12,8,20
18,2,5,48,36,84
26,2,5,69,52,121
31,8,21,318,248,566
17,8,21,175,136,311
3,1,2,3,3,6
21,1,2,20,21,41
26,1,2,25,26,51
30,13,35,650,390,1040
12,13,35,260,156,416
6,1,2,3,6,9
1,1,4,3,1,4
8,1,4,23,8,31
25,1,4,71,25,96
12,2,5,35,24,59
11,2,5,32,22,54
11,2,5,32,22,54
26,2,5,75,52,127
26,1,4,64,26,90
9,2,5,27,18,45
8,2,5,24,16,40
14,2,5,41,28,69
21,11,30,286,231,517
22,1,4,55,22,77
13,1,4,32,13,45
20,1,4,50,20,70
6,1,4,15,6,21
19,1,2,18,19,37
28,1,2,27,28,55
27,8,21,272,216,488
26,8,21,262,208,470
8,9,25,126,72,198
3,9,25,47,27,74
11,1,2,7,11,18
24,1,2,15,24,39
8,1,2,5,8,13
20,2,5,47,40,87
23,1,2,20,23,43
14,1,2,12,14,26
20,2,5,47,40,87
7,9,25,109,63,172
8,9,25,124,72,196
4,9,25,62,36,98
22,1,4,55,22,77
3,2,5,9,6,15
12,1,4,28,12,40
19,2,5,55,38,93
30,2,5,87,60,147
8,8,21,74,64,138
3,2,5,9,6,15
15,2,5,44,30,74
13,1,2,8,13,21
18,1,2,12,18,30
29,2,5,55,58,113
15,2,5,35,30,65
8,2,5,19,16,35
11,1,2,8,11,19
27,1,2,20,27,47
8,1,4,20,8,28
26,1,4,64,26,90
1,461,742,140,461,601
1,461,742,274,461,735
1,461,742,274,461,735
1,461,742,185,461,646
1,461,742,266,461,727
1,1482,2384,807,1482,2289
1,461,742,266,461,727
13,24,64,503,312,815
30,45,120,1458,1350,2808
1,59,159,67,59,126
4,2,5,11,8,19
11,2,5,31,22,53
5,2,5,15,10,25
3,2,5,9,6,15
1,2,5,3,2,5
17,2,5,45,34,79
10,2,5,21,20,41
19,2,5,40,38,78
7,3,9,41,21,62
20,3,9,118,60,178
14,2,5,29,28,57
11,2,5,23,22,45
26,2,5,77,52,129
4,2,5,12,8,20
14,2,5,39,28,67
5,2,5,10,10,20
31,3,9,147,93,240
21,3,9,100,63,163
18,3,9,105,54,159
26,4,10,151,104,255
24,4,10,139,96,235
9,2,5,27,18,45
24,2,5,67,48,115
2,2,5,6,4,10
3,3,9,17,9,26
6,3,9,34,18,52
18,2,5,40,36,76
22,2,5,48,44,92
21,2,5,61,42,103
17,2,5,49,34,83
25,7,9,14,175,189
21,7,9,34,147,181
20,7,9,38,140,178
11,7,9,4,77,81
12,7,9,5,84,89
23,7,9,38,161,199
16,7,9,12,112,124
25,7,9,34,175,209
23,3,8,113,69,182
15,3,8,73,45,118
10,8,22,92,80,172
27,8,22,366,216,582
23,8,22,312,184,496
5,8,22,68,40,108
16,8,22,220,128,348
30,8,22,281,240,521
18,9,24,261,162,423
15,9,24,178,135,313
7,9,24,102,63,165
5,13,35,103,65,168
21,13,35,455,273,728
26,13,35,508,338,846
16,13,35,274,208,482
10,13,35,175,130,305
21,13,35,308,273,581
23,13,35,393,299,692
10,13,35,157,130,287
17,13,35,368,221,589
16,13,35,234,208,442
12,13,35,256,156,412
1,13,35,16,13,29
25,13,35,436,325,761
13,13,35,277,169,446
29,13,35,618,377,995
19,13,35,411,247,658
1,13,35,16,13,29
1,13,35,14,13,27
3,13,35,43,39,82
10,13,35,206,130,336
29,13,35,455,377,832
23,21,55,516,483,999
12,21,55,395,252,647
10,38,50,85,380,465
2,38,50,6,76,82
22,38,50,253,836,1089
25,42,54,111,1050,1161
20,38,50,230,760,990
16,42,54,157,672,829
29,42,54,19,1218,1237
1,1266,2320,961,1266,2227
1,1252,2295,997,1252,2249
3,1266,2320,3023,3798,6821
2,1252,2295,1765,2504,4269
3,1266,2320,2048,3798,5846
1,1266,2320,776,1266,2042
2,1252,2295,2040,2504,4544
1,1252,2295,997,1252,2249
1,1252,2295,630,1252,1882
1,1912,3400,1012,1912,2924
2,487,783,388,974,1362
1,1083,1701,584,1083,1667
1,487,783,155,487,642
2,2171,3578,1454,4342,5796
2,713,1120,500,1426,1926
3,713,1120,986,2139,3125
1,344,540,174,344,518
1,2171,3578,1371,2171,3542
2,2171,3578,2742,4342,7084
1,344,540,126,344,470
1,1555,2443,864,1555,2419
1,1555,2443,717,1555,2272
1,713,1120,228,713,941
1,344,540,174,344,518
1,2171,3578,906,2171,3077
1,344,540,174,344,518
1,2171,3578,620,2171,2791
2,2171,3578,2671,4342,7013
22,26,70,752,572,1324
24,3,9,116,72,188
21,1,2,20,21,41
25,13,35,533,325,858
26,13,35,554,338,892
5,2,5,15,10,25
29,2,5,86,58,144
12,2,5,28,24,52
20,2,5,47,40,87
9,2,5,21,18,39
7,2,5,14,14,28
23,2,5,45,46,91
2,1,2,1,2,3
25,2,5,74,50,124
15,2,5,44,30,74
10,9,25,158,90,248
24,9,25,378,216,594
16,2,5,45,32,77
18,2,5,50,36,86
15,2,5,32,30,62
12,2,5,25,24,49
13,2,5,38,26,64
19,2,5,55,38,93
11,2,5,32,22,54
21,1,4,61,21,82
14,1,4,41,14,55
17,2,5,32,34,66
27,2,5,51,54,105
4,12,33,66,48,114
26,12,33,426,312,738
4,1,2,2,4,6
26,1,2,15,26,41
11,2,5,21,22,43
16,2,5,30,32,62
24,2,5,71,48,119
5,2,5,15,10,25
15,2,5,40,30,70
1,1,2,1,1,2
1,461,742,185,461,646
1,1482,2384,854,1482,2336
1,755,1215,193,755,948
1,461,742,147,461,608
3,1482,2384,1204,4446,5650
2,1482,2384,1756,2964,4720
2,1482,2384,1041,2964,4005
1,24,64,39,24,63
8,45,120,581,360,941
7,45,120,340,315,655
20,2,5,59,40,99
1,2,5,3,2,5
6,2,5,17,12,29
9,2,5,26,18,44
22,2,5,62,44,106
19,2,5,53,38,91
7,2,5,13,14,27
27,3,9,130,81,211
3,4,10,14,12,26
3,4,10,11,12,23
24,4,10,91,96,187
2,2,5,4,4,8
12,2,5,23,24,47
31,3,9,150,93,243
26,2,5,49,52,101
6,2,5,11,12,23
13,2,5,31,26,57
12,2,5,28,24,52
4,2,5,12,8,20
15,2,5,44,30,74
15,3,9,85,45,130
8,2,5,22,16,38
12,3,9,48,36,84
4,3,9,16,12,28
18,7,9,30,126,156
30,7,9,22,210,232
1,7,9,2,7,9
12,7,9,5,84,89
6,7,9,0,42,42
5,3,8,25,15,40
18,3,8,58,54,112
13,3,8,61,39,100
10,3,8,40,30,70
21,3,8,83,63,146
10,3,8,48,30,78
10,3,8,32,30,62
9,8,22,82,72,154
5,8,22,46,40,86
24,8,22,220,192,412
1,8,22,13,8,21
25,8,22,339,200,539
26,8,22,255,208,463
16,9,24,232,144,376
6,9,24,71,54,125
14,13,35,200,182,382
2,13,35,29,26,55
10,13,35,206,130,336
19,13,35,325,247,572
24,13,35,343,312,655
10,13,35,175,130,305
12,13,35,247,156,403
7,13,35,149,91,240
21,13,35,330,273,603
7,13,35,110,91,201
26,13,35,408,338,746
22,13,35,338,286,624
6,13,35,94,78,172
4,13,35,82,52,134
9,13,35,195,117,312
8,13,35,173,104,277
32,13,35,458,416,874
27,13,35,575,351,926
13,13,35,213,169,382
13,38,50,13,494,507
19,38,50,19,722,741
1,42,54,5,42,47
7,38,50,60,266,326
27,42,54,266,1134,1400
24,42,54,120,1008,1128
29,42,54,144,1218,1362
18,42,54,197,756,953
2,42,54,20,84,104
5,42,54,55,210,265
2,1252,2295,1076,2504,3580
1,1266,2320,1008,1266,2274
1,1266,2320,729,1266,1995
1,1266,2320,1031,1266,2297
1,420,769,334,420,754
1,1252,2295,538,1252,1790
1,1252,2295,745,1252,1997
1,1252,2295,951,1252,2203
2,1266,2320,1087,2532,3619
1,1266,2320,961,1266,2227
1,1266,2320,544,1266,1810
1,2171,3578,906,2171,3077
2,487,783,247,974,1221
1,2171,3578,835,2171,3006
3,1083,1701,1650,3249,4899
1,713,1120,205,713,918
1,1555,2443,570,1555,2125
2,1555,2443,897,3110,4007
3,2171,3578,2826,6513,9339
1,2171,3578,620,2171,2791
3,1083,1701,1650,3249,4899
1,344,540,99,344,443
3,344,540,556,1032,1588
2,344,540,370,688,1058
1,713,1120,261,713,974
1,713,1120,205,713,918
1,1083,1701,397,1083,1480
1,487,783,132,487,619
2,487,783,388,974,1362
1,2171,3578,620,2171,2791
1,2171,3578,1335,2171,3506
1,2171,3578,1335,2171,3506
6,26,70,235,156,391
14,26,70,596,364,960
25,3,9,146,75,221
8,3,9,43,24,67
30,8,21,377,240,617
17,8,21,214,136,350
7,8,21,88,56,144
23,8,21,289,184,473
27,8,21,340,216,556
22,1,2,22,22,44
16,1,2,16,16,32
23,1,2,23,23,46
10,2,5,29,20,49
24,2,5,70,48,118
12,13,35,176,156,332
5,13,35,73,65,138
16,1,2,9,16,25
25,1,2,14,25,39
21,1,2,16,21,37
28,1,2,21,28,49
1,2,5,3,2,5
19,2,5,53,38,91
30,2,5,84,60,144
14,12,33,276,168,444
1,12,33,20,12,32
15,12,33,295,180,475
30,2,5,71,60,131
22,2,5,52,44,96
7,13,35,149,91,240
5,12,33,84,60,144
8,12,33,134,96,230
29,9,25,334,261,595
27,9,25,311,243,554
25,1,2,24,25,49
6,1,4,13,6,19
30,1,4,64,30,94
25,1,4,62,25,87
21,1,4,52,21,73
20,1,4,42,20,62
4,1,4,8,4,12
11,9,25,173,99,272
19,11,30,350,209,559
7,11,30,129,77,206
7,1,2,4,7,11
15,1,2,10,15,25
18,1,4,42,18,60
1,1,4,2,1,3
22,2,5,52,44,96
18,2,5,42,36,78
1,2,5,2,2,4
1,1,4,3,1,4
7,1,4,21,7,28
23,1,2,22,23,45
13,8,21,120,104,224
23,8,21,212,184,396
16,11,30,294,176,470
9,11,30,166,99,265
8,2,5,24,16,40
25,1,2,23,25,48
14,8,21,144,112,256
1,8,21,10,8,18
23,1,2,17,23,40
1,1,2,1,1,2
18,12,33,247,216,463
25,11,29,320,275,595
1,8,21,12,8,20
10,8,21,90,80,170
13,8,21,117,104,221
30,8,21,308,240,548
19,1,2,19,19,38
11,1,2,11,11,22
8,1,2,8,8,16
27,1,4,77,27,104
25,1,4,71,25,96
26,11,29,332,286,618
11,2,5,23,22,45
1,2,5,2,2,4
6,1,2,4,6,10
31,1,2,22,31,53
18,8,21,185,144,329
29,9,25,450,261,711
1,1482,2384,878,1482,2360
3,755,1215,1234,2265,3499
1,755,1215,375,755,1130
3,461,742,487,1383,1870
17,24,64,636,408,1044
28,24,64,1084,672,1756
4,2,5,12,8,20
1,2,5,3,2,5
17,2,5,50,34,84
9,2,5,27,18,45
9,3,9,52,27,79
16,4,10,61,64,125
23,4,10,87,92,179
6,2,5,14,12,26
15,2,5,35,30,65
24,7,9,46,168,214
18,7,9,34,126,160
10,7,9,19,70,89
30,3,8,148,90,238
29,3,8,136,87,223
27,8,22,283,216,499
12,8,22,150,96,246
20,8,22,271,160,431
20,8,22,271,160,431
28,8,22,281,224,505
28,8,22,349,224,573
6,8,22,83,48,131
11,8,22,152,88,240
2,8,22,28,16,44
8,8,22,110,64,174
27,9,24,392,243,635
13,13,35,186,169,355
1,13,35,16,13,29
6,13,35,117,78,195
31,13,35,530,403,933
19,13,35,272,247,519
14,13,35,220,182,402
16,13,35,341,208,549
4,13,35,82,52,134
11,13,35,173,143,316
6,13,35,128,78,206
11,13,35,161,143,304
1,13,35,22,13,35
1,13,35,14,13,27
2,13,35,43,26,69
23,13,35,498,299,797
17,13,35,368,221,589
16,13,35,274,208,482
2,13,35,31,26,57
30,42,54,101,1260,1361
2,38,50,23,76,99
25,42,54,287,1050,1337
19,38,50,19,722,741
22,42,54,110,924,1034
26,38,50,78,988,1066
10,38,50,115,380,495
28,38,50,154,1064,1218
19,42,54,2,798,800
3,1898,3375,2811,5694,8505
1,1266,2320,892,1266,2158
1,1266,2320,636,1266,1902
1,420,769,341,420,761
1,1252,2295,951,1252,2203
1,1252,2295,997,1252,2249
1,295,540,240,295,535
1,1898,3375,870,1898,2768
1,713,1120,385,713,1098
1,487,783,280,487,767
3,2171,3578,2826,6513,9339
2,2171,3578,1884,4342,6226
2,2171,3578,1311,4342,5653
3,713,1120,482,2139,2621
1,2171,3578,1371,2171,3542
1,344,540,77,344,421
3,2171,3578,2504,6513,9017
3,2171,3578,4114,6513,10627
22,26,70,953,572,1525
21,26,70,909,546,1455
25,26,70,768,650,1418
6,3,9,26,18,44
15,2,5,29,30,59
1,2,5,2,2,4
20,1,2,19,20,39
2,1,2,2,2,4
1,1,2,1,1,2
7,1,2,7,7,14
16,12,33,315,192,507
31,2,5,91,62,153
14,2,5,41,28,69
5,1,2,5,5,10
29,1,2,28,29,57
23,1,2,22,23,45
25,1,2,24,25,49
10,1,2,10,10,20
29,2,5,77,58,135
1,2,5,3,2,5
1,1,2,1,1,2
29,1,2,19,29,48
9,1,2,6,9,15
24,9,25,306,216,522
28,9,25,357,252,609
9,9,25,115,81,196
1,1,4,2,1,3
16,2,5,37,32,69
18,8,21,208,144,352
23,8,21,265,184,449
7,8,21,81,56,137
8,2,5,22,16,38
29,2,5,81,58,139
18,1,2,13,18,31
12,1,2,9,12,21
15,9,25,188,135,323
22,9,25,275,198,473
1,9,25,13,9,22
30,2,5,57,60,117
26,1,2,25,26,51
1,1,2,1,1,2
12,2,5,35,24,59
1,2,5,3,2,5
10,2,5,29,20,49
3,1,2,3,3,6
6,1,2,6,6,12
12,1,2,12,12,24
16,1,2,15,16,31
24,1,2,15,24,39
10,1,2,6,10,16
1,1,2,1,1,2
1,1482,2384,521,1482,2003
2,1482,2384,1613,2964,4577
1,1482,2384,878,1482,2360
1,755,1215,193,755,948
2,1482,2384,1136,2964,4100
1,461,742,185,461,646
5,24,64,197,120,317
3,24,64,80,72,152
29,24,64,1141,696,1837
6,45,120,450,270,720
9,59,159,585,531,1116
24,3,9,135,72,207
18,3,9,102,54,156
3,2,5,6,6,12
4,2,5,8,8,16
14,2,5,41,28,69
18,4,10,85,72,157
20,4,10,94,80,174
13,4,10,49,52,101
18,4,10,104,72,176
13,4,10,75,52,127
1,2,5,2,2,4
29,2,5,57,58,115
25,2,5,73,50,123
22,2,5,64,44,108
18,2,5,35,36,71
2,2,5,4,4,8
24,2,5,53,48,101
30,2,5,69,60,129
29,2,5,67,58,125
17,3,9,68,51,119
14,2,5,39,28,67
27,2,5,76,54,130
17,4,10,66,68,134
21,4,10,82,84,166
20,7,9,0,140,140
14,7,9,28,98,126
18,7,9,33,126,159
21,7,9,0,147,147
19,7,9,0,133,133
13,7,9,5,91,96
3,3,8,11,9,20
21,3,8,68,63,131
28,8,22,256,224,480
3,8,22,27,24,51
22,8,22,245,176,421
11,8,22,149,88,237
28,8,22,367,224,591
11,8,22,103,88,191
27,9,24,399,243,642
20,9,24,194,180,374
16,9,24,213,144,357
31,9,24,331,279,610
5,13,35,107,65,172
24,13,35,343,312,655
18,13,35,257,234,491
7,13,35,144,91,235
15,13,35,309,195,504
23,13,35,401,299,700
10,13,35,175,130,305
9,13,35,192,117,309
11,13,35,238,143,381
24,13,35,511,312,823
12,13,35,176,156,332
16,13,35,251,208,459
19,13,35,332,247,579
9,21,55,296,189,485
13,21,55,285,273,558
17,42,54,57,714,771
8,38,50,8,304,312
11,38,50,127,418,545
15,38,50,45,570,615
19,42,54,207,798,1005
11,42,54,120,462,582
11,38,50,66,418,484
6,38,50,66,228,294
9,38,50,9,342,351
12,42,54,27,504,531
17,42,54,2,714,716
5,38,50,55,190,245
6,38,50,6,228,234
31,42,54,-30,1302,1272
4,42,54,0,168,168
18,38,50,18,684,702
3,1266,2320,3023,3798,6821
1,420,769,318,420,738
1,1266,2320,544,1266,1810
1,1252,2295,538,1252,1790
1,1252,2295,630,1252,1882
1,1266,2320,1054,1266,2320
2,420,769,636,840,1476
1,1266,2320,961,1266,2227
1,1898,3375,1410,1898,3308
1,1266,2320,1008,1266,2274
1,2171,3578,1335,2171,3506
2,2171,3578,2528,4342,6870
1,2171,3578,1264,2171,3435
1,1083,1701,244,1083,1327
1,713,1120,205,713,918
3,1519,2443,1893,4557,6450
1,1083,1701,550,1083,1633
2,1519,2443,822,3038,3860
1,713,1120,385,713,1098
1,487,783,194,487,681
1,344,540,110,344,454
1,344,540,191,344,535
20,26,70,852,520,1372
16,26,70,458,416,874
18,26,70,767,468,1235
1,26,70,29,26,55
27,26,70,772,702,1474
13,3,9,76,39,115
6,3,9,25,18,43
1,1,2,1,1,2
17,1,2,10,17,27
23,1,2,13,23,36
4,13,35,57,52,109
18,13,35,257,234,491
22,13,35,315,286,601
1,1,2,1,1,2
3,1,2,3,3,6
26,9,25,280,234,514
13,1,4,38,13,51
9,1,4,27,9,36
3,1,2,3,3,6
8,1,2,8,8,16
27,1,2,27,27,54
23,1,2,22,23,45
26,1,2,25,26,51
9,11,30,136,99,235
3,1,2,3,3,6
6,9,25,95,54,149
19,9,25,299,171,470
28,9,25,399,252,651
18,2,5,53,36,89
9,2,5,27,18,45
28,2,5,66,56,122
1,1,2,1,1,2
23,1,2,15,23,38
13,1,2,8,13,21
4,1,2,2,4,6
32,2,5,62,64,126
28,8,21,258,224,482
13,8,21,120,104,224
31,8,21,286,248,534
9,1,4,26,9,35
21,11,29,366,231,597
15,11,29,261,165,426
12,1,4,35,12,47
18,1,4,53,18,71
5,1,4,15,5,20
4,2,5,11,8,19
1,2,5,3,2,5
22,2,5,58,44,102
28,2,5,66,56,122
6,2,5,14,12,26
27,1,2,26,27,53
8,2,5,19,16,35
1,2,5,2,2,4
20,1,4,49,20,69
22,1,4,54,22,76
26,1,4,63,26,89
18,2,5,34,36,70
5,2,5,10,10,20
1,2,5,3,2,5
27,2,5,76,54,130
24,11,29,265,264,529
24,11,29,265,264,529
3,2,5,8,6,14
18,2,5,50,36,86
1,1482,2384,401,1482,1883
1,1482,2384,592,1482,2074
1,1482,2384,521,1482,2003
1,461,742,147,461,608
3,461,742,442,1383,1825
1,1482,2384,568,1482,2050
2,45,120,97,90,187
24,2,5,46,48,94
11,2,5,21,22,43
23,4,10,129,92,221
4,4,10,22,16,38
13,4,10,61,52,113
8,4,10,38,32,70
25,2,5,74,50,124
13,2,5,38,26,64
1,2,5,3,2,5
7,2,5,20,14,34
3,4,10,17,12,29
2,3,9,12,6,18
5,3,9,29,15,44
18,3,9,72,54,126
16,2,5,38,32,70
26,2,5,60,52,112
5,2,5,12,10,22
18,2,5,34,36,70
19,2,5,36,38,74
17,2,5,45,34,79
19,3,9,90,57,147
22,4,10,86,88,174
23,3,9,134,69,203
6,2,5,18,12,30
14,2,5,41,28,69
27,2,5,80,54,134
23,2,5,68,46,114
15,2,5,42,30,72
31,2,5,87,62,149
4,2,5,9,8,17
20,2,5,44,40,84
9,2,5,25,18,43
5,2,5,14,10,24
7,2,5,20,14,34
5,2,5,15,10,25
24,7,9,13,168,181
15,7,9,25,105,130
8,7,9,13,56,69
3,7,9,5,21,26
21,7,9,34,147,181
8,7,9,15,56,71
30,7,9,57,210,267
14,7,9,23,98,121
3,7,9,1,21,22
28,8,22,256,224,480
2,8,22,28,16,44
30,8,22,301,240,541
30,8,22,394,240,634
17,8,22,223,136,359
17,8,22,234,136,370
12,8,22,126,96,222
24,9,24,285,216,501
14,9,24,203,126,329
17,9,24,165,153,318
21,9,24,305,189,494
20,13,35,391,260,651
5,13,35,72,65,137
10,13,35,213,130,343
20,13,35,412,260,672
2,13,35,41,26,67
14,13,35,200,182,382
17,13,35,350,221,571
23,13,35,337,299,636
26,13,35,554,338,892
27,13,35,585,351,936
26,13,35,454,338,792
28,13,35,400,364,764
4,13,35,57,52,109
9,13,35,129,117,246
8,13,35,140,104,244
12,13,35,235,156,391
9,13,35,192,117,309
1,13,35,22,13,35
27,13,35,471,351,822
20,13,35,412,260,672
22,13,35,469,286,755
22,13,35,453,286,739
9,13,35,129,117,246
9,13,35,157,117,274
28,13,35,596,364,960
12,13,35,260,156,416
2,13,35,31,26,57
8,13,35,173,104,277
14,42,54,153,588,741
15,38,50,150,570,720
12,38,50,138,456,594
2,38,50,20,76,96
1,38,50,12,38,50
27,38,50,297,1026,1323
3,38,50,33,114,147
6,42,54,1,252,253
10,38,50,40,380,420
26,42,54,256,1092,1348
3,42,54,30,126,156
16,42,54,175,672,847
2,1252,2295,1076,2504,3580
1,1266,2320,961,1266,2227
1,1252,2295,561,1252,1813
1,1252,2295,745,1252,1997
1,1266,2320,1008,1266,2274
1,420,769,318,420,738
3,1266,2320,3092,3798,6890
1,295,540,148,295,443
1,1266,2320,1008,1266,2274
1,1252,2295,882,1252,2134
1,1266,2320,961,1266,2227
2,295,540,350,590,940
1,295,540,234,295,529
2,295,540,479,590,1069
1,1266,2320,1008,1266,2274
1,1266,2320,1008,1266,2274
1,1252,2295,538,1252,1790
3,713,1120,1087,2139,3226
1,344,540,185,344,529
1,713,1120,385,713,1098
1,2171,3578,942,2171,3113
1,1083,1701,244,1083,1327
2,713,1120,500,1426,1926
1,1083,1701,550,1083,1633
2,344,540,370,688,1058
1,344,540,191,344,535
1,1555,2443,570,1555,2125
2,1083,1701,1168,2166,3334
1,1555,2443,790,1555,2345
2,1083,1701,1100,2166,3266
1,2171,3578,1335,2171,3506
2,344,540,252,688,940
3,26,70,130,78,208
16,26,70,682,416,1098
20,26,70,572,520,1092
28,3,9,113,84,197
8,3,9,38,24,62
18,3,9,102,54,156
29,3,9,171,87,258
13,1,2,7,13,20
27,1,2,15,27,42
19,2,5,55,38,93
19,2,5,55,38,93
8,2,5,23,16,39
25,9,25,394,225,619
5,1,2,5,5,10
21,2,5,62,42,104
18,1,2,10,18,28
18,1,2,10,18,28
26,1,2,15,26,41
24,1,2,23,24,47
8,13,35,170,104,274
1,13,35,21,13,34
16,1,2,11,16,27
17,1,2,12,17,29
7,2,5,21,14,35
17,2,5,50,34,84
27,2,5,51,54,105
23,2,5,44,46,90
8,2,5,15,16,31
12,2,5,23,24,47
27,11,30,505,297,802
19,11,30,355,209,564
26,13,35,536,338,874
21,1,2,12,21,33
24,8,21,302,192,494
8,8,21,101,64,165
5,1,2,5,5,10
6,1,2,3,6,9
5,1,2,3,5,8
29,1,2,17,29,46
20,1,2,12,20,32
20,1,2,20,20,40
10,1,4,21,10,31
26,1,4,55,26,81
15,1,4,44,15,59
21,1,4,61,21,82
2,1482,2384,1613,2964,4577
1,1482,2384,401,1482,1883
1,1482,2384,735,1482,2217
1,461,742,251,461,712
1,1482,2384,878,1482,2360
1,755,1215,448,755,1203
1,1482,2384,378,1482,1860
1,755,1215,436,755,1191
1,461,742,266,461,727
1,1482,2384,592,1482,2074
1,1482,2384,473,1482,1955
1,461,742,266,461,727
29,24,64,826,696,1522
22,45,120,1175,990,2165
11,59,159,1083,649,1732
1,59,159,67,59,126
10,59,159,936,590,1526
7,59,159,555,413,968
6,59,159,476,354,830
9,59,159,714,531,1245
29,3,9,156,87,243
18,3,9,97,54,151
10,4,10,56,40,96
15,4,10,84,60,144
29,3,9,164,87,251
11,2,5,23,22,45
30,2,5,57,60,117
1,2,5,2,2,4
5,2,5,15,10,25
14,3,9,75,42,117
20,3,9,107,60,167
28,3,9,115,84,199
5,3,9,21,15,36
21,2,5,62,42,104
32,2,5,94,64,158
13,7,9,21,91,112
2,7,9,4,14,18
13,7,9,21,91,112
7,7,9,10,49,59
25,7,9,46,175,221
5,7,9,2,35,37
17,7,9,14,119,133
23,3,8,91,69,160
22,3,8,87,66,153
9,8,22,122,72,194
29,8,22,285,232,517
23,8,22,302,184,486
7,8,22,95,56,151
12,8,22,150,96,246
12,8,22,163,96,259
18,8,22,244,144,388
26,8,22,358,208,566
9,8,22,94,72,166
16,9,24,232,144,376
21,9,24,305,189,494
23,9,24,323,207,530
14,9,24,207,126,333
3,9,24,33,27,60
25,9,24,351,225,576
18,13,35,257,234,491
19,13,35,391,247,638
10,13,35,217,130,347
5,13,35,98,65,163
12,13,35,205,156,361
2,13,35,43,26,69
8,13,35,170,104,274
12,13,35,247,156,403
13,13,35,186,169,355
18,13,35,383,234,617
21,13,35,330,273,603
22,13,35,476,286,762
24,13,35,419,312,731
4,13,35,85,52,137
23,13,35,361,299,660
17,13,35,267,221,488
18,13,35,383,234,617
30,13,35,524,390,914
17,21,55,382,357,739
11,21,55,350,231,581
10,38,50,110,380,490
16,38,50,176,608,784
5,38,50,13,190,203
14,38,50,140,532,672
24,42,54,236,1008,1244
8,42,54,79,336,415
18,38,50,99,684,783
7,42,54,35,294,329
15,38,50,173,570,743
11,38,50,94,418,512
5,42,54,25,210,235
1,1266,2320,636,1266,1902
1,1252,2295,951,1252,2203
1,1266,2320,961,1266,2227
2,1252,2295,2040,2504,4544
2,420,769,636,840,1476
1,1252,2295,882,1252,2134
2,420,769,483,840,1323
1,420,769,318,420,738
2,1266,2320,1783,2532,4315
1,1252,2295,745,1252,1997
1,1266,2320,1008,1266,2274
1,295,540,234,295,529
1,1252,2295,997,1252,2249
1,1252,2295,997,1252,2249
1,295,540,234,295,529
1,1898,3375,870,1898,2768
1,2171,3578,1157,2171,3328
1,713,1120,385,713,1098
2,1555,2443,1581,3110,4691
1,2171,3578,942,2171,3113
1,2171,3578,942,2171,3113
1,2171,3578,942,2171,3113
1,1083,1701,550,1083,1633
1,713,1120,385,713,1098
1,1555,2443,570,1555,2125
2,713,1120,769,1426,2195
1,344,540,174,344,518
1,344,540,83,344,427
15,26,70,639,390,1029
6,3,9,26,18,44
8,3,9,47,24,71
9,8,21,113,72,185
11,1,2,11,11,22
9,1,2,9,9,18
20,1,2,19,20,39
24,1,2,23,24,47
9,1,2,6,9,15
5,1,2,3,5,8
26,1,4,77,26,103
17,1,2,10,17,27
3,1,2,2,3,5
21,13,35,447,273,720
12,13,35,256,156,412
22,2,5,62,44,106
19,2,5,53,38,91
23,2,5,64,46,110
18,2,5,50,36,86
1,1,2,1,1,2
20,1,2,15,20,35
14,2,5,41,28,69
1,1,2,1,1,2
29,1,2,21,29,50
3,1,2,2,3,5
3,2,5,6,6,12
18,2,5,34,36,70
28,1,2,26,28,54
5,1,2,5,5,10
24,1,2,22,24,46
30,1,2,28,30,58
2,1,2,2,2,4
27,2,5,80,54,134
4,2,5,12,8,20
2,2,5,4,4,8
7,2,5,15,14,29
13,2,5,31,26,57
8,2,5,19,16,35
12,8,21,103,96,199
7,1,4,20,7,27
20,1,4,57,20,77
12,9,25,153,108,261
8,9,25,102,72,174
6,9,25,77,54,131
15,1,2,15,15,30
12,1,2,12,12,24
28,13,35,459,364,823
13,13,35,213,169,382
32,1,2,19,32,51
24,1,2,14,24,38
8,8,21,82,64,146
1,8,21,10,8,18
30,1,4,74,30,104
29,2,5,68,58,126
29,2,5,68,58,126
19,9,25,242,171,413
26,2,5,61,52,113
28,2,5,66,56,122
22,2,5,52,44,96
2,8,21,25,16,41
18,8,21,226,144,370
1,8,21,12,8,20
10,8,21,122,80,202
1,1482,2384,473,1482,1955
1,755,1215,302,755,1057
1,755,1215,436,755,1191
1,755,1215,241,755,996
2,755,1215,410,1510,1920
3,461,742,376,1383,1759
27,24,64,1011,648,1659
5,59,159,484,295,779
1,4,10,6,4,10
7,2,5,13,14,27
4,2,5,11,8,19
3,2,5,8,6,14
27,4,10,113,108,221
7,4,10,29,28,57
14,2,5,29,28,57
16,2,5,34,32,66
3,2,5,9,6,15
12,2,5,35,24,59
25,2,5,59,50,109
13,2,5,31,26,57
30,2,5,54,60,114
29,2,5,86,58,144
24,7,9,20,168,188
27,7,9,44,189,233
3,7,9,1,21,22
10,7,9,18,70,88
13,7,9,5,91,96
12,7,9,20,84,104
6,3,8,24,18,42
24,3,8,85,72,157
7,3,8,34,21,55
18,3,8,87,54,141
9,3,8,44,27,71
12,8,22,163,96,259
16,8,22,178,128,306
13,8,22,179,104,283
28,8,22,386,224,610
17,8,22,223,136,359
19,8,22,212,152,364
17,8,22,234,136,370
24,9,24,337,216,553
20,9,24,194,180,374
16,9,24,179,144,323
26,9,24,278,234,512
11,9,24,107,99,206
6,9,24,67,54,121
27,13,35,396,351,747
15,13,35,215,195,410
27,13,35,396,351,747
11,13,35,192,143,335
25,13,35,358,325,683
15,13,35,236,195,431
5,13,35,103,65,168
7,13,35,103,91,194
4,13,35,85,52,137
1,13,35,17,13,30
16,13,35,274,208,482
24,13,35,494,312,806
1,13,35,14,13,27
7,13,35,110,91,201
4,13,35,78,52,130
15,13,35,236,195,431
11,13,35,173,143,316
1,13,35,22,13,35
20,13,35,314,260,574
13,13,35,213,169,382
26,13,35,372,338,710
9,13,35,185,117,302
2,13,35,31,26,57
5,21,55,121,105,226
4,38,50,46,152,198
20,42,54,46,840,886
21,38,50,210,798,1008
16,42,54,80,672,752
12,42,54,27,504,531
3,1266,2320,3023,3798,6821
1,1912,3400,1046,1912,2958
2,420,769,667,840,1507
1,1252,2295,1020,1252,2272
1,420,769,249,420,669
1,295,540,234,295,529
3,1252,2295,3060,3756,6816
1,1252,2295,538,1252,1790
1,1252,2295,538,1252,1790
2,2171,3578,1240,4342,5582
1,1555,2443,448,1555,2003
1,713,1120,396,713,1109
3,1519,2443,2479,4557,7036
3,1555,2443,905,4665,5570
3,1083,1701,1140,3249,4389
1,1083,1701,312,1083,1395
1,1083,1701,550,1083,1633
1,2171,3578,763,2171,2934
2,2171,3578,1526,4342,5868
1,1083,1701,244,1083,1327
1,713,1120,385,713,1098
3,1519,2443,1819,4557,6376
1,344,540,191,344,535
1,1555,2443,448,1555,2003
1,344,540,99,344,443
1,1555,2443,570,1555,2125
3,344,540,377,1032,1409
2,344,540,252,688,940
1,487,783,288,487,775
1,344,540,110,344,454
1,2171,3578,1335,2171,3506
17,26,70,593,442,1035
1,26,70,41,26,67
7,26,70,244,182,426
30,3,9,145,90,235
27,3,9,116,81,197
18,2,5,34,36,70
23,2,5,44,46,90
18,2,5,52,36,88
18,2,5,52,36,88
27,2,5,76,54,130
2,2,5,6,4,10
27,1,2,26,27,53
14,1,2,13,14,27
14,1,2,10,14,24
21,1,2,16,21,37
28,1,2,16,28,44
24,1,2,13,24,37
19,1,2,11,19,30
6,2,5,11,12,23
26,1,4,61,26,87
18,1,4,42,18,60
24,2,5,50,48,98
14,2,5,29,28,57
20,2,5,41,40,81
17,12,33,351,204,555
10,1,2,7,10,17
1,1,2,1,1,2
6,11,30,91,66,157
18,1,2,17,18,35
2,1,2,2,2,4
16,1,2,15,16,31
17,2,5,40,34,74
26,2,5,61,52,113
17,9,25,242,153,395
27,2,5,63,54,117
24,2,5,56,48,104
31,2,5,65,62,127
23,1,4,67,23,90
12,1,4,35,12,47
1,2,5,2,2,4
19,12,33,261,228,489
6,1,4,15,6,21
13,2,5,36,26,62
10,2,5,30,20,50
6,11,29,70,66,136
27,11,29,314,297,611
13,1,4,28,13,41
4,1,4,8,4,12
18,1,2,13,18,31
2,1,2,1,2,3
25,9,25,319,225,544
10,9,25,128,90,218
9,8,21,109,72,181
1,1482,2384,401,1482,1883
1,1482,2384,401,1482,1883
1,1482,2384,592,1482,2074
1,755,1215,411,755,1166
1,755,1215,448,755,1203
2,1482,2384,1709,2964,4673
1,461,742,147,461,608
2,461,742,295,922,1217
3,461,742,442,1383,1825
2,461,742,236,922,1158
1,461,742,266,461,727
30,24,64,950,720,1670
24,24,64,929,576,1505
16,3,9,95,48,143
26,2,5,64,52,116
17,4,10,80,68,148
25,4,10,118,100,218
6,2,5,17,12,29
12,2,5,34,24,58
7,4,10,29,28,57
9,4,10,38,36,74
23,4,10,133,92,225
14,4,10,81,56,137
30,4,10,114,120,234
7,4,10,27,28,55
16,4,10,90,64,154
14,4,10,78,56,134
18,3,9,82,54,136
28,3,9,128,84,212
18,2,5,52,36,88
24,2,5,70,48,118
20,2,5,58,40,98
13,2,5,38,26,64
1,4,10,4,4,8
13,4,10,49,52,101
20,3,9,95,60,155
29,3,9,137,87,224
17,3,9,74,51,125
29,3,9,127,87,214
27,2,5,80,54,134
7,2,5,21,14,35
26,7,9,43,182,225
7,7,9,13,49,62
26,7,9,47,182,229
21,7,9,40,147,187
6,7,9,1,42,43
17,7,9,31,119,150
20,3,8,97,60,157
2,8,22,27,16,43
23,8,22,241,184,425
17,8,22,186,136,322
7,8,22,70,56,126
10,8,22,138,80,218
12,9,24,174,108,282
32,9,24,342,288,630
28,9,24,299,252,551
12,9,24,128,108,236
2,13,35,31,26,57
5,13,35,107,65,172
22,13,35,322,286,608
9,13,35,192,117,309
31,13,35,639,403,1042
10,13,35,206,130,336
6,13,35,88,78,166
22,13,35,315,286,601
20,13,35,412,260,672
10,13,35,175,130,305
15,13,35,257,195,452
10,13,35,217,130,347
22,13,35,345,286,631
27,13,35,424,351,775
19,13,35,332,247,579
30,13,35,492,390,882
24,13,35,343,312,655
15,13,35,293,195,488
9,13,35,185,117,302
13,13,35,277,169,446
15,13,35,246,195,441
11,21,55,241,231,472
3,21,55,66,63,129
2,42,54,0,84,84
20,42,54,197,840,1037
9,38,50,50,342,392
13,38,50,72,494,566
5,42,54,49,210,259
19,42,54,84,798,882
31,38,50,31,1178,1209
12,38,50,120,456,576
11,42,54,49,462,511
3,42,54,0,126,126
9,38,50,90,342,432
17,42,54,186,714,900
26,42,54,59,1092,1151
26,42,54,59,1092,1151
15,42,54,67,630,697
1,1266,2320,1008,1266,2274
1,1252,2295,791,1252,2043
1,1266,2320,636,1266,1902
1,1252,2295,951,1252,2203
1,1252,2295,676,1252,1928
2,1266,2320,1458,2532,3990
3,420,769,955,1260,2215
3,420,769,955,1260,2215
1,1252,2295,1020,1252,2272
2,295,540,468,590,1058
1,1252,2295,538,1252,1790
1,420,769,188,420,608
2,1266,2320,2015,2532,4547
2,1266,2320,1922,2532,4454
1,295,540,234,295,529
1,1266,2320,961,1266,2227
1,2171,3578,1335,2171,3506
3,2171,3578,2826,6513,9339
1,2171,3578,942,2171,3113
1,1083,1701,244,1083,1327
1,713,1120,385,713,1098
1,713,1120,161,713,874
3,713,1120,482,2139,2621
1,344,540,191,344,535
1,713,1120,261,713,974
2,344,540,198,688,886
1,1083,1701,550,1083,1633
1,713,1120,205,713,918
1,713,1120,228,713,941
3,2171,3578,2504,6513,9017
1,2171,3578,906,2171,3077
8,26,70,346,208,554
22,26,70,752,572,1324
19,26,70,543,494,1037
12,26,70,352,312,664
22,3,9,124,66,190
22,1,2,21,22,43
7,1,2,7,7,14
9,2,5,26,18,44
21,2,5,62,42,104
8,2,5,24,16,40
4,2,5,9,8,17
31,9,25,333,279,612
1,9,25,11,9,20
5,1,2,3,5,8
27,1,2,16,27,43
20,1,4,59,20,79
25,2,5,73,50,123
4,2,5,12,8,20
17,2,5,49,34,83
5,2,5,10,10,20
8,2,5,15,16,31
22,2,5,42,44,86
7,2,5,21,14,35
1,11,29,17,11,28
15,11,29,253,165,418
11,11,29,185,121,306
6,1,2,4,6,10
16,1,4,45,16,61
3,1,4,9,3,12
17,1,2,11,17,28
5,1,2,5,5,10
2,11,30,36,22,58
28,2,5,66,56,122
13,2,5,31,26,57
21,1,2,21,21,42
9,1,4,21,9,30
4,8,21,34,32,66
24,8,21,206,192,398
1,2,5,3,2,5
31,1,4,91,31,122
26,1,4,76,26,102
5,2,5,15,10,25
5,2,5,15,10,25
15,1,2,9,15,24
22,2,5,42,44,86
22,1,4,54,22,76
7,1,4,17,7,24
6,2,5,17,12,29
10,2,5,28,20,48
17,2,5,48,34,82
1,1482,2384,449,1482,1931
3,1482,2384,2634,4446,7080
3,461,742,554,1383,1937
1,755,1215,436,755,1191
1,755,1215,375,755,1130
4,24,64,155,96,251
5,45,120,243,225,468
9,4,10,53,36,89
31,2,5,87,62,149
31,2,5,87,62,149
6,2,5,17,12,29
12,2,5,28,24,52
22,2,5,65,44,109
19,2,5,56,38,94
21,2,5,62,42,104
1,2,5,3,2,5
1,2,5,3,2,5
25,2,5,73,50,123
7,2,5,20,14,34
29,3,9,164,87,251
3,3,9,17,9,26
12,2,5,34,24,58
26,2,5,73,52,125
14,7,9,4,98,102
22,7,9,8,154,162
15,7,9,29,105,134
20,7,9,36,140,176
5,7,9,4,35,39
22,7,9,0,154,154
28,7,9,3,196,199
21,3,8,103,63,166
17,3,8,67,51,118
9,3,8,36,27,63
16,8,22,147,128,275
7,8,22,78,56,134
11,8,22,152,88,240
21,8,22,289,168,457
11,9,24,131,99,230
3,9,24,29,27,56
16,9,24,232,144,376
9,9,24,105,81,186
26,13,35,454,338,792
29,13,35,496,377,873
16,13,35,218,208,426
9,13,35,192,117,309
1,13,35,17,13,30
6,13,35,130,78,208
26,13,35,536,338,874
21,13,35,330,273,603
24,13,35,377,312,689
6,13,35,128,78,206
28,13,35,577,364,941
4,13,35,63,52,115
19,13,35,391,247,638
28,21,55,736,588,1324
3,21,55,100,63,163
23,21,55,769,483,1252
4,38,50,40,152,192
27,38,50,68,1026,1094
15,42,54,172,630,802
31,42,54,4,1302,1306
20,38,50,230,760,990
4,42,54,46,168,214
28,38,50,308,1064,1372
3,42,54,30,126,156
24,38,50,204,912,1116
1,1266,2320,1031,1266,2297
3,1252,2295,1614,3756,5370
1,1252,2295,951,1252,2203
1,1252,2295,630,1252,1882
1,1252,2295,882,1252,2134
3,1266,2320,3023,3798,6821
1,1252,2295,1020,1252,2272
1,1266,2320,752,1266,2018
1,1266,2320,752,1266,2018
1,1252,2295,951,1252,2203
1,487,783,280,487,767
2,487,783,247,974,1221
3,487,783,371,1461,1832
2,1083,1701,488,2166,2654
1,713,1120,362,713,1075
2,713,1120,411,1426,1837
1,1083,1701,499,1083,1582
1,713,1120,362,713,1075
10,26,70,286,260,546
4,3,9,16,12,28
1,3,9,4,3,7
7,13,35,120,91,211
1,1,2,1,1,2
13,2,5,36,26,62
26,11,30,486,286,772
3,1,4,6,3,9
23,2,5,68,46,114
23,2,5,68,46,114
16,2,5,45,32,77
16,1,2,12,16,28
25,1,2,19,25,44
30,1,4,89,30,119
8,1,4,24,8,32
22,1,2,13,22,35
19,1,2,11,19,30
15,8,21,189,120,309
16,8,21,201,128,329
30,8,21,308,240,548
9,2,5,17,18,35
9,8,21,81,72,153
6,8,21,54,48,102
12,11,29,171,132,303
3,1,4,9,3,12
3,1482,2384,990,4446,5436
1,1482,2384,473,1482,1955
7,45,120,349,315,664
1,59,159,98,59,157
21,2,5,40,42,82
15,2,5,29,30,59
20,2,5,42,40,82
11,2,5,23,22,45
32,4,10,189,128,317
24,2,5,67,48,115
21,2,5,59,42,101
7,2,5,20,14,34
22,2,5,58,44,102
2,2,5,5,4,9
5,2,5,14,10,24
19,2,5,53,38,91
9,2,5,26,18,44
17,2,5,49,34,83
24,2,5,70,48,118
12,2,5,35,24,59
25,2,5,73,50,123
1,2,5,3,2,5
17,2,5,37,34,71
5,4,10,20,20,40
23,4,10,90,92,182
1,4,10,4,4,8
26,4,10,99,104,203
26,3,9,140,78,218
6,3,9,32,18,50
13,2,5,31,26,57
18,2,5,42,36,78
10,2,5,28,20,48
26,2,5,73,52,125
1,7,9,1,7,8
32,7,9,58,224,282
29,7,9,53,203,256
30,7,9,55,210,265
5,7,9,9,35,44
21,7,9,34,147,181
3,7,9,5,21,26
12,7,9,10,84,94
14,3,8,54,42,96
1,3,8,4,3,7
1,3,8,5,3,8
21,3,8,102,63,165
18,8,22,165,144,309
19,8,22,258,152,410
4,8,22,54,32,86
16,8,22,220,128,348
19,8,22,212,152,364
1,8,22,9,8,17
18,8,22,201,144,345
6,9,24,89,54,143
3,9,24,44,27,71
9,9,24,126,81,207
14,9,24,139,126,265
7,13,35,144,91,235
15,13,35,320,195,515
22,13,35,453,286,739
19,13,35,325,247,572
2,13,35,35,26,61
7,13,35,149,91,240
16,13,35,251,208,459
29,13,35,628,377,1005
20,13,35,314,260,574
23,13,35,401,299,700
24,13,35,520,312,832
8,13,35,140,104,244
11,13,35,192,143,335
6,13,35,94,78,172
2,13,35,43,26,69
8,13,35,170,104,274
15,13,35,220,195,415
11,21,55,229,231,460
24,21,55,605,504,1109
24,38,50,120,912,1032
29,38,50,334,1102,1436
1,38,50,11,38,49
24,38,50,276,912,1188
26,38,50,221,988,1209
16,38,50,176,608,784
26,38,50,286,988,1274
9,42,54,103,378,481
9,38,50,99,342,441
29,42,54,19,1218,1237
2,42,54,10,84,94
20,38,50,20,760,780
3,1266,2320,2048,3798,5846
1,1252,2295,745,1252,1997
1,1252,2295,538,1252,1790
3,1252,2295,2165,3756,5921
1,1252,2295,630,1252,1882
1,308,565,246,308,554
1,1252,2295,630,1252,1882
1,2171,3578,1264,2171,3435
1,487,783,124,487,611
1,2171,3578,656,2171,2827
3,1519,2443,2479,4557,7036
1,1555,2443,790,1555,2345
1,1555,2443,717,1555,2272
1,344,540,185,344,529
1,1083,1701,550,1083,1633
1,1555,2443,424,1555,1979
2,344,540,370,688,1058
1,1083,1701,346,1083,1429
1,344,540,158,344,502
2,1083,1701,1100,2166,3266
1,487,783,194,487,681
1,487,783,194,487,681
3,2171,3578,4006,6513,10519
22,26,70,953,572,1525
28,26,70,1193,728,1921
16,26,70,682,416,1098
24,26,70,686,624,1310
22,26,70,768,572,1340
5,1,2,5,5,10
23,1,2,17,23,40
24,1,2,18,24,42
1,1,2,1,1,2
20,2,5,59,40,99
26,2,5,77,52,129
13,2,5,27,26,53
16,2,5,34,32,66
9,11,30,136,99,235
12,11,30,181,132,313
7,2,5,16,14,30
25,2,5,48,50,98
27,1,4,73,27,100
30,1,4,82,30,112
1,1,4,3,1,4
18,1,2,17,18,35
28,1,2,26,28,54
1,8,21,9,8,17
5,1,2,5,5,10
19,1,2,19,19,38
32,12,33,440,384,824
14,12,33,192,168,360
11,2,5,31,22,53
1,1,4,2,1,3
28,8,21,352,224,576
4,8,21,50,32,82
18,2,5,53,36,89
14,2,5,41,28,69
5,2,5,15,10,25
11,1,4,32,11,43
5,1,4,15,5,20
15,1,2,8,15,23
15,1,2,8,15,23
29,9,25,334,261,595
17,9,25,196,153,349
4,9,25,46,36,82
2,1482,2384,1184,2964,4148
2,1482,2384,803,2964,3767
1,755,1215,411,755,1166
3,755,1215,906,2265,3171
1,1482,2384,592,1482,2074
1,461,742,229,461,690
1,1482,2384,807,1482,2289
2,1482,2384,946,2964,3910
3,755,1215,797,2265,3062
1,461,742,266,461,727
3,461,742,376,1383,1759
6,24,64,232,144,376
5,59,159,325,295,620
1,2,5,3,2,5
10,2,5,30,20,50
27,2,5,63,54,117
18,3,9,79,54,133
24,2,5,46,48,94
1,2,5,2,2,4
24,2,5,67,48,115
22,2,5,62,44,106
6,4,10,26,24,50
28,4,10,123,112,235
6,2,5,13,12,25
3,2,5,6,6,12
23,2,5,45,46,91
27,2,5,53,54,107
19,2,5,53,38,91
21,2,5,59,42,101
29,2,5,84,58,142
7,2,5,20,14,34
16,2,5,46,32,78
17,2,5,49,34,83
9,4,10,52,36,88
3,4,10,17,12,29
19,3,9,111,57,168
25,3,9,146,75,221
10,3,9,58,30,88
26,3,9,151,78,229
16,7,9,29,112,141
26,7,9,3,182,185
20,7,9,15,140,155
4,7,9,7,28,35
14,7,9,0,98,98
20,7,9,38,140,178
5,3,8,25,15,40
18,3,8,64,54,118
23,3,8,111,69,180
15,3,8,74,45,119
1,8,22,14,8,22
30,8,22,413,240,653
7,8,22,76,56,132
26,8,22,238,208,446
9,8,22,90,72,162
21,8,22,276,168,444
19,8,22,212,152,364
18,8,22,248,144,392
8,8,22,110,64,174
7,9,24,103,63,166
4,9,24,59,36,95
9,9,24,107,81,188
27,9,24,288,243,531
5,9,24,70,45,115
4,9,24,39,36,75
19,9,24,276,171,447
6,13,35,130,78,208
18,13,35,283,234,517
1,13,35,22,13,35
19,13,35,405,247,652
26,13,35,536,338,874
15,13,35,236,195,431
25,13,35,541,325,866
30,13,35,429,390,819
15,13,35,309,195,504
19,13,35,298,247,545
18,13,35,383,234,617
26,13,35,563,338,901
19,13,35,405,247,652
12,13,35,163,156,319
12,13,35,260,156,416
25,13,35,533,325,858
25,13,35,358,325,683
29,13,35,496,377,873
24,21,55,578,504,1082
19,21,55,427,399,826
16,42,54,175,672,847
21,38,50,231,798,1029
3,38,50,35,114,149
1,42,54,5,42,47
8,38,50,68,304,372
25,42,54,111,1050,1161
18,42,54,41,756,797
20,42,54,197,840,1037
1,1252,2295,630,1252,1882
2,1252,2295,1076,2504,3580
2,420,769,667,840,1507
1,1266,2320,961,1266,2227
1,295,540,234,295,529
2,295,540,447,590,1037
2,295,540,447,590,1037
3,420,769,632,1260,1892
1,1266,2320,752,1266,2018
3,1252,2295,1614,3756,5370
1,1555,2443,351,1555,1906
3,2171,3578,1967,6513,8480
1,2171,3578,942,2171,3113
1,2171,3578,835,2171,3006
1,713,1120,385,713,1098
1,1083,1701,601,1083,1684
3,344,540,361,1032,1393
1,1083,1701,397,1083,1480
3,713,1120,616,2139,2755
2,487,783,576,974,1550
1,2171,3578,1335,2171,3506
20,26,70,586,520,1106
5,3,9,29,15,44
7,9,25,110,63,173
13,1,2,13,13,26
5,1,2,4,5,9
20,1,2,15,20,35
1,13,35,16,13,29
1,13,35,16,13,29
29,13,35,618,377,995
13,2,5,25,26,51
22,1,4,65,22,87
26,2,5,73,52,125
5,2,5,15,10,25
24,2,5,71,48,119
26,2,5,77,52,129
5,1,2,4,5,9
7,1,2,6,7,13
8,13,35,165,104,269
12,13,35,247,156,403
20,13,35,412,260,672
22,1,2,13,22,35
3,1,2,2,3,5
21,1,2,12,21,33
20,2,5,39,40,79
13,2,5,25,26,51
20,13,35,426,260,686
9,13,35,192,117,309
6,2,5,18,12,30
12,2,5,35,24,59
30,2,5,63,60,123
3,2,5,9,6,15
6,2,5,17,12,29
30,1,4,74,30,104
4,2,5,8,8,16
26,2,5,49,52,101
18,9,25,284,162,446
9,9,25,142,81,223
1,2,5,3,2,5
6,2,5,18,12,30
26,1,4,59,26,85
9,1,2,5,9,14
20,2,5,59,40,99
28,8,21,352,224,576
22,8,21,277,176,453
9,8,21,75,72,147
26,8,21,218,208,426
23,8,21,231,184,415
15,1,2,15,15,30
8,2,5,15,16,31
6,2,5,11,12,23
23,2,5,44,46,90
14,2,5,27,28,55
4,12,33,52,48,100
13,12,33,170,156,326
30,2,5,89,60,149
5,2,5,10,10,20
7,2,5,13,14,27
1,2,5,2,2,4
22,8,21,203,176,379
5,8,21,46,40,86
22,2,5,64,44,108
12,2,5,28,24,52
9,2,5,21,18,39
14,1,2,10,14,24
19,1,2,13,19,32
1,461,742,266,461,727
1,755,1215,193,755,948
2,755,1215,871,1510,2381
1,461,742,266,461,727
14,2,5,41,28,69
30,2,5,84,60,144
28,2,5,78,56,134
21,2,5,48,42,90
7,2,5,16,14,30
9,2,5,26,18,44
19,3,9,112,57,169
17,3,9,100,51,151
8,2,5,19,16,35
3,3,9,18,9,27
19,3,9,112,57,169
25,2,5,58,50,108
17,2,5,39,34,73
3,2,5,9,6,15
27,2,5,78,54,132
4,2,5,9,8,17
26,2,5,61,52,113
6,7,9,4,42,46
10,7,9,19,70,89
17,7,9,14,119,133
23,7,9,0,161,161
20,7,9,33,140,173
19,7,9,31,133,164
27,7,9,49,189,238
8,7,9,0,56,56
21,7,9,34,147,181
22,3,8,71,66,137
29,3,8,113,87,200
26,8,22,353,208,561
18,8,22,165,144,309
23,8,22,251,184,435
7,8,22,64,56,120
1,8,22,14,8,22
29,9,24,428,261,689
22,9,24,319,198,517
14,9,24,150,126,276
21,13,35,433,273,706
21,13,35,433,273,706
20,13,35,412,260,672
11,13,35,180,143,323
20,13,35,293,260,553
25,13,35,428,325,753
18,13,35,245,234,479
4,13,35,57,52,109
11,13,35,192,143,335
10,13,35,147,130,277
14,13,35,200,182,382
17,13,35,350,221,571
8,13,35,170,104,274
24,13,35,511,312,823
4,13,35,85,52,137
14,13,35,200,182,382
27,13,35,575,351,926
4,13,35,85,52,137
8,13,35,140,104,244
2,13,35,35,26,61
10,13,35,157,130,287
17,21,55,569,357,926
27,42,54,62,1134,1196
15,42,54,164,630,794
19,38,50,190,722,912
18,38,50,18,684,702
8,38,50,92,304,396
5,38,50,55,190,245
3,42,54,13,126,139
3,42,54,30,126,156
6,42,54,49,252,301
20,42,54,46,840,886
19,42,54,43,798,841
3,38,50,33,114,147
14,38,50,140,532,672
3,1912,3400,2832,5736,8568
1,1266,2320,729,1266,1995
1,1912,3400,876,1912,2788
1,1266,2320,961,1266,2227
1,1266,2320,1008,1266,2274
1,1266,2320,497,1266,1763
2,1252,2295,1076,2504,3580
1,1252,2295,538,1252,1790
1,420,769,334,420,754
2,295,540,252,590,842
1,1266,2320,961,1266,2227
1,1252,2295,997,1252,2249
1,1252,2295,722,1252,1974
3,487,783,841,1461,2302
1,1083,1701,550,1083,1633
2,2171,3578,1884,4342,6226
2,713,1120,500,1426,1926
1,2171,3578,835,2171,3006
1,1519,2443,606,1519,2125
3,344,540,523,1032,1555
1,713,1120,329,713,1042
2,344,540,370,688,1058
3,1083,1701,1191,3249,4440
2,487,783,263,974,1237
1,2171,3578,1335,2171,3506
26,26,70,1108,676,1784
17,26,70,724,442,1166
31,26,70,1321,806,2127
15,26,70,492,390,882
9,26,70,371,234,605
13,2,5,25,26,51
28,2,5,53,56,109
13,2,5,25,26,51
13,1,2,12,13,25
29,1,2,28,29,57
27,1,2,26,27,53
2,1,2,2,2,4
15,1,2,15,15,30
18,1,2,17,18,35
19,2,5,53,38,91
29,2,5,81,58,139
5,1,2,4,5,9
25,1,2,14,25,39
21,2,5,61,42,103
8,11,30,99,88,187
10,13,35,196,130,326
5,13,35,98,65,163
29,2,5,81,58,139
5,1,2,3,5,8
16,1,2,9,16,25
27,8,21,232,216,448
11,8,21,94,88,182
11,2,5,31,22,53
15,2,5,42,30,72
1,8,21,13,8,21
22,8,21,277,176,453
3,1,4,9,3,12
1,1,4,3,1,4
11,11,30,186,121,307
21,1,2,15,21,36
19,1,2,14,19,33
28,2,5,78,56,134
10,2,5,28,20,48
16,2,5,45,32,77
28,2,5,78,56,134
11,2,5,21,22,43
8,2,5,15,16,31
12,1,2,7,12,19
4,1,2,2,4,6
7,1,4,20,7,27
10,1,4,28,10,38
28,2,5,53,56,109
5,1,4,15,5,20
22,1,4,64,22,86
8,8,21,101,64,165
14,8,21,176,112,288
7,8,21,88,56,144
14,1,4,34,14,48
2,1482,2384,946,2964,3910
1,1482,2384,592,1482,2074
1,1482,2384,401,1482,1883
1,755,1215,411,755,1166
1,1482,2384,592,1482,2074
1,461,742,251,461,712
3,1482,2384,2634,4446,7080
1,1482,2384,735,1482,2217
2,461,742,369,922,1291
1,1482,2384,378,1482,1860
1,461,742,118,461,579
3,1482,2384,2563,4446,7009
1,1482,2384,568,1482,2050
1,461,742,162,461,623
1,461,742,266,461,727
14,24,64,372,336,708
17,24,64,604,408,1012
5,45,120,369,225,594
9,59,159,871,531,1402
26,2,5,55,52,107
13,2,5,31,26,57
5,2,5,12,10,22
16,4,10,61,64,125
1,4,10,4,4,8
13,2,5,36,26,62
16,2,5,45,32,77
19,2,5,37,38,75
23,4,10,108,92,200
13,4,10,61,52,113
28,2,5,81,56,137
25,4,10,145,100,245
27,4,10,157,108,265
30,4,10,126,120,246
4,4,10,17,16,33
22,2,5,43,44,87
2,2,5,4,4,8
14,2,5,41,28,69
14,3,9,83,42,125
27,3,9,157,81,238
6,3,9,35,18,53
19,3,9,111,57,168
14,2,5,29,28,57
18,2,5,53,36,89
1,2,5,3,2,5
21,2,5,59,42,101
29,4,10,128,116,244
8,4,10,35,32,67
10,2,5,23,20,43
27,2,5,62,54,116
12,2,5,32,24,56
10,2,5,27,20,47
19,2,5,53,38,91
9,2,5,25,18,43
23,3,9,95,69,164
20,3,9,82,60,142
10,2,5,29,20,49
12,2,5,35,24,59
16,7,9,2,112,114
29,7,9,53,203,256
4,7,9,0,28,28
27,7,9,10,189,199
15,7,9,27,105,132
28,7,9,23,196,219
14,7,9,25,98,123
27,7,9,49,189,238
9,7,9,16,63,79
14,7,9,27,98,125
20,7,9,8,140,148
12,7,9,0,84,84
5,3,8,20,15,35
1,3,8,3,3,6
1,3,8,4,3,7
16,3,8,77,48,125
3,3,8,15,9,24
21,8,22,229,168,397
11,8,22,149,88,237
7,8,22,95,56,151
17,8,22,231,136,367
26,9,24,303,234,537
14,9,24,207,126,333
8,9,24,78,72,150
6,13,35,128,78,206
13,13,35,277,169,446
2,13,35,43,26,69
16,13,35,229,208,437
13,13,35,227,169,396
16,13,35,341,208,549
13,13,35,200,169,369
28,13,35,400,364,764
25,13,35,436,325,761
24,13,35,377,312,689
4,13,35,85,52,137
22,13,35,476,286,762
17,13,35,243,221,464
3,13,35,65,39,104
11,13,35,192,143,335
6,13,35,86,78,164
15,13,35,215,195,410
24,13,35,494,312,806
17,13,35,362,221,583
21,21,55,471,441,912
9,21,55,237,189,426
20,42,54,13,840,853
8,38,50,24,304,328
19,38,50,105,722,827
9,38,50,99,342,441
9,42,54,21,378,399
4,38,50,12,152,164
6,38,50,60,228,288
15,42,54,2,630,632
10,42,54,50,420,470
1,1266,2320,636,1266,1902
1,1266,2320,1008,1266,2274
1,1252,2295,722,1252,1974
1,420,769,341,420,761
3,1266,2320,2884,3798,6682
1,1266,2320,961,1266,2227
1,420,769,318,420,738
1,1266,2320,636,1266,1902
1,1252,2295,538,1252,1790
3,2171,3578,2289,6513,8802
1,2171,3578,1264,2171,3435
2,2171,3578,1454,4342,5796
1,1083,1701,380,1083,1463
1,1083,1701,584,1083,1667
3,713,1120,616,2139,2755
1,344,540,185,344,529
1,2171,3578,1371,2171,3542
1,1083,1701,601,1083,1684
3,1519,2443,1819,4557,6376
2,487,783,341,974,1315
1,344,540,174,344,518
1,2171,3578,620,2171,2791
27,26,70,772,702,1474
20,3,9,113,60,173
27,1,2,15,27,42
26,1,2,15,26,41
6,1,2,6,6,12
14,1,2,13,14,27
19,13,35,405,247,652
9,13,35,192,117,309
21,2,5,44,42,86
15,2,5,32,30,62
20,1,2,20,20,40
5,1,2,5,5,10
4,13,35,85,52,137
3,13,35,64,39,103
16,11,30,299,176,475
23,11,30,430,253,683
7,1,2,4,7,11
24,1,2,15,24,39
13,2,5,25,26,51
19,2,5,36,38,74
21,1,4,52,21,73
2,1,2,2,2,4
20,1,4,57,20,77
24,1,4,68,24,92
27,2,5,80,54,134
24,2,5,71,48,119
17,2,5,50,34,84
6,2,5,18,12,30
1,2,5,3,2,5
17,1,2,15,17,32
17,1,2,15,17,32
13,1,4,38,13,51
19,1,4,55,19,74
30,1,4,88,30,118
21,1,2,13,21,34
8,1,2,5,8,13
14,9,25,147,126,273
23,9,25,242,207,449
11,9,25,138,99,237
4,2,5,12,8,20
22,2,5,64,44,108
7,2,5,20,14,34
22,1,2,12,22,34
31,1,2,17,31,48
9,1,4,27,9,36
4,1,4,12,4,16
30,2,5,57,60,117
29,2,5,55,58,113
6,2,5,17,12,29
1,1482,2384,401,1482,1883
2,1482,2384,1184,2964,4148
1,1482,2384,401,1482,1883
1,1482,2384,592,1482,2074
1,1482,2384,592,1482,2074
3,1482,2384,2563,4446,7009
2,755,1215,871,1510,2381
2,1482,2384,1470,2964,4434
3,461,742,554,1383,1937
1,1482,2384,378,1482,1860
3,755,1215,615,2265,2880
1,1482,2384,401,1482,1883
1,1482,2384,568,1482,2050
4,45,120,233,180,413
5,45,120,363,225,588
14,2,5,29,28,57
22,2,5,46,44,90
17,4,10,80,68,148
23,4,10,108,92,200
2,3,9,8,6,14
2,3,9,8,6,14
23,2,5,53,46,99
16,2,5,47,32,79
22,2,5,65,44,109
4,3,9,21,12,33
4,3,9,21,12,33
26,3,9,151,78,229
2,3,9,12,6,18
11,2,5,32,22,54
20,2,5,59,40,99
21,2,5,40,42,82
15,2,5,42,30,72
9,7,9,15,63,78
18,7,9,5,126,131
25,7,9,10,175,185
5,7,9,4,35,39
3,7,9,6,21,27
25,3,8,111,75,186
17,3,8,61,51,112
8,3,8,32,24,56
5,3,8,24,15,39
24,8,22,331,192,523
24,9,24,354,216,570
19,9,24,185,171,356
7,9,24,78,63,141
1,9,24,9,9,18
14,13,35,244,182,426
19,13,35,272,247,519
1,13,35,22,13,35
6,13,35,105,78,183
24,13,35,352,312,664
23,13,35,498,299,797
12,13,35,260,156,416
30,13,35,471,390,861
19,13,35,312,247,559
27,13,35,490,351,841
8,13,35,170,104,274
24,13,35,511,312,823
12,13,35,260,156,416
23,13,35,450,299,749
11,13,35,192,143,335
12,13,35,205,156,361
1,13,35,15,13,28
1,13,35,21,13,34
20,42,54,100,840,940
16,42,54,71,672,743
29,38,50,334,1102,1436
20,42,54,100,840,940
15,38,50,38,570,608
1,420,769,241,420,661
3,420,769,1024,1260,2284
1,1252,2295,630,1252,1882
2,295,540,468,590,1058
1,1266,2320,752,1266,2018
1,1252,2295,997,1252,2249
2,1555,2443,1727,3110,4837
1,2171,3578,620,2171,2791
1,713,1120,284,713,997
3,2171,3578,2826,6513,9339
3,487,783,465,1461,1926
2,2171,3578,1669,4342,6011
1,487,783,288,487,775
1,344,540,158,344,502
1,713,1120,261,713,974
1,487,783,132,487,619
2,344,540,349,688,1037
2,2171,3578,1240,4342,5582
18,26,70,590,468,1058
20,3,9,118,60,178
11,9,25,173,99,272
31,9,25,488,279,767
9,9,25,142,81,223
11,13,35,234,143,377
28,13,35,596,364,960
20,1,2,19,20,39
16,2,5,30,32,62
5,2,5,10,10,20
25,1,2,16,25,41
26,1,2,17,26,43
1,2,5,3,2,5
15,2,5,44,30,74
20,2,5,59,40,99
7,1,2,7,7,14
24,1,2,23,24,47
11,1,4,33,11,44
22,1,4,65,22,87
24,2,5,55,48,103
11,9,25,146,99,245
6,9,25,80,54,134
15,9,25,199,135,334
26,2,5,55,52,107
7,2,5,15,14,29
2,1,2,2,2,4
25,1,2,23,25,48
18,1,2,17,18,35
21,1,2,21,21,42
22,1,2,22,22,44
5,8,21,43,40,83
4,8,21,34,32,66
23,8,21,198,184,382
3,1,2,2,3,5
23,2,5,41,46,87
25,1,2,24,25,49
26,1,2,25,26,51
7,9,25,88,63,151
21,9,25,263,189,452
13,8,21,112,104,216
29,8,21,249,232,481
24,8,21,206,192,398
21,8,21,264,168,432
19,2,5,53,38,91
12,2,5,34,24,58
17,2,5,48,34,82
11,2,5,21,22,43
25,2,5,48,50,98
18,8,21,219,144,363
18,8,21,219,144,363
2,8,21,24,16,40
27,9,25,419,243,662
1,1482,2384,592,1482,2074
1,1482,2384,878,1482,2360
1,755,1215,205,755,960
1,461,742,185,461,646
3,461,742,598,1383,1981
1,1482,2384,473,1482,1955
1,1482,2384,592,1482,2074
1,1482,2384,735,1482,2217
9,59,159,871,531,1402
1,59,159,97,59,156
24,2,5,71,48,119
10,2,5,28,20,48
23,2,5,64,46,110
23,2,5,54,46,100
8,2,5,19,16,35
18,2,5,34,36,70
26,2,5,49,52,101
21,2,5,61,42,103
20,4,10,116,80,196
13,4,10,75,52,127
18,2,5,50,36,86
26,2,5,73,52,125
21,4,10,122,84,206
26,4,10,151,104,255
14,3,9,64,42,106
28,3,9,128,84,212
8,2,5,15,16,31
15,2,5,29,30,59
8,2,5,21,16,37
1,2,5,3,2,5
4,3,9,21,12,33
12,2,5,28,24,52
23,2,5,53,46,99
7,2,5,21,14,35
18,2,5,34,36,70
13,2,5,25,26,51
23,7,9,0,161,161
2,7,9,1,14,15
18,7,9,7,126,133
20,7,9,36,140,176
1,8,22,9,8,17
5,8,22,68,40,108
23,8,22,317,184,501
16,8,22,147,128,275
25,8,22,345,200,545
9,9,24,133,81,214
8,9,24,89,72,161
27,9,24,262,243,505
11,9,24,160,99,259
21,9,24,305,189,494
1,13,35,20,13,33
6,13,35,130,78,208
19,13,35,332,247,579
16,13,35,341,208,549
11,13,35,238,143,381
8,13,35,170,104,274
1,13,35,22,13,35
14,13,35,239,182,421
22,13,35,384,286,670
4,13,35,82,52,134
13,13,35,277,169,446
18,13,35,383,234,617
21,13,35,308,273,581
22,13,35,322,286,608
11,13,35,215,143,358
12,13,35,197,156,353
27,13,35,443,351,794
15,13,35,325,195,520
7,13,35,149,91,240
14,13,35,200,182,382
21,13,35,411,273,684
11,13,35,157,143,300
6,13,35,105,78,183
11,21,55,332,231,563
5,21,55,165,105,270
7,21,55,234,147,381
23,42,54,3,966,969
14,38,50,161,532,693
25,38,50,75,950,1025
21,38,50,242,798,1040
17,38,50,26,646,672
15,42,54,2,630,632
10,38,50,10,380,390
1,38,50,10,38,48
23,42,54,102,966,1068
32,42,54,4,1344,1348
4,38,50,40,152,192
24,38,50,72,912,984
1,38,50,6,38,44
9,38,50,90,342,432
1,1252,2295,538,1252,1790
3,1252,2295,2647,3756,6403
1,1266,2320,752,1266,2018
1,420,769,241,420,661
3,1252,2295,3060,3756,6816
3,1252,2295,3060,3756,6816
1,295,540,126,295,421
1,420,769,318,420,738
1,295,540,234,295,529
1,295,540,234,295,529
1,308,565,246,308,554
1,1898,3375,870,1898,2768
1,344,540,158,344,502
1,1519,2443,582,1519,2101
1,2171,3578,942,2171,3113
1,487,783,132,487,619
1,487,783,280,487,767
1,2171,3578,835,2171,3006
1,2171,3578,656,2171,2827
1,2171,3578,835,2171,3006
1,1555,2443,839,1555,2394
2,487,783,482,974,1456
2,487,783,529,974,1503
1,1555,2443,497,1555,2052
2,344,540,370,688,1058
1,344,540,77,344,421
1,344,540,158,344,502
1,713,1120,362,713,1075
16,26,70,693,416,1109
28,3,9,165,84,249
15,9,25,161,135,296
29,9,25,312,261,573
12,9,25,129,108,237
30,2,5,87,60,147
1,2,5,3,2,5
20,13,35,426,260,686
16,13,35,341,208,549
20,1,2,14,20,34
19,1,2,14,19,33
12,13,35,260,156,416
5,1,2,4,5,9
4,2,5,11,8,19
22,1,2,21,22,43
16,1,2,15,16,31
15,2,5,44,30,74
24,2,5,71,48,119
14,1,2,8,14,22
19,11,29,320,209,529
10,11,29,168,110,278
30,11,29,505,330,835
29,8,21,249,232,481
16,1,2,15,16,31
10,1,2,9,10,19
26,11,30,463,286,749
7,11,30,125,77,202
6,8,21,73,48,121
6,8,21,73,48,121
6,1,2,6,6,12
11,1,2,11,11,22
10,8,21,122,80,202
23,8,21,280,184,464
20,1,2,19,20,39
5,1,2,5,5,10
5,1,2,5,5,10
30,1,2,26,30,56
6,1,2,5,6,11
24,2,5,50,48,98
6,2,5,13,12,25
10,2,5,21,20,41
8,2,5,24,16,40
2,2,5,6,4,10
2,1,4,6,2,8
27,8,21,340,216,556
5,8,21,63,40,103
22,9,25,341,198,539
21,9,25,326,189,515
31,9,25,481,279,760
3,1482,2384,1204,4446,5650
2,755,1215,823,1510,2333
1,1482,2384,854,1482,2336
2,1482,2384,755,2964,3719
1,1482,2384,568,1482,2050
1,755,1215,193,755,948
1,755,1215,241,755,996
1,1482,2384,378,1482,1860
1,24,64,31,24,55
25,24,64,744,600,1344
2,24,64,75,48,123
2,45,120,97,90,187
6,45,120,443,270,713
4,59,159,286,236,522
25,3,9,141,75,216
11,3,9,62,33,95
12,3,9,64,36,100
18,2,5,53,36,89
1,2,5,3,2,5
20,2,5,59,40,99
10,2,5,28,20,48
24,2,5,70,48,118
28,2,5,53,56,109
19,2,5,36,38,74
12,2,5,23,24,47
27,2,5,80,54,134
17,2,5,36,34,70
1,2,5,2,2,4
3,2,5,8,6,14
24,2,5,67,48,115
9,2,5,26,18,44
7,2,5,21,14,35
14,2,5,41,28,69
12,2,5,34,24,58
29,2,5,81,58,139
17,3,9,74,51,125
11,2,5,31,22,53
9,2,5,25,18,43
27,2,5,76,54,130
6,2,5,17,12,29
19,7,9,16,133,149
12,7,9,20,84,104
7,7,9,13,49,62
8,7,9,7,56,63
27,7,9,49,189,238
1,7,9,1,7,8
28,7,9,23,196,219
17,3,8,55,51,106
31,3,8,123,93,216
18,3,8,89,54,143
17,3,8,66,51,117
7,8,22,64,56,120
7,8,22,95,56,151
25,8,22,345,200,545
31,8,22,345,248,593
15,8,22,197,120,317
14,8,22,147,112,259
8,8,22,110,64,174
16,8,22,178,128,306
14,9,24,203,126,329
27,9,24,269,243,512
16,13,35,229,208,437
18,13,35,314,234,548
20,13,35,314,260,574
25,13,35,358,325,683
16,13,35,341,208,549
16,13,35,346,208,554
20,13,35,426,260,686
15,13,35,220,195,415
23,13,35,337,299,636
20,13,35,314,260,574
25,13,35,541,325,866
7,13,35,149,91,240
26,13,35,563,338,901
20,13,35,349,260,609
26,13,35,426,338,764
27,13,35,556,351,907
5,13,35,103,65,168
17,13,35,332,221,553
9,13,35,192,117,309
23,13,35,474,299,773
3,13,35,64,39,103
27,21,55,888,567,1455
26,21,55,855,546,1401
2,42,54,10,84,94
13,42,54,149,546,695
21,42,54,105,882,987
2,42,54,10,84,94
29,38,50,290,1102,1392
21,42,54,3,882,885
16,42,54,80,672,752
32,38,50,96,1216,1312
2,1266,2320,2015,2532,4547
1,420,769,180,420,600
1,1252,2295,538,1252,1790
3,1266,2320,1631,3798,5429
1,1252,2295,951,1252,2203
1,1252,2295,1020,1252,2272
1,420,769,334,420,754
1,295,540,234,295,529
2,295,540,252,590,842
3,308,565,754,924,1678
1,1266,2320,1031,1266,2297
3,308,565,703,924,1627
1,1266,2320,961,1266,2227
1,1252,2295,1020,1252,2272
2,1266,2320,1273,2532,3805
1,1266,2320,1008,1266,2274
1,1252,2295,538,1252,1790
1,2171,3578,906,2171,3077
1,2171,3578,1264,2171,3435
1,487,783,280,487,767
1,1555,2443,351,1555,1906
2,1555,2443,1581,3110,4691
1,344,540,120,344,464
2,1555,2443,1727,3110,4837
2,344,540,316,688,1004
2,344,540,316,688,1004
1,2171,3578,1335,2171,3506
2,2171,3578,2671,4342,7013
29,26,70,1012,754,1766
4,26,70,140,104,244
14,26,70,606,364,970
10,3,9,40,30,70
15,3,9,66,45,111
20,2,5,38,40,78
19,13,35,325,247,572
27,13,35,462,351,813
8,13,35,137,104,241
19,1,2,18,19,37
21,2,5,56,42,98
4,2,5,11,8,19
30,2,5,80,60,140
10,2,5,20,20,40
5,11,30,94,55,149
26,11,30,486,286,772
23,1,2,22,23,45
30,11,29,531,330,861
28,11,29,496,308,804
21,13,35,308,273,581
13,13,35,190,169,359
26,2,5,51,52,103
28,2,5,83,56,139
4,2,5,12,8,20
10,2,5,29,20,49
3,2,5,9,6,15
25,11,30,340,275,615
1,11,30,14,11,25
14,1,2,12,14,26
1,1,2,1,1,2
23,13,35,474,299,773
19,13,35,391,247,638
8,1,4,20,8,28
25,1,4,62,25,87
19,1,4,47,19,66
5,9,25,79,45,124
5,1,4,11,5,16
23,1,4,52,23,75
3,1,2,2,3,5
12,1,2,7,12,19
2,11,29,35,22,57
10,11,29,177,110,287
10,1,2,10,10,20
23,1,2,23,23,46
7,2,5,13,14,27
15,1,2,10,15,25
26,1,2,18,26,44
13,1,2,12,13,25
9,8,21,83,72,155
28,8,21,258,224,482
7,1,2,5,7,12
15,1,2,11,15,26
30,2,5,87,60,147
11,2,5,32,22,54
1,1,4,3,1,4
14,1,4,41,14,55
1,1,4,2,1,3
13,2,5,36,26,62
27,2,5,76,54,130
12,2,5,34,24,58
16,2,5,42,32,74
1,2,5,3,2,5
21,1,4,51,21,72
15,1,4,37,15,52
4,8,21,50,32,82
13,8,21,164,104,268
2,8,21,25,16,41
12,8,21,151,96,247
1,755,1215,411,755,1166
1,461,742,229,461,690
1,755,1215,302,755,1057
1,755,1215,302,755,1057
3,755,1215,615,2265,2880
1,755,1215,411,755,1166
15,24,64,562,360,922
8,24,64,207,192,399
23,24,64,596,552,1148
23,24,64,905,552,1457
6,45,120,292,270,562
18,2,5,52,36,88
1,2,5,3,2,5
23,2,5,68,46,114
2,2,5,6,4,10
5,3,9,28,15,43
24,3,9,135,72,207
29,4,10,171,116,287
19,4,10,112,76,188
1,4,10,5,4,9
7,2,5,15,14,29
14,2,5,29,28,57
20,3,9,113,60,173
4,3,9,23,12,35
30,2,5,89,60,149
11,2,5,32,22,54
30,2,5,84,60,144
13,2,5,36,26,62
10,3,9,59,30,89
1,3,9,4,3,7
20,3,9,80,60,140
12,2,5,35,24,59
19,2,5,56,38,94
10,2,5,23,20,43
1,2,5,2,2,4
6,2,5,13,12,25
1,2,5,3,2,5
12,2,5,35,24,59
26,7,9,43,182,225
15,7,9,25,105,130
23,7,9,42,161,203
16,7,9,6,112,118
2,7,9,3,14,17
10,7,9,4,70,74
23,7,9,44,161,205
19,3,8,92,57,149
23,8,22,317,184,501
18,8,22,248,144,392
29,8,22,393,232,625
5,8,22,52,40,92
20,8,22,262,160,422
24,9,24,354,216,570
7,9,24,81,63,144
8,9,24,118,72,190
6,9,24,87,54,141
7,9,24,68,63,131
21,13,35,330,273,603
4,13,35,82,52,134
22,13,35,476,286,762
8,13,35,173,104,277
26,13,35,563,338,901
13,13,35,268,169,437
18,13,35,390,234,624
10,13,35,206,130,336
12,13,35,247,156,403
22,13,35,453,286,739
25,13,35,358,325,683
14,13,35,244,182,426
6,13,35,103,78,181
13,13,35,277,169,446
22,13,35,315,286,601
13,13,35,222,169,391
8,13,35,137,104,241
31,21,55,815,651,1466
16,21,55,509,336,845
26,21,55,870,546,1416
22,21,55,724,462,1186
15,21,55,502,315,817
14,38,50,14,532,546
9,38,50,27,342,369
16,42,54,54,672,726
21,38,50,210,798,1008
1,38,50,3,38,41
13,38,50,39,494,533
5,38,50,58,190,248
10,38,50,110,380,490
27,42,54,18,1134,1152
1,1252,2295,951,1252,2203
1,1266,2320,729,1266,1995
3,1912,3400,3138,5736,8874
3,1266,2320,2884,3798,6682
1,420,769,334,420,754
1,1252,2295,1020,1252,2272
1,420,769,211,420,631
1,1252,2295,882,1252,2134
1,1252,2295,951,1252,2203
1,420,769,318,420,738
1,308,565,246,308,554
3,295,540,719,885,1604
2,1266,2320,1273,2532,3805
1,2171,3578,1264,2171,3435
1,1555,2443,448,1555,2003
2,713,1120,411,1426,1837
1,713,1120,205,713,918
2,1555,2443,701,3110,3811
1,344,540,191,344,535
1,1555,2443,570,1555,2125
1,2171,3578,1371,2171,3542
1,713,1120,172,713,885
1,2171,3578,1335,2171,3506
10,26,70,433,260,693
9,26,70,314,234,548
30,26,70,1299,780,2079
23,26,70,980,598,1578
32,3,9,155,96,251
24,3,9,142,72,214
15,13,35,325,195,520
1,12,33,20,12,32
19,12,33,374,228,602
21,1,4,62,21,83
4,1,4,12,4,16
4,1,4,12,4,16
23,2,5,68,46,114
7,2,5,21,14,35
22,1,4,65,22,87
9,1,4,27,9,36
14,2,5,39,28,67
23,2,5,64,46,110
20,11,30,272,220,492
5,1,2,5,5,10
7,1,2,6,7,13
16,1,2,15,16,31
26,1,2,19,26,45
7,1,2,5,7,12
11,1,2,6,11,17
15,1,2,8,15,23
11,1,2,6,11,17
19,1,2,11,19,30
13,11,30,239,143,382
26,2,5,60,52,112
30,2,5,71,60,131
22,2,5,52,44,96
2,8,21,17,16,33
26,9,25,273,234,507
17,1,4,48,17,65
32,1,4,91,32,123
31,1,4,88,31,119
23,1,4,67,23,90
23,1,4,67,23,90
1,8,21,9,8,17
13,1,2,13,13,26
4,1,2,4,4,8
12,1,2,7,12,19
4,1,2,2,4,6
30,1,2,17,30,47
27,1,4,66,27,93
15,1,4,37,15,52
17,1,4,41,17,58
5,1,4,12,5,17
27,11,29,345,297,642
3,1482,2384,2420,4446,6866
1,1482,2384,592,1482,2074
3,1482,2384,2634,4446,7080
1,1482,2384,878,1482,2360
3,1482,2384,1133,4446,5579
3,1482,2384,2563,4446,7009
1,755,1215,436,755,1191
1,755,1215,436,755,1191
7,45,120,508,315,823
7,45,120,407,315,722
13,45,120,772,585,1357
12,45,120,583,540,1123
7,59,159,622,413,1035
7,2,5,15,14,29
11,2,5,23,22,45
18,2,5,50,36,86
24,2,5,67,48,115
20,2,5,56,40,96
5,2,5,14,10,24
16,4,10,90,64,154
4,4,10,22,16,38
4,2,5,11,8,19
2,2,5,6,4,10
24,2,5,70,48,118
28,2,5,81,56,137
19,2,5,55,38,93
2,2,5,6,4,10
17,3,9,99,51,150
14,4,10,78,56,134
6,2,5,14,12,26
16,2,5,37,32,69
8,2,5,23,16,39
18,2,5,52,36,88
19,2,5,45,38,83
9,2,5,21,18,39
12,4,10,46,48,94
2,2,5,4,4,8
9,2,5,18,18,36
15,2,5,44,30,74
27,2,5,80,54,134
8,2,5,19,16,35
13,2,5,31,26,57
28,3,9,158,84,242
1,3,9,6,3,9
13,2,5,29,26,55
25,2,5,55,50,105
24,2,5,56,48,104
31,7,9,56,217,273
28,7,9,1,196,197
1,7,9,2,7,9
29,7,9,53,203,256
12,7,9,22,84,106
8,7,9,7,56,63
10,3,8,44,30,74
7,8,22,95,56,151
16,8,22,217,128,345
21,8,22,262,168,430
26,8,22,341,208,549
30,8,22,301,240,541
27,8,22,253,216,469
20,8,22,262,160,422
10,8,22,105,80,185
21,8,22,289,168,457
21,9,24,310,189,499
25,9,24,363,225,588
28,9,24,413,252,665
18,9,24,261,162,423
23,9,24,268,207,475
14,9,24,139,126,265
24,9,24,354,216,570
1,13,35,21,13,34
22,13,35,469,286,755
11,13,35,238,143,381
5,13,35,108,65,173
15,13,35,257,195,452
1,13,35,22,13,35
23,13,35,474,299,773
2,13,35,33,26,59
16,13,35,251,208,459
9,13,35,185,117,302
1,13,35,21,13,34
27,13,35,462,351,813
14,13,35,298,182,480
15,13,35,325,195,520
5,13,35,87,65,152
9,21,55,242,189,431
23,21,55,618,483,1101
4,42,54,9,168,177
23,42,54,264,966,1230
26,42,54,256,1092,1348
31,38,50,357,1178,1535
10,42,54,50,420,470
4,38,50,16,152,168
14,42,54,153,588,741
2,42,54,22,84,106
15,42,54,164,630,794
28,38,50,280,1064,1344
2,308,565,311,616,927
3,1252,2295,2372,3756,6128
2,1252,2295,1902,2504,4406
1,420,769,334,420,754
1,420,769,249,420,669
1,1266,2320,752,1266,2018
1,420,769,318,420,738
1,308,565,234,308,542
3,1266,2320,2884,3798,6682
1,1266,2320,1008,1266,2274
1,1252,2295,538,1252,1790
1,1252,2295,997,1252,2249
1,1252,2295,997,1252,2249
1,2171,3578,763,2171,2934
1,2171,3578,1264,2171,3435
3,713,1120,1154,2139,3293
1,1555,2443,790,1555,2345
3,2171,3578,1967,6513,8480
1,2171,3578,942,2171,3113
1,1555,2443,570,1555,2125
1,1555,2443,497,1555,2052
1,1083,1701,261,1083,1344
2,1083,1701,794,2166,2960
3,1555,2443,2591,4665,7256
1,1555,2443,864,1555,2419
2,487,783,388,974,1362
3,487,783,583,1461,2044
2,713,1120,724,1426,2150
2,2171,3578,2671,4342,7013
25,26,70,873,650,1523
3,26,70,130,78,208
25,26,70,855,650,1505
30,26,70,942,780,1722
11,3,9,52,33,85
7,8,21,90,56,146
16,8,21,205,128,333
21,8,21,269,168,437
17,8,21,217,136,353
8,13,35,170,104,274
20,13,35,426,260,686
24,13,35,511,312,823
12,13,35,256,156,412
27,1,2,26,27,53
30,1,2,29,30,59
4,2,5,8,8,16
2,2,5,4,4,8
24,13,35,511,312,823
23,13,35,490,299,789
18,2,5,41,36,77
31,2,5,71,62,133
11,13,35,238,143,381
12,13,35,260,156,416
1,2,5,3,2,5
15,2,5,44,30,74
23,2,5,68,46,114
17,12,33,284,204,488
26,2,5,77,52,129
28,11,29,358,308,666
21,11,29,268,231,499
27,9,25,405,243,648
15,9,25,225,135,360
9,2,5,24,18,42
11,2,5,21,22,43
8,2,5,16,16,32
21,1,4,52,21,73
19,1,4,47,19,66
28,2,5,50,56,106
7,11,30,89,77,166
15,11,30,191,165,356
21,1,2,16,21,37
14,1,2,10,14,24
13,1,2,13,13,26
4,9,25,57,36,93
17,9,25,242,153,395
16,1,2,15,16,31
6,1,2,6,6,12
14,2,5,41,28,69
8,2,5,23,16,39
27,1,2,16,27,43
24,9,25,306,216,522
5,9,25,64,45,109
6,1,4,14,6,20
9,1,4,21,9,30
9,1,4,21,9,30
6,1,2,4,6,10
24,1,4,70,24,94
20,1,4,58,20,78
26,13,35,408,338,746
9,13,35,141,117,258
15,1,4,41,15,56
23,1,4,63,23,86
27,2,5,76,54,130
18,2,5,53,36,89
31,2,5,90,62,152
3,1,4,9,3,12
8,1,4,23,8,31
27,1,4,58,27,85
28,1,4,59,28,87
8,1,4,17,8,25
11,2,5,31,22,53
12,2,5,34,24,58
30,1,2,17,30,47
27,1,2,15,27,42
4,9,25,62,36,98
12,9,25,186,108,294
3,1482,2384,1204,4446,5650
1,1482,2384,854,1482,2336
2,461,742,369,922,1291
1,461,742,251,461,712
26,24,64,691,624,1315
10,24,64,394,240,634
6,45,120,356,270,626
30,3,9,169,90,259
26,3,9,147,78,225
12,3,9,55,36,91
8,3,9,36,24,60
1,3,9,5,3,8
18,2,5,50,36,86
5,2,5,14,10,24
22,2,5,65,44,109
12,2,5,35,24,59
16,2,5,46,32,78
11,2,5,32,22,54
23,2,5,67,46,113
7,2,5,20,14,34
4,2,5,8,8,16
8,2,5,23,16,39
18,3,9,105,54,159
28,2,5,59,56,115
20,2,5,44,40,84
6,2,5,13,12,25
17,4,10,99,68,167
1,2,5,3,2,5
1,2,5,3,2,5
7,7,9,6,49,55
19,7,9,2,133,135
20,7,9,33,140,173
21,7,9,12,147,159
3,3,8,15,9,24
7,8,22,87,56,143
24,8,22,315,192,507
15,8,22,141,120,261
14,13,35,288,182,470
3,13,35,64,39,103
17,13,35,350,221,571
22,13,35,315,286,601
24,13,35,494,312,806
23,13,35,329,299,628
24,13,35,343,312,655
30,13,35,492,390,882
14,13,35,303,182,485
12,13,35,205,156,361
24,13,35,419,312,731
2,42,54,20,84,104
22,38,50,220,836,1056
15,38,50,15,570,585
30,42,54,149,1260,1409
4,38,50,44,152,196
1,1252,2295,951,1252,2203
1,420,769,334,420,754
1,1266,2320,752,1266,2018
2,2171,3578,1526,4342,5868
3,2171,3578,3792,6513,10305
1,2171,3578,942,2171,3113
1,2171,3578,835,2171,3006
1,2171,3578,656,2171,2827
3,1083,1701,1038,3249,4287
27,26,70,886,702,1588
29,1,2,28,29,57
11,11,30,206,121,327
9,11,30,168,99,267
26,2,5,49,52,101
23,2,5,44,46,90
9,1,2,9,9,18
28,1,2,27,28,55
10,2,5,19,20,39
26,2,5,49,52,101
1,1,2,1,1,2
14,1,2,10,14,24
1,2,5,3,2,5
11,2,5,31,22,53
3,1,2,2,3,5
4,1,2,3,4,7
18,11,30,266,198,464
13,11,30,192,143,335
17,2,5,39,34,73
6,2,5,14,12,26
18,1,2,10,18,28
20,1,2,11,20,31
3,2,5,8,6,14
2,1,4,6,2,8
6,1,4,18,6,24
1,2,5,2,2,4
9,1,4,26,9,35
2,461,742,503,922,1425
1,1482,2384,807,1482,2289
1,461,742,185,461,646
2,24,64,77,48,125
4,45,120,295,180,475
3,45,120,178,135,313
12,4,10,67,48,115
19,4,10,106,76,182
10,2,5,28,20,48
7,4,10,33,28,61
19,4,10,89,76,165
21,4,10,122,84,206
27,4,10,157,108,265
12,2,5,35,24,59
14,3,9,81,42,123
24,3,9,140,72,212
25,2,5,55,50,105
4,2,5,9,8,17
27,2,5,57,54,111
9,2,5,25,18,43
20,7,9,8,140,148
23,7,9,9,161,170
8,7,9,7,56,63
4,7,9,7,28,35
23,7,9,42,161,203
5,3,8,18,15,33
13,8,22,176,104,280
21,8,22,285,168,453
28,8,22,380,224,604
9,8,22,82,72,154
15,8,22,197,120,317
29,8,22,304,232,536
12,8,22,134,96,230
20,9,24,199,180,379
30,9,24,320,270,590
26,9,24,365,234,599
14,9,24,197,126,323
27,9,24,321,243,564
31,9,24,361,279,640
25,13,35,358,325,683
11,13,35,227,143,370
14,13,35,230,182,412
15,13,35,236,195,431
4,13,35,70,52,122
28,13,35,547,364,911
3,13,35,44,39,83
3,13,35,52,39,91
14,13,35,220,182,402
1,13,35,16,13,29
26,13,35,563,338,901
9,13,35,192,117,309
4,13,35,57,52,109
18,13,35,308,234,542
8,13,35,170,104,274
13,21,55,413,273,686
6,38,50,60,228,288
4,38,50,6,152,158
15,38,50,150,570,720
1,42,54,5,42,47
3,38,50,3,114,117
28,42,54,64,1176,1240
23,38,50,127,874,1001
8,38,50,80,304,384
3,420,769,1001,1260,2261
3,1252,2295,1890,3756,5646
1,1266,2320,544,1266,1810
2,1898,3375,2009,3796,5805
3,1252,2295,1614,3756,5370
1,1555,2443,790,1555,2345
1,2171,3578,942,2171,3113
1,1083,1701,499,1083,1582
1,2171,3578,942,2171,3113
2,487,783,310,974,1284
3,1083,1701,935,3249,4184
1,1555,2443,448,1555,2003
18,26,70,616,468,1084
17,26,70,724,442,1166
20,3,9,116,60,176
20,1,2,11,20,31
18,1,2,10,18,28
24,13,35,511,312,823
1,13,35,21,13,34
20,1,2,11,20,31
1,1,2,1,1,2
22,2,5,64,44,108
22,2,5,62,44,106
9,2,5,25,18,43
5,1,2,3,5,8
22,1,2,13,22,35
8,1,2,5,8,13
1,11,30,19,11,30
25,11,30,468,275,743
26,2,5,77,52,129
30,2,5,89,60,149
12,2,5,35,24,59
18,1,2,17,18,35
23,2,5,54,46,100
14,2,5,29,28,57
28,2,5,59,56,115
25,2,5,53,50,103
16,1,2,12,16,28
12,1,2,8,12,20
15,1,2,10,15,25
9,1,2,6,9,15
6,1,2,4,6,10
26,1,2,25,26,51
6,1,4,18,6,24
29,1,4,85,29,114
4,2,5,12,8,20
7,2,5,16,14,30
7,2,5,16,14,30
15,1,2,14,15,29
10,1,2,10,10,20
10,2,5,24,20,44
3,2,5,7,6,13
8,1,4,23,8,31
22,1,4,64,22,86
24,2,5,56,48,104
23,2,5,54,46,100
7,1,2,7,7,14
19,1,2,19,19,38
2,755,1215,604,1510,2114
1,1482,2384,807,1482,2289
3,1482,2384,2563,4446,7009
1,461,742,162,461,623
1,461,742,266,461,727
11,24,64,285,264,549
17,24,64,658,408,1066
6,45,120,320,270,590
16,3,9,95,48,143
8,2,5,24,16,40
31,2,5,91,62,153
28,2,5,83,56,139
6,2,5,14,12,26
11,4,10,65,44,109
4,2,5,12,8,20
15,2,5,44,30,74
6,4,10,35,24,59
5,4,10,29,20,49
15,2,5,35,30,65
8,2,5,18,16,34
31,4,10,130,124,254
19,4,10,80,76,156
11,3,9,45,33,78
6,3,9,25,18,43
12,3,9,58,36,94
1,7,9,2,7,9
16,7,9,2,112,114
17,7,9,32,119,151
30,7,9,57,210,267
23,7,9,42,161,203
6,7,9,5,42,47
19,7,9,16,133,149
28,7,9,53,196,249
19,3,8,62,57,119
29,3,8,143,87,230
1,3,8,5,3,8
12,3,8,53,36,89
15,3,8,58,45,103
29,3,8,115,87,202
12,8,22,163,96,259
12,8,22,165,96,261
18,8,22,244,144,388
1,8,22,13,8,21
4,8,22,55,32,87
30,8,22,407,240,647
19,8,22,258,152,410
12,8,22,157,96,253
2,8,22,28,16,44
25,8,22,235,200,435
3,9,24,44,27,71
7,13,35,100,91,191
18,13,35,390,234,624
24,13,35,394,312,706
18,13,35,314,234,548
9,13,35,129,117,246
1,13,35,17,13,30
4,13,35,85,52,137
17,13,35,362,221,583
16,13,35,341,208,549
17,13,35,332,221,553
13,13,35,204,169,373
3,13,35,44,39,83
9,13,35,141,117,258
15,13,35,236,195,431
21,13,35,455,273,728
13,13,35,281,169,450
22,13,35,322,286,608
8,21,55,180,168,348
15,21,55,477,315,792
29,21,55,922,609,1531
15,42,54,164,630,794
15,38,50,150,570,720
29,38,50,334,1102,1436
20,38,50,60,760,820
22,42,54,252,924,1176
5,42,54,55,210,265
1,1266,2320,1008,1266,2274
3,1252,2295,3060,3756,6816
1,1252,2295,538,1252,1790
1,420,769,334,420,754
2,1252,2295,2040,2504,4544
2,1266,2320,1273,2532,3805
1,420,769,188,420,608
2,1252,2295,1994,2504,4498
1,1266,2320,1008,1266,2274
2,1266,2320,1922,2532,4454
1,1252,2295,951,1252,2203
2,1519,2443,1213,3038,4251
1,2171,3578,656,2171,2827
1,487,783,241,487,728
2,2171,3578,1311,4342,5653
1,1555,2443,448,1555,2003
1,344,540,191,344,535
1,344,540,126,344,470
22,3,9,128,66,194
24,1,2,17,24,41
6,8,21,50,48,98
12,1,2,12,12,24
1,2,5,2,2,4
19,2,5,55,38,93
23,13,35,498,299,797
8,13,35,173,104,277
5,2,5,15,10,25
18,2,5,53,36,89
1,1,2,1,1,2
22,1,2,16,22,38
14,1,2,10,14,24
29,2,5,57,58,115
27,2,5,53,54,107
25,2,5,73,50,123
7,2,5,20,14,34
6,9,25,93,54,147
1,2,5,3,2,5
14,2,5,41,28,69
15,2,5,40,30,70
1,2,5,3,2,5
31,1,4,92,31,123
4,1,4,12,4,16
22,11,30,405,242,647
26,11,30,478,286,764
11,11,30,202,121,323
19,1,2,12,19,31
19,1,2,12,19,31
2,2,5,4,4,8
20,2,5,42,40,82
10,11,30,136,110,246
24,11,30,326,264,590
7,1,2,6,7,13
22,1,2,22,22,44
20,11,29,348,220,568
27,11,29,470,297,767
4,1,2,3,4,7
19,1,2,16,19,35
1,9,25,11,9,20
1,1,2,1,1,2
2,755,1215,896,1510,2406
3,755,1215,724,2265,2989
1,1482,2384,473,1482,1955
1,461,742,274,461,735
3,4,10,12,12,24
13,4,10,51,52,103
27,3,9,123,81,204
8,2,5,17,16,33
11,2,5,23,22,45
7,2,5,16,14,30
1,2,5,3,2,5
28,2,5,83,56,139
24,2,5,71,48,119
4,2,5,12,8,20
7,3,9,41,21,62
7,4,10,39,28,67
5,4,10,28,20,48
1,2,5,2,2,4
1,7,9,1,7,8
2,7,9,3,14,17
26,7,9,3,182,185
17,7,9,31,119,150
17,7,9,31,119,150
24,3,8,89,72,161
10,3,8,44,30,74
17,8,22,231,136,367
8,8,22,87,64,151
4,8,22,52,32,84
6,9,24,89,54,143
23,9,24,246,207,453
26,9,24,365,234,599
15,9,24,221,135,356
22,9,24,325,198,523
18,13,35,390,234,624
14,13,35,303,182,485
18,13,35,390,234,624
4,13,35,87,52,139
24,13,35,377,312,689
16,13,35,341,208,549
1,13,35,21,13,34
10,21,55,335,210,545
2,42,54,5,84,89
27,38,50,149,1026,1175
1,38,50,12,38,50
17,38,50,170,646,816
19,42,54,207,798,1005
2,38,50,23,76,99
1,1252,2295,745,1252,1997
1,1252,2295,745,1252,1997
1,420,769,249,420,669
3,1266,2320,1909,3798,5707
3,295,540,703,885,1588
1,1252,2295,951,1252,2203
3,1898,3375,4229,5694,9923
1,1266,2320,636,1266,1902
1,2171,3578,1371,2171,3542
1,487,783,155,487,642
2,1555,2443,1678,3110,4788
1,713,1120,362,713,1075
3,344,540,232,1032,1264
21,26,70,909,546,1455
17,3,9,100,51,151
3,3,9,12,9,21
16,9,25,252,144,396
2,1,2,2,2,4
9,2,5,26,18,44
14,2,5,41,28,69
12,2,5,35,24,59
21,13,35,447,273,720
9,13,35,192,117,309
24,9,25,306,216,522
31,9,25,395,279,674
28,9,25,357,252,609
1,11,30,19,11,30
1,11,30,19,11,30
1,1,2,1,1,2
7,1,2,7,7,14
18,2,5,42,36,78
21,2,5,49,42,91
16,12,33,315,192,507
6,12,33,118,72,190
23,11,29,374,253,627
25,2,5,74,50,124
29,2,5,86,58,144
30,1,2,29,30,59
29,1,2,28,29,57
24,1,2,24,24,48
1,2,5,3,2,5
16,2,5,47,32,79
3,2,5,6,6,12
10,2,5,24,20,44
29,1,2,28,29,57
27,1,2,26,27,53
10,1,2,6,10,16
24,1,2,13,24,37
22,1,2,12,22,34
4,1,2,3,4,7
29,1,2,21,29,50
13,1,2,10,13,23
1,1,2,1,1,2
12,11,30,152,132,284
18,11,30,229,198,427
4,11,30,51,44,95
19,11,30,350,209,559
21,11,30,386,231,617
24,1,2,14,24,38
17,1,2,10,17,27
11,1,4,26,11,37
11,1,4,26,11,37
19,1,4,45,19,64
24,2,5,56,48,104
3,2,5,7,6,13
17,2,5,49,34,83
21,2,5,61,42,103
9,2,5,26,18,44
17,1,2,10,17,27
1,1482,2384,878,1482,2360
3,755,1215,724,2265,2989
2,461,742,458,922,1380
2,1482,2384,946,2964,3910
1,1482,2384,854,1482,2336
1,461,742,251,461,712
27,24,64,855,648,1503
11,24,64,398,264,662
21,24,64,652,504,1156
2,45,120,116,90,206
28,2,5,81,56,137
3,2,5,7,6,13
4,2,5,9,8,17
27,2,5,51,54,105
10,2,5,19,20,39
4,2,5,11,8,19
19,2,5,53,38,91
21,4,10,80,84,164
4,2,5,12,8,20
6,2,5,18,12,30
5,2,5,15,10,25
6,2,5,17,12,29
3,2,5,9,6,15
3,2,5,9,6,15
28,4,10,106,112,218
12,4,10,46,48,94
2,2,5,4,4,8
12,2,5,26,24,50
5,2,5,11,10,21
24,7,9,20,168,188
24,7,9,44,168,212
22,7,9,36,154,190
8,3,8,26,24,50
7,3,8,33,21,54
15,3,8,49,45,94
8,3,8,39,24,63
17,8,22,156,136,292
6,8,22,66,48,114
17,8,22,223,136,359
14,8,22,193,112,305
5,9,24,74,45,119
27,9,24,321,243,564
30,9,24,443,270,713
7,13,35,152,91,243
20,13,35,342,260,602
8,13,35,137,104,241
27,13,35,556,351,907
10,13,35,157,130,287
6,13,35,128,78,206
22,13,35,384,286,670
28,13,35,400,364,764
1,13,35,22,13,35
10,13,35,217,130,347
15,13,35,320,195,515
11,13,35,227,143,370
14,13,35,303,182,485
7,13,35,100,91,191
25,13,35,393,325,718
21,21,55,529,441,970
20,21,55,438,420,858
21,38,50,63,798,861
12,38,50,138,456,594
14,38,50,154,532,686
21,42,54,71,882,953
22,42,54,74,924,998
26,42,54,129,1092,1221
1,1252,2295,538,1252,1790
1,1266,2320,729,1266,1995
3,1252,2295,2854,3756,6610
1,1252,2295,630,1252,1882
3,1252,2295,2854,3756,6610
1,420,769,334,420,754
1,1266,2320,961,1266,2227
1,487,783,124,487,611
1,487,783,280,487,767
2,344,540,154,688,842
2,713,1120,724,1426,2150
1,2171,3578,1371,2171,3542
3,713,1120,616,2139,2755
26,26,70,1108,676,1784
12,26,70,511,312,823
3,26,70,124,78,202
25,26,70,873,650,1523
19,3,9,76,57,133
23,3,9,134,69,203
19,3,9,112,57,169
8,1,4,17,8,25
24,9,25,378,216,594
24,8,21,201,192,393
28,13,35,479,364,843
28,13,35,479,364,843
8,1,2,7,8,15
13,1,2,9,13,22
1,1,2,1,1,2
21,1,2,21,21,42
18,2,5,50,36,86
25,2,5,70,50,120
19,2,5,53,38,91
11,2,5,23,22,45
28,2,5,59,56,115
28,2,5,78,56,134
27,1,2,26,27,53
29,1,2,28,29,57
7,1,2,7,7,14
29,1,4,72,29,101
12,1,4,30,12,42
23,1,4,57,23,80
18,2,5,50,36,86
22,2,5,62,44,106
13,2,5,36,26,62
17,1,2,11,17,28
28,1,2,18,28,46
16,11,30,203,176,379
28,11,30,356,308,664
29,11,30,368,319,687
20,1,2,20,20,40
30,1,2,29,30,59
24,11,30,427,264,691
19,11,30,338,209,547
29,2,5,77,58,135
6,2,5,17,12,29
7,2,5,20,14,34
23,1,2,23,23,46
29,1,2,28,29,57
7,1,2,4,7,11
13,1,2,7,13,20
18,11,29,230,198,428
10,1,2,7,10,17
1,1,2,1,1,2
12,12,33,165,144,309
21,12,33,289,252,541
25,1,4,57,25,82
8,1,4,18,8,26
17,2,5,48,34,82
1,2,5,3,2,5
15,2,5,42,30,72
1,461,742,266,461,727
3,1482,2384,2634,4446,7080
1,1482,2384,878,1482,2360
28,24,64,1048,672,1720
17,24,64,658,408,1066
6,59,159,495,354,849
1,2,5,3,2,5
8,2,5,24,16,40
3,2,5,7,6,13
7,2,5,16,14,30
17,2,5,48,34,82
11,2,5,31,22,53
2,2,5,4,4,8
1,2,5,2,2,4
14,3,9,81,42,123
23,3,9,134,69,203
28,2,5,64,56,120
27,2,5,53,54,107
9,2,5,18,18,36
8,2,5,22,16,38
18,7,9,34,126,160
20,7,9,20,140,160
17,7,9,31,119,150
4,7,9,3,28,31
13,7,9,1,91,92
5,7,9,7,35,42
28,7,9,11,196,207
1,3,8,5,3,8
30,3,8,116,90,206
7,8,22,96,56,152
23,8,22,312,184,496
16,8,22,217,128,345
1,8,22,14,8,22
11,8,22,149,88,237
18,8,22,201,144,345
29,8,22,400,232,632
17,8,22,189,136,325
11,9,24,160,99,259
1,9,24,15,9,24
26,13,35,554,338,892
12,13,35,260,156,416
8,13,35,126,104,230
22,13,35,453,286,739
22,13,35,453,286,739
23,13,35,498,299,797
26,13,35,554,338,892
7,13,35,152,91,243
12,13,35,247,156,403
32,13,35,693,416,1109
15,13,35,325,195,520
2,13,35,43,26,69
22,13,35,469,286,755
16,13,35,234,208,442
17,13,35,362,221,583
18,13,35,352,234,586
18,21,55,483,378,861
28,21,55,921,588,1509
24,38,50,264,912,1176
7,42,54,80,294,374
20,38,50,200,760,960
26,38,50,286,988,1274
8,42,54,87,336,423
8,42,54,92,336,428
29,42,54,19,1218,1237
12,42,54,118,504,622
18,38,50,45,684,729
12,42,54,118,504,622
3,1252,2295,3060,3756,6816
1,1266,2320,567,1266,1833
1,1252,2295,951,1252,2203
2,1266,2320,2015,2532,4547
1,1266,2320,961,1266,2227
3,1252,2295,2234,3756,5990
2,420,769,498,840,1338
1,2171,3578,656,2171,2827
1,2171,3578,656,2171,2827
1,1083,1701,312,1083,1395
3,1083,1701,1650,3249,4899
1,344,540,174,344,518
3,344,540,248,1032,1280
1,344,540,185,344,529
3,713,1120,616,2139,2755
1,344,540,158,344,502
27,26,70,886,702,1588
8,3,9,45,24,69
28,3,9,158,84,242
9,1,2,9,9,18
16,1,2,16,16,32
18,1,2,18,18,36
4,1,2,2,4,6
7,12,33,138,84,222
12,12,33,236,144,380
8,2,5,23,16,39
8,2,5,23,16,39
19,2,5,56,38,94
9,2,5,27,18,45
30,2,5,89,60,149
14,2,5,39,28,67
17,2,5,48,34,82
6,1,4,14,6,20
1,2,5,3,2,5
9,1,2,8,9,17
7,1,2,6,7,13
13,1,2,11,13,24
11,9,25,127,99,226
16,1,2,15,16,31
14,1,2,13,14,27
15,1,4,37,15,52
16,1,4,40,16,56
16,1,4,40,16,56
20,2,5,49,40,89
1,2,5,2,2,4
20,2,5,49,40,89
8,9,25,124,72,196
20,9,25,310,180,490
15,9,25,233,135,368
18,1,2,13,18,31
18,1,2,13,18,31
16,1,2,16,16,32
30,1,2,29,30,59
15,1,2,11,15,26
17,1,2,13,17,30
27,2,5,63,54,117
9,2,5,21,18,39
3,2,5,7,6,13
9,2,5,21,18,39
21,12,33,295,252,547
10,12,33,141,120,261
14,2,5,39,28,67
25,2,5,70,50,120
5,1,4,11,5,16
20,1,4,46,20,66
12,1,2,11,12,23
22,1,2,20,22,42
32,13,35,469,416,885
18,9,25,270,162,432
5,9,25,75,45,120
6,9,25,90,54,144
14,2,5,41,28,69
15,1,4,44,15,59
13,1,4,38,13,51
27,1,4,60,27,87
17,9,25,217,153,370
15,8,21,182,120,302
13,8,21,158,104,262
1,1482,2384,807,1482,2289
1,1482,2384,473,1482,1955
1,1482,2384,854,1482,2336
1,461,742,266,461,727
30,24,64,950,720,1670
30,45,120,2214,1350,3564
14,4,10,78,56,134
14,4,10,78,56,134
1,3,9,6,3,9
22,3,9,130,66,196
4,2,5,12,8,20
1,2,5,2,2,4
12,2,5,23,24,47
17,4,10,65,68,133
1,4,10,4,4,8
12,4,10,46,48,94
7,4,10,27,28,55
9,2,5,27,18,45
29,2,5,86,58,144
13,2,5,31,26,57
24,2,5,56,48,104
27,2,5,80,54,134
18,2,5,53,36,89
2,2,5,6,4,10
13,3,9,53,39,92
4,3,9,16,12,28
26,2,5,49,52,101
17,2,5,32,34,66
15,7,9,11,105,116
21,7,9,12,147,159
20,7,9,38,140,178
17,7,9,28,119,147
17,7,9,25,119,144
26,7,9,47,182,229
12,3,8,48,36,84
22,8,22,289,176,465
24,8,22,262,192,454
28,8,22,380,224,604
23,8,22,317,184,501
18,9,24,261,162,423
27,9,24,262,243,505
28,9,24,393,252,645
2,9,24,23,18,41
4,9,24,58,36,94
8,9,24,116,72,188
15,13,35,215,195,410
8,13,35,173,104,277
7,13,35,149,91,240
29,13,35,425,377,802
24,13,35,520,312,832
20,13,35,314,260,574
10,13,35,175,130,305
10,13,35,217,130,347
9,13,35,192,117,309
25,13,35,515,325,840
13,13,35,259,169,428
11,13,35,238,143,381
11,13,35,238,143,381
22,13,35,315,286,601
16,13,35,274,208,482
27,21,55,651,567,1218
25,38,50,288,950,1238
11,38,50,121,418,539
29,38,50,29,1102,1131
22,38,50,187,836,1023
11,38,50,121,418,539
18,42,54,60,756,816
24,42,54,120,1008,1128
15,38,50,165,570,735
14,38,50,140,532,672
9,42,54,21,378,399
28,38,50,28,1064,1092
12,38,50,132,456,588
18,42,54,41,756,797
1,1252,2295,951,1252,2203
2,295,540,339,590,929
1,1266,2320,1008,1266,2274
3,2171,3578,1860,6513,8373
1,1519,2443,875,1519,2394
1,487,783,124,487,611
2,1555,2443,897,3110,4007
1,1555,2443,570,1555,2125
3,1083,1701,1191,3249,4440
2,1555,2443,1678,3110,4788
1,713,1120,385,713,1098
1,2171,3578,1371,2171,3542
1,1083,1701,516,1083,1599
1,344,540,191,344,535
1,2171,3578,1371,2171,3542
1,2171,3578,1335,2171,3506
8,26,70,341,208,549
1,3,9,6,3,9
9,2,5,24,18,42
22,13,35,476,286,762
2,13,35,43,26,69
12,2,5,23,24,47
26,2,5,51,52,103
30,2,5,59,60,119
26,1,4,77,26,103
16,1,4,47,16,63
26,1,4,77,26,103
9,1,4,27,9,36
15,1,4,44,15,59
17,2,5,50,34,84
6,2,5,18,12,30
26,2,5,49,52,101
10,1,2,9,10,19
28,1,2,27,28,55
24,1,2,16,24,40
24,2,5,71,48,119
24,2,5,71,48,119
16,2,5,47,32,79
21,1,2,16,21,37
10,1,2,7,10,17
24,1,2,24,24,48
32,1,2,31,32,63
22,1,2,21,22,43
21,1,2,20,21,41
17,11,30,318,187,505
17,11,30,318,187,505
1,11,30,19,11,30
8,1,2,7,8,15
26,12,33,383,312,695
23,1,2,15,23,38
11,1,2,7,11,18
10,1,2,7,10,17
18,1,2,13,18,31
23,11,29,387,253,640
20,11,29,337,220,557
25,11,29,421,275,696
19,1,4,55,19,74
20,1,4,58,20,78
18,1,2,18,18,36
21,1,2,21,21,42
6,2,5,14,12,26
2,2,5,4,4,8
18,1,4,53,18,71
25,1,4,73,25,98
2,461,742,503,922,1425
1,1482,2384,378,1482,1860
2,1482,2384,1709,2964,4673
3,755,1215,578,2265,2843
1,755,1215,193,755,948
15,24,64,389,360,749
14,24,64,363,336,699
27,2,5,73,54,127
11,2,5,30,22,52
10,4,10,42,40,82
10,4,10,42,40,82
1,2,5,2,2,4
1,2,5,2,2,4
19,2,5,55,38,93
25,2,5,73,50,123
16,4,10,93,64,157
25,2,5,53,50,103
22,2,5,46,44,90
8,2,5,17,16,33
7,3,9,29,21,50
28,2,5,78,56,134
16,2,5,45,32,77
25,2,5,70,50,120
21,2,5,62,42,104
14,2,5,41,28,69
30,2,5,71,60,131
9,2,5,21,18,39
14,7,9,5,98,103
1,7,9,0,7,7
18,7,9,15,126,141
15,7,9,8,105,113
10,7,9,4,70,74
6,7,9,5,42,47
1,7,9,1,7,8
14,3,8,50,42,92
3,3,8,12,9,21
10,8,22,109,80,189
19,8,22,258,152,410
8,8,22,110,64,174
9,8,22,118,72,190
18,8,22,165,144,309
23,8,22,317,184,501
21,8,22,197,168,365
11,8,22,110,88,198
27,9,24,288,243,531
18,9,24,266,162,428
7,9,24,70,63,133
9,9,24,131,81,212
2,9,24,23,18,41
17,13,35,267,221,488
7,13,35,152,91,243
11,13,35,234,143,377
24,13,35,520,312,832
7,13,35,103,91,194
25,13,35,358,325,683
26,13,35,508,338,846
23,13,35,490,299,789
4,13,35,82,52,134
7,13,35,122,91,213
6,21,55,201,126,327
30,21,55,806,630,1436
22,38,50,121,836,957
25,38,50,288,950,1238
32,42,54,4,1344,1348
31,38,50,357,1178,1535
16,38,50,88,608,696
7,38,50,77,266,343
2,42,54,10,84,94
1,38,50,11,38,49
10,42,54,1,420,421
10,38,50,115,380,495
12,38,50,36,456,492
3,1252,2295,1477,3756,5233
1,1266,2320,497,1266,1763
1,1252,2295,951,1252,2203
1,1266,2320,1008,1266,2274
1,1266,2320,752,1266,2018
1,1252,2295,951,1252,2203
1,1266,2320,544,1266,1810
1,308,565,251,308,559
1,1266,2320,636,1266,1902
3,1083,1701,1497,3249,4746
1,1083,1701,584,1083,1667
1,1083,1701,550,1083,1633
1,1083,1701,499,1083,1582
1,344,540,83,344,427
17,26,70,486,442,928
20,26,70,656,520,1176
12,26,70,520,312,832
20,3,9,97,60,157
3,3,9,17,9,26
20,3,9,118,60,178
13,3,9,73,39,112
3,2,5,6,6,12
17,2,5,32,34,66
19,1,4,54,19,73
26,1,4,74,26,100
24,2,5,67,48,115
17,2,5,48,34,82
10,1,2,6,10,16
1,1,2,1,1,2
7,1,2,5,7,12
2,2,5,5,4,9
23,2,5,54,46,100
15,2,5,35,30,65
2,1,4,6,2,8
7,2,5,20,14,34
11,2,5,32,22,54
1,1,2,1,1,2
18,1,2,17,18,35
16,13,35,341,208,549
12,13,35,256,156,412
25,13,35,533,325,858
5,13,35,107,65,172
3,1,2,3,3,6
22,1,2,21,22,43
10,2,5,23,20,43
13,2,5,30,26,56
22,2,5,51,44,95
6,2,5,18,12,30
22,2,5,65,44,109
22,1,4,55,22,77
23,1,4,57,23,80
13,11,30,177,143,320
5,11,30,68,55,123
1,1,2,1,1,2
30,1,2,29,30,59
12,13,35,172,156,328
14,13,35,200,182,382
1,1,4,3,1,4
7,1,2,4,7,11
26,1,2,15,26,41
2,1,2,1,2,3
16,2,5,38,32,70
10,1,4,29,10,39
7,1,4,20,7,27
11,1,2,7,11,18
2,1,2,1,2,3
24,2,5,71,48,119
25,2,5,74,50,124
1,2,5,2,2,4
9,2,5,19,18,37
23,11,29,401,253,654
1,11,29,17,11,28
2,1,4,5,2,7
19,1,4,54,19,73
8,1,4,23,8,31
19,1,2,12,19,31
32,1,2,20,32,52
5,1,2,3,5,8
4,8,21,34,32,66
1,8,21,8,8,16
2,2,5,6,4,10
6,8,21,69,48,117
27,8,21,311,216,527
24,8,21,277,192,469
23,11,29,267,253,520
18,2,5,53,36,89
29,2,5,86,58,144
7,2,5,21,14,35
1,461,742,266,461,727
1,461,742,274,461,735
3,461,742,821,1383,2204
3,755,1215,1307,2265,3572
1,1482,2384,473,1482,1955
3,755,1215,906,2265,3171
3,755,1215,724,2265,2989
1,461,742,274,461,735
2,461,742,236,922,1158
31,2,5,91,62,153
25,2,5,74,50,124
14,2,5,33,28,61
7,2,5,16,14,30
14,4,10,83,56,139
27,2,5,78,54,132
28,2,5,81,56,137
17,2,5,49,34,83
24,2,5,70,48,118
27,2,5,72,54,126
7,2,5,19,14,33
9,3,9,52,27,79
21,2,5,48,42,90
7,2,5,13,14,27
19,2,5,55,38,93
30,2,5,87,60,147
23,4,10,133,92,225
13,4,10,75,52,127
7,2,5,16,14,30
7,2,5,16,14,30
26,2,5,61,52,113
4,2,5,9,8,17
2,2,5,5,4,9
4,2,5,9,8,17
20,2,5,58,40,98
23,7,9,38,161,199
2,7,9,3,14,17
14,7,9,25,98,123
29,7,9,21,203,224
16,7,9,22,112,134
24,7,9,20,168,188
24,7,9,-4,168,164
22,7,9,18,154,172
24,3,8,78,72,150
19,3,8,75,57,132
23,8,22,211,184,395
27,8,22,247,216,463
10,8,22,92,80,172
24,8,22,325,192,517
3,8,22,37,24,61
3,9,24,44,27,71
6,9,24,67,54,121
21,9,24,204,189,393
25,13,35,515,325,840
8,13,35,117,104,221
10,13,35,143,130,273
16,13,35,330,208,538
22,13,35,476,286,762
2,13,35,43,26,69
1,13,35,21,13,34
3,13,35,64,39,103
23,13,35,401,299,700
5,13,35,89,65,154
10,13,35,143,130,273
14,13,35,200,182,382
4,13,35,57,52,109
4,42,54,33,168,201
8,42,54,79,336,415
28,42,54,3,1176,1179
2,42,54,22,84,106
13,38,50,13,494,507
13,42,54,2,546,548
1,1266,2320,729,1266,1995
3,1252,2295,2234,3756,5990
1,1266,2320,544,1266,1810
2,295,540,252,590,842
1,420,769,295,420,715
2,308,565,378,616,994
1,1912,3400,740,1912,2652
1,1519,2443,875,1519,2394
1,1555,2443,839,1555,2394
2,2171,3578,1884,4342,6226
3,2171,3578,4114,6513,10627
3,1083,1701,1650,3249,4899
1,344,540,126,344,470
29,26,70,1195,754,1949
13,26,70,563,338,901
5,26,70,143,130,273
22,26,70,629,572,1201
24,26,70,1022,624,1646
13,1,2,13,13,26
6,2,5,18,12,30
23,1,2,21,23,44
28,1,2,26,28,54
1,1,2,1,1,2
15,2,5,44,30,74
10,2,5,30,20,50
23,2,5,68,46,114
28,1,4,80,28,108
19,2,5,34,38,72
27,2,5,49,54,103
15,1,2,14,15,29
2,2,5,4,4,8
1,1,2,1,1,2
21,1,2,16,21,37
17,2,5,50,34,84
15,2,5,44,30,74
20,1,4,59,20,79
20,11,30,338,220,558
1,11,30,19,11,30
4,1,2,3,4,7
12,1,2,8,12,20
23,1,2,15,23,38
26,12,33,434,312,746
24,12,33,401,288,689
13,12,33,217,156,373
15,1,2,8,15,23
7,9,25,74,63,137
22,9,25,231,198,429
1,755,1215,193,755,948
2,755,1215,385,1510,1895
17,24,64,441,408,849
16,24,64,620,384,1004
8,45,120,446,360,806
29,2,5,68,58,126
16,2,5,38,32,70
22,2,5,46,44,90
14,2,5,41,28,69
13,2,5,38,26,64
11,2,5,25,22,47
28,4,10,106,112,218
30,2,5,87,60,147
6,4,10,35,24,59
24,4,10,139,96,235
13,4,10,75,52,127
25,2,5,74,50,124
26,2,5,77,52,129
22,2,5,48,44,92
12,2,5,26,24,50
24,4,10,110,96,206
28,4,10,129,112,241
27,3,9,152,81,233
18,3,9,105,54,159
22,3,9,128,66,194
32,2,5,61,64,125
30,2,5,84,60,144
1,7,9,0,7,7
7,7,9,13,49,62
9,7,9,0,63,63
23,7,9,38,161,199
20,7,9,36,140,176
10,7,9,8,70,78
16,7,9,16,112,128
4,7,9,4,28,32
1,7,9,2,7,9
2,3,8,6,6,12
25,3,8,121,75,196
21,3,8,83,63,146
14,8,22,153,112,265
1,8,22,10,8,18
3,8,22,37,24,61
7,8,22,64,56,120
22,9,24,256,198,454
3,9,24,40,27,67
29,9,24,428,261,689
9,9,24,131,81,212
4,13,35,85,52,137
7,13,35,100,91,191
16,13,35,279,208,487
9,13,35,141,117,258
21,13,35,447,273,720
24,13,35,419,312,731
12,13,35,235,156,391
8,13,35,165,104,269
14,13,35,288,182,470
28,13,35,400,364,764
23,13,35,474,299,773
28,13,35,606,364,970
8,13,35,145,104,249
10,13,35,213,130,343
19,13,35,405,247,652
24,13,35,410,312,722
18,13,35,371,234,605
5,13,35,72,65,137
12,13,35,260,156,416
12,13,35,197,156,353
7,13,35,137,91,228
7,21,55,176,147,323
26,21,55,855,546,1401
4,21,55,88,84,172
11,42,54,126,462,588
16,42,54,36,672,708
20,38,50,230,760,990
6,38,50,66,228,294
19,38,50,209,722,931
24,38,50,132,912,1044
12,42,54,40,504,544
9,38,50,99,342,441
4,42,54,24,168,192
24,38,50,24,912,936
10,38,50,55,380,435
28,38,50,280,1064,1344
9,38,50,90,342,432
14,42,54,138,588,726
28,42,54,306,1176,1482
1,1266,2320,752,1266,2018
1,1252,2295,722,1252,1974
1,1266,2320,1008,1266,2274
2,1252,2295,1765,2504,4269
1,1266,2320,1008,1266,2274
1,1266,2320,1008,1266,2274
3,1266,2320,2675,3798,6473
1,1266,2320,961,1266,2227
2,2171,3578,1240,4342,5582
1,2171,3578,1157,2171,3328
3,2171,3578,2504,6513,9017
1,1555,2443,619,1555,2174
2,344,540,381,688,1069
1,2171,3578,1335,2171,3506
20,26,70,852,520,1372
15,26,70,513,390,903
8,26,70,341,208,549
15,26,70,650,390,1040
26,3,9,105,78,183
25,1,2,18,25,43
4,1,2,3,4,7
16,1,2,16,16,32
13,1,2,13,13,26
12,9,25,189,108,297
26,9,25,410,234,644
12,1,2,12,12,24
26,1,2,25,26,51
13,9,25,156,117,273
12,2,5,23,24,47
19,13,35,371,247,618
11,2,5,26,22,48
13,1,2,11,13,24
22,1,2,19,22,41
29,2,5,67,58,125
9,2,5,21,18,39
28,11,30,524,308,832
6,11,30,112,66,178
23,13,35,490,299,789
25,13,35,533,325,858
10,13,35,213,130,343
18,12,33,354,216,570
18,13,35,383,234,617
11,13,35,234,143,377
19,11,30,241,209,450
16,11,30,203,176,379
10,1,2,7,10,17
23,1,2,16,23,39
1,1,2,1,1,2
4,1,2,4,4,8
5,9,25,66,45,111
17,13,35,350,221,571
23,13,35,474,299,773
3,9,25,47,27,74
4,1,2,3,4,7
24,1,2,18,24,42
4,1,4,11,4,15
26,1,4,74,26,100
5,1,4,15,5,20
2,1,4,6,2,8
5,2,5,12,10,22
7,2,5,16,14,30
9,2,5,21,18,39
27,2,5,80,54,134
29,2,5,86,58,144
7,1,4,20,7,27
13,1,4,28,13,41
3,1,4,6,3,9
15,1,2,14,15,29
25,1,4,54,25,79
10,1,4,22,10,32
11,1,2,7,11,18
8,1,2,5,8,13
2,2,5,6,4,10
28,2,5,83,56,139
28,2,5,83,56,139
19,2,5,56,38,94
1,2,5,3,2,5
17,8,21,182,136,318
24,1,2,24,24,48
22,1,2,22,22,44
4,1,2,4,4,8
16,1,2,16,16,32
5,1,2,4,5,9
25,1,2,22,25,47
18,2,5,48,36,84
16,2,5,42,32,74
17,2,5,45,34,79
8,9,25,124,72,196
1,1482,2384,878,1482,2360
1,461,742,251,461,712
3,461,742,598,1383,1981
1,1482,2384,568,1482,2050
3,755,1215,1307,2265,3572
1,1482,2384,378,1482,1860
1,1482,2384,378,1482,1860
2,1482,2384,1709,2964,4673
1,461,742,229,461,690
10,24,64,394,240,634
4,59,159,355,236,591
15,3,9,89,45,134
7,3,9,41,21,62
1,4,10,5,4,9
11,4,10,58,44,102
14,3,9,58,42,100
3,3,9,12,9,21
7,2,5,21,14,35
6,2,5,18,12,30
17,4,10,66,68,134
29,4,10,113,116,229
1,2,5,3,2,5
14,2,5,39,28,67
18,2,5,34,36,70
25,2,5,48,50,98
12,2,5,35,24,59
11,4,10,62,44,106
5,2,5,12,10,22
22,2,5,51,44,95
15,4,10,57,60,117
15,4,10,57,60,117
6,2,5,13,12,25
9,2,5,20,18,38
21,2,5,59,42,101
5,2,5,14,10,24
1,2,5,2,2,4
14,2,5,33,28,61
14,2,5,39,28,67
19,7,9,31,133,164
4,7,9,7,28,35
25,7,9,3,175,178
12,7,9,22,84,106
13,7,9,21,91,112
24,7,9,39,168,207
17,7,9,10,119,129
19,3,8,62,57,119
5,3,8,25,15,40
30,3,8,119,90,209
10,3,8,32,30,62
1,8,22,11,8,19
14,8,22,147,112,259
18,8,22,244,144,388
5,8,22,69,40,109
28,8,22,367,224,591
5,8,22,69,40,109
16,8,22,220,128,348
5,9,24,49,45,94
2,9,24,24,18,42
27,9,24,379,243,622
19,9,24,276,171,447
9,13,35,122,117,239
13,13,35,254,169,423
27,13,35,575,351,926
7,13,35,115,91,206
23,13,35,490,299,789
5,13,35,77,65,142
15,13,35,309,195,504
21,13,35,330,273,603
17,13,35,243,221,464
25,13,35,533,325,858
15,13,35,325,195,520
9,13,35,192,117,309
27,13,35,575,351,926
23,13,35,490,299,789
17,21,55,456,357,813
15,21,55,329,315,644
14,21,55,353,294,647
6,42,54,69,252,321
7,38,50,77,266,343
5,38,50,5,190,195
9,38,50,14,342,356
27,38,50,27,1026,1053
13,42,54,65,546,611
22,42,54,240,924,1164
1,42,54,11,42,53
21,38,50,105,798,903
7,42,54,69,294,363
5,38,50,20,190,210
1,1266,2320,729,1266,1995
3,1252,2295,1683,3756,5439
1,1252,2295,745,1252,1997
1,1266,2320,752,1266,2018
1,1252,2295,1020,1252,2272
3,295,540,379,885,1264
1,1252,2295,997,1252,2249
1,344,540,66,344,410
3,2171,3578,3792,6513,10305
3,713,1120,784,2139,2923
1,2171,3578,835,2171,3006
2,2171,3578,1311,4342,5653
3,344,540,361,1032,1393
1,713,1120,385,713,1098
1,1555,2443,570,1555,2125
1,344,540,174,344,518
21,26,70,601,546,1147
15,26,70,513,390,903
9,26,70,314,234,548
8,26,70,346,208,554
1,26,70,43,26,69
24,3,9,142,72,214
9,3,9,43,27,70
25,3,9,101,75,176
22,1,2,21,22,43
26,1,2,25,26,51
25,1,2,24,25,49
17,1,2,16,17,33
24,2,5,71,48,119
25,2,5,59,50,109
7,2,5,16,14,30
25,2,5,59,50,109
19,11,30,236,209,445
10,11,30,124,110,234
3,2,5,8,6,14
27,2,5,72,54,126
17,2,5,45,34,79
11,2,5,31,22,53
15,1,2,11,15,26
6,2,5,17,12,29
26,2,5,75,52,127
21,1,2,12,21,33
27,2,5,51,54,105
1,2,5,2,2,4
16,1,2,15,16,31
19,1,2,17,19,36
28,2,5,83,56,139
16,2,5,47,32,79
22,11,30,273,242,515
5,11,30,62,55,117
1,2,5,3,2,5
15,2,5,44,30,74
25,2,5,73,50,123
22,1,2,16,22,38
27,1,4,62,27,89
24,1,4,55,24,79
27,12,33,549,324,873
4,12,33,81,48,129
7,2,5,20,14,34
17,2,5,49,34,83
22,1,4,55,22,77
13,1,4,32,13,45
20,1,4,50,20,70
6,2,5,11,12,23
1,1482,2384,401,1482,1883
2,1482,2384,1613,2964,4577
2,461,742,532,922,1454
1,1482,2384,854,1482,2336
1,461,742,162,461,623
6,24,64,190,144,334
31,24,64,1161,744,1905
4,2,5,11,8,19
16,2,5,47,32,79
6,2,5,18,12,30
18,2,5,42,36,78
32,2,5,75,64,139
29,2,5,81,58,139
8,2,5,18,16,34
24,2,5,56,48,104
13,2,5,38,26,64
12,2,5,35,24,59
20,2,5,58,40,98
4,2,5,9,8,17
3,2,5,7,6,13
23,2,5,54,46,100
6,2,5,14,12,26
11,2,5,21,22,43
7,2,5,14,14,28
20,7,9,15,140,155
25,7,9,21,175,196
26,7,9,22,182,204
4,7,9,3,28,31
21,7,9,38,147,185
14,7,9,19,98,117
18,3,8,84,54,138
1,3,8,3,3,6
1,3,8,5,3,8
24,3,8,95,72,167
23,8,22,312,184,496
12,8,22,163,96,259
27,8,22,366,216,582
29,8,22,400,232,632
6,8,22,83,48,131
5,8,22,56,40,96
10,8,22,111,80,191
19,9,24,280,171,451
1,9,24,12,9,21
11,13,35,234,143,377
1,13,35,21,13,34
16,13,35,346,208,554
28,13,35,577,364,941
1,13,35,14,13,27
26,13,35,381,338,719
15,13,35,262,195,457
29,13,35,506,377,883
30,13,35,587,390,977
23,13,35,490,299,789
5,13,35,103,65,168
11,21,55,295,231,526
14,42,54,160,588,748
5,42,54,49,210,259
16,38,50,184,608,792
11,38,50,127,418,545
8,38,50,80,304,384
22,42,54,110,924,1034
7,42,54,16,294,310
15,38,50,150,570,720
7,42,54,35,294,329
26,38,50,130,988,1118
1,1266,2320,1008,1266,2274
1,295,540,240,295,535
2,1252,2295,1994,2504,4498
3,420,769,632,1260,1892
1,2171,3578,942,2171,3113
3,2171,3578,1967,6513,8480
1,713,1120,362,713,1075
1,713,1120,362,713,1075
1,2171,3578,620,2171,2791
1,1083,1701,397,1083,1480
1,713,1120,261,713,974
27,26,70,1169,702,1871
14,26,70,479,364,843
8,8,21,102,64,166
21,2,5,62,42,104
3,2,5,9,6,15
18,2,5,53,36,89
1,2,5,3,2,5
21,2,5,62,42,104
24,2,5,67,48,115
7,2,5,20,14,34
5,2,5,15,10,25
27,2,5,78,54,132
6,12,33,118,72,190
16,1,2,15,16,31
21,1,2,20,21,41
26,1,2,25,26,51
3,1,2,3,3,6
2,1,2,2,2,4
24,1,2,23,24,47
31,2,5,90,62,152
4,12,33,56,48,104
10,12,33,141,120,261
21,13,35,308,273,581
19,13,35,278,247,525
5,1,2,3,5,8
24,1,2,13,24,37
16,1,2,16,16,32
20,11,30,236,220,456
26,1,2,15,26,41
1,1,2,1,1,2
10,1,2,10,10,20
11,1,2,11,11,22
2,755,1215,871,1510,2381
1,1482,2384,735,1482,2217
3,755,1215,870,2265,3135
1,1482,2384,854,1482,2336
1,1482,2384,807,1482,2289
6,24,64,159,144,303
13,24,64,412,312,724
2,24,64,79,48,127
7,59,159,689,413,1102
13,2,5,29,26,55
14,2,5,32,28,60
19,4,10,112,76,188
25,2,5,74,50,124
4,2,5,12,8,20
20,2,5,56,40,96
19,2,5,53,38,91
11,2,5,32,22,54
19,2,5,55,38,93
7,2,5,20,14,34
29,2,5,84,58,142
29,2,5,55,58,113
18,2,5,34,36,70
16,3,9,93,48,141
19,3,9,111,57,168
17,2,5,50,34,84
3,2,5,7,6,13
20,2,5,47,40,87
26,3,9,151,78,229
19,3,9,111,57,168
16,3,9,90,48,138
24,3,9,135,72,207
9,7,9,-1,63,62
5,3,8,16,15,31
31,8,22,420,248,668
6,8,22,81,48,129
13,8,22,179,104,283
25,8,22,229,200,429
15,8,22,207,120,327
21,8,22,276,168,444
13,8,22,176,104,280
18,9,24,201,162,363
9,9,24,107,81,188
5,13,35,107,65,172
22,13,35,369,286,655
14,13,35,230,182,412
23,13,35,401,299,700
31,13,35,639,403,1042
12,13,35,209,156,365
10,13,35,136,130,266
9,13,35,157,117,274
1,13,35,17,13,30
7,13,35,95,91,186
27,13,35,471,351,822
15,13,35,309,195,504
1,13,35,21,13,34
7,13,35,144,91,235
11,21,55,241,231,472
5,42,54,55,210,265
1,420,769,334,420,754
2,295,540,479,590,1069
1,1252,2295,951,1252,2203
3,1252,2295,2991,3756,6747
1,1266,2320,961,1266,2227
1,2171,3578,835,2171,3006
1,713,1120,138,713,851
1,1083,1701,312,1083,1395
1,713,1120,205,713,918
1,1555,2443,790,1555,2345
26,3,9,151,78,229
21,3,9,124,63,187
3,2,5,7,6,13
1,2,5,2,2,4
23,2,5,54,46,100
22,1,2,16,22,38
20,1,4,57,20,77
12,13,35,197,156,353
14,2,5,41,28,69
27,2,5,80,54,134
24,2,5,71,48,119
6,2,5,13,12,25
3,2,5,7,6,13
18,2,5,34,36,70
20,2,5,38,40,78
22,13,35,384,286,670
19,2,5,45,38,83
18,2,5,42,36,78
18,2,5,53,36,89
18,2,5,53,36,89
10,1,4,23,10,33
2,1,4,5,2,7
22,11,30,260,242,502
31,11,30,366,341,707
25,2,5,73,50,123
12,1,2,8,12,20
8,1,2,5,8,13
5,1,2,3,5,8
11,1,2,7,11,18
32,2,5,93,64,157
5,1,2,5,5,10
18,2,5,41,36,77
1,2,5,2,2,4
31,8,21,390,248,638
2,9,25,31,18,49
23,9,25,357,207,564
6,9,25,93,54,147
1,1482,2384,521,1482,2003
1,1482,2384,330,1482,1812
1,1482,2384,568,1482,2050
23,24,64,729,552,1281
13,3,9,59,39,98
17,2,5,50,34,84
4,4,10,17,16,33
26,2,5,75,52,127
3,2,5,9,6,15
13,2,5,38,26,64
18,2,5,34,36,70
2,2,5,4,4,8
1,4,10,4,4,8
11,2,5,32,22,54
8,2,5,24,16,40
17,3,9,100,51,151
27,3,9,160,81,241
18,4,10,68,72,140
12,4,10,46,48,94
19,3,9,76,57,133
10,3,9,40,30,70
12,3,9,70,36,106
22,3,9,106,66,172
13,3,9,63,39,102
6,7,9,10,42,52
1,7,9,2,7,9
9,7,9,3,63,66
26,7,9,36,182,218
29,7,9,53,203,256
6,3,8,30,18,48
22,3,8,82,66,148
4,8,22,37,32,69
13,8,22,119,104,223
11,8,22,144,88,232
3,8,22,41,24,65
4,8,22,55,32,87
14,8,22,122,112,234
20,8,22,223,160,383
29,9,24,310,261,571
16,9,24,171,144,315
19,9,24,212,171,383
5,13,35,98,65,163
12,13,35,235,156,391
13,13,35,204,169,373
1,13,35,16,13,29
12,13,35,256,156,412
10,13,35,196,130,326
26,13,35,536,338,874
9,13,35,157,117,274
1,13,35,14,13,27
18,13,35,390,234,624
12,13,35,209,156,365
21,13,35,447,273,720
5,13,35,103,65,168
9,13,35,141,117,258
24,13,35,520,312,832
3,13,35,47,39,86
14,13,35,230,182,412
1,13,35,14,13,27
2,13,35,43,26,69
20,13,35,433,260,693
16,21,55,509,336,845
30,42,54,68,1260,1328
3,38,50,3,114,117
24,38,50,24,912,936
6,42,54,66,252,318
4,42,54,0,168,168
21,38,50,116,798,914
14,38,50,140,532,672
23,38,50,230,874,1104
1,38,50,4,38,42
3,38,50,33,114,147
12,38,50,138,456,594
19,38,50,57,722,779
3,42,54,10,126,136
5,38,50,50,190,240
17,42,54,11,714,725
5,42,54,25,210,235
8,38,50,88,304,392
1,1898,3375,768,1898,2666
3,1912,3400,2832,5736,8568
1,1266,2320,1008,1266,2274
1,1252,2295,538,1252,1790
3,1266,2320,3023,3798,6821
2,1266,2320,1783,2532,4315
1,1266,2320,961,1266,2227
1,308,565,133,308,441
1,1266,2320,636,1266,1902
3,1266,2320,1631,3798,5429
1,1266,2320,544,1266,1810
1,1555,2443,839,1555,2394
1,1555,2443,790,1555,2345
3,2171,3578,2504,6513,9017
1,487,783,155,487,642
1,344,540,77,344,421
2,1555,2443,994,3110,4104
1,2171,3578,1335,2171,3506
30,26,70,1278,780,2058
11,26,70,453,286,739
23,26,70,996,598,1594
7,26,70,298,182,480
12,1,2,7,12,19
28,1,2,16,28,44
25,1,2,24,25,49
7,1,2,7,7,14
3,1,2,3,3,6
10,13,35,213,130,343
4,2,5,8,8,16
26,2,5,73,52,125
23,2,5,67,46,113
1,1,4,2,1,3
26,2,5,77,52,129
27,2,5,49,54,103
20,2,5,36,40,76
27,1,2,23,27,50
20,9,25,310,180,490
22,9,25,341,198,539
30,9,25,465,270,735
28,1,2,26,28,54
29,1,2,27,29,56
26,1,2,18,26,44
7,1,2,5,7,12
28,2,5,83,56,139
32,1,2,20,32,52
27,1,2,17,27,44
14,1,2,10,14,24
20,1,2,14,20,34
15,1,2,15,15,30
18,1,2,18,18,36
31,2,5,60,62,122
23,1,2,22,23,45
16,2,5,46,32,78
27,2,5,78,54,132
5,2,5,15,10,25
18,1,2,18,18,36
25,1,2,25,25,50
24,2,5,70,48,118
13,2,5,38,26,64
12,2,5,35,24,59
17,1,2,10,17,27
1,755,1215,375,755,1130
1,461,742,185,461,646
14,2,5,29,28,57
14,2,5,29,28,57
18,2,5,52,36,88
26,2,5,55,52,107
4,2,5,8,8,16
26,4,10,146,104,250
20,2,5,38,40,78
3,2,5,9,6,15
5,2,5,15,10,25
24,3,9,114,72,186
12,3,9,57,36,93
23,2,5,67,46,113
9,2,5,26,18,44
20,3,9,80,60,140
4,3,9,21,12,33
27,3,9,145,81,226
30,2,5,89,60,149
4,2,5,12,8,20
2,2,5,6,4,10
29,2,5,86,58,144
6,3,9,35,18,53
1,3,9,6,3,9
4,4,10,18,16,34
28,4,10,129,112,241
31,2,5,73,62,135
31,2,5,73,62,135
7,2,5,21,14,35
19,7,9,7,133,140
19,7,9,35,133,168
13,7,9,24,91,115
25,7,9,19,175,194
1,7,9,2,7,9
8,3,8,39,24,63
14,3,8,58,42,100
12,3,8,40,36,76
18,3,8,60,54,114
20,8,22,271,160,431
1,8,22,14,8,22
28,8,22,349,224,573
22,8,22,298,176,474
6,8,22,63,48,111
25,9,24,267,225,492
2,9,24,21,18,39
13,9,24,129,117,246
27,9,24,392,243,635
30,13,35,650,390,1040
15,13,35,325,195,520
24,13,35,377,312,689
3,13,35,64,39,103
19,13,35,405,247,652
29,13,35,476,377,853
7,13,35,107,91,198
3,13,35,62,39,101
27,13,35,424,351,775
15,13,35,220,195,415
14,13,35,244,182,426
27,13,35,443,351,794
28,13,35,596,364,960
8,13,35,170,104,274
27,13,35,386,351,737
30,13,35,429,390,819
2,13,35,41,26,67
3,13,35,51,39,90
2,13,35,41,26,67
31,13,35,530,403,933
23,21,55,504,483,987
7,38,50,77,266,343
16,38,50,184,608,792
22,42,54,110,924,1034
1,38,50,5,38,43
3,42,54,15,126,141
13,38,50,143,494,637
16,38,50,176,608,784
1,1266,2320,961,1266,2227
1,1252,2295,997,1252,2249
1,1266,2320,1008,1266,2274
3,1252,2295,2234,3756,5990
2,1252,2295,1994,2504,4498
1,1252,2295,997,1252,2249
1,295,540,169,295,464
1,295,540,240,295,535
1,713,1120,385,713,1098
2,2171,3578,1311,4342,5653
1,2171,3578,656,2171,2827
1,2171,3578,835,2171,3006
3,2171,3578,2826,6513,9339
2,713,1120,769,1426,2195
1,344,540,174,344,518
1,344,540,120,344,464
2,344,540,252,688,940
1,713,1120,362,713,1075
1,344,540,126,344,470
16,26,70,682,416,1098
13,26,70,554,338,892
16,1,4,47,16,63
20,1,4,59,20,79
2,13,35,34,26,60
20,13,35,342,260,602
11,1,2,11,11,22
20,1,2,20,20,40
22,1,2,22,22,44
22,1,2,15,22,37
1,1,2,1,1,2
1,1,2,1,1,2
25,1,2,15,25,40
16,2,5,47,32,79
32,2,5,94,64,158
24,1,2,22,24,46
18,1,2,17,18,35
21,1,2,19,21,40
26,1,2,25,26,51
28,1,2,27,28,55
22,2,5,42,44,86
27,1,4,69,27,96
16,1,4,41,16,57
15,1,2,14,15,29
11,1,2,11,11,22
31,9,25,333,279,612
18,9,25,194,162,356
27,8,21,272,216,488
29,8,21,292,232,524
14,2,5,27,28,55
19,2,5,36,38,74
22,13,35,315,286,601
2,13,35,29,26,55
11,1,2,7,11,18
3,1,2,2,3,5
13,1,2,8,13,21
29,1,4,68,29,97
2,1,4,5,2,7
21,1,2,16,21,37
22,11,30,411,242,653
19,2,5,44,38,82
11,2,5,25,22,47
28,8,21,241,224,465
1,8,21,9,8,17
8,8,21,69,64,133
13,1,4,30,13,43
28,1,4,64,28,92
22,1,4,50,22,72
22,1,2,22,22,44
17,1,2,17,17,34
1,8,21,9,8,17
5,8,21,46,40,86
3,461,742,754,1383,2137
1,461,742,147,461,608
1,461,742,185,461,646
1,1482,2384,807,1482,2289
1,755,1215,241,755,996
1,755,1215,290,755,1045
1,1482,2384,854,1482,2336
9,24,64,285,216,501
29,24,64,1141,696,1837
23,24,64,596,552,1148
7,45,120,517,315,832
15,2,5,44,30,74
1,2,5,3,2,5
8,4,10,38,32,70
32,4,10,150,128,278
1,2,5,3,2,5
32,4,10,189,128,317
11,4,10,65,44,109
18,2,5,53,36,89
8,2,5,24,16,40
31,2,5,60,62,122
12,2,5,35,24,59
15,2,5,44,30,74
25,4,10,145,100,245
32,2,5,61,64,125
21,2,5,40,42,82
23,2,5,67,46,113
7,2,5,20,14,34
23,2,5,45,46,91
1,2,5,2,2,4
15,3,9,68,45,113
27,2,5,62,54,116
2,2,5,5,4,9
16,3,9,93,48,141
22,2,5,58,44,102
3,2,5,8,6,14
4,3,9,23,12,35
7,3,9,39,21,60
2,2,5,6,4,10
2,2,5,6,4,10
21,3,9,101,63,164
21,7,9,2,147,149
14,7,9,27,98,125
11,7,9,9,77,86
1,7,9,1,7,8
4,7,9,0,28,28
4,7,9,7,28,35
7,7,9,6,49,55
9,7,9,17,63,80
25,7,9,48,175,223
22,7,9,42,154,196
18,3,8,87,54,141
10,3,8,48,30,78
12,8,22,163,96,259
22,8,22,303,176,479
9,8,22,124,72,196
10,8,22,138,80,218
9,8,22,82,72,154
18,9,24,201,162,363
1,9,24,15,9,24
4,9,24,56,36,92
5,13,35,107,65,172
11,13,35,173,143,316
28,13,35,577,364,941
19,13,35,332,247,579
6,13,35,86,78,164
24,13,35,469,312,781
31,13,35,541,403,944
2,13,35,33,26,59
18,13,35,308,234,542
1,13,35,14,13,27
11,21,55,362,231,593
7,21,55,230,147,377
30,38,50,345,1140,1485
26,42,54,214,1092,1306
13,38,50,72,494,566
14,38,50,140,532,672
9,42,54,98,378,476
17,42,54,30,714,744
8,38,50,24,304,328
20,42,54,100,840,940
24,42,54,262,1008,1270
22,38,50,242,836,1078
1,1912,3400,1046,1912,2958
3,1266,2320,1909,3798,5707
1,1266,2320,752,1266,2018
2,1252,2295,1994,2504,4498
1,1252,2295,745,1252,1997
2,420,769,498,840,1338
1,420,769,334,420,754
1,1252,2295,997,1252,2249
1,1266,2320,567,1266,1833
2,420,769,498,840,1338
1,1266,2320,961,1266,2227
1,295,540,126,295,421
1,295,540,234,295,529
2,2171,3578,1526,4342,5868
1,1555,2443,790,1555,2345
1,1083,1701,499,1083,1582
1,2171,3578,942,2171,3113
1,1555,2443,448,1555,2003
3,1083,1701,1191,3249,4440
1,713,1120,194,713,907
2,487,783,263,974,1237
16,26,70,626,416,1042
13,26,70,536,338,874
16,26,70,693,416,1109
17,26,70,724,442,1166
25,3,9,148,75,223
4,3,9,24,12,36
28,1,2,21,28,49
10,1,2,10,10,20
2,13,35,29,26,55
9,13,35,195,117,312
32,13,35,693,416,1109
26,1,4,74,26,100
32,1,4,91,32,123
2,1,4,6,2,8
20,2,5,58,40,98
18,2,5,52,36,88
19,8,21,175,152,327
21,1,2,16,21,37
10,1,2,6,10,16
1,1,2,1,1,2
6,1,2,6,6,12
19,13,35,332,247,579
17,2,5,48,34,82
21,2,5,59,42,101
22,2,5,62,44,106
19,1,4,47,19,66
1,1,4,2,1,3
5,1,4,12,5,17
25,2,5,48,50,98
2,2,5,4,4,8
11,2,5,21,22,43
6,2,5,17,12,29
28,1,2,19,28,47
30,9,25,473,270,743
17,9,25,268,153,421
12,2,5,28,24,52
22,2,5,52,44,96
3,2,5,9,6,15
30,2,5,87,60,147
3,2,5,9,6,15
27,11,30,335,297,632
12,11,30,149,132,281
2,1,2,1,2,3
12,1,2,7,12,19
3,1,2,2,3,5
31,1,2,30,31,61
24,8,21,201,192,393
19,8,21,159,152,311
23,1,2,21,23,44
15,1,2,14,15,29
14,1,4,35,14,49
2,8,21,25,16,41
18,8,21,226,144,370
22,8,21,277,176,453
5,8,21,63,40,103
17,1,2,10,17,27
1,1482,2384,807,1482,2289
1,755,1215,436,755,1191
1,1482,2384,854,1482,2336
3,755,1215,1344,2265,3609
24,24,64,637,576,1213
29,45,120,2105,1305,3410
30,4,10,177,120,297
18,4,10,106,72,178
2,4,10,9,8,17
1,4,10,5,4,9
6,2,5,17,12,29
1,2,5,3,2,5
8,2,5,23,16,39
27,2,5,51,54,105
8,2,5,15,16,31
31,2,5,76,62,138
12,2,5,29,24,53
5,2,5,15,10,25
17,3,9,70,51,121
11,3,9,45,33,78
25,3,9,146,75,221
27,3,9,157,81,238
5,2,5,13,10,23
18,3,9,97,54,151
20,3,9,107,60,167
9,7,9,17,63,80
1,7,9,0,7,7
28,3,8,136,84,220
16,3,8,79,48,127
7,3,8,31,21,52
17,3,8,55,51,106
9,3,8,36,27,63
27,8,22,295,216,511
13,8,22,179,104,283
23,9,24,334,207,541
11,9,24,131,99,230
3,9,24,44,27,71
20,13,35,349,260,609
20,13,35,426,260,686
26,13,35,454,338,792
4,13,35,87,52,139
16,13,35,346,208,554
18,13,35,264,234,498
1,13,35,21,13,34
13,13,35,281,169,450
10,13,35,217,130,347
3,13,35,52,39,91
13,13,35,259,169,428
25,13,35,366,325,691
15,13,35,293,195,488
7,13,35,115,91,206
4,38,50,22,152,174
9,42,54,40,378,418
4,42,54,46,168,214
4,42,54,13,168,181
1,1252,2295,722,1252,1974
2,1266,2320,1783,2532,4315
1,420,769,295,420,715
1,420,769,249,420,669
2,420,769,683,840,1523
1,295,540,240,295,535
1,1266,2320,892,1266,2158
1,2171,3578,942,2171,3113
1,487,783,194,487,681
2,2171,3578,1884,4342,6226
1,1555,2443,570,1555,2125
3,344,540,572,1032,1604
1,1555,2443,497,1555,2052
12,26,70,394,312,706
1,26,70,43,26,69
16,26,70,693,416,1109
9,8,21,115,72,187
13,9,25,205,117,322
5,1,2,5,5,10
28,13,35,606,364,970
14,13,35,303,182,485
21,9,25,268,189,457
5,9,25,64,45,109
18,9,25,230,162,392
8,2,5,22,16,38
23,2,5,64,46,110
11,2,5,31,22,53
11,1,2,11,11,22
7,1,2,5,7,12
26,1,2,19,26,45
2,9,25,23,18,41
3,9,25,34,27,61
13,2,5,25,26,51
5,11,29,80,55,135
9,11,29,144,99,243
3,11,29,48,33,81
9,11,30,136,99,235
21,1,2,19,21,40
9,1,2,8,9,17
8,1,2,8,8,16
29,1,2,28,29,57
7,1,2,6,7,13
1,1,2,1,1,2
5,1,2,3,5,8
24,12,33,338,288,626
12,1,2,12,12,24
14,1,2,14,14,28
24,2,5,70,48,118
25,1,2,25,25,50
21,11,30,260,231,491
11,11,30,136,121,257
23,11,30,285,253,538
1,9,25,15,9,24
11,2,5,31,22,53
5,2,5,14,10,24
3,1482,2384,2563,4446,7009
1,1482,2384,378,1482,1860
24,3,9,92,72,164
25,3,9,96,75,171
4,2,5,8,8,16
1,2,5,2,2,4
7,2,5,13,14,27
25,2,5,70,50,120
29,2,5,84,58,142
6,4,10,23,24,47
10,4,10,38,40,78
1,2,5,2,2,4
9,2,5,18,18,36
22,4,10,84,88,172
3,4,10,11,12,23
8,2,5,23,16,39
17,3,9,96,51,147
13,3,9,73,39,112
1,3,9,5,3,8
28,3,9,150,84,234
9,3,9,37,27,64
29,3,9,119,87,206
6,2,5,17,12,29
18,2,5,50,36,86
15,7,9,0,105,105
20,7,9,33,140,173
30,7,9,49,210,259
27,7,9,3,189,192
13,7,9,21,91,112
17,7,9,13,119,132
13,3,8,63,39,102
27,3,8,90,81,171
18,3,8,58,54,112
12,8,22,110,96,206
8,8,22,73,64,137
28,9,24,373,252,625
18,9,24,261,162,423
14,9,24,166,126,292
17,13,35,362,221,583
24,13,35,326,312,638
23,13,35,450,299,749
1,13,35,22,13,35
2,13,35,29,26,55
1,13,35,21,13,34
16,13,35,330,208,538
21,13,35,433,273,706
9,13,35,185,117,302
4,13,35,82,52,134
11,13,35,188,143,331
31,13,35,487,403,890
13,13,35,268,169,437
28,13,35,596,364,960
13,13,35,227,169,396
30,13,35,587,390,977
13,13,35,281,169,450
20,13,35,314,260,574
3,13,35,51,39,90
22,13,35,322,286,608
25,21,55,823,525,1348
2,21,55,44,42,86
14,42,54,2,588,590
23,42,54,226,966,1192
16,42,54,175,672,847
29,38,50,29,1102,1131
12,42,54,118,504,622
21,42,54,229,882,1111
17,38,50,145,646,791
3,42,54,13,126,139
26,38,50,78,988,1066
3,38,50,8,114,122
1,308,565,121,308,429
1,1266,2320,1008,1266,2274
1,295,540,223,295,518
3,295,540,703,885,1588
1,1555,2443,839,1555,2394
1,2171,3578,942,2171,3113
1,713,1120,161,713,874
1,1519,2443,411,1519,1930
1,1519,2443,411,1519,1930
3,487,783,794,1461,2255
1,344,540,120,344,464
3,2171,3578,4114,6513,10627
3,713,1120,515,2139,2654
1,344,540,174,344,518
1,713,1120,329,713,1042
1,713,1120,194,713,907
1,344,540,174,344,518
3,344,540,248,1032,1280
6,26,70,260,156,416
2,26,70,85,52,137
6,26,70,184,156,340
21,26,70,909,546,1455
15,3,9,89,45,134
2,3,9,8,6,14
16,3,9,69,48,117
25,3,9,148,75,223
5,1,2,5,5,10
12,13,35,176,156,332
3,13,35,44,39,83
28,2,5,78,56,134
29,2,5,81,58,139
20,2,5,56,40,96
8,1,2,7,8,15
4,1,2,4,4,8
14,1,2,8,14,22
8,2,5,17,16,33
9,1,2,8,9,17
2,1,2,2,2,4
5,2,5,15,10,25
16,2,5,46,32,78
24,1,4,51,24,75
23,1,4,49,23,72
31,9,25,310,279,589
18,9,25,180,162,342
22,9,25,220,198,418
25,2,5,48,50,98
1,9,25,15,9,24
17,2,5,40,34,74
1,2,5,2,2,4
5,1,4,15,5,20
7,1,2,6,7,13
29,2,5,86,58,144
28,12,33,422,336,758
18,12,33,271,216,487
13,2,5,38,26,64
12,2,5,23,24,47
3,2,5,6,6,12
25,2,5,48,50,98
5,1,4,12,5,17
20,1,4,49,20,69
28,8,21,288,224,512
1,8,21,10,8,18
12,8,21,123,96,219
19,1,2,18,19,37
16,1,2,15,16,31
13,1,2,12,13,25
1,1,4,3,1,4
21,1,4,57,21,78
8,8,21,74,64,138
27,8,21,249,216,465
29,1,2,28,29,57
3,1,2,3,3,6
7,2,5,20,14,34
25,1,2,16,25,41
16,1,2,10,16,26
13,1,2,13,13,26
26,1,2,25,26,51
17,1,2,15,17,32
5,1,2,3,5,8
17,1,2,10,17,27
7,1,4,17,7,24
15,1,4,37,15,52
1,461,742,147,461,608
3,1482,2384,2420,4446,6866
17,24,64,669,408,1077
29,24,64,770,696,1466
8,45,120,581,360,941
1,4,10,6,4,10
3,2,5,8,6,14
18,2,5,34,36,70
12,2,5,23,24,47
7,2,5,15,14,29
19,2,5,42,38,80
31,2,5,90,62,152
14,2,5,41,28,69
25,2,5,74,50,124
9,3,9,43,27,70
23,3,9,111,69,180
20,3,9,116,60,176
15,3,9,87,45,132
2,2,5,6,4,10
15,2,5,44,30,74
27,3,9,130,81,211
2,3,9,10,6,16
15,2,5,29,30,59
20,2,5,38,40,78
29,2,5,81,58,139
21,2,5,59,42,101
24,2,5,47,48,95
26,2,5,51,52,103
7,7,9,5,49,54
6,7,9,11,42,53
19,7,9,35,133,168
12,7,9,20,84,104
6,7,9,11,42,53
32,7,9,27,224,251
12,7,9,23,84,107
1,3,8,3,3,6
3,3,8,11,9,20
20,3,8,97,60,157
18,8,22,165,144,309
6,8,22,56,48,104
25,8,22,273,200,473
16,8,22,217,128,345
4,8,22,54,32,86
8,8,22,108,64,172
23,9,24,273,207,480
17,9,24,169,153,322
13,9,24,154,117,271
7,9,24,83,63,146
13,13,35,190,169,359
21,13,35,411,273,684
9,13,35,192,117,309
3,13,35,49,39,88
18,13,35,295,234,529
20,13,35,349,260,609
25,13,35,366,325,691
13,13,35,268,169,437
21,13,35,366,273,639
13,13,35,268,169,437
19,13,35,378,247,625
24,13,35,419,312,731
6,13,35,86,78,164
22,21,55,482,462,944
32,38,50,160,1216,1376
6,42,54,4,252,256
31,38,50,93,1178,1271
28,38,50,280,1064,1344
1,38,50,11,38,49
4,38,50,40,152,192
1,1266,2320,961,1266,2227
2,1266,2320,2015,2532,4547
1,1252,2295,722,1252,1974
1,1266,2320,1008,1266,2274
1,1266,2320,961,1266,2227
3,1266,2320,3023,3798,6821
1,2171,3578,942,2171,3113
1,2171,3578,835,2171,3006
3,344,540,556,1032,1588
1,1519,2443,533,1519,2052
1,2171,3578,620,2171,2791
3,344,540,377,1032,1409
26,26,70,1071,676,1747
9,26,70,383,234,617
31,3,9,180,93,273
19,1,2,18,19,37
28,1,2,27,28,55
6,1,2,6,6,12
24,1,2,22,24,46
22,1,2,16,22,38
1,1,2,1,1,2
22,1,2,21,22,43
30,1,2,29,30,59
5,1,2,5,5,10
11,1,2,9,11,20
3,1,2,3,3,6
13,1,2,9,13,22
7,1,2,5,7,12
14,2,5,41,28,69
29,2,5,86,58,144
31,1,4,77,31,108
24,1,4,60,24,84
14,2,5,27,28,55
11,2,5,32,22,54
14,2,5,41,28,69
25,1,4,68,25,93
27,1,4,73,27,100
13,1,4,38,13,51
21,1,4,61,21,82
1,1,4,3,1,4
19,1,2,17,19,36
22,1,2,20,22,42
25,2,5,68,50,118
13,11,29,226,143,369
11,11,29,192,121,313
10,8,21,122,80,202
28,8,21,340,224,564
3,2,5,8,6,14
15,2,5,40,30,70
25,9,25,375,225,600
23,9,25,345,207,552
10,8,21,86,80,166
5,8,21,43,40,83
7,8,21,60,56,116
17,8,21,146,136,282
11,11,29,195,121,316
32,1,2,18,32,50
3,755,1215,797,2265,3062
1,461,742,274,461,735
1,1482,2384,854,1482,2336
1,1482,2384,378,1482,1860
2,461,742,547,922,1469
6,45,120,443,270,713
7,45,120,374,315,689
14,4,10,62,56,118
24,4,10,134,96,230
12,4,10,67,48,115
22,2,5,62,44,106
23,2,5,64,46,110
21,2,5,40,42,82
16,4,10,61,64,125
2,4,10,8,8,16
24,2,5,46,48,94
13,2,5,25,26,51
7,2,5,16,14,30
15,2,5,35,30,65
3,2,5,6,6,12
23,2,5,44,46,90
12,2,5,35,24,59
17,2,5,49,34,83
9,2,5,17,18,35
17,2,5,32,34,66
8,3,9,47,24,71
10,3,9,59,30,89
5,2,5,14,10,24
21,2,5,59,42,101
4,2,5,12,8,20
8,2,5,18,16,34
3,4,10,11,12,23
1,4,10,4,4,8
30,2,5,57,60,117
23,3,9,111,69,180
13,3,9,63,39,102
17,2,5,32,34,66
27,2,5,51,54,105
9,7,9,15,63,78
24,7,9,9,168,177
27,7,9,52,189,241
17,7,9,32,119,151
26,7,9,43,182,225
2,7,9,1,14,15
1,7,9,2,7,9
8,3,8,39,24,63
20,3,8,65,60,125
9,3,8,36,27,63
28,3,8,93,84,177
8,3,8,28,24,52
7,3,8,34,21,55
6,8,22,81,48,129
7,8,22,95,56,151
18,8,22,244,144,388
3,8,22,33,24,57
4,8,22,54,32,86
16,8,22,161,128,289
24,8,22,241,192,433
8,8,22,110,64,174
13,8,22,145,104,249
5,9,24,73,45,118
8,13,35,165,104,269
4,13,35,82,52,134
11,13,35,234,143,377
15,13,35,246,195,441
1,13,35,22,13,35
18,13,35,264,234,498
8,13,35,126,104,230
17,13,35,243,221,464
10,13,35,206,130,336
1,13,35,21,13,34
16,13,35,229,208,437
30,13,35,587,390,977
28,13,35,577,364,941
5,13,35,79,65,144
29,13,35,618,377,995
1,13,35,22,13,35
14,13,35,303,182,485
11,13,35,234,143,377
12,13,35,176,156,332
16,13,35,341,208,549
15,13,35,215,195,410
11,13,35,161,143,304
20,13,35,349,260,609
5,38,50,58,190,248
26,38,50,130,988,1118
12,38,50,12,456,468
9,38,50,90,342,432
3,38,50,33,114,147
27,42,54,222,1134,1356
1,1252,2295,997,1252,2249
1,1252,2295,722,1252,1974
3,1252,2295,1614,3756,5370
1,1898,3375,937,1898,2835
2,1266,2320,1922,2532,4454
2,1266,2320,1922,2532,4454
2,420,769,667,840,1507
3,295,540,443,885,1328
1,1266,2320,752,1266,2018
1,1266,2320,1031,1266,2297
1,1252,2295,997,1252,2249
1,1252,2295,745,1252,1997
1,344,540,174,344,518
3,487,783,371,1461,1832
1,344,540,77,344,421
2,1555,2443,1678,3110,4788
1,2171,3578,656,2171,2827
1,1083,1701,499,1083,1582
1,1083,1701,550,1083,1633
3,713,1120,515,2139,2654
1,487,783,132,487,619
1,713,1120,205,713,918
1,344,540,126,344,470
21,26,70,909,546,1455
21,3,9,101,63,164
5,3,9,22,15,37
7,3,9,28,21,49
16,1,2,15,16,31
16,1,2,15,16,31
1,1,2,1,1,2
4,1,2,4,4,8
23,1,2,22,23,45
21,2,5,59,42,101
22,2,5,62,44,106
6,2,5,17,12,29
27,2,5,76,54,130
22,2,5,64,44,108
12,1,2,12,12,24
11,1,2,11,11,22
26,2,5,73,52,125
10,2,5,28,20,48
18,2,5,50,36,86
21,1,2,12,21,33
2,1,2,1,2,3
4,9,25,43,36,79
3,9,25,32,27,59
6,12,33,100,72,172
3,12,33,50,36,86
11,2,5,32,22,54
13,2,5,38,26,64
6,2,5,18,12,30
1,2,5,3,2,5
16,2,5,47,32,79
27,2,5,72,54,126
1,2,5,3,2,5
1,1,2,1,1,2
5,1,2,3,5,8
26,1,2,17,26,43
32,1,2,20,32,52
3,12,33,47,36,83
20,1,4,47,20,67
12,1,4,28,12,40
4,9,25,62,36,98
7,9,25,109,63,172
1,9,25,16,9,25
3,9,25,45,27,72
25,2,5,66,50,116
20,2,5,58,40,98
13,2,5,38,26,64
24,2,5,70,48,118
15,1,2,14,15,29
18,11,30,223,198,421
1,1,2,1,1,2
27,2,5,78,54,132
23,2,5,67,46,113
7,2,5,20,14,34
26,8,21,223,208,431
27,8,21,232,216,448
8,2,5,24,16,40
13,2,5,38,26,64
22,8,21,277,176,453
4,1,2,4,4,8
8,1,2,8,8,16
13,1,4,38,13,51
18,1,4,53,18,71
24,1,4,70,24,94
26,1,4,76,26,102
6,9,25,69,54,123
24,9,25,276,216,492
26,9,25,299,234,533
28,1,2,19,28,47
1,1482,2384,807,1482,2289
1,1482,2384,807,1482,2289
2,1482,2384,1613,2964,4577
1,461,742,251,461,712
1,461,742,185,461,646
1,755,1215,375,755,1130
2,1482,2384,755,2964,3719
1,755,1215,193,755,948
3,461,742,821,1383,2204
1,24,64,27,24,51
21,24,64,746,504,1250
19,24,64,541,456,997
18,24,64,478,432,910
3,59,159,195,177,372
22,4,10,86,88,174
26,4,10,101,104,205
25,2,5,74,50,124
1,2,5,3,2,5
5,4,10,27,20,47
13,4,10,61,52,113
9,4,10,42,36,78
21,2,5,40,42,82
30,2,5,57,60,117
11,2,5,31,22,53
1,2,5,3,2,5
29,2,5,84,58,142
16,2,5,35,32,67
9,4,10,38,36,74
11,4,10,46,44,90
20,2,5,39,40,79
29,2,5,68,58,126
15,2,5,44,30,74
30,2,5,87,60,147
20,2,5,59,40,99
19,4,10,110,76,186
19,4,10,110,76,186
21,3,9,113,63,176
26,7,9,3,182,185
24,7,9,44,168,212
15,7,9,0,105,105
8,7,9,11,56,67
9,7,9,5,63,68
4,7,9,3,28,31
8,7,9,3,56,59
20,3,8,70,60,130
16,3,8,75,48,123
3,8,22,27,24,51
18,8,22,201,144,345
14,8,22,190,112,302
22,8,22,303,176,479
8,8,22,110,64,174
5,9,24,74,45,119
16,9,24,236,144,380
21,9,24,224,189,413
13,9,24,154,117,271
26,13,35,354,338,692
13,13,35,277,169,446
7,13,35,95,91,186
3,13,35,43,39,82
4,13,35,87,52,139
17,13,35,332,221,553
12,13,35,197,156,353
12,13,35,172,156,328
23,13,35,474,299,773
15,13,35,325,195,520
13,13,35,190,169,359
1,13,35,16,13,29
28,13,35,489,364,853
4,13,35,70,52,122
29,13,35,628,377,1005
13,13,35,204,169,373
4,21,55,132,84,216
2,21,55,48,42,90
3,42,54,33,126,159
15,38,50,150,570,720
8,42,54,18,336,354
8,38,50,24,304,328
6,42,54,66,252,318
27,42,54,309,1134,1443
4,38,50,22,152,174
7,42,54,35,294,329
18,42,54,148,756,904
1,308,565,121,308,429
1,1898,3375,937,1898,2835
3,1252,2295,1477,3756,5233
2,1252,2295,1811,2504,4315
3,1266,2320,3023,3798,6821
1,2171,3578,1157,2171,3328
1,713,1120,385,713,1098
1,2171,3578,942,2171,3113
1,1083,1701,550,1083,1633
1,713,1120,385,713,1098
1,2171,3578,1371,2171,3542
3,713,1120,784,2139,2923
1,713,1120,261,713,974
3,713,1120,784,2139,2923
3,2171,3578,4006,6513,10519
26,26,70,816,676,1492
30,3,9,123,90,213
16,3,9,77,48,125
16,8,21,137,128,265
4,11,29,44,44,88
6,2,5,18,12,30
32,2,5,94,64,158
17,2,5,50,34,84
20,1,2,13,20,33
25,1,2,16,25,41
21,1,2,13,21,34
3,1,2,2,3,5
18,12,33,271,216,487
14,1,2,14,14,28
1,1,2,1,1,2
13,9,25,140,117,257
18,2,5,48,36,84
1,2,5,3,2,5
2,1,4,5,2,7
18,1,4,45,18,63
1,1,2,1,1,2
30,2,5,71,60,131
1,1,2,1,1,2
25,1,2,16,25,41
3,1,2,2,3,5
8,1,2,8,8,16
7,1,2,5,7,12
23,1,2,15,23,38
11,1,2,7,11,18
1,1,2,1,1,2
1,1,2,1,1,2
16,1,4,45,16,61
13,1,4,37,13,50
13,9,25,166,117,283
10,9,25,128,90,218
24,2,5,70,48,118
3,1482,2384,2420,4446,6866
1,1482,2384,807,1482,2289
3,461,742,554,1383,1937
1,461,742,147,461,608
1,461,742,118,461,579
3,461,742,798,1383,2181
23,24,64,905,552,1457
4,24,64,127,96,223
1,45,120,74,45,119
11,2,5,21,22,43
11,2,5,21,22,43
25,3,9,134,75,209
24,3,9,129,72,201
18,2,5,40,36,76
23,2,5,51,46,97
24,2,5,55,48,103
26,2,5,60,52,112
4,3,9,23,12,35
5,3,9,29,15,44
22,2,5,43,44,87
4,2,5,8,8,16
1,2,5,3,2,5
22,2,5,62,44,106
11,7,9,18,77,95
21,7,9,17,147,164
23,7,9,9,161,170
3,3,8,14,9,23
3,3,8,14,9,23
19,3,8,74,57,131
26,8,22,290,208,498
5,8,22,50,40,90
8,8,22,73,64,137
11,8,22,144,88,232
10,9,24,133,90,223
20,9,24,290,180,470
7,9,24,93,63,156
6,13,35,130,78,208
15,13,35,220,195,415
18,13,35,371,234,605
12,13,35,247,156,403
19,13,35,272,247,519
1,13,35,16,13,29
12,13,35,260,156,416
18,13,35,390,234,624
24,13,35,419,312,731
29,13,35,597,377,974
18,13,35,352,234,586
12,13,35,172,156,328
25,13,35,533,325,858
11,13,35,173,143,316
25,21,55,795,525,1320
8,38,50,80,304,384
3,38,50,35,114,149
19,38,50,190,722,912
22,42,54,74,924,998
5,42,54,3,210,213
8,38,50,68,304,372
11,42,54,120,462,582
7,38,50,70,266,336
1,1266,2320,961,1266,2227
1,1266,2320,636,1266,1902
3,1252,2295,2854,3756,6610
1,1519,2443,875,1519,2394
2,2171,3578,2528,4342,6870
1,713,1120,161,713,874
1,487,783,280,487,767
1,1083,1701,312,1083,1395
1,713,1120,385,713,1098
1,1083,1701,550,1083,1633
2,1083,1701,1100,2166,3266
1,2171,3578,1335,2171,3506
1,344,540,77,344,421
1,487,783,132,487,619
1,344,540,174,344,518
3,344,540,377,1032,1409
19,1,2,19,19,38
3,1,2,3,3,6
22,8,21,189,176,365
9,8,21,77,72,149
26,2,5,77,52,129
9,2,5,27,18,45
28,2,5,78,56,134
6,2,5,17,12,29
12,11,30,224,132,356
8,1,2,8,8,16
4,1,2,4,4,8
23,1,2,22,23,45
19,1,4,56,19,75
31,1,4,92,31,123
21,1,4,62,21,83
19,2,5,55,38,93
13,2,5,38,26,64
5,2,5,15,10,25
13,2,5,38,26,64
2,1,2,1,2,3
21,1,4,52,21,73
25,2,5,74,50,124
28,1,2,26,28,54
21,1,2,19,21,40
23,1,2,21,23,44
22,9,25,253,198,451
13,9,25,150,117,267
8,2,5,24,16,40
14,2,5,41,28,69
16,1,2,9,16,25
16,1,2,9,16,25
9,1,2,9,9,18
10,1,2,10,10,20
18,1,2,18,18,36
26,11,30,330,286,616
3,2,5,9,6,15
17,11,30,318,187,505
21,9,25,268,189,457
27,9,25,344,243,587
26,1,2,24,26,50
8,1,2,7,8,15
21,1,2,19,21,40
11,1,4,32,11,43
10,1,4,29,10,39
19,8,21,231,152,383
15,1,2,15,15,30
13,1,2,8,13,21
15,1,2,10,15,25
2,1482,2384,1756,2964,4720
3,461,742,687,1383,2070
1,1482,2384,807,1482,2289
1,1482,2384,568,1482,2050
3,1482,2384,2205,4446,6651
3,755,1215,1307,2265,3572
1,461,742,147,461,608
21,24,64,598,504,1102
6,59,159,581,354,935
9,3,9,51,27,78
13,3,9,73,39,112
18,2,5,48,36,84
20,2,5,58,40,98
28,2,5,81,56,137
11,4,10,53,44,97
25,4,10,120,100,220
25,4,10,148,100,248
14,4,10,83,56,139
20,2,5,58,40,98
4,2,5,11,8,19
1,2,5,3,2,5
17,2,5,32,34,66
10,2,5,19,20,39
21,4,10,122,84,206
28,4,10,162,112,274
11,7,9,21,77,98
21,7,9,38,147,185
6,7,9,0,42,42
1,7,9,1,7,8
24,7,9,33,168,201
9,7,9,17,63,80
8,3,8,39,24,63
9,3,8,44,27,71
21,3,8,68,63,131
30,8,22,275,240,515
25,8,22,251,200,451
1,8,22,14,8,22
26,8,22,358,208,566
17,8,22,234,136,370
25,8,22,345,200,545
10,8,22,111,80,191
1,8,22,14,8,22
21,8,22,289,168,457
26,8,22,261,208,469
26,13,35,508,338,846
2,13,35,43,26,69
22,13,35,315,286,601
10,13,35,213,130,343
18,13,35,314,234,548
6,13,35,105,78,183
9,13,35,192,117,309
1,38,50,6,38,44
10,38,50,115,380,495
9,42,54,98,378,476
6,42,54,1,252,253
21,38,50,179,798,977
31,38,50,31,1178,1209
1,1252,2295,997,1252,2249
3,295,540,443,885,1328
1,1252,2295,1020,1252,2272
2,1252,2295,1994,2504,4498
1,1252,2295,538,1252,1790
1,1266,2320,636,1266,1902
1,1252,2295,630,1252,1882
1,487,783,280,487,767
1,2171,3578,656,2171,2827
3,487,783,583,1461,2044
1,713,1120,385,713,1098
1,2171,3578,1335,2171,3506
3,1,2,3,3,6
2,9,25,24,18,42
1,9,25,12,9,21
25,2,5,73,50,123
21,1,4,62,21,83
21,11,30,393,231,624
1,11,30,19,11,30
25,2,5,70,50,120
21,2,5,59,42,101
15,2,5,42,30,72
14,2,5,41,28,69
25,2,5,73,50,123
6,12,33,124,72,196
28,1,4,69,28,97
6,1,4,15,6,21
1,1,4,2,1,3
18,2,5,42,36,78
2,2,5,5,4,9
26,1,2,19,26,45
16,1,2,12,16,28
1,2,5,3,2,5
7,2,5,21,14,35
4,2,5,12,8,20
25,2,5,74,50,124
23,1,4,52,23,75
15,1,4,34,15,49
24,8,21,201,192,393
5,8,21,42,40,82
7,12,33,117,84,201
18,12,33,301,216,517
29,2,5,55,58,113
1,12,33,14,12,26
4,12,33,55,48,103
23,2,5,54,46,100
12,1,2,12,12,24
10,1,2,10,10,20
16,2,5,46,32,78
19,2,5,55,38,93
5,1,4,15,5,20
18,1,4,53,18,71
13,1,2,8,13,21
4,1,2,4,4,8
5,1,2,5,5,10
29,1,2,28,29,57
1,1482,2384,616,1482,2098
3,1482,2384,2420,4446,6866
3,59,159,238,177,415
14,4,10,78,56,134
13,4,10,73,52,125
19,2,5,40,38,78
10,2,5,21,20,41
9,2,5,27,18,45
14,2,5,41,28,69
20,3,9,116,60,176
28,3,9,163,84,247
3,4,10,18,12,30
15,4,10,90,60,150
32,2,5,75,64,139
21,2,5,43,42,85
18,2,5,37,36,73
12,2,5,35,24,59
26,2,5,73,52,125
23,2,5,64,46,110
15,3,9,62,45,107
21,3,9,86,63,149
2,2,5,6,4,10
27,2,5,78,54,132
13,3,9,52,39,91
12,7,9,20,84,104
1,7,9,2,7,9
8,7,9,15,56,71
15,7,9,8,105,113
5,7,9,8,35,43
1,7,9,0,7,7
24,7,9,44,168,212
26,7,9,47,182,229
4,3,8,20,12,32
27,3,8,87,81,168
7,8,22,66,56,122
7,8,22,96,56,152
1,8,22,11,8,19
4,8,22,54,32,86
32,8,22,356,256,612
6,9,24,84,54,138
11,9,24,160,99,259
7,9,24,103,63,166
1,9,24,15,9,24
25,9,24,297,225,522
3,9,24,32,27,59
14,9,24,210,126,336
7,9,24,83,63,146
22,9,24,261,198,459
7,9,24,68,63,131
14,9,24,166,126,292
15,13,35,320,195,515
14,13,35,303,182,485
26,13,35,554,338,892
2,13,35,41,26,67
6,13,35,105,78,183
13,13,35,204,169,373
17,13,35,350,221,571
8,13,35,140,104,244
5,13,35,107,65,172
30,13,35,639,390,1029
28,13,35,606,364,970
15,13,35,262,195,457
11,13,35,192,143,335
19,13,35,312,247,559
22,13,35,476,286,762
1,13,35,14,13,27
12,13,35,205,156,361
18,21,55,483,378,861
5,21,55,134,105,239
24,38,50,24,912,936
11,38,50,121,418,539
15,42,54,75,630,705
27,42,54,62,1134,1196
19,38,50,48,722,770
6,38,50,69,228,297
21,42,54,71,882,953
27,38,50,149,1026,1175
5,38,50,50,190,240
2,1252,2295,1443,2504,3947
1,1266,2320,961,1266,2227
1,1252,2295,722,1252,1974
1,420,769,249,420,669
1,308,565,246,308,554
1,1252,2295,630,1252,1882
1,420,769,249,420,669
3,420,769,747,1260,2007
1,2171,3578,1264,2171,3435
2,1083,1701,1236,2166,3402
1,1555,2443,790,1555,2345
1,2171,3578,763,2171,2934
3,2171,3578,2826,6513,9339
3,713,1120,1154,2139,3293
1,2171,3578,727,2171,2898
2,1083,1701,624,2166,2790
1,344,540,83,344,427
3,344,540,296,1032,1328
1,713,1120,205,713,918
3,713,1120,784,2139,2923
1,2171,3578,620,2171,2791
1,344,540,174,344,518
19,26,70,597,494,1091
3,26,70,105,78,183
28,3,9,135,84,219
14,3,9,66,42,108
16,1,2,15,16,31
4,13,35,85,52,137
4,13,35,85,52,137
7,2,5,16,14,30
11,2,5,26,22,48
10,11,29,177,110,287
17,11,29,301,187,488
5,2,5,15,10,25
17,2,5,50,34,84
23,1,2,23,23,46
16,1,4,47,16,63
3,1,4,9,3,12
12,1,4,35,12,47
25,2,5,73,50,123
14,2,5,41,28,69
19,2,5,55,38,93
3,2,5,6,6,12
12,2,5,23,24,47
11,13,35,192,143,335
7,1,2,5,7,12
11,1,2,8,11,19
18,1,2,13,18,31
6,11,30,82,66,148
6,11,30,82,66,148
27,1,2,25,27,52
15,1,2,14,15,29
31,1,2,29,31,60
7,1,2,4,7,11
14,1,2,8,14,22
13,2,5,31,26,57
7,1,4,15,7,22
25,1,4,53,25,78
9,1,4,19,9,28
5,1,2,3,5,8
24,1,4,70,24,94
18,1,4,53,18,71
7,1,2,7,7,14
10,1,2,10,10,20
15,2,5,29,30,59
23,2,5,44,46,90
1,12,33,14,12,26
16,1,2,11,16,27
3,9,25,35,27,62
10,9,25,115,90,205
19,9,25,238,171,409
27,9,25,338,243,581
31,2,5,73,62,135
30,12,33,501,360,861
20,12,33,334,240,574
16,8,21,164,128,292
1,8,21,10,8,18
7,8,21,72,56,128
27,1,2,15,27,42
27,2,5,78,54,132
12,1,4,29,12,41
29,1,4,71,29,100
1,1482,2384,807,1482,2289
1,461,742,274,461,735
1,1482,2384,735,1482,2217
1,1482,2384,854,1482,2336
3,755,1215,1307,2265,3572
1,1482,2384,854,1482,2336
1,1482,2384,854,1482,2336
30,24,64,797,720,1517
23,24,64,684,552,1236
14,24,64,542,336,878
2,59,159,187,118,305
17,2,5,48,34,82
12,2,5,34,24,58
7,2,5,16,14,30
31,2,5,73,62,135
13,2,5,36,26,62
24,2,5,67,48,115
22,2,5,65,44,109
28,2,5,83,56,139
28,2,5,53,56,109
9,2,5,17,18,35
20,2,5,47,40,87
6,4,10,35,24,59
1,3,9,6,3,9
17,3,9,100,51,151
21,2,5,61,42,103
28,2,5,81,56,137
8,2,5,24,16,40
8,2,5,24,16,40
19,3,9,92,57,149
10,3,9,48,30,78
17,2,5,49,34,83
24,3,9,135,72,207
9,3,9,51,27,78
10,2,5,24,20,44
12,7,9,20,84,104
19,7,9,16,133,149
22,7,9,36,154,190
10,7,9,18,70,88
22,7,9,42,154,196
1,3,8,5,3,8
11,3,8,54,33,87
7,3,8,23,21,44
6,8,22,55,48,103
4,8,22,54,32,86
4,8,22,38,32,70
10,9,24,97,90,187
8,9,24,116,72,188
4,13,35,85,52,137
31,13,35,639,403,1042
7,13,35,144,91,235
5,13,35,103,65,168
26,13,35,454,338,792
26,13,35,372,338,710
20,13,35,342,260,602
19,13,35,272,247,519
22,13,35,384,286,670
27,13,35,367,351,718
19,13,35,332,247,579
24,13,35,352,312,664
11,13,35,227,143,370
18,21,55,483,378,861
3,21,55,99,63,162
21,21,55,691,441,1132
31,21,55,986,651,1637
1,38,50,1,38,39
30,38,50,330,1140,1470
5,42,54,55,210,265
27,42,54,309,1134,1443
2,38,50,6,76,82
16,38,50,88,608,696
15,38,50,150,570,720
2,38,50,22,76,98
25,42,54,138,1050,1188
2,1252,2295,1902,2504,4406
1,1266,2320,636,1266,1902
1,1266,2320,544,1266,1810
2,1266,2320,1783,2532,4315
1,1252,2295,997,1252,2249
3,2171,3578,2826,6513,9339
2,1083,1701,1100,2166,3266
1,1555,2443,448,1555,2003
1,2171,3578,1371,2171,3542
1,487,783,194,487,681
1,2171,3578,1371,2171,3542
2,2171,3578,1240,4342,5582
1,2171,3578,1335,2171,3506
13,26,70,372,338,710
20,26,70,852,520,1372
22,26,70,783,572,1355
24,3,9,140,72,212
8,3,9,47,24,71
8,3,9,33,24,57
3,3,9,12,9,21
23,3,9,130,69,199
10,13,35,213,130,343
1,13,35,21,13,34
10,13,35,147,130,277
22,2,5,62,44,106
1,2,5,3,2,5
10,1,2,10,10,20
1,1,2,1,1,2
15,13,35,257,195,452
24,13,35,410,312,722
27,2,5,76,54,130
11,2,5,21,22,43
10,2,5,19,20,39
13,13,35,186,169,355
3,2,5,7,6,13
32,2,5,74,64,138
16,1,2,12,16,28
19,2,5,36,38,74
21,2,5,40,42,82
17,11,30,201,187,388
24,2,5,67,48,115
16,2,5,45,32,77
16,1,4,39,16,55
26,1,4,63,26,89
26,2,5,73,52,125
12,1,2,11,12,23
17,2,5,48,34,82
4,2,5,11,8,19
17,9,25,264,153,417
30,1,4,64,30,94
12,1,4,25,12,37
28,1,2,16,28,44
3,1482,2384,1204,4446,5650
3,1482,2384,2420,4446,6866
3,1482,2384,2634,4446,7080
1,461,742,147,461,608
30,24,64,1162,720,1882
28,45,120,1966,1260,3226
4,59,159,266,236,502
3,59,159,290,177,467
12,3,9,53,36,89
11,3,9,48,33,81
16,4,10,70,64,134
16,4,10,70,64,134
23,4,10,133,92,225
27,4,10,157,108,265
27,2,5,80,54,134
19,2,5,56,38,94
11,2,5,32,22,54
27,3,9,123,81,204
10,2,5,24,20,44
5,2,5,12,10,22
27,2,5,63,54,117
8,3,9,47,24,71
3,2,5,9,6,15
12,2,5,35,24,59
4,2,5,12,8,20
24,2,5,71,48,119
7,7,9,4,49,53
23,7,9,9,161,170
16,7,9,31,112,143
5,7,9,10,35,45
7,7,9,13,49,62
18,7,9,34,126,160
8,3,8,39,24,63
7,3,8,28,21,49
7,8,22,78,56,134
26,8,22,353,208,561
1,8,22,10,8,18
15,8,22,157,120,277
2,8,22,19,16,35
12,8,22,110,96,206
26,8,22,238,208,446
24,8,22,331,192,523
28,9,24,413,252,665
4,9,24,53,36,89
24,9,24,337,216,553
20,9,24,290,180,470
2,13,35,43,26,69
18,13,35,390,234,624
23,13,35,490,299,789
17,13,35,291,221,512
28,13,35,489,364,853
16,13,35,246,208,454
14,13,35,288,182,470
17,13,35,350,221,571
10,13,35,136,130,266
8,13,35,114,104,218
8,13,35,156,104,260
3,13,35,64,39,103
21,13,35,344,273,617
23,13,35,329,299,628
1,13,35,20,13,33
9,13,35,185,117,302
8,13,35,173,104,277
11,13,35,157,143,300
1,13,35,16,13,29
28,13,35,489,364,853
26,42,54,298,1092,1390
1,38,50,12,38,50
31,42,54,355,1302,1657
14,42,54,47,588,635
17,38,50,0,646,646
13,38,50,72,494,566
16,42,54,80,672,752
3,38,50,30,114,144
1,1266,2320,544,1266,1810
1,1898,3375,937,1898,2835
3,1266,2320,2257,3798,6055
1,1266,2320,1031,1266,2297
1,1252,2295,951,1252,2203
1,1266,2320,961,1266,2227
1,295,540,126,295,421
3,308,565,754,924,1678
3,1266,2320,3023,3798,6821
1,344,540,99,344,443
2,1555,2443,1678,3110,4788
2,2171,3578,2528,4342,6870
3,2171,3578,2826,6513,9339
2,1555,2443,603,3110,3713
1,1083,1701,397,1083,1480
1,713,1120,329,713,1042
1,2171,3578,727,2171,2898
1,344,540,158,344,502
1,344,540,174,344,518
3,344,540,523,1032,1555
7,9,25,110,63,173
10,1,2,6,10,16
11,1,2,8,11,19
4,1,2,3,4,7
6,1,2,4,6,10
20,1,2,15,20,35
20,2,5,59,40,99
12,2,5,35,24,59
6,2,5,18,12,30
3,1,2,2,3,5
32,1,4,87,32,119
31,13,35,660,403,1063
1,9,25,14,9,23
4,9,25,57,36,93
20,1,2,19,20,39
2,1,2,2,2,4
26,1,2,25,26,51
15,2,5,29,30,59
10,2,5,20,20,40
25,2,5,45,50,95
23,11,30,423,253,676
28,11,30,515,308,823
32,11,30,589,352,941
24,11,30,442,264,706
7,1,2,6,7,13
30,9,25,465,270,735
5,9,25,78,45,123
26,1,2,25,26,51
11,1,2,8,11,19
6,1,2,4,6,10
27,2,5,80,54,134
20,2,5,59,40,99
4,1,4,12,4,16
23,1,2,13,23,36
1,1,2,1,1,2
9,2,5,21,18,39
12,8,21,146,96,242
10,2,5,24,20,44
16,8,21,201,128,329
13,1,2,12,13,25
13,2,5,38,26,64
22,8,21,175,176,351
26,8,21,207,208,415
28,8,21,223,224,447
6,2,5,17,12,29
14,2,5,41,28,69
19,2,5,55,38,93
1,461,742,125,461,586
3,461,742,554,1383,1937
24,24,64,945,576,1521
1,45,120,50,45,95
3,4,10,13,12,25
14,4,10,59,56,115
14,4,10,59,56,115
13,4,10,55,52,107
17,3,9,82,51,133
3,3,9,14,9,23
5,4,10,19,20,39
1,4,10,4,4,8
15,2,5,35,30,65
12,2,5,28,24,52
3,2,5,7,6,13
7,2,5,21,14,35
27,2,5,80,54,134
18,2,5,38,36,74
2,2,5,4,4,8
10,2,5,24,20,44
3,2,5,9,6,15
8,2,5,24,16,40
2,2,5,6,4,10
30,2,5,69,60,129
9,2,5,21,18,39
26,2,5,55,52,107
4,2,5,8,8,16
14,3,9,56,42,98
22,2,5,64,44,108
21,2,5,61,42,103
29,7,9,48,203,251
8,7,9,11,56,67
20,7,9,38,140,178
27,7,9,49,189,238
30,8,22,407,240,647
30,8,22,394,240,634
6,8,22,81,48,129
6,8,22,55,48,103
12,8,22,120,96,216
17,8,22,167,136,303
2,8,22,28,16,44
8,8,22,100,64,164
7,8,22,64,56,120
26,8,22,238,208,446
8,9,24,116,72,188
25,9,24,363,225,588
8,13,35,114,104,218
24,13,35,419,312,731
22,13,35,469,286,755
12,13,35,256,156,412
7,13,35,110,91,201
3,13,35,47,39,86
19,13,35,391,247,638
16,13,35,330,208,538
4,13,35,70,52,122
29,13,35,476,377,853
15,13,35,309,195,504
4,13,35,78,52,130
27,13,35,575,351,926
19,13,35,411,247,658
11,13,35,192,143,335
26,21,55,827,546,1373
1,21,55,22,21,43
1,38,50,1,38,39
7,38,50,18,266,284
1,42,54,5,42,47
10,42,54,50,420,470
2,38,50,23,76,99
1,1252,2295,538,1252,1790
3,1252,2295,2165,3756,5921
1,1252,2295,561,1252,1813
3,1252,2295,2854,3756,6610
3,1266,2320,2675,3798,6473
1,295,540,148,295,443
2,295,540,252,590,842
2,295,540,468,590,1058
1,295,540,240,295,535
2,1519,2443,1506,3038,4544
1,2171,3578,942,2171,3113
1,2171,3578,835,2171,3006
3,487,783,465,1461,1926
1,713,1120,396,713,1109
1,2171,3578,763,2171,2934
1,487,783,265,487,752
1,1555,2443,570,1555,2125
1,344,540,126,344,470
11,26,70,376,286,662
31,3,9,183,93,276
21,3,9,84,63,147
25,1,2,25,25,50
29,1,2,28,29,57
21,1,2,20,21,41
27,1,2,26,27,53
8,1,2,6,8,14
12,1,2,9,12,21
12,2,5,35,24,59
22,2,5,64,44,108
14,2,5,27,28,55
1,2,5,3,2,5
26,2,5,77,52,129
11,1,4,23,11,34
6,1,4,13,6,19
3,9,25,43,27,70
29,9,25,413,261,674
17,2,5,48,34,82
17,2,5,48,34,82
27,2,5,78,54,132
26,2,5,75,52,127
4,9,25,60,36,96
5,1,2,4,5,9
1,1,2,1,1,2
18,1,4,42,18,60
22,11,30,372,242,614
10,11,30,169,110,279
5,9,25,75,45,120
3,9,25,45,27,72
12,9,25,150,108,258
20,8,21,172,160,332
23,8,21,198,184,382
25,2,5,48,50,98
14,2,5,27,28,55
10,2,5,21,20,41
21,2,5,44,42,86
5,1,2,5,5,10
28,1,2,24,28,52
9,1,2,8,9,17
24,1,2,21,24,45
3,1,4,7,3,10
24,1,4,59,24,83
3,1,4,7,3,10
1,1482,2384,592,1482,2074
1,1482,2384,878,1482,2360
1,1482,2384,807,1482,2289
3,755,1215,724,2265,2989
1,461,742,177,461,638
19,24,64,541,456,997
5,59,159,484,295,779
14,2,5,33,28,61
28,2,5,66,56,122
23,2,5,64,46,110
2,2,5,6,4,10
25,2,5,74,50,124
16,2,5,47,32,79
6,4,10,35,24,59
8,3,9,39,24,63
3,3,9,14,9,23
19,3,9,87,57,144
10,2,5,30,20,50
15,2,5,44,30,74
5,2,5,15,10,25
1,2,5,2,2,4
27,2,5,51,54,105
29,2,5,68,58,126
8,2,5,19,16,35
22,2,5,58,44,102
27,2,5,72,54,126
21,4,10,122,84,206
5,4,10,29,20,49
17,2,5,33,34,67
12,2,5,23,24,47
17,3,9,99,51,150
6,2,5,14,12,26
25,2,5,59,50,109
30,2,5,80,60,140
15,3,9,85,45,130
11,3,9,62,33,95
8,2,5,15,16,31
25,2,5,48,50,98
26,7,9,1,182,183
27,7,9,1,189,190
28,7,9,51,196,247
2,7,9,3,14,17
7,3,8,28,21,49
15,3,8,58,45,103
30,3,8,100,90,190
28,3,8,100,84,184
5,8,22,68,40,108
26,8,22,353,208,561
24,8,22,325,192,517
22,8,22,245,176,421
15,8,22,203,120,323
29,8,22,317,232,549
12,8,22,163,96,259
19,9,24,280,171,451
14,9,24,203,126,329
21,9,24,194,189,383
4,9,24,58,36,94
12,13,35,247,156,403
16,13,35,341,208,549
4,13,35,85,52,137
1,13,35,21,13,34
7,13,35,144,91,235
10,13,35,196,130,326
10,13,35,136,130,266
2,13,35,29,26,55
20,13,35,412,260,672
16,13,35,330,208,538
22,13,35,430,286,716
26,13,35,563,338,901
23,13,35,490,299,789
9,13,35,157,117,274
15,13,35,262,195,457
8,13,35,170,104,274
26,13,35,372,338,710
24,13,35,511,312,823
6,21,55,161,126,287
16,21,55,509,336,845
5,21,55,165,105,270
18,42,54,12,756,768
22,38,50,253,836,1089
27,38,50,149,1026,1175
17,38,50,187,646,833
17,38,50,170,646,816
19,42,54,-18,798,780
11,38,50,11,418,429
16,42,54,157,672,829
6,38,50,66,228,294
20,42,54,229,840,1069
26,42,54,3,1092,1095
1,1266,2320,752,1266,2018
1,1252,2295,745,1252,1997
1,1252,2295,997,1252,2249
1,420,769,334,420,754
1,1266,2320,1008,1266,2274
1,1266,2320,892,1266,2158
3,2171,3578,1860,6513,8373
1,2171,3578,1371,2171,3542
2,2171,3578,1526,4342,5868
2,1083,1701,488,2166,2654
1,2171,3578,656,2171,2827
1,713,1120,385,713,1098
1,1083,1701,550,1083,1633
3,2171,3578,4006,6513,10519
3,2171,3578,4114,6513,10627
1,344,540,185,344,529
1,1519,2443,606,1519,2125
19,26,70,557,494,1051
16,26,70,458,416,874
17,3,9,82,51,133
8,3,9,45,24,69
25,3,9,146,75,221
18,3,9,106,54,160
21,3,9,96,63,159
26,2,5,75,52,127
5,8,21,61,40,101
26,2,5,73,52,125
20,13,35,433,260,693
9,13,35,195,117,312
9,1,2,9,9,18
4,13,35,85,52,137
1,1,2,1,1,2
6,1,2,4,6,10
3,13,35,52,39,91
26,13,35,454,338,792
1,9,25,13,9,22
30,1,2,17,30,47
30,1,2,29,30,59
4,2,5,12,8,20
24,2,5,47,48,95
18,2,5,35,36,71
15,2,5,29,30,59
18,2,5,34,36,70
15,2,5,29,30,59
13,11,30,153,143,296
3,11,30,35,33,68
28,2,5,74,56,130
30,2,5,63,60,123
29,2,5,61,58,119
28,2,5,59,56,115
14,1,2,13,14,27
1,1,2,1,1,2
8,2,5,15,16,31
20,2,5,38,40,78
3,1,2,3,3,6
14,1,2,14,14,28
5,1,4,14,5,19
10,2,5,29,20,49
11,2,5,32,22,54
27,1,2,20,27,47
3,1,2,2,3,5
23,1,2,17,23,40
7,11,30,129,77,206
20,2,5,47,40,87
18,2,5,42,36,78
11,1,2,11,11,22
3,9,25,38,27,65
1,9,25,13,9,22
17,11,30,313,187,500
28,1,2,16,28,44
15,9,25,158,135,293
28,9,25,294,252,546
7,2,5,20,14,34
25,2,5,73,50,123
5,1,2,5,5,10
1,1,2,1,1,2
25,1,2,24,25,49
1,1482,2384,807,1482,2289
1,1482,2384,807,1482,2289
1,1482,2384,735,1482,2217
1,461,742,266,461,727
3,461,742,442,1383,1825
1,24,64,39,24,63
12,24,64,472,288,760
6,24,64,190,144,334
7,24,64,249,168,417
10,2,5,27,20,47
30,2,5,89,60,149
20,4,10,116,80,196
24,4,10,139,96,235
31,3,9,175,93,268
7,2,5,13,14,27
20,2,5,42,40,82
17,3,9,99,51,150
10,3,9,58,30,88
12,4,10,70,48,118
6,4,10,35,24,59
4,2,5,8,8,16
14,2,5,41,28,69
18,2,5,52,36,88
2,2,5,6,4,10
17,2,5,40,34,74
15,2,5,35,30,65
6,3,9,27,18,45
17,2,5,49,34,83
4,2,5,12,8,20
13,7,9,21,91,112
17,7,9,32,119,151
1,3,8,4,3,7
23,8,22,256,184,440
27,8,22,366,216,582
20,8,22,262,160,422
15,8,22,197,120,317
9,8,22,124,72,196
3,8,22,41,24,65
9,8,22,124,72,196
22,9,24,319,198,517
21,9,24,295,189,484
21,9,24,219,189,408
13,9,24,192,117,309
2,13,35,43,26,69
14,13,35,274,182,456
3,13,35,62,39,101
13,13,35,268,169,437
3,13,35,52,39,91
32,13,35,693,416,1109
9,13,35,195,117,312
20,13,35,433,260,693
10,13,35,157,130,287
16,13,35,341,208,549
3,13,35,64,39,103
25,13,35,384,325,709
13,13,35,190,169,359
19,21,55,416,399,815
9,21,55,271,189,460
23,38,50,69,874,943
30,38,50,135,1140,1275
10,38,50,115,380,495
5,38,50,58,190,248
31,42,54,355,1302,1657
8,38,50,88,304,392
2,42,54,22,84,106
22,38,50,121,836,957
23,38,50,69,874,943
1,1252,2295,1020,1252,2272
2,420,769,467,840,1307
2,1252,2295,1489,2504,3993
1,420,769,334,420,754
1,1266,2320,544,1266,1810
1,420,769,341,420,761
1,1266,2320,1008,1266,2274
1,308,565,121,308,429
3,1266,2320,2884,3798,6682
3,1266,2320,2884,3798,6682
1,295,540,169,295,464
1,487,783,265,487,752
1,2171,3578,763,2171,2934
1,344,540,185,344,529
1,713,1120,205,713,918
1,344,540,185,344,529
3,1519,2443,1379,4557,5936
1,344,540,126,344,470
1,1555,2443,864,1555,2419
2,344,540,219,688,907
1,1555,2443,448,1555,2003
2,2171,3578,2671,4342,7013
18,26,70,779,468,1247
23,26,70,948,598,1546
22,3,9,128,66,194
21,3,9,98,63,161
4,13,35,68,52,120
12,13,35,205,156,361
23,8,21,265,184,449
15,8,21,173,120,293
14,13,35,303,182,485
13,1,2,10,13,23
1,1,2,1,1,2
17,2,5,50,34,84
24,2,5,71,48,119
21,1,2,12,21,33
28,1,2,16,28,44
19,1,2,18,19,37
3,12,33,62,36,98
11,12,33,227,132,359
19,9,25,190,171,361
23,9,25,230,207,437
29,1,2,21,29,50
14,1,2,10,14,24
3,1,2,2,3,5
22,2,5,64,44,108
21,2,5,61,42,103
28,1,2,27,28,55
5,1,4,14,5,19
10,2,5,28,20,48
19,2,5,53,38,91
27,2,5,76,54,130
15,1,4,44,15,59
6,1,4,18,6,24
14,2,5,41,28,69
11,1,2,11,11,22
26,8,21,267,208,475
19,2,5,53,38,91
1,2,5,3,2,5
21,1,2,18,21,39
28,1,2,24,28,52
10,2,5,19,20,39
28,1,2,27,28,55
10,1,2,10,10,20
3,1,4,7,3,10
19,8,21,239,152,391
21,8,21,264,168,432
13,8,21,164,104,268
5,2,5,11,10,21
20,2,5,42,40,82
1,1482,2384,473,1482,1955
2,755,1215,750,1510,2260
9,59,159,871,531,1402
1,59,159,78,59,137
9,59,159,714,531,1245
20,2,5,42,40,82
9,2,5,24,18,42
24,2,5,64,48,112
3,2,5,8,6,14
9,2,5,25,18,43
4,4,10,21,16,37
8,4,10,42,32,74
20,4,10,116,80,196
1,4,10,6,4,10
18,2,5,38,36,74
2,4,10,11,8,19
13,4,10,73,52,125
14,4,10,64,56,120
19,4,10,87,76,163
26,2,5,49,52,101
5,2,5,10,10,20
14,2,5,27,28,55
4,2,5,9,8,17
16,7,9,5,112,117
29,7,9,48,203,251
20,7,9,38,140,178
21,7,9,34,147,181
19,7,9,31,133,164
29,7,9,24,203,227
4,7,9,0,28,28
15,7,9,2,105,107
21,3,8,102,63,165
22,3,8,85,66,151
7,3,8,23,21,44
13,3,8,63,39,102
24,3,8,78,72,150
16,8,22,199,128,327
1,8,22,9,8,17
11,8,22,149,88,237
19,8,22,174,152,326
9,8,22,124,72,196
10,9,24,112,90,202
3,9,24,29,27,56
18,9,24,201,162,363
3,13,35,47,39,86
7,13,35,149,91,240
21,13,35,308,273,581
29,13,35,567,377,944
22,13,35,430,286,716
3,13,35,64,39,103
24,13,35,394,312,706
11,13,35,173,143,316
20,13,35,412,260,672
5,13,35,86,65,151
7,13,35,100,91,191
5,13,35,87,65,152
3,21,55,90,63,153
2,21,55,54,42,96
4,21,55,107,84,191
24,38,50,72,912,984
1,42,54,3,42,45
15,38,50,128,570,698
23,38,50,230,874,1104
28,42,54,276,1176,1452
2,1252,2295,2040,2504,4544
1,1252,2295,538,1252,1790
3,1252,2295,2165,3756,5921
1,1266,2320,892,1266,2158
1,308,565,155,308,463
1,1252,2295,997,1252,2249
1,1252,2295,882,1252,2134
2,1252,2295,1076,2504,3580
2,420,769,498,840,1338
1,1083,1701,346,1083,1429
2,1083,1701,760,2166,2926
1,344,540,126,344,470
1,26,70,29,26,55
21,3,9,122,63,185
30,1,2,17,30,47
16,1,2,9,16,25
10,1,2,6,10,16
22,13,35,322,286,608
9,1,2,6,9,15
1,1,2,1,1,2
13,2,5,36,26,62
17,2,5,49,34,83
7,9,25,75,63,138
5,1,2,5,5,10
27,1,2,26,27,53
16,9,25,228,144,372
2,9,25,29,18,47
29,2,5,57,58,115
5,2,5,10,10,20
19,1,4,47,19,66
30,12,33,501,360,861
26,1,2,25,26,51
18,9,25,284,162,446
6,9,25,95,54,149
2,1,2,1,2,3
8,1,2,6,8,14
1,1,4,2,1,3
8,1,4,20,8,28
19,1,4,56,19,75
32,1,4,95,32,127
16,2,5,47,32,79
3,2,5,9,6,15
22,2,5,65,44,109
16,11,30,242,176,418
16,11,30,242,176,418
1,1,2,1,1,2
5,1,2,3,5,8
11,1,2,6,11,17
13,2,5,25,26,51
22,2,5,42,44,86
24,12,33,488,288,776
16,12,33,325,192,517
9,1,2,9,9,18
20,1,2,15,20,35
7,1,2,5,7,12
20,1,4,43,20,63
9,1,4,19,9,28
14,8,21,144,112,256
9,8,21,92,72,164
17,8,21,175,136,311
4,8,21,49,32,81
1,11,29,16,11,27
27,1,2,19,27,46
30,1,2,22,30,52
3,1482,2384,2205,4446,6651
2,461,742,236,922,1158
1,755,1215,436,755,1191
1,755,1215,436,755,1191
2,1482,2384,1184,2964,4148
2,461,742,236,922,1158
3,461,742,687,1383,2070
2,1482,2384,1709,2964,4673
4,24,64,157,96,253
12,45,120,713,540,1253
8,2,5,17,16,33
8,2,5,17,16,33
15,2,5,44,30,74
13,2,5,38,26,64
9,2,5,26,18,44
20,2,5,39,40,79
3,2,5,7,6,13
1,2,5,2,2,4
26,2,5,51,52,103
20,2,5,58,40,98
29,2,5,84,58,142
26,2,5,75,52,127
14,2,5,27,28,55
11,2,5,21,22,43
9,2,5,21,18,39
27,2,5,53,54,107
32,2,5,94,64,158
4,2,5,11,8,19
14,3,9,58,42,100
6,3,9,32,18,50
18,3,9,97,54,151
31,3,9,166,93,259
22,3,9,118,66,184
22,4,10,92,88,180
1,4,10,4,4,8
13,7,9,25,91,116
11,7,9,8,77,85
6,7,9,10,42,52
1,7,9,0,7,7
19,7,9,2,133,135
7,7,9,13,49,62
18,7,9,15,126,141
27,7,9,10,189,199
6,3,8,30,18,48
6,3,8,30,18,48
13,3,8,43,39,82
20,3,8,66,60,126
1,8,22,14,8,22
24,8,22,220,192,412
25,8,22,339,200,539
4,8,22,38,32,70
15,8,22,203,120,323
17,9,24,251,153,404
20,9,24,194,180,374
1,9,24,15,9,24
30,9,24,436,270,706
10,9,24,107,90,197
15,9,24,200,135,335
5,13,35,73,65,138
25,13,35,393,325,718
30,13,35,650,390,1040
9,13,35,151,117,268
23,13,35,337,299,636
8,13,35,170,104,274
9,13,35,154,117,271
5,13,35,103,65,168
16,13,35,251,208,459
25,13,35,410,325,735
21,13,35,411,273,684
4,13,35,63,52,115
27,21,55,888,567,1455
17,21,55,428,357,785
9,38,50,104,342,446
25,38,50,213,950,1163
1,42,54,0,42,42
19,42,54,84,798,882
8,38,50,68,304,372
11,42,54,1,462,463
1,42,54,5,42,47
1,1898,3375,768,1898,2666
2,1266,2320,1783,2532,4315
2,308,565,367,616,983
1,420,769,249,420,669
1,308,565,246,308,554
1,1898,3375,1410,1898,3308
2,2171,3578,1311,4342,5653
2,2171,3578,1884,4342,6226
1,1519,2443,606,1519,2125
2,1555,2443,1141,3110,4251
1,344,540,99,344,443
3,1083,1701,1497,3249,4746
1,1519,2443,533,1519,2052
1,2171,3578,1335,2171,3506
1,487,783,132,487,619
22,26,70,953,572,1525
13,3,9,76,39,115
15,3,9,87,45,132
2,3,9,12,6,18
7,2,5,13,14,27
28,2,5,53,56,109
19,13,35,411,247,658
19,13,35,411,247,658
20,13,35,433,260,693
11,1,2,10,11,21
1,1,2,1,1,2
26,1,2,19,26,45
9,1,2,7,9,16
20,1,2,15,20,35
23,1,2,17,23,40
1,11,30,19,11,30
1,11,30,19,11,30
10,1,4,30,10,40
4,1,2,3,4,7
14,1,2,10,14,24
13,9,25,140,117,257
20,9,25,215,180,395
24,9,25,258,216,474
20,13,35,426,260,686
11,13,35,234,143,377
18,12,33,372,216,588
7,1,2,7,7,14
25,1,2,24,25,49
13,1,2,12,13,25
1,1,2,1,1,2
2,1,2,1,2,3
7,1,2,7,7,14
10,9,25,123,90,213
24,9,25,294,216,510
1,1,4,3,1,4
20,11,30,254,220,474
2,11,30,25,22,47
24,11,30,305,264,569
16,1,4,36,16,52
22,1,4,50,22,72
3,1,4,9,3,12
2,2,5,5,4,9
5,2,5,12,10,22
14,1,4,35,14,49
17,1,2,15,17,32
7,1,2,6,7,13
18,2,5,52,36,88
21,2,5,61,42,103
1,461,742,185,461,646
1,1482,2384,854,1482,2336
1,461,742,147,461,608
1,755,1215,375,755,1130
1,461,742,147,461,608
1,461,742,229,461,690
5,45,120,369,225,594
1,45,120,67,45,112
4,45,120,290,180,470
1,3,9,4,3,7
26,4,10,120,104,224
26,4,10,120,104,224
16,2,5,45,32,77
18,4,10,76,72,148
19,2,5,55,38,93
15,2,5,44,30,74
22,2,5,64,44,108
18,2,5,52,36,88
13,4,10,72,52,124
19,4,10,105,76,181
26,2,5,75,52,127
18,2,5,44,36,80
2,2,5,5,4,9
28,2,5,53,56,109
10,2,5,19,20,39
9,4,10,34,36,70
19,4,10,72,76,148
12,2,5,35,24,59
5,2,5,15,10,25
13,2,5,38,26,64
7,2,5,21,14,35
1,2,5,2,2,4
11,2,5,23,22,45
6,7,9,10,42,52
27,7,9,37,189,226
25,7,9,46,175,221
18,7,9,10,126,136
2,7,9,3,14,17
24,7,9,39,168,207
21,7,9,8,147,155
21,7,9,38,147,185
13,7,9,25,91,116
15,3,8,74,45,119
14,3,8,68,42,110
16,3,8,79,48,127
29,3,8,103,87,190
20,8,22,218,160,378
2,8,22,20,16,36
22,8,22,240,176,416
1,8,22,12,8,20
2,8,22,27,16,43
29,8,22,400,232,632
23,9,24,246,207,453
14,9,24,207,126,333
17,13,35,368,221,589
20,13,35,349,260,609
9,13,35,157,117,274
14,13,35,274,182,456
6,13,35,117,78,195
12,13,35,256,156,412
18,13,35,308,234,542
17,13,35,297,221,518
9,13,35,141,117,258
15,13,35,320,195,515
21,13,35,433,273,706
31,13,35,530,403,933
28,13,35,606,364,970
17,13,35,243,221,464
14,13,35,298,182,480
22,13,35,453,286,739
16,13,35,262,208,470
10,13,35,157,130,287
19,21,55,500,399,899
4,21,55,132,84,216
21,21,55,702,441,1143
20,21,55,658,420,1078
19,38,50,219,722,941
8,42,54,48,336,384
14,42,54,2,588,590
13,38,50,130,494,624
25,38,50,250,950,1200
15,38,50,173,570,743
24,38,50,72,912,984
24,42,54,236,1008,1244
1,1266,2320,544,1266,1810
2,1252,2295,1765,2504,4269
1,1266,2320,636,1266,1902
2,1252,2295,1352,2504,3856
1,1266,2320,1008,1266,2274
1,1266,2320,799,1266,2065
1,1252,2295,791,1252,2043
1,1912,3400,740,1912,2652
1,1266,2320,1008,1266,2274
2,1252,2295,1443,2504,3947
1,1252,2295,538,1252,1790
2,344,540,198,688,886
1,2171,3578,620,2171,2791
3,1555,2443,2371,4665,7036
1,1555,2443,448,1555,2003
1,713,1120,172,713,885
2,344,540,349,688,1037
1,2171,3578,906,2171,3077
1,2171,3578,1335,2171,3506
10,26,70,433,260,693
25,3,9,103,75,178
24,1,2,13,24,37
21,1,2,12,21,33
22,2,5,64,44,108
13,2,5,38,26,64
3,1,2,2,3,5
10,1,2,7,10,17
15,1,2,11,15,26
28,8,21,241,224,465
5,8,21,43,40,83
8,2,5,24,16,40
11,2,5,32,22,54
26,2,5,77,52,129
21,9,25,263,189,452
8,9,25,100,72,172
13,9,25,163,117,280
11,2,5,26,22,48
7,2,5,16,14,30
20,13,35,433,260,693
15,13,35,325,195,520
6,13,35,130,78,208
3,1,2,3,3,6
22,1,2,20,22,42
1,11,29,13,11,24
3,1,2,3,3,6
11,1,2,11,11,22
28,1,4,69,28,97
11,1,4,27,11,38
10,1,2,7,10,17
4,1,2,3,4,7
28,2,5,83,56,139
19,2,5,42,38,80
13,9,25,185,117,302
13,9,25,185,117,302
8,2,5,15,16,31
5,2,5,10,10,20
24,1,4,55,24,79
28,1,4,64,28,92
26,2,5,51,52,103
3,2,5,6,6,12
2,1,2,2,2,4
29,9,25,370,261,631
19,2,5,53,38,91
7,2,5,20,14,34
10,1,2,6,10,16
31,1,2,29,31,60
26,1,2,24,26,50
22,1,4,55,22,77
26,1,4,64,26,90
15,1,2,10,15,25
28,2,5,53,56,109
25,2,5,48,50,98
24,1,4,70,24,94
2,1,4,4,2,6
20,1,4,42,20,62
29,1,4,61,29,90
6,1,4,13,6,19
13,11,29,185,143,328
2,1482,2384,1613,2964,4577
3,1482,2384,2420,4446,6866
1,755,1215,241,755,996
1,755,1215,436,755,1191
1,1482,2384,378,1482,1860
1,461,742,229,461,690
1,461,742,147,461,608
1,24,64,37,24,61
28,2,5,83,56,139
29,2,5,86,58,144
16,3,9,77,48,125
20,3,9,97,60,157
26,4,10,153,104,257
10,4,10,59,40,99
27,2,5,57,54,111
29,2,5,61,58,119
30,2,5,57,60,117
12,2,5,23,24,47
30,2,5,84,60,144
24,2,5,70,48,118
20,2,5,58,40,98
6,2,5,11,12,23
12,3,9,55,36,91
12,3,9,55,36,91
19,2,5,56,38,94
14,2,5,41,28,69
21,2,5,61,42,103
22,2,5,64,44,108
16,2,5,38,32,70
24,2,5,56,48,104
5,2,5,11,10,21
5,2,5,11,10,21
15,3,9,71,45,116
10,2,5,25,20,45
12,2,5,29,24,53
10,2,5,29,20,49
10,2,5,29,20,49
18,7,9,15,126,141
10,7,9,16,70,86
6,7,9,3,42,45
14,7,9,2,98,100
28,7,9,23,196,219
13,7,9,7,91,98
20,7,9,38,140,178
31,7,9,42,217,259
2,7,9,4,14,18
25,3,8,97,75,172
17,3,8,63,51,114
5,3,8,16,15,31
19,3,8,92,57,149
17,8,22,156,136,292
22,8,22,245,176,421
3,8,22,41,24,65
12,8,22,126,96,222
16,8,22,220,128,348
7,9,24,103,63,166
18,9,24,266,162,428
22,13,35,361,286,647
1,13,35,18,13,31
22,13,35,345,286,631
17,13,35,297,221,518
30,13,35,524,390,914
24,13,35,436,312,748
11,13,35,173,143,316
15,13,35,293,195,488
14,13,35,274,182,456
5,21,55,159,105,264
25,21,55,520,525,1045
27,21,55,591,567,1158
22,21,55,554,462,1016
26,21,55,870,546,1416
15,21,55,494,315,809
6,42,54,69,252,321
24,38,50,24,912,936
9,38,50,104,342,446
11,42,54,37,462,499
1,38,50,5,38,43
14,42,54,160,588,748
22,42,54,110,924,1034
27,42,54,18,1134,1152
6,42,54,59,252,311
16,42,54,80,672,752
1,1266,2320,752,1266,2018
1,420,769,249,420,669
2,420,769,421,840,1261
1,1266,2320,961,1266,2227
1,1266,2320,544,1266,1810
1,1252,2295,951,1252,2203
3,1252,2295,1477,3756,5233
1,1252,2295,951,1252,2203
1,1519,2443,631,1519,2150
1,1519,2443,484,1519,2003
1,344,540,174,344,518
1,344,540,185,344,529
1,1555,2443,570,1555,2125
3,2171,3578,4006,6513,10519
1,344,540,174,344,518
1,344,540,158,344,502
3,2171,3578,4006,6513,10519
21,26,70,659,546,1205
17,26,70,736,442,1178
10,26,70,342,260,602
18,26,70,779,468,1247
21,3,9,92,63,155
4,3,9,23,12,35
19,1,2,11,19,30
19,1,2,11,19,30
23,1,2,13,23,36
25,2,5,74,50,124
24,2,5,71,48,119
2,2,5,6,4,10
9,1,2,5,9,14
27,11,30,505,297,802
2,11,30,37,22,59
23,2,5,41,46,87
20,2,5,36,40,76
11,1,2,9,11,20
3,1,2,3,3,6
7,12,33,110,84,194
6,12,33,94,72,166
24,1,2,21,24,45
26,1,2,22,26,48
14,1,2,9,14,23
11,1,2,7,11,18
23,1,2,15,23,38
7,1,4,20,7,27
22,1,2,14,22,36
16,1,2,10,16,26
22,1,2,20,22,42
29,1,2,17,29,46
26,1,4,76,26,102
7,11,30,129,77,206
15,12,33,305,180,485
14,12,33,285,168,453
24,12,33,488,288,776
13,1,2,7,13,20
20,2,5,56,40,96
17,1,4,50,17,67
10,1,4,29,10,39
12,2,5,28,24,52
25,8,21,304,200,504
1,8,21,12,8,20
1,1482,2384,592,1482,2074
1,1482,2384,521,1482,2003
3,1482,2384,2634,4446,7080
2,1482,2384,946,2964,3910
2,1482,2384,1280,2964,4244
15,3,9,85,45,130
3,3,9,17,9,26
17,4,10,75,68,143
24,4,10,106,96,202
1,3,9,6,3,9
21,3,9,118,63,181
32,4,10,189,128,317
18,4,10,68,72,140
11,4,10,42,44,86
12,3,9,58,36,94
7,3,9,34,21,55
17,2,5,49,34,83
13,2,5,38,26,64
19,2,5,55,38,93
17,2,5,49,34,83
2,4,10,8,8,16
8,2,5,18,16,34
22,2,5,48,44,92
29,2,5,55,58,113
5,2,5,15,10,25
6,2,5,17,12,29
10,2,5,29,20,49
8,2,5,23,16,39
24,2,5,70,48,118
27,2,5,76,54,130
11,2,5,31,22,53
5,2,5,12,10,22
18,2,5,35,36,71
29,2,5,57,58,115
7,2,5,21,14,35
22,2,5,65,44,109
27,3,9,130,81,211
26,3,9,126,78,204
24,7,9,46,168,214
1,7,9,2,7,9
17,7,9,31,119,150
22,7,9,40,154,194
13,7,9,11,91,102
1,7,9,1,7,8
13,7,9,4,91,95
1,7,9,0,7,7
22,7,9,0,154,154
1,7,9,1,7,8
31,7,9,3,217,220
9,3,8,44,27,71
13,3,8,58,39,97
26,3,8,115,78,193
24,8,22,225,192,417
20,8,22,210,160,370
21,8,22,289,168,457
2,8,22,22,16,38
1,8,22,10,8,18
5,9,24,56,45,101
26,9,24,384,234,618
23,9,24,334,207,541
21,13,35,433,273,706
28,13,35,577,364,941
12,13,35,256,156,412
24,13,35,394,312,706
10,13,35,164,130,294
17,13,35,261,221,482
10,13,35,206,130,336
16,13,35,330,208,538
25,13,35,515,325,840
28,13,35,547,364,911
9,13,35,157,117,274
7,13,35,110,91,201
15,13,35,325,195,520
27,13,35,443,351,794
31,13,35,541,403,944
18,13,35,302,234,536
20,13,35,426,260,686
18,13,35,320,234,554
21,13,35,366,273,639
18,13,35,314,234,548
4,13,35,63,52,115
23,13,35,490,299,789
12,13,35,209,156,365
26,21,55,712,546,1258
7,38,50,81,266,347
19,38,50,48,722,770
7,42,54,76,294,370
5,42,54,25,210,235
10,38,50,55,380,435
17,42,54,195,714,909
21,42,54,105,882,987
8,42,54,40,336,376
15,42,54,148,630,778
1,42,54,11,42,53
1,1912,3400,1352,1912,3264
1,1898,3375,937,1898,2835
3,1912,3400,3138,5736,8874
3,1266,2320,2257,3798,6055
1,420,769,334,420,754
2,420,769,667,840,1507
1,1252,2295,745,1252,1997
1,1266,2320,892,1266,2158
1,420,769,249,420,669
2,1266,2320,1273,2532,3805
1,1252,2295,997,1252,2249
1,308,565,246,308,554
1,487,783,124,487,611
1,2171,3578,942,2171,3113
3,2171,3578,2826,6513,9339
3,344,540,556,1032,1588
1,344,540,126,344,470
1,713,1120,205,713,918
1,344,540,174,344,518
1,344,540,83,344,427
3,344,540,248,1032,1280
7,26,70,200,182,382
29,26,70,1235,754,1989
23,26,70,996,598,1594
14,3,9,81,42,123
28,3,9,135,84,219
26,13,35,563,338,901
26,13,35,563,338,901
14,1,2,10,14,24
20,1,2,14,20,34
8,2,5,23,16,39
32,2,5,62,64,126
25,1,2,19,25,44
4,1,2,3,4,7
5,13,35,98,65,163
15,13,35,293,195,488
23,13,35,401,299,700
20,13,35,349,260,609
6,1,4,13,6,19
1,2,5,3,2,5
5,2,5,15,10,25
6,1,2,6,6,12
15,1,2,14,15,29
2,2,5,6,4,10
16,2,5,47,32,79
10,1,4,23,10,33
27,2,5,63,54,117
2,1,2,2,2,4
10,2,5,30,20,50
2,2,5,6,4,10
29,1,2,20,29,49
7,1,2,5,7,12
1,9,25,16,9,25
6,9,25,93,54,147
6,1,2,4,6,10
19,11,29,331,209,540
8,11,29,139,88,227
8,1,4,23,8,31
7,1,4,18,7,25
26,1,4,66,26,92
13,2,5,31,26,57
1,1,2,1,1,2
2,1,4,6,2,8
17,1,4,48,17,65
4,1,4,11,4,15
19,1,4,55,19,74
4,2,5,9,8,17
13,2,5,31,26,57
5,8,21,63,40,103
21,8,21,264,168,432
13,1,2,11,13,24
1,1,2,1,1,2
20,8,21,184,160,344
6,8,21,55,48,103
1,461,742,251,461,712
1,461,742,251,461,712
3,1482,2384,2420,4446,6866
1,1482,2384,592,1482,2074
1,755,1215,436,755,1191
22,24,64,852,528,1380
3,45,120,146,135,281
8,45,120,466,360,826
3,59,159,238,177,415
30,4,10,141,120,261
14,4,10,66,56,122
23,2,5,64,46,110
7,2,5,20,14,34
18,2,5,50,36,86
3,2,5,8,6,14
18,2,5,52,36,88
25,2,5,73,50,123
5,2,5,15,10,25
3,2,5,9,6,15
14,2,5,41,28,69
7,2,5,20,14,34
5,2,5,15,10,25
20,2,5,58,40,98
15,2,5,44,30,74
26,2,5,73,52,125
27,2,5,78,54,132
11,3,9,48,33,81
12,3,9,53,36,89
1,7,9,2,7,9
4,7,9,2,28,30
2,7,9,4,14,18
8,7,9,15,56,71
29,9,24,421,261,682
1,9,24,15,9,24
9,9,24,107,81,188
1,9,24,15,9,24
9,13,35,195,117,312
11,13,35,192,143,335
6,13,35,88,78,166
23,13,35,498,299,797
18,13,35,371,234,605
14,13,35,200,182,382
29,13,35,628,377,1005
2,13,35,31,26,57
19,13,35,391,247,638
19,13,35,411,247,658
28,13,35,459,364,823
1,13,35,21,13,34
31,13,35,660,403,1063
26,13,35,372,338,710
26,13,35,408,338,746
21,38,50,242,798,1040
2,42,54,23,84,107
12,38,50,138,456,594
20,38,50,50,760,810
1,42,54,5,42,47
1,38,50,11,38,49
1,1898,3375,937,1898,2835
1,1266,2320,961,1266,2227
1,1252,2295,997,1252,2249
1,1555,2443,790,1555,2345
1,713,1120,385,713,1098
2,713,1120,769,1426,2195
2,1555,2443,1581,3110,4691
1,487,783,155,487,642
3,713,1120,751,2139,2890
3,713,1120,515,2139,2654
3,344,540,296,1032,1328
18,26,70,742,468,1210
1,26,70,29,26,55
17,3,9,68,51,119
6,1,2,6,6,12
4,1,2,4,4,8
9,1,2,5,9,14
1,1,2,1,1,2
12,8,21,103,96,199
27,2,5,78,54,132
15,1,2,15,15,30
5,11,30,94,55,149
27,11,30,505,297,802
5,2,5,15,10,25
27,1,2,18,27,45
11,2,5,32,22,54
20,1,2,14,20,34
8,1,2,6,8,14
11,1,2,8,11,19
16,2,5,38,32,70
6,2,5,14,12,26
5,9,25,75,45,120
31,9,25,465,279,744
25,2,5,59,50,109
19,12,33,317,228,545
23,9,25,362,207,569
1,9,25,16,9,25
1,1,4,2,1,3
18,1,4,41,18,59
25,1,4,57,25,82
6,2,5,14,12,26
23,2,5,54,46,100
20,1,2,20,20,40
11,1,2,11,11,22
30,1,2,20,30,50
9,1,2,6,9,15
5,2,5,10,10,20
14,2,5,27,28,55
10,2,5,19,20,39
27,2,5,57,54,111
10,2,5,21,20,41
25,1,2,14,25,39
15,8,21,138,120,258
10,8,21,92,80,172
12,1,2,10,12,22
14,8,21,144,112,256
8,8,21,82,64,146
14,8,21,144,112,256
1,1482,2384,592,1482,2074
3,461,742,554,1383,1937
1,461,742,185,461,646
1,1482,2384,807,1482,2289
1,1482,2384,473,1482,1955
3,755,1215,1307,2265,3572
1,1482,2384,378,1482,1860
1,461,742,162,461,623
16,24,64,599,384,983
21,3,9,118,63,181
4,3,9,23,12,35
13,2,5,25,26,51
17,4,10,95,68,163
1,2,5,3,2,5
6,2,5,18,12,30
25,4,10,148,100,248
1,2,5,2,2,4
7,2,5,14,14,28
9,2,5,26,18,44
20,2,5,58,40,98
17,2,5,32,34,66
5,2,5,10,10,20
8,2,5,23,16,39
17,2,5,49,34,83
7,2,5,13,14,27
11,2,5,32,22,54
28,2,5,83,56,139
22,2,5,58,44,102
21,2,5,56,42,98
25,3,9,148,75,223
18,3,9,106,54,160
10,2,5,24,20,44
26,2,5,61,52,113
10,7,9,1,70,71
21,7,9,19,147,166
21,7,9,34,147,181
24,7,9,39,168,207
17,7,9,31,119,150
25,7,9,48,175,223
12,7,9,10,84,94
28,7,9,51,196,247
15,7,9,27,105,132
9,7,9,0,63,63
20,3,8,97,60,157
18,3,8,58,54,112
1,3,8,5,3,8
25,8,22,345,200,545
16,8,22,217,128,345
17,8,22,231,136,367
20,8,22,227,160,387
15,8,22,207,120,327
31,8,22,284,248,532
12,8,22,165,96,261
28,8,22,386,224,610
15,8,22,207,120,327
27,8,22,372,216,588
24,9,24,354,216,570
9,9,24,133,81,214
24,9,24,354,216,570
2,9,24,30,18,48
9,9,24,131,81,212
19,9,24,276,171,447
20,9,24,290,180,470
9,13,35,195,117,312
15,13,35,215,195,410
24,13,35,377,312,689
11,13,35,227,143,370
25,13,35,419,325,744
5,13,35,68,65,133
20,13,35,426,260,686
2,13,35,43,26,69
15,13,35,320,195,515
12,13,35,256,156,412
12,13,35,172,156,328
14,13,35,298,182,480
1,13,35,21,13,34
28,13,35,596,364,960
11,13,35,234,143,377
6,13,35,107,78,185
13,13,35,277,169,446
8,13,35,170,104,274
23,42,54,264,966,1230
27,42,54,3,1134,1137
8,42,54,92,336,428
12,38,50,132,456,588
20,42,54,100,840,940
5,38,50,58,190,248
19,42,54,187,798,985
28,38,50,28,1064,1092
11,42,54,120,462,582
28,42,54,306,1176,1482
23,42,54,189,966,1155
7,42,54,76,294,370
2,1252,2295,1260,2504,3764
2,308,565,345,616,961
1,1252,2295,997,1252,2249
2,1252,2295,1260,2504,3764
1,1266,2320,1008,1266,2274
1,1266,2320,752,1266,2018
1,1266,2320,1031,1266,2297
2,420,769,498,840,1338
1,308,565,189,308,497
3,344,540,556,1032,1588
1,487,783,124,487,611
1,344,540,185,344,529
2,2171,3578,1884,4342,6226
1,1083,1701,244,1083,1327
3,713,1120,1019,2139,3158
2,487,783,529,974,1503
1,344,540,185,344,529
1,344,540,185,344,529
1,344,540,158,344,502
1,344,540,185,344,529
3,344,540,199,1032,1231
1,1555,2443,864,1555,2419
1,2171,3578,1335,2171,3506
2,3,9,12,6,18
17,2,5,49,34,83
24,13,35,511,312,823
10,13,35,213,130,343
4,2,5,12,8,20
4,2,5,12,8,20
18,2,5,42,36,78
17,2,5,50,34,84
13,2,5,38,26,64
17,2,5,48,34,82
29,1,2,25,29,54
1,1,2,1,1,2
20,1,2,14,20,34
21,13,35,330,273,603
30,13,35,471,390,861
20,13,35,314,260,574
25,1,2,24,25,49
30,1,2,29,30,59
21,1,2,20,21,41
14,1,2,13,14,27
17,1,2,16,17,33
18,1,2,17,18,35
20,1,2,11,20,31
19,9,25,285,171,456
21,9,25,315,189,504
16,1,2,14,16,30
25,1,2,22,25,47
10,1,2,9,10,19
13,12,33,204,156,360
17,12,33,239,204,443
10,12,33,141,120,261
25,1,2,19,25,44
19,2,5,55,38,93
4,1,4,12,4,16
13,1,4,38,13,51
17,1,4,50,17,67
22,2,5,64,44,108
18,1,2,18,18,36
1,11,30,15,11,26
25,11,30,378,275,653
30,11,30,453,330,783
26,1,2,25,26,51
15,1,2,14,15,29
22,1,2,21,22,43
12,8,21,103,96,199
7,8,21,60,56,116
15,8,21,129,120,249
14,1,2,14,14,28
3,11,29,38,33,71
24,11,29,307,264,571
21,1,4,61,21,82
15,2,5,44,30,74
6,2,5,17,12,29
10,1,2,10,10,20
6,1,4,18,6,24
5,1,4,15,5,20
2,1482,2384,1613,2964,4577
3,1482,2384,2420,4446,6866
3,461,742,376,1383,1759
1,24,64,39,24,63
6,24,64,232,144,376
10,2,5,28,20,48
2,2,5,5,4,9
27,2,5,72,54,126
9,2,5,17,18,35
27,2,5,78,54,132
25,2,5,73,50,123
12,2,5,35,24,59
4,4,10,23,16,39
29,2,5,64,58,122
12,3,9,48,36,84
6,3,9,28,18,46
14,3,9,66,42,108
30,3,9,177,90,267
10,3,9,59,30,89
24,3,9,109,72,181
23,3,9,105,69,174
15,4,10,59,60,119
5,4,10,20,20,40
13,7,9,21,91,112
4,7,9,7,28,35
1,7,9,0,7,7
6,7,9,4,42,46
24,7,9,0,168,168
23,7,9,17,161,178
20,7,9,0,140,140
3,7,9,1,21,22
9,7,9,1,63,64
25,3,8,121,75,196
15,8,22,167,120,287
1,8,22,11,8,19
27,8,22,295,216,511
28,8,22,367,224,591
26,9,24,290,234,524
21,9,24,244,189,433
15,9,24,178,135,313
20,13,35,328,260,588
1,13,35,20,13,33
11,13,35,227,143,370
16,13,35,330,208,538
17,13,35,362,221,583
1,13,35,21,13,34
27,13,35,462,351,813
9,13,35,195,117,312
24,13,35,419,312,731
11,13,35,227,143,370
22,13,35,469,286,755
12,13,35,209,156,365
24,13,35,511,312,823
27,13,35,462,351,813
1,13,35,21,13,34
3,21,55,95,63,158
11,21,55,362,231,593
13,21,55,428,273,701
13,21,55,435,273,708
2,42,54,10,84,94
18,42,54,197,756,953
9,42,54,98,378,476
2,38,50,22,76,98
4,42,54,39,168,207
31,38,50,155,1178,1333
25,38,50,100,950,1050
26,42,54,115,1092,1207
26,42,54,129,1092,1221
15,42,54,75,630,705
21,42,54,14,882,896
3,1252,2295,3060,3756,6816
1,1266,2320,961,1266,2227
3,1266,2320,1631,3798,5429
1,308,565,234,308,542
1,1252,2295,951,1252,2203
1,1266,2320,1008,1266,2274
1,2171,3578,942,2171,3113
1,713,1120,362,713,1075
1,713,1120,172,713,885
3,487,783,583,1461,2044
1,344,540,126,344,470
1,2171,3578,1335,2171,3506
23,26,70,980,598,1578
14,26,70,596,364,960
5,26,70,217,130,347
16,3,9,95,48,143
17,9,25,268,153,421
18,1,2,15,18,33
22,1,2,21,22,43
27,1,2,26,27,53
24,9,25,306,216,522
10,9,25,128,90,218
17,1,2,11,17,28
12,1,2,8,12,20
11,1,2,7,11,18
22,1,2,21,22,43
11,1,2,11,11,22
24,1,2,18,24,42
29,1,2,21,29,50
19,12,33,374,228,602
29,12,33,571,348,919
1,2,5,3,2,5
3,11,30,56,33,89
10,11,30,187,110,297
13,2,5,38,26,64
8,1,2,5,8,13
1,1,2,1,1,2
12,1,2,8,12,20
14,1,2,13,14,27
23,1,2,22,23,45
8,2,5,17,16,33
14,2,5,29,28,57
22,2,5,52,44,96
15,1,2,14,15,29
27,8,21,277,216,493
29,8,21,298,232,530
26,8,21,267,208,475
11,2,5,32,22,54
16,2,5,46,32,78
28,1,2,27,28,55
24,1,2,24,24,48
3,2,5,6,6,12
19,11,29,226,209,435
5,1,2,5,5,10
28,1,2,26,28,54
21,12,33,344,252,596
4,12,33,66,48,114
11,2,5,26,22,48
2,1,2,1,2,3
31,1,2,22,31,53
26,2,5,75,52,127
21,2,5,61,42,103
18,2,5,52,36,88
21,2,5,61,42,103
20,2,5,58,40,98
7,2,5,20,14,34
20,8,21,201,160,361
16,8,21,161,128,289
26,1,2,15,26,41
22,1,4,55,22,77
12,1,4,30,12,42
1,1,4,2,1,3
1,1482,2384,735,1482,2217
1,755,1215,411,755,1166
1,1482,2384,878,1482,2360
3,1482,2384,2563,4446,7009
2,461,742,354,922,1276
3,1482,2384,2420,4446,6866
18,24,64,674,432,1106
9,24,64,348,216,564
7,24,64,271,168,439
6,45,120,299,270,569
4,59,159,317,236,553
26,2,5,61,52,113
16,2,5,38,32,70
18,2,5,50,36,86
1,2,5,3,2,5
24,2,5,67,48,115
14,3,9,81,42,123
22,3,9,128,66,194
3,2,5,9,6,15
24,2,5,56,48,104
14,2,5,41,28,69
5,2,5,15,10,25
26,3,9,154,78,232
5,3,9,30,15,45
25,2,5,48,50,98
7,2,5,13,14,27
16,4,10,61,64,125
13,3,9,73,39,112
13,3,9,73,39,112
24,3,9,114,72,186
14,3,9,66,42,108
22,3,9,124,66,190
20,3,9,113,60,173
13,2,5,31,26,57
9,2,5,21,18,39
1,2,5,3,2,5
5,2,5,15,10,25
2,7,9,0,14,14
19,7,9,14,133,147
26,7,9,36,182,218
13,7,9,21,91,112
21,7,9,34,147,181
8,7,9,15,56,71
14,7,9,25,98,123
11,7,9,9,77,86
21,7,9,38,147,185
10,7,9,19,70,89
22,7,9,18,154,172
30,3,8,119,90,209
13,8,22,162,104,266
6,8,22,56,48,104
29,8,22,317,232,549
20,8,22,218,160,378
22,8,22,202,176,378
16,8,22,220,128,348
16,8,22,220,128,348
13,9,24,183,117,300
13,9,24,145,117,262
14,9,24,139,126,265
11,9,24,123,99,222
16,9,24,190,144,334
15,13,35,246,195,441
1,13,35,15,13,28
10,13,35,217,130,347
22,13,35,476,286,762
25,13,35,358,325,683
1,13,35,21,13,34
14,13,35,288,182,470
15,13,35,309,195,504
3,13,35,59,39,98
6,13,35,128,78,206
6,13,35,124,78,202
4,13,35,87,52,139
6,13,35,124,78,202
2,13,35,31,26,57
28,13,35,459,364,823
10,13,35,196,130,326
15,13,35,257,195,452
20,21,55,438,420,858
30,21,55,987,630,1617
1,38,50,5,38,43
23,38,50,265,874,1139
31,38,50,31,1178,1209
27,42,54,309,1134,1443
24,38,50,132,912,1044
17,38,50,85,646,731
15,38,50,150,570,720
9,42,54,45,378,423
1,1252,2295,538,1252,1790
1,1912,3400,1046,1912,2958
1,1912,3400,774,1912,2686
1,1912,3400,774,1912,2686
3,1252,2295,2165,3756,5921
1,1252,2295,997,1252,2249
1,1252,2295,722,1252,1974
1,1266,2320,961,1266,2227
1,1252,2295,1020,1252,2272
2,308,565,469,616,1085
1,308,565,234,308,542
1,1252,2295,882,1252,2134
1,2171,3578,620,2171,2791
3,2171,3578,4006,6513,10519
2,713,1120,411,1426,1837
1,487,783,280,487,767
1,1555,2443,790,1555,2345
1,1555,2443,790,1555,2345
1,1519,2443,753,1519,2272
1,487,783,265,487,752
3,713,1120,482,2139,2621
3,344,540,523,1032,1555
1,344,540,191,344,535
1,344,540,126,344,470
1,487,783,194,487,681
1,344,540,174,344,518
3,344,540,377,1032,1409
12,26,70,494,312,806
18,26,70,767,468,1235
3,1,4,6,3,9
8,1,4,17,8,25
23,1,2,21,23,44
24,1,2,22,24,46
18,1,2,18,18,36
7,13,35,149,91,240
20,13,35,426,260,686
19,1,2,18,19,37
4,12,33,67,48,115
9,1,4,21,9,30
3,1,4,7,3,10
5,1,2,5,5,10
21,1,2,19,21,40
4,2,5,12,8,20
28,1,2,26,28,54
3,2,5,9,6,15
25,2,5,74,50,124
15,1,4,43,15,58
10,1,4,28,10,38
11,2,5,23,22,45
26,8,21,316,208,524
8,8,21,97,64,161
18,1,4,51,18,69
1,1,4,3,1,4
20,1,4,57,20,77
20,11,30,302,220,522
14,12,33,192,168,360
17,1,2,10,17,27
24,1,2,15,24,39
30,2,5,87,60,147
28,1,4,68,28,96
25,1,4,61,25,86
5,1,4,14,5,19
24,1,4,65,24,89
1,1482,2384,521,1482,2003
1,755,1215,266,755,1021
1,1482,2384,878,1482,2360
1,755,1215,302,755,1057
1,461,742,125,461,586
2,1482,2384,1470,2964,4434
1,461,742,177,461,638
1,755,1215,302,755,1057
3,1482,2384,2563,4446,7009
3,461,742,554,1383,1937
29,24,64,770,696,1466
9,24,64,354,216,570
8,3,9,35,24,59
2,3,9,9,6,15
16,4,10,75,64,139
7,4,10,33,28,61
29,2,5,81,58,139
3,3,9,12,9,21
1,3,9,4,3,7
29,3,9,132,87,219
18,3,9,82,54,136
13,2,5,27,26,53
14,2,5,29,28,57
4,2,5,12,8,20
1,2,5,3,2,5
5,2,5,14,10,24
14,2,5,39,28,67
5,2,5,14,10,24
20,2,5,56,40,96
6,2,5,17,12,29
15,2,5,44,30,74
7,2,5,20,14,34
20,4,10,116,80,196
9,4,10,52,36,88
22,4,10,128,88,216
19,4,10,110,76,186
25,4,10,145,100,245
22,4,10,128,88,216
2,2,5,4,4,8
24,2,5,50,48,98
24,2,5,54,48,102
1,2,5,2,2,4
16,2,5,45,32,77
13,3,9,53,39,92
7,2,5,20,14,34
1,2,5,3,2,5
12,7,9,23,84,107
29,7,9,53,203,256
4,7,9,7,28,35
24,7,9,46,168,214
23,7,9,42,161,203
1,7,9,2,7,9
11,7,9,20,77,97
3,7,9,1,21,22
2,7,9,3,14,17
19,7,9,14,133,147
1,7,9,2,7,9
3,7,9,2,21,23
26,7,9,47,182,229
18,3,8,64,54,118
17,3,8,65,51,116
14,8,22,128,112,240
1,9,24,15,9,24
23,9,24,273,207,480
3,13,35,62,39,101
15,13,35,320,195,515
19,13,35,391,247,638
25,13,35,393,325,718
7,13,35,122,91,213
16,13,35,330,208,538
1,13,35,21,13,34
19,13,35,405,247,652
1,13,35,21,13,34
19,13,35,278,247,525
18,13,35,371,234,605
10,13,35,164,130,294
11,13,35,192,143,335
12,13,35,209,156,365
11,13,35,238,143,381
11,13,35,161,143,304
3,42,54,34,126,160
14,38,50,154,532,686
4,38,50,46,152,198
1,38,50,1,38,39
22,38,50,121,836,957
28,42,54,306,1176,1482
13,42,54,142,546,688
26,38,50,260,988,1248
9,38,50,27,342,369
1,1266,2320,752,1266,2018
1,1252,2295,997,1252,2249
3,1252,2295,3060,3756,6816
2,295,540,296,590,886
1,1266,2320,961,1266,2227
1,1266,2320,567,1266,1833
2,1266,2320,1273,2532,3805
1,2171,3578,1371,2171,3542
1,713,1120,385,713,1098
3,713,1120,1154,2139,3293
1,1519,2443,484,1519,2003
1,1519,2443,826,1519,2345
1,344,540,185,344,529
1,1555,2443,570,1555,2125
1,1083,1701,363,1083,1446
1,344,540,66,344,410
1,344,540,185,344,529
1,713,1120,261,713,974
3,487,783,395,1461,1856
1,2171,3578,1335,2171,3506
2,344,540,165,688,853
1,2171,3578,656,2171,2827
1,26,70,43,26,69
18,26,70,616,468,1084
26,2,5,75,52,127
14,2,5,41,28,69
7,13,35,103,91,194
28,1,2,27,28,55
10,13,35,217,130,347
11,13,35,238,143,381
19,1,2,18,19,37
2,13,35,43,26,69
12,13,35,256,156,412
32,1,2,31,32,63
25,1,2,24,25,49
16,1,2,15,16,31
14,9,25,151,126,277
32,1,2,20,32,52
6,1,2,4,6,10
6,1,2,6,6,12
16,1,2,15,16,31
18,1,2,10,18,28
17,1,2,10,17,27
11,2,5,20,22,42
29,2,5,52,58,110
3,2,5,7,6,13
7,2,5,16,14,30
5,11,29,87,55,142
9,11,29,157,99,256
3,2,5,6,6,12
14,2,5,27,28,55
30,2,5,57,60,117
19,8,21,239,152,391
12,1,4,29,12,41
15,1,4,37,15,52
9,2,5,21,18,39
27,2,5,63,54,117
5,2,5,12,10,22
1,1482,2384,473,1482,1955
3,1482,2384,1562,4446,6008
2,755,1215,410,1510,1920
3,1482,2384,2420,4446,6866
1,755,1215,436,755,1191
3,1482,2384,2563,4446,7009
1,1482,2384,807,1482,2289
10,24,64,387,240,627
3,59,159,238,177,415
25,2,5,74,50,124
20,2,5,59,40,99
27,2,5,76,54,130
20,2,5,56,40,96
22,2,5,64,44,108
11,3,9,59,33,92
8,3,9,43,24,67
2,2,5,5,4,9
27,2,5,72,54,126
5,3,9,29,15,44
3,3,9,17,9,26
20,3,9,91,60,151
26,3,9,119,78,197
28,3,9,113,84,197
8,3,9,32,24,56
21,2,5,49,42,91
2,2,5,5,4,9
28,3,9,123,84,207
9,3,9,39,27,66
5,2,5,11,10,21
8,2,5,17,16,33
29,2,5,81,58,139
8,2,5,22,16,38
25,2,5,70,50,120
1,7,9,1,7,8
3,7,9,2,21,23
16,7,9,16,112,128
17,7,9,14,119,133
4,3,8,16,12,28
4,3,8,20,12,32
17,3,8,63,51,114
12,3,8,48,36,84
17,3,8,84,51,135
11,3,8,51,33,84
17,8,22,186,136,322
11,8,22,120,88,208
4,8,22,44,32,76
3,8,22,41,24,65
1,8,22,13,8,21
11,8,22,152,88,240
20,8,22,276,160,436
4,9,24,58,36,94
19,9,24,276,171,447
29,13,35,425,377,802
28,13,35,479,364,843
1,13,35,21,13,34
23,13,35,474,299,773
23,13,35,401,299,700
21,13,35,433,273,706
17,13,35,362,221,583
20,13,35,314,260,574
28,13,35,410,364,774
19,13,35,325,247,572
6,13,35,130,78,208
14,13,35,254,182,436
11,13,35,173,143,316
8,13,35,170,104,274
17,13,35,243,221,464
21,13,35,300,273,573
2,13,35,31,26,57
18,13,35,257,234,491
9,13,35,154,117,271
1,38,50,6,38,44
4,38,50,46,152,198
14,42,54,62,588,650
14,38,50,119,532,651
28,38,50,322,1064,1386
12,42,54,118,504,622
2,38,50,13,76,89
3,1266,2320,1909,3798,5707
1,420,769,295,420,715
1,1252,2295,951,1252,2203
1,1252,2295,951,1252,2203
1,295,540,126,295,421
1,308,565,246,308,554
1,487,783,186,487,673
1,713,1120,329,713,1042
3,1083,1701,1650,3249,4899
1,1083,1701,499,1083,1582
3,487,783,865,1461,2326
3,1555,2443,1491,4665,6156
1,713,1120,205,713,918
1,713,1120,205,713,918
19,26,70,809,494,1303
29,26,70,1256,754,2010
15,3,9,85,45,130
11,1,2,6,11,17
6,2,5,18,12,30
1,2,5,3,2,5
10,2,5,30,20,50
4,2,5,12,8,20
13,2,5,38,26,64
6,11,29,85,66,151
4,11,29,57,44,101
6,11,29,85,66,151
7,2,5,14,14,28
26,2,5,51,52,103
3,9,25,32,27,59
4,1,2,4,4,8
17,2,5,32,34,66
6,2,5,11,12,23
25,1,2,25,25,50
25,1,2,25,25,50
12,1,2,12,12,24
31,2,5,87,62,149
2,12,33,30,24,54
6,12,33,90,72,162
29,11,30,455,319,774
26,11,30,408,286,694
23,1,4,67,23,90
3,1,2,2,3,5
19,1,2,11,19,30
4,1,2,2,4,6
19,1,2,18,19,37
16,1,2,15,16,31
24,1,4,70,24,94
4,1,4,12,4,16
15,2,5,35,30,65
6,1,2,4,6,10
24,1,2,17,24,41
25,2,5,59,50,109
7,1,4,20,7,27
26,1,4,76,26,102
20,1,2,14,20,34
1,1482,2384,401,1482,1883
1,1482,2384,807,1482,2289
2,461,742,369,922,1291
3,461,742,353,1383,1736
24,2,5,47,48,95
14,2,5,27,28,55
8,2,5,24,16,40
1,2,5,3,2,5
19,2,5,36,38,74
9,2,5,27,18,45
17,4,10,66,68,134
5,4,10,20,20,40
9,2,5,27,18,45
15,2,5,44,30,74
16,2,5,34,32,66
21,2,5,44,42,86
27,3,9,123,81,204
7,3,9,32,21,53
3,3,9,14,9,23
20,2,5,39,40,79
21,2,5,41,42,83
2,2,5,6,4,10
6,2,5,13,12,25
18,2,5,41,36,77
7,2,5,16,14,30
28,4,10,106,112,218
19,3,9,102,57,159
23,3,9,124,69,193
32,3,9,129,96,225
17,3,9,68,51,119
14,7,9,27,98,125
20,7,9,2,140,142
23,7,9,0,161,161
14,3,8,68,42,110
8,3,8,39,24,63
24,8,22,331,192,523
11,8,22,120,88,208
14,8,22,128,112,240
3,8,22,41,24,65
21,8,22,220,168,388
26,8,22,358,208,566
13,8,22,145,104,249
25,9,24,279,225,504
16,9,24,225,144,369
5,9,24,53,45,98
26,13,35,426,338,764
15,13,35,236,195,431
12,13,35,188,156,344
16,13,35,229,208,437
7,13,35,107,91,198
3,13,35,51,39,90
5,13,35,73,65,138
23,13,35,474,299,773
13,13,35,281,169,450
27,13,35,585,351,936
3,13,35,44,39,83
1,13,35,17,13,30
21,13,35,359,273,632
1,13,35,17,13,30
21,21,55,702,441,1143
12,21,55,401,252,653
15,21,55,403,315,718
10,21,55,302,210,512
13,38,50,111,494,605
16,38,50,184,608,792
29,38,50,290,1102,1392
9,38,50,104,342,446
27,38,50,81,1026,1107
30,42,54,149,1260,1409
17,42,54,11,714,725
21,42,54,173,882,1055
2,1252,2295,2040,2504,4544
3,1252,2295,2991,3756,6747
1,1266,2320,544,1266,1810
1,1252,2295,722,1252,1974
2,1266,2320,1458,2532,3990
2,1252,2295,1489,2504,3993
1,308,565,251,308,559
3,308,565,754,924,1678
1,295,540,126,295,421
1,1266,2320,636,1266,1902
1,1252,2295,630,1252,1882
1,344,540,185,344,529
1,344,540,77,344,421
1,344,540,158,344,502
1,344,540,83,344,427
2,487,783,388,974,1362
2,344,540,349,688,1037
17,3,9,81,51,132
5,3,9,28,15,43
21,3,9,101,63,164
17,1,2,10,17,27
3,1,2,2,3,5
19,1,2,19,19,38
18,1,2,18,18,36
22,2,5,43,44,87
28,2,5,83,56,139
21,2,5,62,42,104
27,2,5,80,54,134
24,11,29,404,264,668
27,11,29,455,297,752
26,12,33,392,312,704
24,2,5,49,48,97
8,2,5,16,16,32
22,2,5,62,44,106
27,2,5,53,54,107
20,2,5,39,40,79
28,2,5,53,56,109
13,2,5,25,26,51
24,1,4,68,24,92
1,1,2,1,1,2
5,1,2,5,5,10
11,1,2,10,11,21
19,1,2,17,19,36
12,1,2,11,12,23
22,2,5,65,44,109
24,2,5,71,48,119
28,2,5,83,56,139
29,1,2,28,29,57
21,1,2,21,21,42
10,1,2,7,10,17
27,11,30,481,297,778
7,8,21,65,56,121
25,8,21,231,200,431
24,8,21,241,192,433
4,8,21,40,32,72
27,2,5,63,54,117
11,2,5,26,22,48
27,9,25,344,243,587
21,9,25,268,189,457
18,2,5,48,36,84
14,2,5,37,28,65
1,1,2,1,1,2
5,1,2,4,5,9
4,1,2,3,4,7
26,1,2,15,26,41
19,1,2,11,19,30
4,2,5,8,8,16
25,2,5,53,50,103
21,1,4,61,21,82
12,1,4,35,12,47
1,2,5,2,2,4
19,2,5,45,38,83
1,1,4,2,1,3
9,1,2,9,9,18
24,1,2,23,24,47
3,1,2,3,3,6
21,2,5,56,42,98
18,8,21,219,144,363
27,8,21,328,216,544
1,1482,2384,521,1482,2003
1,1482,2384,401,1482,1883
3,1482,2384,1133,4446,5579
1,755,1215,241,755,996
1,1482,2384,568,1482,2050
1,24,64,32,24,56
5,24,64,197,120,317
24,24,64,852,576,1428
8,3,9,45,24,69
5,3,9,28,15,43
15,2,5,44,30,74
13,2,5,38,26,64
1,4,10,6,4,10
5,4,10,28,20,48
9,4,10,50,36,86
32,4,10,186,128,314
16,4,10,93,64,157
4,2,5,11,8,19
15,2,5,42,30,72
22,2,5,65,44,109
1,2,5,3,2,5
15,2,5,27,30,57
9,2,5,16,18,34
19,2,5,45,38,83
12,2,5,28,24,52
24,2,5,53,48,101
8,2,5,18,16,34
6,2,5,14,12,26
17,2,5,40,34,74
4,2,5,12,8,20
4,2,5,12,8,20
16,3,9,64,48,112
2,3,9,8,6,14
23,7,9,38,161,199
1,7,9,2,7,9
12,7,9,7,84,91
20,8,22,271,160,431
9,8,22,122,72,194
13,8,22,179,104,283
11,8,22,152,88,240
14,9,24,139,126,265
21,9,24,204,189,393
8,13,35,131,104,235
27,13,35,585,351,936
1,13,35,17,13,30
5,13,35,82,65,147
1,13,35,22,13,35
23,13,35,490,299,789
8,13,35,140,104,244
11,13,35,157,143,300
11,21,55,277,231,508
21,38,50,63,798,861
26,42,54,115,1092,1207
1,38,50,2,38,40
3,38,50,3,114,117
15,42,54,67,630,697
27,42,54,91,1134,1225
1,1266,2320,683,1266,1949
1,1266,2320,752,1266,2018
2,1266,2320,1087,2532,3619
1,1266,2320,961,1266,2227
1,420,769,318,420,738
1,1266,2320,961,1266,2227
3,1266,2320,2884,3798,6682
2,308,565,503,616,1119
1,1252,2295,722,1252,1974
1,487,783,124,487,611
1,1519,2443,826,1519,2345
3,2171,3578,2504,6513,9017
1,1555,2443,302,1555,1857
3,713,1120,616,2139,2755
1,344,540,120,344,464
3,2171,3578,2504,6513,9017
4,26,70,137,104,241
26,26,70,1071,676,1747
5,26,70,171,130,301
12,26,70,427,312,739
21,3,9,122,63,185
4,8,21,50,32,82
8,8,21,101,64,165
7,1,2,7,7,14
17,11,30,318,187,505
12,11,30,224,132,356
13,11,30,243,143,386
4,2,5,11,8,19
24,2,5,55,48,103
2,2,5,5,4,9
12,1,2,8,12,20
8,2,5,24,16,40
31,1,4,77,31,108
1,12,33,17,12,29
22,12,33,368,264,632
12,9,25,156,108,264
17,9,25,221,153,374
28,9,25,364,252,616
18,12,33,283,216,499
10,2,5,30,20,50
4,2,5,12,8,20
25,1,2,25,25,50
22,1,4,62,22,84
17,1,2,12,17,29
26,1,2,18,26,44
12,2,5,35,24,59
16,2,5,46,32,78
9,2,5,26,18,44
18,2,5,42,36,78
13,8,21,131,104,235
14,8,21,141,112,253
29,2,5,68,58,126
11,1,4,27,11,38
12,1,4,29,12,41
12,1,4,29,12,41
6,1,4,15,6,21
28,1,4,68,28,96
1,1482,2384,521,1482,2003
1,1482,2384,807,1482,2289
2,1482,2384,1709,2964,4673
1,461,742,266,461,727
27,45,120,1960,1215,3175
6,3,9,25,18,43
19,3,9,78,57,135
4,2,5,8,8,16
8,2,5,15,16,31
25,4,10,148,100,248
30,4,10,177,120,297
16,4,10,94,64,158
20,2,5,56,40,96
25,2,5,70,50,120
4,2,5,12,8,20
8,2,5,24,16,40
31,2,5,90,62,152
25,2,5,73,50,123
14,2,5,39,28,67
7,2,5,20,14,34
32,2,5,61,64,125
4,2,5,12,8,20
6,2,5,17,12,29
16,2,5,46,32,78
2,2,5,6,4,10
18,3,9,105,54,159
28,3,9,163,84,247
29,2,5,67,58,125
25,2,5,51,50,101
15,2,5,31,30,61
5,2,5,14,10,24
12,2,5,34,24,58
17,2,5,40,34,74
2,2,5,5,4,9
30,3,9,137,90,227
2,7,9,4,14,18
23,7,9,17,161,178
22,7,9,8,154,162
29,7,9,8,203,211
25,7,9,41,175,216
18,7,9,7,126,133
16,7,9,9,112,121
26,3,8,126,78,204
8,3,8,28,24,52
24,8,22,225,192,417
17,8,22,231,136,367
21,8,22,289,168,457
29,8,22,393,232,625
29,8,22,393,232,625
16,8,22,178,128,306
27,8,22,372,216,588
19,9,24,280,171,451
18,9,24,266,162,428
10,9,24,116,90,206
27,9,24,301,243,544
15,13,35,309,195,504
5,13,35,73,65,138
24,13,35,520,312,832
26,13,35,381,338,719
22,13,35,453,286,739
5,13,35,68,65,133
6,13,35,105,78,183
20,13,35,433,260,693
3,13,35,52,39,91
16,13,35,262,208,470
28,13,35,596,364,960
8,13,35,131,104,235
11,13,35,161,143,304
27,13,35,462,351,813
19,13,35,405,247,652
19,13,35,405,247,652
2,13,35,33,26,59
11,21,55,277,231,508
29,38,50,334,1102,1436
27,42,54,18,1134,1152
4,42,54,9,168,177
24,38,50,240,912,1152
14,38,50,161,532,693
23,38,50,115,874,989
22,42,54,98,924,1022
3,38,50,12,114,126
7,42,54,1,294,295
11,38,50,33,418,451
24,38,50,264,912,1176
1,1898,3375,768,1898,2666
1,420,769,334,420,754
1,1252,2295,997,1252,2249
1,1266,2320,1008,1266,2274
3,1519,2443,2625,4557,7182
3,1083,1701,629,3249,3878
1,2171,3578,835,2171,3006
1,487,783,265,487,752
1,2171,3578,656,2171,2827
1,713,1120,329,713,1042
1,344,540,185,344,529
1,344,540,77,344,421
3,344,540,280,1032,1312
5,26,70,171,130,301
6,26,70,256,156,412
3,26,70,128,78,206
2,26,70,68,52,120
25,3,9,110,75,185
27,3,9,128,81,209
28,3,9,150,84,234
25,13,35,533,325,858
19,13,35,405,247,652
14,13,35,239,182,421
13,13,35,222,169,391
6,1,2,6,6,12
27,1,2,26,27,53
4,13,35,85,52,137
24,13,35,511,312,823
14,13,35,298,182,480
2,13,35,43,26,69
21,1,2,16,21,37
1,1,2,1,1,2
22,1,2,21,22,43
7,1,2,4,7,11
23,1,2,13,23,36
12,1,2,7,12,19
14,2,5,31,28,59
6,2,5,12,12,24
13,2,5,25,26,51
24,2,5,47,48,95
1,1,4,2,1,3
30,1,4,74,30,104
12,1,4,30,12,42
15,1,4,35,15,50
16,1,4,38,16,54
1,1,4,3,1,4
16,1,2,16,16,32
6,1,2,6,6,12
14,1,2,10,14,24
24,1,2,18,24,42
9,9,25,135,81,216
20,9,25,300,180,480
8,1,4,18,8,26
5,1,4,11,5,16
19,1,4,43,19,62
5,1,2,5,5,10
29,8,21,267,232,499
5,2,5,10,10,20
17,2,5,32,34,66
25,2,5,48,50,98
19,1,2,14,19,33
18,1,2,17,18,35
18,1,2,17,18,35
19,8,21,175,152,327
19,1,2,19,19,38
24,1,2,23,24,47
10,1,2,10,10,20
31,1,4,91,31,122
22,2,5,62,44,106
3,2,5,8,6,14
26,2,5,73,52,125
1,1482,2384,807,1482,2289
1,1482,2384,854,1482,2336
1,755,1215,205,755,960
1,461,742,125,461,586
1,1482,2384,521,1482,2003
1,24,64,39,24,63
11,24,64,292,264,556
2,59,159,143,118,261
9,59,159,671,531,1202
25,2,5,48,50,98
18,2,5,50,36,86
30,2,5,59,60,119
11,2,5,21,22,43
28,2,5,83,56,139
1,2,5,3,2,5
6,2,5,12,12,24
18,2,5,37,36,73
5,2,5,14,10,24
22,3,9,124,66,190
3,2,5,7,6,13
12,4,10,55,48,103
2,4,10,9,8,17
8,2,5,21,16,37
20,2,5,59,40,99
19,2,5,56,38,94
14,2,5,41,28,69
19,2,5,36,38,74
7,7,9,13,49,62
18,7,9,33,126,159
21,7,9,29,147,176
8,7,9,13,56,69
22,7,9,12,154,166
22,7,9,36,154,190
10,7,9,4,70,74
16,7,9,22,112,134
13,3,8,64,39,103
5,8,22,49,40,89
9,8,22,122,72,194
27,8,22,247,216,463
17,8,22,212,136,348
25,9,24,249,225,474
29,9,24,421,261,682
5,9,24,73,45,118
13,13,35,200,169,369
18,13,35,295,234,529
25,13,35,498,325,823
19,13,35,312,247,559
18,13,35,352,234,586
31,13,35,639,403,1042
16,13,35,346,208,554
14,13,35,298,182,480
26,13,35,536,338,874
19,13,35,411,247,658
23,13,35,474,299,773
11,13,35,157,143,300
1,13,35,14,13,27
28,13,35,596,364,960
13,13,35,190,169,359
15,13,35,215,195,410
23,13,35,361,299,660
18,13,35,257,234,491
8,13,35,156,104,260
7,13,35,144,91,235
12,13,35,205,156,361
28,42,54,18,1176,1194
5,38,50,55,190,245
5,38,50,15,190,205
21,42,54,14,882,896
21,42,54,48,882,930
10,42,54,44,420,464
15,42,54,75,630,705
7,38,50,21,266,287
2,1912,3400,1888,3824,5712
3,1252,2295,1614,3756,5370
3,1252,2295,2854,3756,6610
2,1252,2295,1352,2504,3856
1,1252,2295,607,1252,1859
1,420,769,188,420,608
3,1252,2295,2854,3756,6610
1,308,565,223,308,531
3,1252,2295,2647,3756,6403
1,1252,2295,951,1252,2203
1,1252,2295,997,1252,2249
1,2171,3578,763,2171,2934
1,1519,2443,875,1519,2394
1,1083,1701,312,1083,1395
1,2171,3578,656,2171,2827
1,713,1120,362,713,1075
1,713,1120,385,713,1098
1,344,540,185,344,529
1,344,540,174,344,518
1,1555,2443,448,1555,2003
28,26,70,1193,728,1921
1,26,70,43,26,69
25,3,9,110,75,185
26,1,2,25,26,51
23,2,5,67,46,113
19,2,5,55,38,93
21,1,2,14,21,35
9,1,2,6,9,15
28,9,25,357,252,609
27,8,21,249,216,465
21,1,2,16,21,37
20,1,2,15,20,35
15,1,2,14,15,29
3,1,2,3,3,6
10,2,5,21,20,41
27,2,5,57,54,111
5,1,2,5,5,10
4,2,5,12,8,20
17,1,4,40,17,57
4,1,4,9,4,13
9,2,5,17,18,35
2,1,2,1,2,3
1,1,2,1,1,2
6,1,2,4,6,10
24,2,5,71,48,119
9,2,5,27,18,45
9,9,25,135,81,216
8,9,25,120,72,192
16,1,2,15,16,31
6,1,2,6,6,12
13,2,5,38,26,64
26,2,5,75,52,127
16,1,2,15,16,31
20,1,2,19,20,39
27,1,2,18,27,45
3,1,2,2,3,5
26,1,2,18,26,44
14,1,2,10,14,24
27,1,2,18,27,45
17,2,5,50,34,84
27,2,5,80,54,134
2,2,5,4,4,8
11,2,5,23,22,45
23,11,29,267,253,520
9,1,4,26,9,35
3,1,4,9,3,12
27,8,21,340,216,556
17,8,21,214,136,350
1,755,1215,375,755,1130
1,1482,2384,378,1482,1860
1,1482,2384,854,1482,2336
1,1482,2384,568,1482,2050
16,24,64,620,384,1004
7,24,64,181,168,349
4,45,120,238,180,418
5,45,120,369,225,594
7,59,159,678,413,1091
5,2,5,15,10,25
17,2,5,49,34,83
26,2,5,55,52,107
28,2,5,66,56,122
1,2,5,3,2,5
2,2,5,6,4,10
19,2,5,44,38,82
3,2,5,7,6,13
17,2,5,35,34,69
9,2,5,27,18,45
6,2,5,18,12,30
18,2,5,52,36,88
8,2,5,23,16,39
8,2,5,19,16,35
23,2,5,54,46,100
6,7,9,3,42,45
11,7,9,20,77,97
5,7,9,4,35,39
13,7,9,18,91,109
12,8,22,120,96,216
19,8,22,258,152,410
15,8,22,164,120,284
27,8,22,366,216,582
29,8,22,400,232,632
5,8,22,47,40,87
12,9,24,143,108,251
30,9,24,436,270,706
19,9,24,221,171,392
16,13,35,341,208,549
17,13,35,350,221,571
20,13,35,426,260,686
1,13,35,20,13,33
9,13,35,185,117,302
4,13,35,82,52,134
12,13,35,209,156,365
29,13,35,618,377,995
11,13,35,234,143,377
21,13,35,433,273,706
13,13,35,227,169,396
1,13,35,17,13,30
19,21,55,604,399,1003
25,21,55,823,525,1348
3,21,55,81,63,144
6,42,54,1,252,253
4,38,50,12,152,164
5,38,50,50,190,240
4,42,54,13,168,181
26,42,54,214,1092,1306
17,38,50,94,646,740
15,38,50,75,570,645
13,42,54,-12,546,534
3,1898,3375,3115,5694,8809
3,1266,2320,1909,3798,5707
1,1266,2320,1008,1266,2274
2,1252,2295,1443,2504,3947
2,420,769,667,840,1507
1,1266,2320,1031,1266,2297
1,1266,2320,961,1266,2227
3,308,565,551,924,1475
1,1252,2295,882,1252,2134
2,1252,2295,2040,2504,4544
1,1252,2295,997,1252,2249
1,2171,3578,1264,2171,3435
1,487,783,280,487,767
3,1083,1701,731,3249,3980
2,1555,2443,1581,3110,4691
3,1083,1701,1497,3249,4746
1,487,783,155,487,642
1,1083,1701,346,1083,1429
3,344,540,377,1032,1409
1,713,1120,205,713,918
1,2171,3578,1335,2171,3506
9,26,70,308,234,542
27,26,70,1150,702,1852
18,3,9,106,54,160
7,3,9,41,21,62
3,1,2,2,3,5
22,1,2,16,22,38
11,2,5,26,22,48
1,2,5,2,2,4
22,2,5,52,44,96
1,1,2,1,1,2
17,1,2,16,17,33
21,1,2,19,21,40
16,2,5,47,32,79
30,2,5,89,60,149
10,2,5,30,20,50
15,13,35,320,195,515
16,13,35,341,208,549
19,1,2,11,19,30
10,1,2,10,10,20
17,2,5,49,34,83
24,2,5,46,48,94
13,2,5,25,26,51
5,2,5,10,10,20
6,13,35,128,78,206
15,13,35,320,195,515
9,1,2,9,9,18
28,1,2,21,28,49
1,1,2,1,1,2
23,1,2,21,23,44
5,1,2,5,5,10
30,1,4,85,30,115
25,8,21,288,200,488
29,8,21,334,232,566
1,1,2,1,1,2
13,9,25,166,117,283
14,1,2,9,14,23
22,1,2,16,22,38
12,1,2,9,12,21
9,2,5,21,18,39
29,2,5,84,58,142
4,2,5,12,8,20
5,11,29,58,55,113
4,11,29,46,44,90
4,11,29,51,44,95
1,755,1215,302,755,1057
3,461,742,754,1383,2137
1,1482,2384,473,1482,1955
1,1482,2384,592,1482,2074
1,1482,2384,592,1482,2074
29,24,64,1123,696,1819
4,59,159,375,236,611
18,4,10,79,72,151
3,4,10,13,12,25
8,4,10,47,32,79
15,4,10,89,60,149
22,2,5,42,44,86
6,2,5,11,12,23
10,3,9,56,30,86
8,3,9,45,24,69
11,4,10,42,44,86
18,4,10,68,72,140
1,2,5,2,2,4
1,2,5,2,2,4
2,2,5,6,4,10
17,2,5,49,34,83
5,2,5,15,10,25
13,2,5,38,26,64
26,2,5,75,52,127
12,2,5,35,24,59
6,2,5,11,12,23
15,2,5,29,30,59
11,2,5,32,22,54
3,2,5,9,6,15
7,2,5,20,14,34
20,3,9,95,60,155
3,3,9,14,9,23
26,2,5,55,52,107
9,2,5,19,18,37
30,4,10,177,120,297
10,4,10,59,40,99
27,2,5,63,54,117
20,2,5,47,40,87
11,2,5,26,22,48
23,2,5,47,46,93
15,2,5,31,30,61
1,7,9,1,7,8
4,7,9,0,28,28
1,7,9,0,7,7
6,7,9,11,42,53
20,7,9,36,140,176
21,7,9,38,147,185
13,7,9,4,91,95
24,3,8,116,72,188
12,8,22,110,96,206
21,8,22,285,168,453
1,8,22,11,8,19
29,8,22,266,232,498
15,8,22,203,120,323
28,8,22,367,224,591
2,9,24,29,18,47
12,9,24,177,108,285
26,9,24,378,234,612
18,9,24,261,162,423
16,13,35,313,208,521
11,13,35,173,143,316
26,13,35,454,338,792
23,13,35,490,299,789
1,13,35,21,13,34
4,13,35,54,52,106
20,13,35,433,260,693
21,13,35,300,273,573
8,13,35,173,104,277
26,13,35,554,338,892
20,13,35,426,260,686
18,13,35,383,234,617
6,13,35,105,78,183
18,13,35,283,234,517
26,38,50,260,988,1248
24,38,50,24,912,936
23,42,54,251,966,1217
18,38,50,99,684,783
24,42,54,3,1008,1011
13,38,50,150,494,644
26,38,50,78,988,1066
17,42,54,75,714,789
4,42,54,20,168,188
1,1912,3400,1046,1912,2958
1,1252,2295,538,1252,1790
1,1266,2320,729,1266,1995
1,420,769,318,420,738
3,295,540,670,885,1555
2,1252,2295,1260,2504,3764
2,1266,2320,1087,2532,3619
3,1252,2295,2991,3756,6747
1,1266,2320,1031,1266,2297
1,1266,2320,961,1266,2227
1,1266,2320,1008,1266,2274
2,487,783,561,974,1535
1,2171,3578,835,2171,3006
1,1555,2443,839,1555,2394
1,1555,2443,351,1555,1906
1,1555,2443,497,1555,2052
1,713,1120,261,713,974
1,487,783,194,487,681
12,26,70,410,312,722
3,26,70,124,78,202
1,26,70,43,26,69
4,26,70,170,104,274
20,3,9,116,60,176
20,3,9,91,60,151
7,1,2,7,7,14
26,1,2,25,26,51
9,9,25,108,81,189
28,1,2,27,28,55
15,13,35,325,195,520
5,13,35,87,65,152
13,13,35,227,169,396
11,1,4,33,11,44
27,2,5,57,54,111
7,2,5,21,14,35
4,2,5,12,8,20
12,1,2,12,12,24
5,1,2,5,5,10
20,2,5,38,40,78
29,2,5,81,58,139
9,2,5,27,18,45
27,2,5,80,54,134
14,1,2,10,14,24
21,1,2,13,21,34
30,2,5,89,60,149
27,2,5,49,54,103
27,2,5,49,54,103
11,9,25,165,99,264
27,9,25,405,243,648
2,9,25,30,18,48
16,2,5,46,32,78
11,2,5,32,22,54
8,2,5,23,16,39
24,2,5,70,48,118
5,1,2,4,5,9
1,2,5,3,2,5
1,1482,2384,592,1482,2074
1,1482,2384,592,1482,2074
1,1482,2384,878,1482,2360
1,1482,2384,878,1482,2360
1,1482,2384,807,1482,2289
1,1482,2384,473,1482,1955
1,1482,2384,473,1482,1955
2,1482,2384,1709,2964,4673
1,461,742,229,461,690
1,461,742,266,461,727
22,2,5,52,44,96
22,2,5,42,44,86
8,2,5,15,16,31
5,4,10,21,20,41
15,4,10,63,60,123
21,4,10,122,84,206
9,4,10,52,36,88
12,4,10,70,48,118
5,2,5,10,10,20
9,4,10,34,36,70
7,4,10,27,28,55
23,4,10,129,92,221
8,4,10,45,32,77
28,2,5,81,56,137
9,2,5,26,18,44
12,2,5,28,24,52
7,2,5,16,14,30
21,2,5,62,42,104
6,7,9,0,42,42
2,7,9,2,14,16
9,7,9,0,63,63
13,3,8,51,39,90
1,3,8,3,3,6
6,3,8,21,18,39
25,8,22,251,200,451
26,8,22,353,208,561
5,8,22,68,40,108
22,8,22,303,176,479
5,9,24,73,45,118
7,9,24,102,63,165
11,9,24,117,99,216
4,9,24,58,36,94
27,13,35,462,351,813
23,13,35,490,299,789
10,13,35,164,130,294
6,13,35,117,78,195
3,13,35,65,39,104
27,13,35,424,351,775
25,13,35,541,325,866
24,13,35,511,312,823
26,13,35,508,338,846
7,13,35,149,91,240
17,13,35,267,221,488
7,13,35,122,91,213
28,13,35,577,364,941
26,13,35,554,338,892
8,21,55,202,168,370
27,21,55,725,567,1292
13,42,54,149,546,695
26,38,50,78,988,1066
25,38,50,75,950,1025
17,38,50,187,646,833
14,38,50,42,532,574
1,1252,2295,882,1252,2134
2,1266,2320,2015,2532,4547
1,1266,2320,961,1266,2227
1,344,540,99,344,443
2,344,540,370,688,1058
1,1555,2443,448,1555,2003
1,1083,1701,499,1083,1582
3,487,783,465,1461,1926
1,487,783,155,487,642
1,1519,2443,606,1519,2125
3,1083,1701,1191,3249,4440
3,344,540,572,1032,1604
1,1,2,1,1,2
12,1,2,12,12,24
16,1,2,15,16,31
8,1,2,5,8,13
18,1,2,12,18,30
14,2,5,39,28,67
27,2,5,76,54,130
17,2,5,48,34,82
16,2,5,47,32,79
1,2,5,3,2,5
1,11,30,14,11,25
7,2,5,20,14,34
1,9,25,16,9,25
16,2,5,34,32,66
32,2,5,67,64,131
10,1,2,7,10,17
21,1,2,14,21,35
23,2,5,53,46,99
1,11,30,19,11,30
14,11,30,262,154,416
27,1,2,17,27,44
10,9,25,115,90,205
5,9,25,58,45,103
2,12,33,41,24,65
25,12,33,517,300,817
13,2,5,25,26,51
25,2,5,48,50,98
16,2,5,46,32,78
8,2,5,15,16,31
25,2,5,48,50,98
25,1,4,57,25,82
29,2,5,68,58,126
18,1,4,53,18,71
1,1,4,3,1,4
23,1,2,13,23,36
1,2,5,3,2,5
2,2,5,5,4,9
15,1,2,15,15,30
18,1,2,18,18,36
8,1,2,8,8,16
28,2,5,59,56,115
15,2,5,32,30,62
28,2,5,59,56,115
7,11,29,89,77,166
1,11,29,13,11,24
1,1482,2384,521,1482,2003
3,755,1215,906,2265,3171
1,1482,2384,592,1482,2074
3,461,742,353,1383,1736
29,24,64,900,696,1596
32,24,64,1014,768,1782
10,24,64,259,240,499
26,2,5,69,52,121
16,2,5,42,32,74
18,3,9,79,54,133
11,3,9,48,33,81
29,4,10,168,116,284
9,3,9,48,27,75
19,3,9,102,57,159
2,2,5,5,4,9
30,2,5,71,60,131
20,2,5,47,40,87
16,2,5,38,32,70
22,2,5,48,44,92
23,2,5,51,46,97
24,2,5,67,48,115
12,2,5,34,24,58
13,2,5,38,26,64
12,2,5,35,24,59
3,2,5,9,6,15
2,2,5,6,4,10
21,2,5,62,42,104
20,2,5,39,40,79
9,2,5,27,18,45
4,2,5,12,8,20
21,3,9,113,63,176
9,3,9,48,27,75
9,2,5,26,18,44
1,7,9,2,7,9
6,7,9,11,42,53
4,7,9,8,28,36
18,7,9,0,126,126
18,7,9,34,126,160
20,3,8,97,60,157
29,3,8,94,87,181
30,3,8,104,90,194
22,3,8,87,66,153
1,8,22,10,8,18
6,8,22,60,48,108
13,8,22,179,104,283
21,8,22,289,168,457
9,8,22,124,72,196
6,8,22,56,48,104
24,9,24,348,216,564
6,9,24,87,54,141
7,9,24,83,63,146
21,9,24,280,189,469
13,9,24,126,117,243
4,9,24,47,36,83
22,9,24,325,198,523
26,9,24,384,234,618
15,13,35,309,195,504
7,13,35,152,91,243
22,13,35,476,286,762
29,13,35,628,377,1005
20,13,35,412,260,672
25,13,35,489,325,814
6,13,35,105,78,183
9,13,35,148,117,265
24,13,35,494,312,806
31,13,35,660,403,1063
29,13,35,597,377,974
1,13,35,17,13,30
26,13,35,563,338,901
25,13,35,541,325,866
23,13,35,490,299,789
8,13,35,170,104,274
23,13,35,337,299,636
9,13,35,192,117,309
31,13,35,541,403,944
1,13,35,15,13,28
7,13,35,100,91,191
17,13,35,243,221,464
1,21,55,33,21,54
6,21,55,145,126,271
6,21,55,191,126,317
24,21,55,605,504,1109
8,42,54,92,336,428
6,38,50,69,228,297
3,1252,2295,2854,3756,6610
1,1252,2295,951,1252,2203
1,1266,2320,961,1266,2227
3,1266,2320,2048,3798,5846
1,1252,2295,882,1252,2134
1,1252,2295,951,1252,2203
1,1252,2295,538,1252,1790
1,420,769,249,420,669
1,1266,2320,544,1266,1810
1,295,540,148,295,443
1,1252,2295,1020,1252,2272
1,2171,3578,620,2171,2791
2,1555,2443,897,3110,4007
1,713,1120,385,713,1098
1,2171,3578,835,2171,3006
1,713,1120,362,713,1075
1,713,1120,385,713,1098
1,2171,3578,942,2171,3113
1,713,1120,261,713,974
1,1519,2443,606,1519,2125
1,1083,1701,584,1083,1667
1,487,783,132,487,619
1,1519,2443,900,1519,2419
3,344,540,377,1032,1409
17,26,70,486,442,928
3,26,70,130,78,208
19,3,9,83,57,140
20,3,9,116,60,176
27,1,2,26,27,53
3,1,2,3,3,6
30,2,5,57,60,117
12,2,5,23,24,47
16,2,5,47,32,79
29,1,2,27,29,56
7,1,2,5,7,12
7,1,2,5,7,12
15,1,2,10,15,25
22,1,2,14,22,36
5,1,2,3,5,8
9,1,2,5,9,14
2,11,30,37,22,59
29,11,30,542,319,861
2,2,5,4,4,8
12,2,5,35,24,59
9,2,5,27,18,45
26,11,30,330,286,616
26,1,2,22,26,48
4,1,2,3,4,7
1,2,5,3,2,5
12,2,5,34,24,58
3,2,5,8,6,14
3,2,5,8,6,14
29,2,5,61,58,119
3,2,5,6,6,12
30,2,5,71,60,131
29,2,5,68,58,126
11,13,35,157,143,300
10,13,35,143,130,273
21,13,35,300,273,573
12,2,5,35,24,59
15,2,5,44,30,74
1,2,5,2,2,4
5,2,5,12,10,22
6,1,2,4,6,10
9,1,2,7,9,16
6,2,5,17,12,29
7,2,5,20,14,34
21,1,2,15,21,36
1,1,2,1,1,2
3,8,21,25,24,49
14,8,21,117,112,229
10,2,5,30,20,50
5,2,5,13,10,23
21,2,5,56,42,98
2,1,2,2,2,4
21,1,2,20,21,41
12,1,2,12,12,24
4,12,33,55,48,103
4,2,5,9,8,17
5,12,33,69,60,129
21,1,2,21,21,42
32,1,2,31,32,63
14,1,2,14,14,28
27,1,2,26,27,53
8,1,4,23,8,31
24,1,4,68,24,92
14,1,2,13,14,27
20,11,29,256,220,476
1,1,2,1,1,2
8,1,4,22,8,30
12,1,4,33,12,45
12,1,2,7,12,19
17,1,2,10,17,27
24,2,5,56,48,104
29,2,5,68,58,126
6,1,4,13,6,19
6,1,4,13,6,19
1,1482,2384,807,1482,2289
3,1482,2384,1419,4446,5865
1,755,1215,375,755,1130
2,1482,2384,755,2964,3719
1,1482,2384,854,1482,2336
15,24,64,562,360,922
14,24,64,399,336,735
1,24,64,39,24,63
1,45,120,74,45,119
3,59,159,238,177,415
10,59,159,650,590,1240
28,4,10,157,112,269
21,2,5,41,42,83
10,2,5,20,20,40
9,3,9,35,27,62
27,3,9,104,81,185
31,2,5,91,62,153
11,2,5,32,22,54
8,2,5,19,16,35
19,2,5,45,38,83
1,2,5,3,2,5
28,2,5,81,56,137
11,2,5,32,22,54
5,2,5,10,10,20
26,2,5,73,52,125
12,2,5,35,24,59
19,2,5,55,38,93
6,3,9,35,18,53
8,3,9,47,24,71
29,2,5,84,58,142
30,4,10,168,120,288
8,4,10,45,32,77
14,2,5,37,28,65
20,2,5,53,40,93
7,3,9,34,21,55
1,3,9,5,3,8
7,2,5,20,14,34
6,2,5,17,12,29
10,7,9,6,70,76
26,7,9,43,182,225
28,7,9,11,196,207
12,7,9,20,84,104
16,7,9,29,112,141
15,7,9,25,105,130
1,7,9,1,7,8
26,3,8,126,78,204
27,3,8,87,81,168
1,3,8,5,3,8
12,3,8,53,36,89
21,3,8,98,63,161
27,3,8,131,81,212
18,8,22,197,144,341
22,8,22,221,176,397
16,9,24,148,144,292
4,9,24,48,36,84
22,9,24,309,198,507
28,9,24,333,252,585
7,13,35,144,91,235
25,13,35,515,325,840
4,13,35,70,52,122
1,13,35,14,13,27
6,13,35,109,78,187
23,13,35,474,299,773
28,13,35,596,364,960
19,13,35,391,247,638
1,13,35,21,13,34
14,13,35,288,182,470
14,13,35,200,182,382
26,13,35,426,338,764
19,13,35,298,247,545
14,13,35,288,182,470
25,13,35,533,325,858
13,13,35,277,169,446
13,13,35,268,169,437
4,13,35,63,52,115
7,21,55,234,147,381
15,21,55,477,315,792
24,21,55,790,504,1294
4,38,50,40,152,192
13,38,50,130,494,624
2,38,50,22,76,98
15,38,50,45,570,615
24,42,54,262,1008,1270
1,42,54,5,42,47
1,1912,3400,944,1912,2856
1,1266,2320,497,1266,1763
2,1252,2295,1489,2504,3993
1,420,769,334,420,754
2,1266,2320,1087,2532,3619
1,1266,2320,1008,1266,2274
1,1252,2295,630,1252,1882
2,1266,2320,1922,2532,4454
3,295,540,622,885,1507
1,2171,3578,1335,2171,3506
1,2171,3578,1335,2171,3506
1,2171,3578,1264,2171,3435
1,344,540,77,344,421
2,344,540,370,688,1058
2,2171,3578,1884,4342,6226
2,1083,1701,1100,2166,3266
1,713,1120,362,713,1075
1,344,540,185,344,529
2,487,783,388,974,1362
1,1555,2443,864,1555,2419
5,26,70,213,130,343
23,26,70,980,598,1578
1,26,70,35,26,61
11,3,9,64,33,97
2,3,9,12,6,18
6,3,9,35,18,53
11,3,9,53,33,86
25,1,2,25,25,50
8,1,2,8,8,16
26,13,35,554,338,892
10,13,35,213,130,343
13,13,35,277,169,446
23,2,5,67,46,113
6,1,2,4,6,10
15,1,2,10,15,25
4,1,2,3,4,7
12,13,35,205,156,361
11,2,5,32,22,54
29,2,5,86,58,144
8,2,5,24,16,40
12,13,35,260,156,416
11,13,35,238,143,381
8,13,35,173,104,277
4,13,35,87,52,139
26,13,35,563,338,901
19,1,2,18,19,37
30,1,2,29,30,59
1,1,2,1,1,2
16,13,35,279,208,487
11,1,2,7,11,18
9,1,2,6,9,15
21,1,2,16,21,37
14,1,2,13,14,27
15,2,5,44,30,74
22,2,5,65,44,109
26,1,2,25,26,51
24,1,2,23,24,47
4,1,2,4,4,8
2,2,5,6,4,10
13,1,2,9,13,22
5,1,2,4,5,9
12,2,5,23,24,47
11,2,5,21,22,43
23,11,30,292,253,545
13,11,30,165,143,308
11,2,5,23,22,45
16,2,5,34,32,66
8,9,25,126,72,198
26,1,2,24,26,50
1,1,2,1,1,2
24,1,2,22,24,46
12,1,2,9,12,21
12,1,2,9,12,21
16,9,25,204,144,348
22,9,25,281,198,479
15,2,5,29,30,59
1,2,5,3,2,5
19,1,4,54,19,73
12,1,4,34,12,46
30,1,2,29,30,59
3,1,2,3,3,6
14,2,5,27,28,55
17,1,2,10,17,27
27,1,2,15,27,42
2,2,5,6,4,10
3,2,5,9,6,15
8,2,5,17,16,33
27,2,5,57,54,111
12,2,5,25,24,49
3,2,5,9,6,15
2,2,5,6,4,10
27,2,5,80,54,134
12,2,5,34,24,58
1,461,742,147,461,608
2,755,1215,823,1510,2333
3,1482,2384,2634,4446,7080
1,461,742,185,461,646
1,1482,2384,854,1482,2336
1,1482,2384,854,1482,2336
1,461,742,118,461,579
1,1482,2384,854,1482,2336
3,45,120,160,135,295
10,59,159,793,590,1383
29,2,5,81,58,139
7,2,5,19,14,33
2,2,5,5,4,9
6,4,10,35,24,59
7,2,5,21,14,35
18,2,5,53,36,89
1,2,5,2,2,4
21,2,5,44,42,86
4,2,5,8,8,16
14,2,5,29,28,57
20,2,5,38,40,78
30,2,5,57,60,117
22,3,9,88,66,154
12,3,9,48,36,84
9,2,5,21,18,39
11,2,5,26,22,48
5,4,10,29,20,49
26,3,9,140,78,218
4,3,9,23,12,35
29,3,9,169,87,256
7,2,5,14,14,28
6,4,10,23,24,47
1,4,10,4,4,8
2,7,9,3,14,17
10,7,9,1,70,71
7,7,9,13,49,62
5,7,9,1,35,36
14,7,9,12,98,110
20,7,9,0,140,140
24,7,9,0,168,168
10,7,9,1,70,71
26,7,9,43,182,225
12,3,8,43,36,79
11,3,8,36,33,69
2,8,22,27,16,43
26,8,22,353,208,561
3,8,22,41,24,65
10,8,22,131,80,211
25,9,24,243,225,468
1,9,24,14,9,23
10,9,24,145,90,235
9,9,24,126,81,207
9,13,35,176,117,293
7,13,35,144,91,235
9,13,35,157,117,274
16,13,35,279,208,487
27,13,35,585,351,936
10,13,35,175,130,305
1,13,35,21,13,34
1,13,35,21,13,34
14,13,35,298,182,480
8,13,35,114,104,218
1,13,35,16,13,29
30,21,55,1004,630,1634
25,42,54,206,1050,1256
10,38,50,100,380,480
1,42,54,2,42,44
15,38,50,83,570,653
28,38,50,0,1064,1064
27,38,50,270,1026,1296
22,38,50,242,836,1078
15,38,50,150,570,720
11,42,54,55,462,517
2,1266,2320,994,2532,3526
1,1252,2295,882,1252,2134
1,1252,2295,630,1252,1882
2,1252,2295,1260,2504,3764
1,1266,2320,1008,1266,2274
1,1252,2295,997,1252,2249
1,1252,2295,951,1252,2203
2,1252,2295,2040,2504,4544
2,1519,2443,1653,3038,4691
1,1083,1701,244,1083,1327
2,487,783,388,974,1362
3,344,540,232,1032,1264
1,1083,1701,584,1083,1667
3,1083,1701,1752,3249,5001
1,344,540,158,344,502
11,26,70,469,286,755
31,3,9,127,93,220
5,3,9,28,15,43
4,3,9,23,12,35
14,2,5,27,28,55
12,13,35,256,156,412
3,13,35,64,39,103
19,13,35,405,247,652
12,1,2,8,12,20
3,1,2,2,3,5
13,2,5,34,26,60
1,2,5,3,2,5
9,1,2,9,9,18
13,2,5,25,26,51
8,2,5,16,16,32
30,11,30,561,330,891
8,11,30,150,88,238
13,11,30,243,143,386
16,2,5,47,32,79
12,1,4,28,12,40
32,1,4,76,32,108
5,1,2,5,5,10
11,13,35,234,143,377
1,13,35,21,13,34
29,1,4,72,29,101
16,2,5,47,32,79
26,2,5,77,52,129
3,2,5,8,6,14
32,2,5,90,64,154
8,2,5,22,16,38
18,2,5,53,36,89
27,2,5,80,54,134
25,1,4,57,25,82
28,2,5,66,56,122
24,2,5,56,48,104
26,2,5,57,52,109
25,1,2,25,25,50
1,2,5,3,2,5
18,11,30,266,198,464
24,11,30,355,264,619
5,2,5,12,10,22
13,2,5,31,26,57
11,2,5,26,22,48
18,1,4,53,18,71
10,2,5,28,20,48
11,1,4,25,11,36
2,8,21,17,16,33
3,8,21,26,24,50
10,1,4,22,10,32
1,1,4,2,1,3
14,1,4,30,14,44
14,1,4,30,14,44
25,1,2,14,25,39
2,1,2,1,2,3
2,1,2,1,2,3
4,2,5,12,8,20
11,2,5,32,22,54
15,8,21,189,120,309
24,8,21,302,192,494
30,8,21,377,240,617
23,9,25,357,207,564
2,461,742,503,922,1425
3,1482,2384,2420,4446,6866
1,755,1215,241,755,996
1,1482,2384,854,1482,2336
1,1482,2384,378,1482,1860
14,24,64,444,336,780
9,45,120,535,405,940
5,59,159,468,295,763
24,4,10,142,96,238
2,4,10,12,8,20
29,2,5,81,58,139
14,2,5,39,28,67
6,2,5,13,12,25
8,2,5,15,16,31
2,2,5,4,4,8
1,2,5,2,2,4
4,2,5,9,8,17
17,2,5,49,34,83
18,3,9,87,54,141
23,3,9,111,69,180
21,4,10,122,84,206
26,4,10,151,104,255
29,2,5,84,58,142
28,2,5,81,56,137
6,3,9,29,18,47
12,3,9,58,36,94
8,2,5,24,16,40
5,2,5,15,10,25
10,2,5,23,20,43
26,2,5,60,52,112
11,2,5,29,22,51
16,4,10,93,64,157
10,4,10,58,40,98
28,2,5,59,56,115
10,4,10,38,40,78
29,4,10,110,116,226
17,2,5,48,34,82
5,2,5,14,10,24
14,2,5,41,28,69
23,2,5,67,46,113
17,2,5,40,34,74
7,2,5,16,14,30
6,2,5,17,12,29
3,2,5,9,6,15
2,2,5,4,4,8
17,7,9,28,119,147
12,7,9,5,84,89
1,7,9,2,7,9
17,7,9,10,119,129
28,7,9,46,196,242
16,7,9,29,112,141
6,7,9,5,42,47
31,7,9,26,217,243
14,7,9,5,98,103
23,7,9,17,161,178
16,3,8,77,48,125
27,3,8,90,81,171
21,3,8,75,63,138
18,3,8,58,54,112
11,8,22,149,88,237
17,8,22,223,136,359
10,8,22,136,80,216
23,8,22,312,184,496
28,8,22,367,224,591
18,8,22,157,144,301
25,8,22,312,200,512
5,8,22,69,40,109
7,8,22,78,56,134
6,8,22,83,48,131
16,8,22,220,128,348
1,8,22,9,8,17
26,9,24,346,234,580
6,9,24,89,54,143
13,9,24,189,117,306
22,9,24,309,198,507
15,9,24,149,135,284
11,9,24,131,99,230
25,9,24,297,225,522
8,13,35,165,104,269
24,13,35,377,312,689
5,13,35,108,65,173
2,13,35,29,26,55
13,13,35,268,169,437
6,13,35,105,78,183
3,13,35,52,39,91
25,13,35,541,325,866
6,13,35,117,78,195
19,13,35,278,247,525
9,13,35,157,117,274
5,13,35,79,65,144
19,13,35,405,247,652
1,13,35,21,13,34
9,13,35,132,117,249
27,13,35,424,351,775
27,13,35,424,351,775
16,13,35,279,208,487
21,13,35,330,273,603
13,13,35,190,169,359
23,13,35,329,299,628
24,13,35,469,312,781
30,13,35,524,390,914
14,21,55,461,294,755
19,42,54,95,798,893
18,38,50,207,684,891
13,38,50,143,494,637
1,38,50,3,38,41
28,38,50,84,1064,1148
26,42,54,284,1092,1376
10,42,54,109,420,529
2,42,54,22,84,106
11,42,54,1,462,463
14,42,54,70,588,658
3,1252,2295,2991,3756,6747
1,1252,2295,997,1252,2249
1,1252,2295,997,1252,2249
1,1252,2295,561,1252,1813
1,1266,2320,683,1266,1949
1,1252,2295,951,1252,2203
3,308,565,652,924,1576
1,308,565,155,308,463
2,1252,2295,1902,2504,4406
1,1252,2295,997,1252,2249
1,1266,2320,497,1266,1763
1,295,540,207,295,502
1,1252,2295,745,1252,1997
2,1252,2295,1076,2504,3580
1,1252,2295,745,1252,1997
3,420,769,724,1260,1984
1,1266,2320,961,1266,2227
3,1252,2295,1890,3756,5646
2,308,565,469,616,1085
1,344,540,185,344,529
2,1555,2443,897,3110,4007
2,2171,3578,1311,4342,5653
1,1519,2443,900,1519,2419
1,1519,2443,753,1519,2272
1,1555,2443,448,1555,2003
1,1555,2443,839,1555,2394
1,1555,2443,546,1555,2101
3,487,783,794,1461,2255
1,1519,2443,606,1519,2125
1,487,783,155,487,642
1,713,1120,329,713,1042
2,344,540,198,688,886
3,344,540,377,1032,1409
17,26,70,581,442,1023
21,26,70,718,546,1264
16,3,9,90,48,138
20,3,9,80,60,140
4,3,9,19,12,31
14,1,2,13,14,27
10,1,2,9,10,19
5,1,2,5,5,10
1,1,2,1,1,2
3,9,25,38,27,65
21,2,5,59,42,101
29,13,35,618,377,995
24,2,5,70,48,118
3,2,5,7,6,13
21,2,5,49,42,91
13,9,25,140,117,257
17,9,25,183,153,336
21,2,5,49,42,91
25,1,2,17,25,42
1,2,5,3,2,5
18,13,35,314,234,548
29,2,5,81,58,139
6,2,5,17,12,29
8,2,5,22,16,38
13,2,5,36,26,62
27,1,4,57,27,84
4,1,4,8,4,12
17,1,2,13,17,30
24,1,2,18,24,42
21,1,2,15,21,36
5,1,2,4,5,9
1,1,2,1,1,2
14,9,25,161,126,287
32,11,30,406,352,758
22,11,30,279,242,521
8,2,5,24,16,40
19,2,5,56,38,94
7,1,2,6,7,13
20,1,2,10,20,30
7,1,4,16,7,23
1,1,4,2,1,3
15,1,4,34,15,49
8,9,25,102,72,174
22,9,25,281,198,479
28,8,21,352,224,576
29,8,21,365,232,597
7,1,4,16,7,23
5,1,4,11,5,16
20,8,21,168,160,328
4,8,21,34,32,66
12,11,30,221,132,353
30,11,30,552,330,882
19,11,30,350,209,559
13,12,33,213,156,369
4,11,29,51,44,95
7,11,29,89,77,166
19,11,29,243,209,452
11,1,4,32,11,43
17,1,4,50,17,67
11,9,25,132,99,231
6,1,2,3,6,9
12,1,2,7,12,19
5,1,2,5,5,10
6,1,4,15,6,21
18,1,4,45,18,63
18,1,4,53,18,71
17,1,4,50,17,67
8,1,4,23,8,31
24,1,2,24,24,48
29,1,2,28,29,57
25,2,5,53,50,103
6,2,5,13,12,25
10,1,4,25,10,35
2,755,1215,823,1510,2333
1,1482,2384,592,1482,2074
2,1482,2384,1709,2964,4673
1,1482,2384,878,1482,2360
3,1482,2384,2563,4446,7009
26,24,64,824,624,1448
8,24,64,310,192,502
3,24,64,116,72,188
22,24,64,852,528,1380
6,45,120,349,270,619
6,45,120,292,270,562
3,59,159,281,177,458
10,3,9,46,30,76
20,2,5,42,40,82
8,2,5,17,16,33
12,2,5,35,24,59
28,2,5,83,56,139
22,2,5,40,44,84
10,2,5,30,20,50
23,2,5,67,46,113
11,2,5,32,22,54
13,3,9,76,39,115
14,2,5,27,28,55
3,2,5,6,6,12
31,2,5,59,62,121
21,2,5,40,42,82
10,2,5,22,20,42
19,2,5,42,38,80
31,2,5,59,62,121
11,2,5,21,22,43
13,2,5,25,26,51
14,2,5,27,28,55
29,4,10,110,116,226
19,4,10,72,76,148
2,3,9,8,6,14
1,3,9,4,3,7
8,2,5,19,16,35
30,2,5,71,60,131
13,4,10,49,52,101
24,4,10,91,96,187
6,2,5,18,12,30
23,3,9,95,69,164
4,2,5,9,8,17
17,7,9,2,119,121
30,7,9,1,210,211
22,7,9,36,154,190
18,7,9,30,126,156
4,7,9,7,28,35
11,3,8,54,33,87
13,3,8,48,39,87
13,8,22,145,104,249
5,8,22,69,40,109
5,9,24,74,45,119
4,9,24,59,36,95
13,9,24,129,117,246
2,9,24,22,18,40
25,9,24,279,225,504
22,9,24,214,198,412
8,9,24,95,72,167
7,9,24,68,63,131
18,13,35,264,234,498
17,13,35,297,221,518
7,13,35,144,91,235
4,13,35,82,52,134
8,13,35,173,104,277
30,13,35,639,390,1029
7,13,35,115,91,206
2,13,35,35,26,61
7,13,35,122,91,213
18,13,35,314,234,548
17,13,35,243,221,464
29,13,35,455,377,832
2,13,35,29,26,55
16,13,35,330,208,538
26,13,35,408,338,746
20,13,35,314,260,574
25,13,35,436,325,761
2,13,35,35,26,61
15,13,35,257,195,452
28,21,55,921,588,1509
8,21,55,180,168,348
3,42,54,34,126,160
9,42,54,6,378,384
13,42,54,72,546,618
4,42,54,0,168,168
7,38,50,21,266,287
2,42,54,10,84,94
1,1266,2320,544,1266,1810
1,1266,2320,683,1266,1949
3,1252,2295,1477,3756,5233
3,308,565,737,924,1661
3,308,565,466,924,1390
2,1252,2295,1076,2504,3580
2,1266,2320,1087,2532,3619
1,1083,1701,244,1083,1327
1,487,783,265,487,752
1,2171,3578,942,2171,3113
3,1555,2443,1711,4665,6376
1,713,1120,385,713,1098
1,344,540,191,344,535
1,487,783,132,487,619
2,344,540,219,688,907
1,26,70,29,26,55
2,26,70,87,52,139
19,26,70,543,494,1037
7,3,9,34,21,55
18,1,4,53,18,71
25,8,21,215,200,415
13,13,35,190,169,359
20,13,35,293,260,553
8,13,35,117,104,221
29,11,30,542,319,861
22,1,4,62,22,84
23,1,4,65,23,88
9,13,35,154,117,271
5,13,35,86,65,151
6,13,35,103,78,181
7,1,2,6,7,13
4,11,30,60,44,104
14,11,30,211,154,365
12,1,4,30,12,42
25,1,4,62,25,87
8,1,2,4,8,12
16,1,4,40,16,56
3,1,4,7,3,10
6,11,30,110,66,176
21,11,30,386,231,617
4,11,30,74,44,118
20,9,25,315,180,495
11,9,25,173,99,272
27,9,25,425,243,668
16,11,30,285,176,461
25,9,25,288,225,513
19,9,25,219,171,390
1,2,5,3,2,5
15,2,5,35,30,65
1,2,5,2,2,4
26,11,30,486,286,772
3,11,30,56,33,89
14,1,4,41,14,55
9,1,4,26,9,35
6,11,29,77,66,143
20,11,29,256,220,476
14,1,4,41,14,55
19,1,4,55,19,74
12,1,2,7,12,19
9,1,2,6,9,15
8,8,21,97,64,161
2,2,5,5,4,9
12,2,5,28,24,52
28,2,5,66,56,122
14,1,2,10,14,24
19,1,2,14,19,33
25,1,2,16,25,41
32,1,2,20,32,52
7,2,5,15,14,29
27,2,5,59,54,113
1,2,5,2,2,4
7,9,25,74,63,137
30,9,25,315,270,585
20,1,4,50,20,70
3,461,742,554,1383,1937
1,1482,2384,807,1482,2289
1,1482,2384,378,1482,1860
1,755,1215,436,755,1191
1,755,1215,436,755,1191
1,461,742,185,461,646
8,24,64,228,192,420
24,24,64,929,576,1505
21,45,120,1046,945,1991
2,59,159,159,118,277
11,3,9,62,33,95
10,3,9,56,30,86
17,3,9,91,51,142
13,3,9,70,39,109
17,2,5,32,34,66
26,2,5,49,52,101
26,4,10,153,104,257
30,2,5,71,60,131
16,2,5,38,32,70
27,4,10,103,108,211
8,2,5,18,16,34
20,2,5,46,40,86
2,4,10,9,8,17
14,4,10,62,56,118
26,2,5,75,52,127
13,2,5,38,26,64
11,3,9,64,33,97
11,3,9,64,33,97
5,3,9,21,15,36
3,3,9,12,9,21
21,3,9,90,63,153
23,2,5,54,46,100
30,2,5,71,60,131
20,7,9,38,140,178
29,7,9,24,203,227
24,7,9,44,168,212
5,7,9,4,35,39
4,7,9,7,28,35
10,3,8,33,30,63
9,3,8,36,27,63
3,3,8,12,9,21
13,8,22,162,104,266
17,8,22,234,136,370
16,8,22,199,128,327
18,9,24,266,162,428
9,9,24,131,81,212
10,9,24,107,90,197
17,9,24,247,153,400
8,9,24,80,72,152
12,9,24,125,108,233
14,13,35,244,182,426
19,13,35,371,247,618
24,13,35,469,312,781
16,13,35,341,208,549
15,13,35,325,195,520
22,13,35,361,286,647
29,13,35,618,377,995
25,13,35,541,325,866
4,13,35,73,52,125
28,13,35,577,364,941
4,13,35,63,52,115
10,13,35,171,130,301
18,13,35,383,234,617
31,13,35,487,403,890
14,21,55,337,294,631
18,21,55,454,378,832
5,42,54,57,210,267
1,38,50,12,38,50
10,42,54,115,420,535
16,42,54,157,672,829
13,38,50,130,494,624
23,42,54,226,966,1192
23,42,54,189,966,1155
8,42,54,36,336,372
1,1266,2320,752,1266,2018
2,1266,2320,2015,2532,4547
1,420,769,180,420,600
1,420,769,295,420,715
1,308,565,155,308,463
1,1266,2320,683,1266,1949
1,1266,2320,636,1266,1902
1,1252,2295,1020,1252,2272
2,420,769,636,840,1476
1,1252,2295,1020,1252,2272
3,1252,2295,2647,3756,6403
2,487,783,561,974,1535
1,2171,3578,942,2171,3113
2,713,1120,411,1426,1837
1,344,540,174,344,518
1,26,70,43,26,69
17,2,5,49,34,83
27,1,2,20,27,47
23,1,2,17,23,40
9,1,2,7,9,16
22,1,2,21,22,43
1,1,2,1,1,2
1,13,35,21,13,34
15,13,35,320,195,515
1,12,33,15,12,27
9,2,5,27,18,45
28,2,5,83,56,139
20,2,5,46,40,86
3,1,2,2,3,5
22,11,30,299,242,541
9,11,30,122,99,221
1,11,30,18,11,29
13,11,30,239,143,382
27,11,30,497,297,794
14,11,30,220,154,374
2,11,30,31,22,53
4,1,2,3,4,7
11,9,25,165,99,264
20,1,2,14,20,34
7,1,2,5,7,12
30,1,2,22,30,52
3,2,5,9,6,15
24,2,5,70,48,118
18,1,2,10,18,28
8,1,2,5,8,13
4,2,5,9,8,17
27,2,5,63,54,117
19,2,5,45,38,83
27,1,4,79,27,106
1,1482,2384,401,1482,1883
3,755,1215,1234,2265,3499
1,1482,2384,854,1482,2336
1,755,1215,375,755,1130
1,461,742,251,461,712
26,2,5,61,52,113
13,2,5,31,26,57
29,2,5,71,58,129
21,2,5,51,42,93
6,3,9,34,18,52
20,4,10,118,80,198
25,4,10,148,100,248
2,2,5,6,4,10
1,2,5,3,2,5
27,2,5,76,54,130
16,2,5,45,32,77
1,2,5,3,2,5
21,2,5,61,42,103
17,2,5,49,34,83
19,2,5,56,38,94
14,2,5,27,28,55
9,2,5,17,18,35
25,3,9,103,75,178
10,3,9,44,30,74
3,3,9,13,9,22
5,2,5,12,10,22
3,2,5,7,6,13
32,3,9,180,96,276
12,7,9,20,84,104
28,7,9,51,196,247
26,3,8,122,78,200
22,3,8,106,66,172
23,3,8,76,69,145
23,8,22,211,184,395
1,8,22,14,8,22
12,8,22,157,96,253
25,8,22,345,200,545
22,9,24,261,198,459
14,9,24,203,126,329
10,9,24,145,90,235
25,13,35,436,325,761
16,13,35,330,208,538
18,13,35,383,234,617
23,13,35,490,299,789
1,13,35,21,13,34
8,13,35,140,104,244
20,13,35,314,260,574
23,13,35,450,299,749
22,13,35,453,286,739
12,13,35,247,156,403
1,13,35,17,13,30
26,13,35,454,338,792
1,13,35,22,13,35
21,13,35,359,273,632
5,38,50,5,190,195
8,38,50,80,304,384
23,42,54,251,966,1217
16,38,50,184,608,792
1,1912,3400,1046,1912,2958
2,420,769,636,840,1476
1,1266,2320,544,1266,1810
1,1266,2320,1008,1266,2274
2,1266,2320,1922,2532,4454
3,420,769,747,1260,2007
1,420,769,318,420,738
1,1266,2320,636,1266,1902
2,308,565,469,616,1085
3,1555,2443,2371,4665,7036
1,1519,2443,606,1519,2125
3,1083,1701,1293,3249,4542
2,344,540,154,688,842
1,344,540,191,344,535
1,487,783,132,487,619
1,344,540,126,344,470
4,26,70,165,104,269
26,26,70,1108,676,1784
13,26,70,554,338,892
24,3,9,140,72,212
14,2,5,41,28,69
18,13,35,383,234,617
6,13,35,128,78,206
10,2,5,20,20,40
10,2,5,20,20,40
7,1,2,7,7,14
20,1,2,19,20,39
16,1,2,15,16,31
4,1,2,4,4,8
16,2,5,47,32,79
17,2,5,50,34,84
1,1,2,1,1,2
3,1,2,3,3,6
19,2,5,45,38,83
5,2,5,12,10,22
9,2,5,21,18,39
15,1,4,44,15,59
32,1,4,95,32,127
27,13,35,528,351,879
22,13,35,430,286,716
29,2,5,86,58,144
15,2,5,42,30,72
28,1,2,21,28,49
16,1,2,10,16,26
1,1,2,1,1,2
7,2,5,13,14,27
27,2,5,51,54,105
1,2,5,2,2,4
13,2,5,25,26,51
29,2,5,71,58,129
3,2,5,7,6,13
26,12,33,357,312,669
4,12,33,55,48,103
18,12,33,247,216,463
18,2,5,41,36,77
14,1,4,40,14,54
21,2,5,49,42,91
12,2,5,28,24,52
30,2,5,71,60,131
19,2,5,45,38,83
19,2,5,44,38,82
27,2,5,62,54,116
24,2,5,70,48,118
19,2,5,55,38,93
21,1,4,60,21,81
1,1,4,3,1,4
18,8,21,219,144,363
19,8,21,231,152,383
1,1482,2384,330,1482,1812
1,1482,2384,401,1482,1883
1,755,1215,302,755,1057
3,1482,2384,2420,4446,6866
1,755,1215,436,755,1191
2,755,1215,483,1510,1993
1,1482,2384,854,1482,2336
1,1482,2384,378,1482,1860
2,461,742,547,922,1469
2,461,742,532,922,1454
25,3,9,121,75,196
4,3,9,19,12,31
23,2,5,54,46,100
22,2,5,52,44,96
8,2,5,19,16,35
31,2,5,65,62,127
16,2,5,34,32,66
19,2,5,44,38,82
7,2,5,16,14,30
2,2,5,5,4,9
24,2,5,70,48,118
9,2,5,26,18,44
21,2,5,61,42,103
17,2,5,39,34,73
6,2,5,17,12,29
4,2,5,12,8,20
3,2,5,6,6,12
3,2,5,6,6,12
14,2,5,37,28,65
6,4,10,35,24,59
15,4,10,87,60,147
10,3,9,59,30,89
8,3,9,47,24,71
7,3,9,29,21,50
15,3,9,62,45,107
8,2,5,19,16,35
4,2,5,9,8,17
27,4,10,159,108,267
24,2,5,71,48,119
10,2,5,24,20,44
23,2,5,54,46,100
6,7,9,5,42,47
10,7,9,18,70,88
29,7,9,48,203,251
3,7,9,0,21,21
20,7,9,8,140,148
21,7,9,-3,147,144
25,7,9,46,175,221
17,7,9,0,119,119
9,7,9,1,63,64
22,7,9,16,154,170
13,3,8,42,39,81
11,3,8,44,33,77
14,3,8,55,42,97
14,3,8,66,42,108
28,3,8,111,84,195
14,8,22,184,112,296
24,8,22,267,192,459
29,8,22,393,232,625
16,8,22,147,128,275
25,8,22,279,200,479
11,9,24,107,99,206
1,9,24,15,9,24
23,9,24,323,207,530
14,13,35,220,182,402
11,13,35,180,143,323
26,13,35,454,338,792
4,13,35,82,52,134
20,13,35,412,260,672
9,13,35,192,117,309
12,13,35,172,156,328
3,13,35,59,39,98
17,13,35,362,221,583
23,13,35,401,299,700
21,13,35,300,273,573
13,13,35,277,169,446
23,13,35,401,299,700
20,13,35,426,260,686
22,13,35,476,286,762
22,13,35,384,286,670
18,13,35,383,234,617
11,13,35,227,143,370
17,21,55,410,357,767
19,38,50,105,722,827
3,38,50,33,114,147
17,42,54,2,714,716
10,38,50,110,380,490
6,42,54,59,252,311
1,1252,2295,997,1252,2249
1,1252,2295,745,1252,1997
1,1252,2295,722,1252,1974
1,420,769,334,420,754
2,1252,2295,1902,2504,4406
1,1266,2320,752,1266,2018
1,1252,2295,951,1252,2203
1,295,540,234,295,529
3,1266,2320,2257,3798,6055
1,308,565,184,308,492
1,1266,2320,544,1266,1810
1,1252,2295,538,1252,1790
1,1898,3375,1443,1898,3341
1,2171,3578,1335,2171,3506
1,1519,2443,826,1519,2345
2,1083,1701,420,2166,2586
1,2171,3578,942,2171,3113
2,713,1120,724,1426,2150
1,344,540,174,344,518
1,344,540,191,344,535
1,344,540,174,344,518
6,26,70,260,156,416
14,26,70,606,364,970
18,26,70,515,468,983
5,3,9,30,15,45
30,2,5,87,60,147
15,2,5,44,30,74
16,2,5,46,32,78
17,1,2,16,17,33
10,1,2,7,10,17
29,1,2,21,29,50
17,1,2,13,17,30
7,1,2,7,7,14
14,1,2,13,14,27
19,1,2,18,19,37
13,9,25,166,117,283
12,9,25,153,108,261
4,9,25,51,36,87
23,1,2,15,23,38
2,1,2,1,2,3
17,2,5,45,34,79
20,2,5,53,40,93
12,2,5,28,24,52
9,9,25,115,81,196
3,1,2,3,3,6
15,1,2,13,15,28
27,1,2,26,27,53
22,1,2,22,22,44
7,11,30,125,77,202
1,1,2,1,1,2
20,1,2,11,20,31
9,1,2,5,9,14
9,11,30,112,99,211
3,2,5,7,6,13
1,2,5,2,2,4
30,2,5,71,60,131
14,2,5,27,28,55
13,8,21,134,104,238
31,8,21,318,248,566
25,1,2,18,25,43
28,1,2,20,28,48
17,2,5,32,34,66
3,2,5,8,6,14
23,1,4,65,23,88
24,1,4,68,24,92
2,1482,2384,1470,2964,4434
1,1482,2384,592,1482,2074
1,1482,2384,401,1482,1883
1,1482,2384,521,1482,2003
1,1482,2384,592,1482,2074
1,1482,2384,473,1482,1955
2,1482,2384,1709,2964,4673
2,755,1215,483,1510,1993
18,2,5,42,36,78
29,2,5,68,58,126
14,4,10,78,56,134
23,2,5,67,46,113
13,2,5,38,26,64
19,2,5,45,38,83
11,2,5,26,22,48
17,2,5,39,34,73
18,2,5,41,36,77
19,2,5,36,38,74
24,2,5,46,48,94
4,2,5,8,8,16
6,3,9,24,18,42
4,3,9,16,12,28
26,7,9,22,182,204
21,7,9,40,147,187
10,7,9,1,70,71
17,7,9,14,119,133
6,7,9,0,42,42
16,3,8,75,48,123
20,8,22,183,160,343
21,8,22,276,168,444
1,8,22,9,8,17
3,9,24,35,27,62
5,9,24,59,45,104
24,13,35,410,312,722
11,13,35,234,143,377
29,13,35,597,377,974
18,13,35,383,234,617
1,13,35,21,13,34
18,13,35,257,234,491
3,13,35,44,39,83
24,13,35,494,312,806
28,13,35,459,364,823
23,21,55,769,483,1252
11,38,50,11,418,429
15,42,54,10,630,640
28,38,50,280,1064,1344
25,42,54,125,1050,1175
2,1252,2295,1902,2504,4406
1,1252,2295,951,1252,2203
1,420,769,341,420,761
1,420,769,188,420,608
1,1252,2295,538,1252,1790
1,295,540,126,295,421
2,308,565,367,616,983
1,1555,2443,790,1555,2345
1,1083,1701,550,1083,1633
1,713,1120,250,713,963
1,713,1120,385,713,1098
1,487,783,265,487,752
1,1083,1701,312,1083,1395
17,26,70,736,442,1178
1,26,70,43,26,69
4,26,70,170,104,274
2,26,70,66,52,118
19,2,5,55,38,93
21,2,5,61,42,103
14,13,35,239,182,421
7,13,35,120,91,211
23,2,5,64,46,110
14,2,5,39,28,67
9,1,2,8,9,17
23,1,2,21,23,44
10,1,2,6,10,16
5,1,2,4,5,9
9,1,2,8,9,17
8,1,2,7,8,15
28,1,2,19,28,47
15,1,2,10,15,25
20,11,30,356,220,576
9,11,30,160,99,259
18,13,35,314,234,548
5,13,35,87,65,152
26,1,2,17,26,43
20,1,2,18,20,38
25,1,2,23,25,48
13,11,30,243,143,386
16,11,30,299,176,475
21,2,5,49,42,91
20,2,5,38,40,78
7,2,5,13,14,27
8,11,30,99,88,187
7,11,30,87,77,164
20,1,2,19,20,39
28,1,2,27,28,55
16,2,5,46,32,78
10,1,4,25,10,35
10,45,120,498,450,948
11,4,10,62,44,106
19,4,10,106,76,182
23,2,5,45,46,91
8,2,5,16,16,32
24,2,5,71,48,119
3,2,5,9,6,15
4,2,5,11,8,19
4,2,5,11,8,19
3,2,5,9,6,15
20,2,5,42,40,82
27,2,5,51,54,105
2,2,5,4,4,8
26,4,10,99,104,203
17,4,10,65,68,133
14,4,10,64,56,120
14,7,9,10,98,108
9,7,9,12,63,75
1,7,9,0,7,7
20,7,9,17,140,157
1,7,9,1,7,8
7,3,8,23,21,44
12,3,8,56,36,92
6,3,8,27,18,45
15,3,8,49,45,94
19,8,22,258,152,410
8,8,22,108,64,172
26,8,22,353,208,561
30,8,22,374,240,614
2,9,24,19,18,37
10,9,24,112,90,202
19,9,24,203,171,374
12,9,24,174,108,282
13,13,35,227,169,396
31,13,35,639,403,1042
21,13,35,366,273,639
2,13,35,29,26,55
1,13,35,21,13,34
4,13,35,82,52,134
4,13,35,70,52,122
7,13,35,149,91,240
17,13,35,267,221,488
16,13,35,274,208,482
16,13,35,279,208,487
13,13,35,254,169,423
23,13,35,329,299,628
16,21,55,350,336,686
19,21,55,625,399,1024
3,42,54,33,126,159
7,38,50,70,266,336
20,42,54,13,840,853
18,38,50,72,684,756
26,38,50,299,988,1287
14,42,54,77,588,665
18,42,54,12,756,768
1,1266,2320,961,1266,2227
3,1252,2295,2854,3756,6610
1,1266,2320,1008,1266,2274
1,1252,2295,882,1252,2134
1,308,565,246,308,554
1,344,540,185,344,529
1,1555,2443,717,1555,2272
1,1083,1701,499,1083,1582
3,2171,3578,1967,6513,8480
3,2171,3578,2504,6513,9017
3,1555,2443,1711,4665,6376
1,344,540,120,344,464
2,344,540,370,688,1058
1,2171,3578,1335,2171,3506
1,713,1120,172,713,885
24,26,70,703,624,1327
5,26,70,143,130,273
16,26,70,458,416,874
10,1,2,10,10,20
7,2,5,16,14,30
2,2,5,5,4,9
13,2,5,34,26,60
17,2,5,45,34,79
17,2,5,40,34,74
13,2,5,31,26,57
7,2,5,20,14,34
14,2,5,41,28,69
12,2,5,35,24,59
13,9,25,202,117,319
19,9,25,295,171,466
28,2,5,53,56,109
28,2,5,78,56,134
6,2,5,17,12,29
9,2,5,25,18,43
3,1,2,3,3,6
10,2,5,28,20,48
25,2,5,70,50,120
28,1,2,16,28,44
18,1,2,10,18,28
6,1,2,6,6,12
28,1,2,27,28,55
7,1,2,6,7,13
1,2,5,2,2,4
26,1,2,19,26,45
31,2,5,73,62,135
20,2,5,58,40,98
3,2,5,9,6,15
31,1,4,78,31,109
21,9,25,315,189,504
10,9,25,150,90,240
13,2,5,38,26,64
23,1,2,13,23,36
6,1,2,3,6,9
1,1482,2384,592,1482,2074
2,1482,2384,1613,2964,4577
1,461,742,185,461,646
1,461,742,229,461,690
1,45,120,49,45,94
1,59,159,98,59,157
8,2,5,19,16,35
10,2,5,19,20,39
28,2,5,53,56,109
27,2,5,51,54,105
5,2,5,10,10,20
18,2,5,42,36,78
18,2,5,42,36,78
24,4,10,139,96,235
29,4,10,168,116,284
5,2,5,15,10,25
14,2,5,41,28,69
5,2,5,12,10,22
31,2,5,73,62,135
12,3,9,58,36,94
19,2,5,45,38,83
5,2,5,10,10,20
3,2,5,6,6,12
5,3,9,28,15,43
29,2,5,84,58,142
8,2,5,23,16,39
20,2,5,56,40,96
12,2,5,34,24,58
8,7,9,15,56,71
29,7,9,24,203,227
4,7,9,4,28,32
15,7,9,29,105,134
19,7,9,11,133,144
12,7,9,10,84,94
16,7,9,26,112,138
5,7,9,4,35,39
1,7,9,1,7,8
8,3,8,39,24,63
19,3,8,92,57,149
22,3,8,78,66,144
19,3,8,62,57,119
12,8,22,131,96,227
7,8,22,95,56,151
24,8,22,331,192,523
25,8,22,345,200,545
25,9,24,369,225,594
4,9,24,58,36,94
9,9,24,131,81,212
23,9,24,339,207,546
1,13,35,21,13,34
13,13,35,281,169,450
11,13,35,238,143,381
29,13,35,597,377,974
8,13,35,173,104,277
3,13,35,62,39,101
22,13,35,476,286,762
12,13,35,218,156,374
26,13,35,454,338,792
23,13,35,498,299,797
8,13,35,114,104,218
9,13,35,185,117,302
9,13,35,192,117,309
13,13,35,277,169,446
4,13,35,70,52,122
29,13,35,597,377,974
17,13,35,338,221,559
6,13,35,86,78,164
18,13,35,257,234,491
25,21,55,823,525,1348
9,21,55,197,189,386
8,42,54,92,336,428
25,38,50,288,950,1238
31,38,50,31,1178,1209
24,42,54,120,1008,1128
11,38,50,127,418,545
10,38,50,55,380,435
24,38,50,24,912,936
28,38,50,322,1064,1386
27,42,54,18,1134,1152
31,38,50,341,1178,1519
21,38,50,189,798,987
1,1252,2295,997,1252,2249
3,1266,2320,1631,3798,5429
1,1266,2320,636,1266,1902
1,420,769,341,420,761
3,1252,2295,1890,3756,5646
3,1266,2320,3023,3798,6821
1,1083,1701,397,1083,1480
2,1555,2443,1727,3110,4837
3,344,540,523,1032,1555
18,26,70,779,468,1247
24,3,9,99,72,171
2,2,5,4,4,8
28,2,5,81,56,137
22,2,5,64,44,108
6,13,35,128,78,206
8,1,2,8,8,16
28,2,5,66,56,122
1,2,5,2,2,4
27,2,5,76,54,130
17,2,5,48,34,82
22,11,30,411,242,653
16,11,30,299,176,475
23,1,2,13,23,36
8,2,5,22,16,38
11,2,5,31,22,53
6,9,25,65,54,119
18,9,25,194,162,356
9,1,2,9,9,18
29,12,33,599,348,947
21,12,33,434,252,686
23,2,5,44,46,90
19,2,5,36,38,74
20,1,2,19,20,39
27,1,2,21,27,48
19,1,2,15,19,34
14,1,2,10,14,24
18,1,2,13,18,31
1,2,5,3,2,5
17,2,5,40,34,74
4,2,5,9,8,17
8,9,25,126,72,198
20,9,25,315,180,495
5,1,4,14,5,19
18,1,4,51,18,69
12,2,5,28,24,52
3,2,5,7,6,13
25,1,2,19,25,44
1,1,2,1,1,2
16,2,5,47,32,79
11,2,5,32,22,54
30,1,4,64,30,94
28,1,2,27,28,55
28,1,2,27,28,55
13,1,2,8,13,21
26,1,2,17,26,43
22,12,33,447,264,711
13,12,33,264,156,420
4,1,2,4,4,8
5,1,2,5,5,10
11,2,5,32,22,54
6,2,5,16,12,28
17,2,5,46,34,80
12,1,2,9,12,21
13,1,2,7,13,20
25,1,2,14,25,39
28,1,2,16,28,44
16,1,4,47,16,63
21,1,4,61,21,82
3,1,4,9,3,12
9,1,4,26,9,35
3,461,742,798,1383,2181
2,461,742,236,922,1158
2,1482,2384,1613,2964,4577
16,45,120,1162,720,1882
3,45,120,160,135,295
9,3,9,48,27,75
19,3,9,102,57,159
4,2,5,8,8,16
11,2,5,21,22,43
18,2,5,52,36,88
26,2,5,75,52,127
4,2,5,12,8,20
4,2,5,12,8,20
27,3,9,152,81,233
20,3,9,113,60,173
14,2,5,39,28,67
20,3,9,116,60,176
9,3,9,52,27,79
11,3,9,62,33,95
14,2,5,41,28,69
15,2,5,44,30,74
31,2,5,68,62,130
14,7,9,5,98,103
8,7,9,11,56,67
9,7,9,17,63,80
27,7,9,22,189,211
3,7,9,2,21,23
5,7,9,9,35,44
18,3,8,71,54,125
13,3,8,63,39,102
17,3,8,56,51,107
19,3,8,62,57,119
13,8,22,176,104,280
16,8,22,217,128,345
3,8,22,37,24,61
28,8,22,312,224,536
7,8,22,73,56,129
6,9,24,80,54,134
5,9,24,73,45,118
6,13,35,128,78,206
6,13,35,88,78,166
4,13,35,78,52,130
21,13,35,330,273,603
29,13,35,425,377,802
14,13,35,298,182,480
29,13,35,597,377,974
29,13,35,618,377,995
9,13,35,176,117,293
8,13,35,170,104,274
24,13,35,419,312,731
25,13,35,541,325,866
24,13,35,511,312,823
22,13,35,469,286,755
24,13,35,511,312,823
18,13,35,283,234,517
24,13,35,343,312,655
11,13,35,234,143,377
1,13,35,15,13,28
20,13,35,412,260,672
1,13,35,21,13,34
25,13,35,533,325,858
7,13,35,149,91,240
2,13,35,29,26,55
23,21,55,516,483,999
17,38,50,196,646,842
21,42,54,48,882,930
20,42,54,100,840,940
2,38,50,20,76,96
11,42,54,7,462,469
2,1252,2295,1765,2504,4269
1,420,769,334,420,754
3,295,540,443,885,1328
1,1266,2320,1008,1266,2274
1,1266,2320,892,1266,2158
1,1266,2320,1008,1266,2274
3,1252,2295,2647,3756,6403
2,1252,2295,1489,2504,3993
1,420,769,249,420,669
1,308,565,246,308,554
1,295,540,126,295,421
2,1555,2443,1141,3110,4251
3,344,540,556,1032,1588
2,2171,3578,1669,4342,6011
3,2171,3578,1967,6513,8480
1,713,1120,161,713,874
1,713,1120,385,713,1098
1,713,1120,205,713,918
1,1555,2443,375,1555,1930
1,713,1120,362,713,1075
2,344,540,370,688,1058
2,344,540,370,688,1058
1,344,540,99,344,443
1,1083,1701,550,1083,1633
1,713,1120,362,713,1075
25,26,70,715,650,1365
13,3,9,53,39,92
9,3,9,52,27,79
21,13,35,447,273,720
19,1,2,18,19,37
21,1,2,20,21,41
27,1,4,77,27,104
18,1,4,51,18,69
5,2,5,14,10,24
17,2,5,48,34,82
12,8,21,103,96,199
24,8,21,206,192,398
14,2,5,41,28,69
1,9,25,11,9,20
14,9,25,151,126,277
5,12,33,98,60,158
30,12,33,590,360,950
13,12,33,256,156,412
29,13,35,618,377,995
2,13,35,35,26,61
4,1,2,3,4,7
21,1,2,16,21,37
22,12,33,455,264,719
25,12,33,517,300,817
26,2,5,49,52,101
20,2,5,38,40,78
11,2,5,32,22,54
21,2,5,44,42,86
3,2,5,7,6,13
9,2,5,21,18,39
5,2,5,15,10,25
19,2,5,55,38,93
15,9,25,191,135,326
15,9,25,191,135,326
1,9,25,13,9,22
20,1,2,15,20,35
13,1,2,10,13,23
13,12,33,196,156,352
1,12,33,15,12,27
18,1,2,13,18,31
1,2,5,2,2,4
3,2,5,6,6,12
3,2,5,6,6,12
15,1,2,13,15,28
21,1,2,18,21,39
5,8,21,51,40,91
12,2,5,23,24,47
22,2,5,42,44,86
12,11,29,153,132,285
7,11,29,89,77,166
24,1,2,21,24,45
19,8,21,231,152,383
10,8,21,122,80,202
1,2,5,2,2,4
15,2,5,29,30,59
4,2,5,9,8,17
2,1482,2384,803,2964,3767
1,1482,2384,807,1482,2289
3,755,1215,1307,2265,3572
2,1482,2384,1709,2964,4673
1,461,742,185,461,646
1,461,742,266,461,727
6,24,64,156,144,300
14,24,64,524,336,860
4,45,120,199,180,379
5,45,120,291,225,516
4,45,120,185,180,365
9,4,10,50,36,86
18,2,5,35,36,71
9,2,5,18,18,36
4,2,5,11,8,19
6,2,5,17,12,29
23,4,10,129,92,221
2,4,10,11,8,19
31,2,5,73,62,135
23,2,5,54,46,100
11,4,10,65,44,109
31,2,5,73,62,135
23,2,5,54,46,100
5,3,9,23,15,38
23,3,9,105,69,174
13,2,5,38,26,64
30,2,5,87,60,147
25,2,5,73,50,123
6,2,5,17,12,29
27,2,5,63,54,117
19,4,10,72,76,148
13,4,10,49,52,101
10,2,5,29,20,49
9,2,5,26,18,44
15,2,5,44,30,74
23,2,5,48,46,94
11,2,5,23,22,45
11,2,5,29,22,51
22,2,5,58,44,102
8,2,5,23,16,39
2,2,5,6,4,10
10,2,5,28,20,48
16,3,9,95,48,143
20,3,9,118,60,178
5,3,9,20,15,35
9,3,9,36,27,63
27,2,5,59,54,113
9,2,5,20,18,38
3,2,5,8,6,14
18,2,5,50,36,86
20,3,9,97,60,157
27,3,9,130,81,211
11,2,5,32,22,54
24,3,9,116,72,188
23,3,9,111,69,180
1,7,9,1,7,8
23,7,9,19,161,180
23,7,9,0,161,161
6,7,9,10,42,52
2,7,9,4,14,18
1,7,9,2,7,9
9,7,9,17,63,80
18,7,9,33,126,159
9,7,9,7,63,70
21,7,9,40,147,187
22,7,9,8,154,162
2,7,9,2,14,16
3,7,9,5,21,26
18,7,9,34,126,160
10,3,8,47,30,77
32,3,8,157,96,253
10,3,8,47,30,77
4,8,22,44,32,76
20,8,22,183,160,343
25,8,22,328,200,528
3,8,22,41,24,65
27,8,22,247,216,463
29,8,22,291,232,523
16,8,22,147,128,275
21,8,22,289,168,457
20,8,22,223,160,383
1,9,24,15,9,24
20,9,24,223,180,403
10,9,24,100,90,190
9,9,24,133,81,214
15,9,24,146,135,281
16,9,24,232,144,376
29,9,24,386,261,647
29,9,24,338,261,599
30,9,24,356,270,626
20,13,35,293,260,553
1,13,35,21,13,34
11,13,35,180,143,323
11,13,35,238,143,381
13,13,35,254,169,423
26,13,35,536,338,874
13,13,35,268,169,437
23,13,35,474,299,773
19,13,35,272,247,519
24,13,35,494,312,806
1,13,35,22,13,35
5,13,35,89,65,154
7,13,35,137,91,228
20,13,35,342,260,602
7,13,35,149,91,240
7,13,35,115,91,206
3,13,35,51,39,90
1,13,35,21,13,34
6,13,35,105,78,183
1,13,35,17,13,30
23,13,35,377,299,676
14,13,35,249,182,431
28,13,35,489,364,853
1,13,35,16,13,29
17,13,35,279,221,500
19,13,35,411,247,658
6,13,35,130,78,208
29,13,35,496,377,873
3,13,35,59,39,98
3,13,35,62,39,101
5,13,35,87,65,152
4,13,35,63,52,115
22,21,55,724,462,1186
16,21,55,509,336,845
9,21,55,301,189,490
6,21,55,161,126,287
24,21,55,790,504,1294
1,21,55,33,21,54
22,21,55,591,462,1053
22,21,55,591,462,1053
4,21,55,96,84,180
9,42,54,89,378,467
4,38,50,44,152,196
12,38,50,60,456,516
10,38,50,100,380,480
3,38,50,3,114,117
7,42,54,76,294,370
19,38,50,190,722,912
28,38,50,308,1064,1372
25,38,50,250,950,1200
19,38,50,29,722,751
29,42,54,332,1218,1550
21,38,50,105,798,903
30,38,50,90,1140,1230
22,42,54,110,924,1034
12,42,54,99,504,603
1,1912,3400,944,1912,2856
1,1252,2295,1020,1252,2272
2,1898,3375,1874,3796,5670
2,1266,2320,1922,2532,4454
3,1266,2320,2884,3798,6682
1,1252,2295,745,1252,1997
1,1266,2320,1008,1266,2274
2,1252,2295,1994,2504,4498
1,1252,2295,538,1252,1790
1,1252,2295,951,1252,2203
1,1252,2295,676,1252,1928
1,1252,2295,1020,1252,2272
1,308,565,184,308,492
1,1252,2295,997,1252,2249
2,1252,2295,1902,2504,4406
3,1252,2295,1614,3756,5370
1,1266,2320,961,1266,2227
1,1266,2320,752,1266,2018
2,487,783,561,974,1535
1,1555,2443,790,1555,2345
1,1519,2443,753,1519,2272
1,2171,3578,942,2171,3113
3,713,1120,1087,2139,3226
2,2171,3578,1884,4342,6226
1,1519,2443,533,1519,2052
1,344,540,174,344,518
1,344,540,174,344,518
1,713,1120,138,713,851
3,1083,1701,1752,3249,5001
1,1519,2443,411,1519,1930
1,1083,1701,312,1083,1395
1,344,540,131,344,475
3,487,783,583,1461,2044
1,1083,1701,550,1083,1633
3,344,540,296,1032,1328
1,487,783,194,487,681
1,344,540,174,344,518
3,344,540,377,1032,1409
1,2171,3578,656,2171,2827
1,26,70,33,26,59
9,26,70,383,234,617
23,26,70,803,598,1401
8,3,9,47,24,71
22,3,9,118,66,184
4,3,9,23,12,35
15,3,9,72,45,117
11,1,4,23,11,34
23,1,4,49,23,72
7,1,4,15,7,22
16,8,21,137,128,265
7,1,2,7,7,14
22,2,5,65,44,109
5,1,2,5,5,10
19,1,2,18,19,37
26,1,2,19,26,45
13,1,2,9,13,22
1,12,33,20,12,32
8,2,5,18,16,34
18,1,2,13,18,31
29,1,2,21,29,50
3,12,33,59,36,95
15,1,2,8,15,23
1,11,29,18,11,29
26,1,2,19,26,45
14,1,2,10,14,24
28,1,4,66,28,94
3,2,5,6,6,12
1,2,5,2,2,4
21,2,5,48,42,90
4,2,5,8,8,16
6,1,2,6,6,12
25,2,5,74,50,124
21,9,25,242,189,431
30,1,2,28,30,58
16,1,2,15,16,31
4,12,33,63,48,111
22,12,33,346,264,610
18,12,33,283,216,499
16,13,35,229,208,437
8,2,5,23,16,39
1,2,5,3,2,5
21,1,4,62,21,83
3,1,4,9,3,12
20,11,30,368,220,588
11,11,30,202,121,323
11,1,2,8,11,19
11,1,2,8,11,19
21,1,2,16,21,37
10,1,2,7,10,17
13,1,2,10,13,23
5,2,5,11,10,21
23,2,5,51,46,97
18,2,5,52,36,88
13,1,2,12,13,25
3,9,25,47,27,74
29,1,2,27,29,56
24,1,2,22,24,46
18,1,2,17,18,35
26,1,2,24,26,50
16,1,2,15,16,31
30,1,2,23,30,53
23,13,35,337,299,636
24,13,35,352,312,664
20,13,35,293,260,553
29,2,5,61,58,119
2,2,5,4,4,8
17,2,5,49,34,83
5,1,2,5,5,10
19,2,5,56,38,94
16,2,5,47,32,79
12,2,5,32,24,56
24,2,5,53,48,101
29,2,5,86,58,144
26,1,4,71,26,97
25,1,2,23,25,48
11,1,2,10,11,21
27,1,4,64,27,91
5,1,4,15,5,20
16,1,4,36,16,52
22,1,4,50,22,72
7,1,4,21,7,28
9,1,4,27,9,36
7,9,25,105,63,168
24,9,25,360,216,576
14,8,21,176,112,288
1,8,21,13,8,21
16,1,4,40,16,56
11,8,21,138,88,226
29,1,4,71,29,100
25,1,4,61,25,86
15,1,2,11,15,26
22,1,2,16,22,38
24,1,2,17,24,41
9,1,2,8,9,17
6,1,2,5,6,11
19,1,2,11,19,30
8,1,4,23,8,31
2,755,1215,823,1510,2333
1,461,742,251,461,712
1,1482,2384,878,1482,2360
3,1482,2384,1419,4446,5865
3,1482,2384,2563,4446,7009
2,1482,2384,1184,2964,4148
1,755,1215,290,755,1045
1,1482,2384,854,1482,2336
1,1482,2384,854,1482,2336
1,461,742,229,461,690
1,1482,2384,807,1482,2289
10,24,64,374,240,614
13,24,64,412,312,724
5,45,120,363,225,588
6,45,120,292,270,562
11,2,5,21,22,43
24,2,5,46,48,94
8,2,5,22,16,38
8,2,5,22,16,38
19,3,9,107,57,164
13,2,5,38,26,64
8,2,5,21,16,37
8,2,5,15,16,31
1,2,5,2,2,4
12,2,5,34,24,58
24,2,5,67,48,115
14,3,9,66,42,108
24,3,9,114,72,186
21,2,5,41,42,83
1,2,5,2,2,4
27,4,10,127,108,235
24,4,10,113,96,209
23,2,5,64,46,110
10,2,5,28,20,48
13,3,9,70,39,109
11,3,9,59,33,92
25,3,9,110,75,185
9,3,9,39,27,66
1,7,9,2,7,9
7,7,9,0,49,49
21,7,9,38,147,185
14,7,9,25,98,123
2,7,9,3,14,17
1,7,9,0,7,7
16,7,9,26,112,138
17,8,22,231,136,367
6,8,22,55,48,103
4,8,22,37,32,69
31,8,22,311,248,559
18,8,22,244,144,388
26,8,22,353,208,561
14,9,24,203,126,329
5,9,24,74,45,119
4,13,35,59,52,111
8,13,35,117,104,221
1,13,35,16,13,29
6,13,35,86,78,164
27,13,35,575,351,926
25,13,35,533,325,858
23,13,35,474,299,773
10,13,35,136,130,266
12,13,35,235,156,391
18,13,35,371,234,605
9,13,35,154,117,271
10,13,35,196,130,326
1,13,35,17,13,30
16,13,35,330,208,538
26,21,55,827,546,1373
16,21,55,386,336,722
8,38,50,12,304,316
6,42,54,59,252,311
6,42,54,4,252,256
21,38,50,63,798,861
21,38,50,231,798,1029
10,38,50,10,380,390
4,42,54,44,168,212
8,42,54,87,336,423
3,1898,3375,3115,5694,8809
1,1252,2295,561,1252,1813
1,420,769,249,420,669
3,1252,2295,1614,3756,5370
2,420,769,636,840,1476
1,1252,2295,997,1252,2249
3,308,565,737,924,1661
3,713,1120,1087,2139,3226
1,1519,2443,484,1519,2003
3,2171,3578,1967,6513,8480
2,1519,2443,1213,3038,4251
1,1555,2443,570,1555,2125
1,344,540,185,344,529
2,344,540,349,688,1037
2,713,1120,724,1426,2150
1,344,540,126,344,470
10,26,70,426,260,686
22,26,70,937,572,1509
13,26,70,554,338,892
14,3,9,79,42,121
24,3,9,140,72,212
20,3,9,95,60,155
25,13,35,366,325,691
25,12,33,492,300,792
32,12,33,630,384,1014
12,1,2,8,12,20
14,13,35,239,182,421
23,13,35,393,299,692
1,2,5,2,2,4
2,2,5,5,4,9
6,2,5,14,12,26
19,1,2,11,19,30
23,11,30,423,253,676
13,11,30,239,143,382
7,2,5,20,14,34
14,2,5,41,28,69
8,2,5,23,16,39
18,9,25,284,162,446
21,9,25,331,189,520
4,2,5,7,8,15
17,1,2,17,17,34
3,1,2,3,3,6
9,1,4,24,9,33
3,1,4,9,3,12
7,1,4,20,7,27
1,2,5,3,2,5
5,2,5,15,10,25
22,1,4,62,22,84
28,1,4,80,28,108
31,8,21,377,248,625
1,8,21,12,8,20
2,755,1215,483,1510,1993
2,1482,2384,1136,2964,4100
3,755,1215,1125,2265,3390
1,1482,2384,807,1482,2289
16,24,64,620,384,1004
9,4,10,50,36,86
7,4,10,39,28,67
20,4,10,118,80,198
23,3,9,134,69,203
23,3,9,134,69,203
9,2,5,26,18,44
13,2,5,36,26,62
25,3,9,110,75,185
3,3,9,13,9,22
9,4,10,53,36,89
16,4,10,94,64,158
18,2,5,44,36,80
25,4,10,145,100,245
10,2,5,19,20,39
1,2,5,2,2,4
12,2,5,35,24,59
14,2,5,41,28,69
1,2,5,2,2,4
13,2,5,38,26,64
3,2,5,9,6,15
14,2,5,27,28,55
14,2,5,27,28,55
23,7,9,38,161,199
15,7,9,15,105,120
1,7,9,0,7,7
2,7,9,4,14,18
17,7,9,2,119,121
25,3,8,97,75,172
24,3,8,118,72,190
3,3,8,15,9,24
5,8,22,68,40,108
27,8,22,366,216,582
1,8,22,11,8,19
29,8,22,291,232,523
9,8,22,100,72,172
2,9,24,21,18,39
26,9,24,346,234,580
12,9,24,177,108,285
15,9,24,167,135,302
10,13,35,213,130,343
17,13,35,291,221,512
16,13,35,262,208,470
5,13,35,107,65,172
30,13,35,639,390,1029
18,13,35,383,234,617
4,13,35,85,52,137
26,13,35,408,338,746
9,13,35,195,117,312
16,13,35,251,208,459
14,13,35,200,182,382
24,13,35,511,312,823
20,13,35,314,260,574
17,13,35,350,221,571
8,13,35,170,104,274
12,21,55,395,252,647
2,21,55,67,42,109
10,38,50,85,380,465
5,38,50,58,190,248
26,42,54,298,1092,1390
6,42,54,36,252,288
13,42,54,30,546,576
21,42,54,207,882,1089
22,38,50,121,836,957
18,38,50,99,684,783
7,38,50,39,266,305
1,1898,3375,1038,1898,2936
2,1252,2295,1489,2504,3993
2,1266,2320,2015,2532,4547
1,1266,2320,1031,1266,2297
1,1266,2320,636,1266,1902
1,1266,2320,961,1266,2227
1,295,540,234,295,529
1,1898,3375,1038,1898,2936
1,2171,3578,1157,2171,3328
1,1555,2443,448,1555,2003
1,713,1120,362,713,1075
1,487,783,155,487,642
1,1555,2443,448,1555,2003
1,344,540,77,344,421
3,1083,1701,1191,3249,4440
1,2171,3578,1335,2171,3506
25,26,70,715,650,1365
25,3,9,119,75,194
12,3,9,71,36,107
12,2,5,35,24,59
13,2,5,38,26,64
13,2,5,38,26,64
23,2,5,68,46,114
6,13,35,130,78,208
14,13,35,303,182,485
3,1,2,3,3,6
12,1,2,12,12,24
19,12,33,286,228,514
3,12,33,45,36,81
10,1,2,10,10,20
9,2,5,27,18,45
6,2,5,18,12,30
2,2,5,6,4,10
26,2,5,49,52,101
24,2,5,46,48,94
17,1,2,10,17,27
5,1,2,3,5,8
9,2,5,19,18,37
3,2,5,7,6,13
6,2,5,14,12,26
7,8,21,60,56,116
22,12,33,302,264,566
5,12,33,69,60,129
25,9,25,281,225,506
18,1,2,10,18,28
1,1,4,2,1,3
19,2,5,44,38,82
9,2,5,21,18,39
16,8,21,148,128,276
4,8,21,37,32,69
12,2,5,23,24,47
15,2,5,29,30,59
9,1,4,26,9,35
26,1,4,76,26,102
1,461,742,147,461,608
1,1482,2384,854,1482,2336
3,461,742,798,1383,2181
2,24,64,56,48,104
3,45,120,218,135,353
7,45,120,349,315,664
9,2,5,17,18,35
1,2,5,2,2,4
7,2,5,21,14,35
27,2,5,80,54,134
7,2,5,21,14,35
8,2,5,24,16,40
14,2,5,41,28,69
21,2,5,61,42,103
3,2,5,8,6,14
19,2,5,53,38,91
22,2,5,64,44,108
19,2,5,55,38,93
15,4,10,87,60,147
15,4,10,87,60,147
1,4,10,6,4,10
18,2,5,52,36,88
26,4,10,99,104,203
10,4,10,38,40,78
21,2,5,61,42,103
8,2,5,23,16,39
31,2,5,60,62,122
27,2,5,53,54,107
10,2,5,24,20,44
13,2,5,31,26,57
25,3,9,119,75,194
11,3,9,52,33,85
17,2,5,33,34,67
20,3,9,80,60,140
14,3,9,56,42,98
26,7,9,43,182,225
9,7,9,0,63,63
12,7,9,10,84,94
29,7,9,55,203,258
14,7,9,12,98,110
12,7,9,16,84,100
4,3,8,19,12,31
11,3,8,43,33,76
14,3,8,68,42,110
30,3,8,97,90,187
7,8,22,64,56,120
24,8,22,241,192,433
27,8,22,235,216,451
4,8,22,45,32,77
11,8,22,152,88,240
3,9,24,29,27,56
27,9,24,379,243,622
22,9,24,256,198,454
18,13,35,314,234,548
3,13,35,62,39,101
14,13,35,190,182,372
21,13,35,374,273,647
5,13,35,87,65,152
22,13,35,476,286,762
23,13,35,490,299,789
10,13,35,143,130,273
26,13,35,408,338,746
22,13,35,469,286,755
6,13,35,128,78,206
18,13,35,383,234,617
19,13,35,325,247,572
10,21,55,329,210,539
15,21,55,477,315,792
12,42,54,138,504,642
12,38,50,138,456,594
14,42,54,138,588,726
16,38,50,160,608,768
31,42,54,104,1302,1406
9,42,54,98,378,476
1,1898,3375,1038,1898,2936
1,420,769,249,420,669
1,308,565,234,308,542
1,1252,2295,492,1252,1744
2,1083,1701,1168,2166,3334
1,1083,1701,244,1083,1327
1,2171,3578,835,2171,3006
1,1519,2443,606,1519,2125
2,1519,2443,1066,3038,4104
1,2171,3578,1335,2171,3506
1,713,1120,205,713,918
3,487,783,395,1461,1856
2,344,540,252,688,940
1,2171,3578,1335,2171,3506
15,3,9,89,45,134
20,13,35,426,260,686
10,12,33,187,120,307
15,11,29,192,165,357
3,9,25,32,27,59
27,9,25,290,243,533
28,2,5,66,56,122
21,2,5,49,42,91
22,1,2,17,22,39
9,1,2,7,9,16
17,11,29,286,187,473
18,11,29,303,198,501
18,2,5,42,36,78
10,2,5,24,20,44
24,1,2,18,24,42
18,1,2,18,18,36
25,1,2,25,25,50
3,2,5,8,6,14
7,2,5,19,14,33
3,2,5,8,6,14
6,2,5,17,12,29
1,2,5,3,2,5
20,2,5,56,40,96
17,2,5,36,34,70
1,2,5,2,2,4
20,2,5,42,40,82
22,11,29,351,242,593
29,11,29,463,319,782
13,11,29,208,143,351
9,11,30,112,99,211
1,11,30,14,11,25
30,1,2,26,30,56
7,1,2,6,7,13
7,1,2,7,7,14
27,1,2,26,27,53
20,12,33,275,240,515
15,2,5,42,30,72
28,2,5,78,56,134
22,2,5,62,44,106
2,2,5,4,4,8
5,2,5,15,10,25
7,8,21,88,56,144
25,2,5,58,50,108
21,1,2,13,21,34
15,1,2,10,15,25
1,461,742,125,461,586
1,1482,2384,807,1482,2289
3,461,742,554,1383,1937
1,1482,2384,735,1482,2217
2,461,742,236,922,1158
10,24,64,298,240,538
23,24,64,655,552,1207
3,2,5,9,6,15
20,2,5,47,40,87
28,2,5,66,56,122
7,2,5,21,14,35
25,2,5,70,50,120
24,2,5,67,48,115
18,4,10,76,72,148
18,4,10,76,72,148
27,4,10,159,108,267
25,3,9,146,75,221
24,3,9,140,72,212
10,2,5,29,20,49
5,2,5,15,10,25
17,2,5,49,34,83
3,2,5,8,6,14
7,2,5,20,14,34
28,2,5,66,56,122
8,2,5,19,16,35
18,2,5,41,36,77
23,2,5,53,46,99
27,2,5,80,54,134
20,2,5,46,40,86
24,2,5,55,48,103
19,7,9,11,133,144
28,7,9,16,196,212
23,7,9,19,161,180
12,7,9,5,84,89
21,7,9,29,147,176
14,7,9,0,98,98
18,7,9,7,126,133
2,3,8,7,6,13
7,8,22,95,56,151
20,8,22,276,160,436
2,8,22,18,16,34
14,8,22,190,112,302
27,8,22,271,216,487
17,8,22,231,136,367
27,8,22,366,216,582
15,13,35,215,195,410
7,13,35,120,91,211
2,13,35,34,26,60
11,13,35,192,143,335
19,13,35,391,247,638
9,13,35,195,117,312
29,13,35,628,377,1005
17,13,35,332,221,553
18,13,35,371,234,605
1,13,35,17,13,30
27,13,35,424,351,775
4,13,35,78,52,130
11,13,35,227,143,370
12,13,35,197,156,353
9,13,35,138,117,255
19,13,35,391,247,638
25,13,35,489,325,814
18,21,55,592,378,970
24,42,54,262,1008,1270
2,38,50,10,76,86
11,42,54,7,462,469
26,38,50,143,988,1131
24,38,50,240,912,1152
22,42,54,3,924,927
10,38,50,85,380,465
3,42,54,34,126,160
28,38,50,70,1064,1134
1,420,769,334,420,754
3,420,769,955,1260,2215
1,308,565,234,308,542
2,1252,2295,1765,2504,4269
1,1266,2320,636,1266,1902
1,295,540,234,295,529
1,1266,2320,1008,1266,2274
3,1555,2443,1125,4665,5790
1,713,1120,194,713,907
16,9,25,172,144,316
16,13,35,341,208,549
15,13,35,325,195,520
5,1,2,5,5,10
24,1,2,24,24,48
14,1,2,14,14,28
22,2,5,65,44,109
19,2,5,56,38,94
14,2,5,41,28,69
1,2,5,3,2,5
6,12,33,112,72,184
7,13,35,122,91,213
24,11,29,383,264,647
26,2,5,77,52,129
4,2,5,12,8,20
20,2,5,59,40,99
22,2,5,42,44,86
22,2,5,42,44,86
9,2,5,27,18,45
27,2,5,80,54,134
11,2,5,32,22,54
1,1,2,1,1,2
5,1,2,5,5,10
31,2,5,59,62,121
14,11,30,174,154,328
26,1,2,19,26,45
13,2,5,27,26,53
24,8,21,277,192,469
1,1,4,3,1,4
29,1,4,82,29,111
4,8,21,41,32,73
7,8,21,72,56,128
28,2,5,81,56,137
5,8,21,46,40,86
25,2,5,70,50,120
10,2,5,28,20,48
16,1,4,45,16,61
17,1,4,48,17,65
11,1,4,27,11,38
3,1,4,7,3,10
1,755,1215,266,755,1021
3,1482,2384,2634,4446,7080
1,1482,2384,807,1482,2289
3,1482,2384,2420,4446,6866
1,461,742,118,461,579
1,755,1215,375,755,1130
1,461,742,147,461,608
1,461,742,229,461,690
6,24,64,236,144,380
30,24,64,854,720,1574
6,24,64,236,144,380
17,4,10,80,68,148
18,4,10,85,72,157
3,2,5,9,6,15
28,2,5,83,56,139
9,2,5,27,18,45
16,2,5,47,32,79
1,2,5,3,2,5
25,2,5,70,50,120
32,2,5,90,64,154
13,2,5,36,26,62
12,2,5,34,24,58
11,2,5,31,22,53
3,2,5,9,6,15
18,2,5,38,36,74
27,2,5,57,54,111
13,3,9,76,39,115
16,3,9,93,48,141
8,2,5,19,16,35
4,2,5,9,8,17
23,2,5,45,46,91
25,2,5,49,50,99
27,2,5,78,54,132
26,2,5,75,52,127
28,2,5,83,56,139
30,2,5,89,60,149
19,7,9,16,133,149
3,7,9,1,21,22
19,7,9,7,133,140
9,7,9,17,63,80
20,3,8,65,60,125
18,3,8,87,54,141
14,8,22,147,112,259
14,8,22,193,112,305
23,8,22,302,184,486
16,8,22,178,128,306
15,9,24,167,135,302
12,9,24,120,108,228
14,13,35,205,182,387
21,13,35,300,273,573
21,13,35,344,273,617
16,13,35,346,208,554
23,13,35,361,299,660
22,13,35,345,286,631
5,13,35,108,65,173
18,13,35,390,234,624
1,13,35,21,13,34
10,13,35,213,130,343
28,13,35,596,364,960
12,13,35,209,156,365
25,13,35,393,325,718
19,13,35,391,247,638
8,13,35,170,104,274
13,13,35,268,169,437
11,13,35,161,143,304
22,13,35,315,286,601
12,13,35,205,156,361
8,13,35,131,104,235
27,21,55,725,567,1292
5,38,50,50,190,240
10,38,50,55,380,435
17,38,50,94,646,740
21,42,54,14,882,896
17,38,50,170,646,816
23,38,50,265,874,1139
24,42,54,236,1008,1244
22,38,50,242,836,1078
1,42,54,11,42,53
1,38,50,12,38,50
1,1252,2295,997,1252,2249
1,1252,2295,745,1252,1997
1,1252,2295,951,1252,2203
1,1252,2295,561,1252,1813
1,1266,2320,961,1266,2227
1,1266,2320,961,1266,2227
1,308,565,178,308,486
2,420,769,421,840,1261
2,1252,2295,1902,2504,4406
2,2171,3578,1526,4342,5868
1,2171,3578,1264,2171,3435
2,487,783,310,974,1284
1,1519,2443,411,1519,1930
2,1519,2443,1066,3038,4104
1,713,1120,228,713,941
1,2171,3578,1335,2171,3506
19,26,70,783,494,1277
9,26,70,383,234,617
12,26,70,511,312,823
19,3,9,111,57,168
12,2,5,25,24,49
21,2,5,44,42,86
15,2,5,44,30,74
15,11,30,213,165,378
15,12,33,295,180,475
27,12,33,531,324,855
7,1,2,7,7,14
4,1,2,4,4,8
14,12,33,211,168,379
28,12,33,422,336,758
29,2,5,55,58,113
9,2,5,17,18,35
2,9,25,31,18,49
1,9,25,16,9,25
8,9,25,126,72,198
15,1,2,11,15,26
3,1,2,2,3,5
25,1,2,19,25,44
24,13,35,394,312,706
1,8,21,10,8,18
25,8,21,257,200,457
23,8,21,236,184,420
8,2,5,23,16,39
29,2,5,84,58,142
2,2,5,6,4,10
21,1,2,19,21,40
7,11,30,129,77,206
10,2,5,29,20,49
25,2,5,73,50,123
12,1,4,29,12,41
19,1,4,46,19,65
8,1,2,8,8,16
9,1,2,9,9,18
10,1,4,25,10,35
8,1,4,17,8,25
18,1,2,13,18,31
3,1,2,2,3,5
29,13,35,425,377,802
19,13,35,278,247,525
20,1,2,11,20,31
1,1482,2384,878,1482,2360
2,461,742,250,922,1172
18,24,64,708,432,1140
2,2,5,5,4,9
4,2,5,11,8,19
11,2,5,21,22,43
26,4,10,101,104,205
11,2,5,32,22,54
21,2,5,62,42,104
13,2,5,38,26,64
5,2,5,15,10,25
25,2,5,73,50,123
1,2,5,3,2,5
3,2,5,9,6,15
1,2,5,3,2,5
24,3,9,96,72,168
28,4,10,162,112,274
25,4,10,145,100,245
14,2,5,41,28,69
2,2,5,6,4,10
15,2,5,44,30,74
16,2,5,47,32,79
29,2,5,86,58,144
22,3,9,90,66,156
11,3,9,45,33,78
4,2,5,11,8,19
6,2,5,17,12,29
27,2,5,76,54,130
21,7,9,0,147,147
4,7,9,8,28,36
15,7,9,25,105,130
1,7,9,0,7,7
12,7,9,0,84,84
15,7,9,12,105,117
2,7,9,1,14,15
20,7,9,27,140,167
4,3,8,19,12,31
4,3,8,19,12,31
26,8,22,358,208,566
18,8,22,165,144,309
3,8,22,41,24,65
30,8,22,281,240,521
24,8,22,331,192,523
3,8,22,41,24,65
7,8,22,64,56,120
14,8,22,193,112,305
12,9,24,177,108,285
2,9,24,29,18,47
14,9,24,203,126,329
16,13,35,346,208,554
2,13,35,35,26,61
26,13,35,517,338,855
23,13,35,498,299,797
4,13,35,63,52,115
3,13,35,62,39,101
24,13,35,419,312,731
23,13,35,474,299,773
10,13,35,143,130,273
30,13,35,618,390,1008
28,13,35,606,364,970
1,13,35,16,13,29
8,13,35,173,104,277
8,13,35,140,104,244
22,13,35,338,286,624
27,13,35,556,351,907
6,13,35,105,78,183
31,13,35,639,403,1042
6,13,35,117,78,195
20,21,55,537,420,957
9,21,55,296,189,485
6,42,54,1,252,253
20,38,50,110,760,870
29,42,54,254,1218,1472
21,38,50,231,798,1029
9,42,54,98,378,476
20,38,50,230,760,990
4,42,54,13,168,181
24,42,54,262,1008,1270
22,38,50,220,836,1056
24,38,50,240,912,1152
1,42,54,11,42,53
2,38,50,23,76,99
5,42,54,17,210,227
21,38,50,242,798,1040
1,1266,2320,636,1266,1902
2,420,769,636,840,1476
1,420,769,341,420,761
1,295,540,132,295,427
1,1252,2295,951,1252,2203
1,295,540,126,295,421
1,308,565,251,308,559
1,1266,2320,1008,1266,2274
1,713,1120,385,713,1098
1,1519,2443,826,1519,2345
1,1083,1701,584,1083,1667
3,2171,3578,2504,6513,9017
3,1519,2443,1819,4557,6376
3,344,540,556,1032,1588
1,344,540,93,344,437
2,487,783,263,974,1237
2,713,1120,456,1426,1882
1,713,1120,329,713,1042
27,26,70,772,702,1474
7,26,70,239,182,421
5,3,9,30,15,45
31,3,9,125,93,218
3,1,2,2,3,5
23,1,2,13,23,36
23,13,35,329,299,628
16,1,2,16,16,32
22,1,2,22,22,44
7,2,5,13,14,27
5,2,5,10,10,20
4,12,33,60,48,108
22,12,33,331,264,595
22,2,5,65,44,109
26,2,5,77,52,129
21,2,5,62,42,104
31,2,5,87,62,149
27,1,2,25,27,52
20,1,2,19,20,39
11,1,2,11,11,22
26,1,2,25,26,51
17,11,30,216,187,403
10,11,30,127,110,237
8,1,2,4,8,12
14,1,4,40,14,54
1,2,5,2,2,4
6,1,2,6,6,12
17,1,2,16,17,33
10,1,2,9,10,19
7,2,5,19,14,33
20,2,5,53,40,93
15,12,33,236,180,416
6,12,33,94,72,166
7,1,2,5,7,12
1,1,2,1,1,2
6,9,25,95,54,149
13,9,25,205,117,322
20,1,4,59,20,79
29,1,4,86,29,115
12,2,5,35,24,59
26,2,5,75,52,127
17,2,5,49,34,83
24,2,5,70,48,118
17,1,2,16,17,33
30,1,2,28,30,58
1,1,2,1,1,2
1,2,5,3,2,5
2,2,5,6,4,10
25,1,4,62,25,87
1,1,4,2,1,3
1,461,742,251,461,712
1,1482,2384,878,1482,2360
1,461,742,185,461,646
27,24,64,1063,648,1711
12,2,5,32,24,56
6,2,5,16,12,28
25,2,5,48,50,98
15,2,5,29,30,59
20,2,5,56,40,96
1,2,5,3,2,5
2,2,5,5,4,9
6,2,5,14,12,26
10,2,5,29,20,49
1,2,5,3,2,5
13,2,5,25,26,51
17,2,5,32,34,66
6,4,10,23,24,47
9,2,5,25,18,43
29,2,5,68,58,126
28,2,5,66,56,122
13,2,5,31,26,57
6,2,5,14,12,26
9,3,9,43,27,70
26,3,9,126,78,204
31,3,9,127,93,220
14,3,9,58,42,100
2,7,9,0,14,14
20,7,9,11,140,151
6,8,22,67,48,115
10,8,22,109,80,189
10,8,22,131,80,211
24,8,22,225,192,417
23,9,24,268,207,475
18,9,24,175,162,337
7,9,24,81,63,144
16,9,24,171,144,315
12,13,35,256,156,412
27,13,35,528,351,879
12,13,35,209,156,365
1,13,35,16,13,29
5,13,35,103,65,168
7,13,35,149,91,240
24,13,35,352,312,664
13,13,35,222,169,391
20,13,35,391,260,651
23,13,35,361,299,660
2,13,35,43,26,69
18,13,35,383,234,617
20,13,35,433,260,693
12,13,35,188,156,344
26,13,35,536,338,874
21,13,35,300,273,573
11,13,35,173,143,316
10,21,55,329,210,539
16,42,54,2,672,674
24,42,54,107,1008,1115
16,42,54,132,672,804
21,38,50,21,798,819
7,38,50,77,266,343
22,42,54,50,924,974
11,38,50,17,418,435
3,1266,2320,2257,3798,6055
1,1252,2295,882,1252,2134
1,420,769,241,420,661
2,1252,2295,1902,2504,4406
1,1252,2295,882,1252,2134
3,1252,2295,1890,3756,5646
3,713,1120,751,2139,2890
1,487,783,124,487,611
1,713,1120,161,713,874
1,344,540,77,344,421
2,1083,1701,1168,2166,3334
3,344,540,232,1032,1264
1,344,540,174,344,518
1,1083,1701,550,1083,1633
3,344,540,377,1032,1409
1,1083,1701,550,1083,1633
3,344,540,377,1032,1409
3,26,70,117,78,195
29,3,9,164,87,251
1,3,9,6,3,9
8,1,2,8,8,16
12,13,35,197,156,353
23,2,5,68,46,114
7,2,5,20,14,34
1,2,5,3,2,5
11,2,5,31,22,53
7,2,5,20,14,34
25,1,2,17,25,42
29,8,21,292,232,524
5,2,5,15,10,25
23,2,5,67,46,113
13,2,5,38,26,64
6,2,5,17,12,29
3,2,5,7,6,13
13,2,5,31,26,57
12,1,2,12,12,24
24,2,5,46,48,94
11,1,4,25,11,36
4,1,2,4,4,8
1,12,33,14,12,26
19,12,33,261,228,489
8,2,5,23,16,39
18,12,33,301,216,517
22,12,33,368,264,632
12,2,5,25,24,49
6,2,5,13,12,25
13,1,2,9,13,22
25,1,2,17,25,42
1,1482,2384,807,1482,2289
1,755,1215,241,755,996
1,461,742,185,461,646
2,1482,2384,1709,2964,4673
11,24,64,412,264,676
15,24,64,475,360,835
1,45,120,70,45,115
1,45,120,73,45,118
5,59,159,397,295,692
8,59,159,749,472,1221
9,2,5,18,18,36
3,2,5,6,6,12
14,2,5,32,28,60
25,2,5,74,50,124
15,4,10,69,60,129
13,3,9,70,39,109
13,3,9,70,39,109
15,4,10,87,60,147
1,2,5,2,2,4
21,2,5,49,42,91
14,2,5,33,28,61
10,3,9,58,30,88
23,3,9,134,69,203
19,2,5,56,38,94
4,2,5,12,8,20
26,3,9,107,78,185
13,7,9,21,91,112
30,7,9,22,210,232
27,7,9,20,189,209
14,7,9,5,98,103
12,7,9,22,84,106
1,7,9,0,7,7
25,7,9,41,175,216
1,7,9,0,7,7
14,7,9,8,98,106
26,3,8,128,78,206
28,3,8,111,84,195
29,8,22,266,232,498
13,8,22,176,104,280
31,8,22,339,248,587
3,8,22,41,24,65
21,8,22,285,168,453
29,8,22,400,232,632
14,8,22,193,112,305
21,9,24,305,189,494
1,9,24,15,9,24
26,9,24,378,234,612
20,9,24,290,180,470
22,13,35,469,286,755
23,13,35,474,299,773
14,13,35,220,182,402
2,13,35,29,26,55
6,13,35,128,78,206
3,13,35,64,39,103
7,13,35,122,91,213
23,13,35,490,299,789
17,13,35,332,221,553
24,13,35,469,312,781
7,13,35,152,91,243
5,13,35,79,65,144
16,13,35,341,208,549
20,13,35,426,260,686
24,13,35,377,312,689
18,13,35,257,234,491
27,13,35,575,351,926
29,13,35,597,377,974
24,13,35,511,312,823
21,21,55,691,441,1132
2,21,55,53,42,95
14,21,55,445,294,739
28,42,54,139,1176,1315
10,42,54,98,420,518
21,42,54,93,882,975
6,38,50,30,228,258
3,38,50,15,114,129
29,38,50,334,1102,1436
11,38,50,110,418,528
14,42,54,153,588,741
2,38,50,23,76,99
6,42,54,20,252,272
1,1912,3400,944,1912,2856
1,1266,2320,729,1266,1995
1,420,769,249,420,669
1,1252,2295,997,1252,2249
1,1252,2295,538,1252,1790
1,420,769,249,420,669
3,1252,2295,2165,3756,5921
1,420,769,341,420,761
1,1252,2295,951,1252,2203
1,713,1120,362,713,1075
1,1555,2443,839,1555,2394
1,487,783,202,487,689
3,713,1120,1087,2139,3226
3,713,1120,1154,2139,3293
1,487,783,241,487,728
1,344,540,99,344,443
1,1555,2443,497,1555,2052
2,344,540,381,688,1069
1,344,540,185,344,529
2,1083,1701,1168,2166,3334
1,344,540,185,344,529
3,713,1120,986,2139,3125
1,2171,3578,906,2171,3077
13,26,70,426,338,764
14,3,9,83,42,125
17,2,5,48,34,82
1,2,5,3,2,5
1,2,5,3,2,5
28,2,5,81,56,137
22,1,2,21,22,43
12,2,5,35,24,59
27,1,2,26,27,53
30,1,2,19,30,49
5,1,2,3,5,8
16,9,25,184,144,328
14,1,4,35,14,49
20,9,25,285,180,465
13,9,25,185,117,302
18,13,35,314,234,548
1,13,35,17,13,30
2,13,35,41,26,67
11,13,35,227,143,370
28,1,4,69,28,97
19,1,4,47,19,66
14,1,4,35,14,49
24,1,4,60,24,84
8,1,4,20,8,28
2,11,29,34,22,56
20,11,29,337,220,557
26,1,2,25,26,51
10,9,25,128,90,218
9,9,25,115,81,196
13,1,2,8,13,21
10,1,4,24,10,34
25,2,5,49,50,99
17,2,5,33,34,67
4,11,30,75,44,119
15,2,5,32,30,62
27,2,5,57,54,111
24,8,21,201,192,393
7,8,21,59,56,115
27,1,2,15,27,42
18,1,2,10,18,28
25,2,5,48,50,98
5,2,5,10,10,20
27,1,4,79,27,106
15,1,4,44,15,59
27,1,4,80,27,107
4,1,2,4,4,8
23,1,2,22,23,45
29,1,2,28,29,57
18,11,29,314,198,512
10,11,29,174,110,284
24,1,2,15,24,39
26,2,5,75,52,127
18,2,5,52,36,88
17,1,2,12,17,29
9,11,29,152,99,251
4,11,29,67,44,111
29,2,5,68,58,126
20,2,5,47,40,87
21,2,5,61,42,103
1,1482,2384,878,1482,2360
1,461,742,147,461,608
3,1482,2384,2563,4446,7009
1,755,1215,205,755,960
6,24,64,190,144,334
2,45,120,107,90,197
6,45,120,443,270,713
11,59,159,873,649,1522
11,4,10,65,44,109
22,2,5,65,44,109
8,2,5,24,16,40
26,2,5,55,52,107
11,2,5,23,22,45
24,2,5,46,48,94
25,2,5,48,50,98
25,2,5,74,50,124
9,2,5,27,18,45
24,2,5,67,48,115
4,2,5,11,8,19
6,3,9,27,18,45
4,3,9,18,12,30
4,3,9,23,12,35
23,2,5,64,46,110
15,2,5,42,30,72
11,4,10,42,44,86
10,2,5,21,20,41
31,2,5,91,62,153
14,2,5,32,28,60
15,2,5,44,30,74
9,2,5,17,18,35
12,2,5,35,24,59
9,2,5,26,18,44
14,2,5,41,28,69
19,7,9,28,133,161
32,7,9,61,224,285
30,7,9,11,210,221
27,7,9,49,189,238
11,7,9,20,77,97
14,7,9,12,98,110
20,3,8,94,60,154
22,3,8,106,66,172
19,8,22,207,152,359
21,8,22,229,168,397
20,8,22,276,160,436
14,9,24,136,126,262
7,9,24,98,63,161
32,9,24,472,288,760
7,13,35,100,91,191
3,13,35,52,39,91
17,13,35,350,221,571
24,13,35,478,312,790
23,13,35,401,299,700
23,13,35,361,299,660
24,13,35,352,312,664
27,13,35,386,351,737
23,13,35,361,299,660
2,13,35,33,26,59
31,13,35,671,403,1074
19,13,35,272,247,519
27,13,35,556,351,907
3,13,35,62,39,101
25,13,35,533,325,858
6,13,35,130,78,208
32,13,35,659,416,1075
22,13,35,469,286,755
21,13,35,359,273,632
3,13,35,52,39,91
30,21,55,987,630,1617
12,38,50,138,456,594
18,38,50,99,684,783
7,38,50,81,266,347
7,38,50,81,266,347
22,42,54,50,924,974
1,38,50,1,38,39
1,42,54,10,42,52
1,38,50,3,38,41
14,38,50,21,532,553
23,38,50,265,874,1139
1,42,54,0,42,42
1,1252,2295,538,1252,1790
1,1252,2295,538,1252,1790
1,1252,2295,1020,1252,2272
1,1252,2295,630,1252,1882
1,1252,2295,630,1252,1882
1,1266,2320,1008,1266,2274
1,487,783,155,487,642
1,1083,1701,244,1083,1327
3,1083,1701,731,3249,3980
1,1555,2443,570,1555,2125
1,487,783,265,487,752
1,344,540,174,344,518
1,1083,1701,261,1083,1344
1,1083,1701,346,1083,1429
1,344,540,126,344,470
1,26,70,43,26,69
15,26,70,639,390,1029
11,26,70,322,286,608
5,26,70,217,130,347
12,26,70,520,312,832
13,3,9,63,39,102
19,13,35,298,247,545
1,13,35,16,13,29
28,13,35,440,364,804
6,1,2,3,6,9
23,1,2,20,23,43
1,1,2,1,1,2
25,2,5,70,50,120
6,2,5,17,12,29
6,2,5,17,12,29
4,2,5,11,8,19
26,2,5,70,52,122
3,1,2,2,3,5
24,1,2,23,24,47
14,2,5,41,28,69
14,2,5,41,28,69
12,2,5,35,24,59
19,1,2,13,19,32
13,1,2,9,13,22
10,1,2,9,10,19
1,11,30,18,11,29
27,11,30,497,297,794
29,1,2,19,29,48
20,1,2,13,20,33
7,1,2,7,7,14
3,9,25,47,27,74
24,9,25,306,216,522
28,9,25,357,252,609
18,2,5,34,36,70
13,2,5,25,26,51
18,11,30,223,198,421
13,11,30,161,143,304
12,1,2,7,12,19
2,1,4,5,2,7
10,1,4,25,10,35
28,8,21,340,224,564
21,8,21,255,168,423
23,8,21,280,184,464
2,8,21,24,16,40
8,1,2,6,8,14
22,11,29,313,242,555
7,1,2,5,7,12
16,1,2,12,16,28
8,1,4,23,8,31
1,1,4,3,1,4
10,2,5,28,20,48
24,1,4,60,24,84
7,1,4,17,7,24
1,1482,2384,807,1482,2289
1,1482,2384,807,1482,2289
1,1482,2384,401,1482,1883
2,1482,2384,1613,2964,4577
25,2,5,49,50,99
9,3,9,53,27,80
21,3,9,124,63,187
10,2,5,30,20,50
19,2,5,56,38,94
27,2,5,59,54,113
3,2,5,7,6,13
25,2,5,59,50,109
27,2,5,63,54,117
8,2,5,23,16,39
28,2,5,81,56,137
23,4,10,133,92,225
15,4,10,87,60,147
6,2,5,13,12,25
15,2,5,32,30,62
29,4,10,168,116,284
3,4,10,17,12,29
16,2,5,42,32,74
8,3,9,31,24,55
22,3,9,84,66,150
9,2,5,24,18,42
3,2,5,8,6,14
8,2,5,21,16,37
12,2,5,32,24,56
15,2,5,44,30,74
23,4,10,87,92,179
22,4,10,84,88,172
9,2,5,25,18,43
13,2,5,31,26,57
8,2,5,19,16,35
21,2,5,56,42,98
14,2,5,37,28,65
11,2,5,26,22,48
17,2,5,40,34,74
7,7,9,13,49,62
11,7,9,-2,77,75
3,7,9,4,21,25
19,7,9,31,133,164
19,7,9,36,133,169
13,7,9,11,91,102
29,8,22,393,232,625
26,8,22,353,208,561
7,8,22,95,56,151
24,8,22,220,192,412
11,8,22,110,88,198
21,8,22,285,168,453
23,8,22,302,184,486
11,8,22,149,88,237
24,8,22,299,192,491
2,8,22,26,16,42
1,8,22,12,8,20
6,9,24,67,54,121
3,13,35,47,39,86
14,13,35,288,182,470
14,13,35,303,182,485
12,13,35,188,156,344
8,13,35,126,104,230
29,13,35,506,377,883
16,13,35,313,208,521
14,13,35,288,182,470
17,13,35,368,221,589
23,13,35,377,299,676
15,13,35,309,195,504
10,13,35,217,130,347
10,13,35,143,130,273
6,13,35,130,78,208
20,13,35,412,260,672
1,21,55,22,21,43
24,21,55,790,504,1294
26,21,55,584,546,1130
21,38,50,63,798,861
1,38,50,3,38,41
18,38,50,207,684,891
14,38,50,154,532,686
3,42,54,7,126,133
1,1266,2320,636,1266,1902
3,1266,2320,1631,3798,5429
1,420,769,318,420,738
2,1266,2320,2015,2532,4547
1,1266,2320,1008,1266,2274
2,420,769,421,840,1261
2,1266,2320,1273,2532,3805
1,1252,2295,492,1252,1744
1,1266,2320,892,1266,2158
2,420,769,421,840,1261
3,308,565,737,924,1661
2,1266,2320,2015,2532,4547
2,2171,3578,2313,4342,6655
1,1555,2443,497,1555,2052
1,713,1120,228,713,941
27,26,70,1150,702,1852
8,26,70,251,208,459
14,3,9,83,42,125
14,2,5,41,28,69
6,1,2,6,6,12
6,1,2,6,6,12
11,13,35,234,143,377
6,13,35,128,78,206
2,2,5,5,4,9
26,2,5,60,52,112
1,9,25,12,9,21
5,9,25,75,45,120
22,9,25,330,198,528
19,13,35,298,247,545
4,1,2,3,4,7
3,1,4,9,3,12
15,1,4,44,15,59
28,8,21,323,224,547
29,8,21,334,232,566
23,1,4,65,23,88
17,1,2,11,17,28
8,1,2,5,8,13
13,2,5,31,26,57
16,2,5,38,32,70
25,1,4,74,25,99
3,1,4,9,3,12
1,13,35,16,13,29
15,1,4,44,15,59
7,2,5,16,14,30
6,8,21,55,48,103
24,1,2,24,24,48
25,1,2,25,25,50
13,1,4,38,13,51
14,1,4,34,14,48
15,1,4,37,15,52
12,1,4,29,12,41
28,11,29,488,308,796
6,11,29,105,66,171
9,2,5,25,18,43
27,2,5,80,54,134
19,8,21,239,152,391
1,8,21,13,8,21
20,2,5,47,40,87
16,2,5,38,32,70
5,2,5,12,10,22
29,2,5,84,58,142
3,1482,2384,1419,4446,5865
2,461,742,369,922,1291
2,1482,2384,1470,2964,4434
2,1482,2384,1756,2964,4720
9,24,64,354,216,570
2,24,64,57,48,105
19,24,64,736,456,1192
6,45,120,335,270,605
1,59,159,98,59,157
17,2,5,45,34,79
10,2,5,27,20,47
1,2,5,2,2,4
9,2,5,18,18,36
28,4,10,132,112,244
26,4,10,122,104,226
3,3,9,14,9,23
6,2,5,16,12,28
3,2,5,8,6,14
21,2,5,56,42,98
13,2,5,34,26,60
20,4,10,94,80,174
6,4,10,28,24,52
6,2,5,14,12,26
25,2,5,73,50,123
13,4,10,49,52,101
28,4,10,106,112,218
10,2,5,29,20,49
18,2,5,52,36,88
25,2,5,53,50,103
4,2,5,9,8,17
2,2,5,5,4,9
1,2,5,3,2,5
8,2,5,23,16,39
3,2,5,6,6,12
7,2,5,13,14,27
2,7,9,0,14,14
2,7,9,1,14,15
17,7,9,31,119,150
2,3,8,10,6,16
12,3,8,58,36,94
5,3,8,25,15,40
21,3,8,83,63,146
11,3,8,44,33,77
3,8,22,27,24,51
1,8,22,11,8,19
6,8,22,81,48,129
21,8,22,220,168,388
27,8,22,271,216,487
25,8,22,312,200,512
3,9,24,36,27,63
21,9,24,295,189,484
18,9,24,253,162,415
24,9,24,348,216,564
18,9,24,214,162,376
5,13,35,72,65,137
25,13,35,489,325,814
18,13,35,264,234,498
24,13,35,419,312,731
15,13,35,325,195,520
28,13,35,577,364,941
7,13,35,122,91,213
23,13,35,450,299,749
10,13,35,206,130,336
28,13,35,489,364,853
1,13,35,14,13,27
18,13,35,383,234,617
17,13,35,297,221,518
16,13,35,341,208,549
24,13,35,343,312,655
17,13,35,362,221,583
11,13,35,234,143,377
1,13,35,17,13,30
1,42,54,0,42,42
9,42,54,74,378,452
28,38,50,28,1064,1092
28,42,54,139,1176,1315
24,38,50,264,912,1176
19,38,50,19,722,741
11,38,50,121,418,539
18,38,50,99,684,783
24,38,50,276,912,1188
6,38,50,60,228,288
11,42,54,1,462,463
30,42,54,328,1260,1588
1,1898,3375,937,1898,2835
1,1252,2295,882,1252,2134
1,1252,2295,997,1252,2249
2,1266,2320,1505,2532,4037
3,1266,2320,1700,3798,5498
1,1266,2320,1008,1266,2274
2,1266,2320,1087,2532,3619
1,1266,2320,636,1266,1902
3,1252,2295,2234,3756,5990
1,1252,2295,951,1252,2203
2,1266,2320,1087,2532,3619
1,1266,2320,892,1266,2158
1,1266,2320,752,1266,2018
1,295,540,234,295,529
2,1252,2295,2040,2504,4544
1,2171,3578,942,2171,3113
1,487,783,280,487,767
1,487,783,280,487,767
3,1519,2443,2259,4557,6816
1,1083,1701,244,1083,1327
1,2171,3578,656,2171,2827
1,487,783,288,487,775
1,713,1120,161,713,874
1,713,1120,261,713,974
3,344,540,523,1032,1555
16,26,70,469,416,885
18,26,70,767,468,1235
15,3,9,81,45,126
5,3,9,29,15,44
7,3,9,41,21,62
7,2,5,13,14,27
18,2,5,34,36,70
5,9,25,54,45,99
7,9,25,75,63,138
3,9,25,32,27,59
10,2,5,22,20,42
28,2,5,62,56,118
28,2,5,62,56,118
25,2,5,73,50,123
22,1,2,20,22,42
11,1,2,10,11,21
25,1,4,74,25,99
6,1,2,3,6,9
23,1,2,13,23,36
7,2,5,20,14,34
20,1,4,50,20,70
2,1,4,5,2,7
16,1,2,12,16,28
6,2,5,11,12,23
12,2,5,23,24,47
24,13,35,343,312,655
18,13,35,257,234,491
11,11,30,202,121,323
24,2,5,71,48,119
7,2,5,21,14,35
3,1,4,7,3,10
5,1,2,5,5,10
15,1,2,15,15,30
13,2,5,38,26,64
22,2,5,52,44,96
1,2,5,2,2,4
1,1,2,1,1,2
18,1,2,10,18,28
2,2,5,6,4,10
23,2,5,68,46,114
2,2,5,6,4,10
1,2,5,2,2,4
9,1,4,26,9,35
21,1,4,61,21,82
14,2,5,33,28,61
19,2,5,45,38,83
25,1,2,19,25,44
23,1,2,17,23,40
1,2,5,3,2,5
3,1482,2384,2205,4446,6651
3,755,1215,1234,2265,3499
1,461,742,185,461,646
1,1482,2384,854,1482,2336
2,1482,2384,1709,2964,4673
3,1482,2384,1776,4446,6222
1,755,1215,375,755,1130
1,1482,2384,378,1482,1860
22,45,120,1624,990,2614
3,45,120,218,135,353
8,59,159,533,472,1005
27,2,5,80,54,134
28,2,5,83,56,139
13,4,10,77,52,129
2,4,10,12,8,20
3,4,10,17,12,29
18,4,10,104,72,176
15,2,5,44,30,74
27,2,5,78,54,132
13,2,5,25,26,51
17,2,5,49,34,83
27,2,5,78,54,132
1,2,5,2,2,4
15,2,5,35,30,65
18,2,5,41,36,77
25,2,5,55,50,105
10,4,10,47,40,87
1,4,10,5,4,9
4,4,10,19,16,35
25,3,9,114,75,189
10,2,5,22,20,42
23,2,5,51,46,97
15,7,9,29,105,134
12,7,9,22,84,106
20,7,9,33,140,173
13,7,9,18,91,109
30,7,9,-5,210,205
3,7,9,3,21,24
6,7,9,1,42,43
2,3,8,9,6,15
26,3,8,128,78,206
26,3,8,101,78,179
8,8,22,73,64,137
12,8,22,126,96,222
2,8,22,18,16,34
23,9,24,339,207,546
5,9,24,73,45,118
13,9,24,154,117,271
26,9,24,384,234,618
13,13,35,190,169,359
7,13,35,152,91,243
24,13,35,520,312,832
9,13,35,176,117,293
17,13,35,297,221,518
14,13,35,298,182,480
22,13,35,430,286,716
28,13,35,577,364,941
3,13,35,64,39,103
6,13,35,130,78,208
23,13,35,401,299,700
27,13,35,490,351,841
5,13,35,103,65,168
28,13,35,400,364,764
9,21,55,202,189,391
21,21,55,691,441,1132
7,21,55,230,147,377
26,21,55,684,546,1230
1,21,55,30,21,51
3,21,55,99,63,162
19,21,55,479,399,878
3,38,50,3,114,117
7,38,50,81,266,347
22,42,54,252,924,1176
11,38,50,17,418,435
21,42,54,229,882,1111
7,42,54,1,294,295
2,1898,3375,1537,3796,5333
1,1266,2320,892,1266,2158
1,1266,2320,961,1266,2227
1,1266,2320,567,1266,1833
1,1252,2295,676,1252,1928
2,1252,2295,1902,2504,4406
1,1266,2320,1008,1266,2274
1,420,769,318,420,738
1,420,769,211,420,631
1,1555,2443,717,1555,2272
1,2171,3578,656,2171,2827
3,1519,2443,1819,4557,6376
1,344,540,185,344,529
1,487,783,132,487,619
1,344,540,126,344,470
1,713,1120,172,713,885
1,2171,3578,1335,2171,3506
1,2171,3578,906,2171,3077
28,26,70,1212,728,1940
13,3,9,52,39,91
23,3,9,130,69,199
21,3,9,84,63,147
18,3,9,72,54,126
17,3,9,99,51,150
23,2,5,45,46,91
22,2,5,43,44,87
22,1,4,65,22,87
13,1,4,38,13,51
4,8,21,34,32,66
5,1,2,5,5,10
2,2,5,6,4,10
15,2,5,42,30,72
19,13,35,405,247,652
26,13,35,554,338,892
17,2,5,48,34,82
12,2,5,34,24,58
14,12,33,262,168,430
27,12,33,505,324,829
20,2,5,59,40,99
14,2,5,41,28,69
14,11,29,199,154,353
19,11,29,270,209,479
21,2,5,59,42,101
16,1,2,12,16,28
13,1,2,12,13,25
9,1,2,9,9,18
28,1,2,24,28,52
12,1,2,10,12,22
12,9,25,129,108,237
3,9,25,43,27,70
16,9,25,228,144,372
24,9,25,276,216,492
26,9,25,299,234,533
16,9,25,184,144,328
16,1,2,12,16,28
2,1,4,6,2,8
12,1,4,34,12,46
31,1,4,88,31,119
10,1,2,10,10,20
10,1,2,10,10,20
20,2,5,49,40,89
5,2,5,14,10,24
14,2,5,39,28,67
25,2,5,70,50,120
5,9,25,78,45,123
20,9,25,310,180,490
14,2,5,39,28,67
26,2,5,73,52,125
26,1,4,77,26,103
29,1,4,86,29,115
4,2,5,9,8,17
7,2,5,21,14,35
10,2,5,30,20,50
27,12,33,451,324,775
10,12,33,203,120,323
15,1,2,14,15,29
6,8,21,62,48,110
14,8,21,144,112,256
22,12,33,302,264,566
1,2,5,2,2,4
4,8,21,50,32,82
16,8,21,201,128,329
27,8,21,340,216,556
22,1,4,62,22,84
18,1,4,51,18,69
23,1,4,65,23,88
6,1,4,18,6,24
27,1,4,79,27,106
27,8,21,340,216,556
19,2,5,42,38,80
21,2,5,46,42,88
28,1,2,16,28,44
5,1,2,3,5,8
17,9,25,264,153,417
24,9,25,372,216,588
1,461,742,251,461,712
1,1482,2384,807,1482,2289
1,1482,2384,807,1482,2289
1,1482,2384,878,1482,2360
1,1482,2384,878,1482,2360
1,755,1215,436,755,1191
3,755,1215,1307,2265,3572
1,461,742,274,461,735
3,45,120,178,135,313
4,59,159,260,236,496
20,3,9,113,60,173
9,3,9,51,27,78
22,2,5,42,44,86
10,2,5,19,20,39
23,2,5,45,46,91
9,2,5,18,18,36
4,4,10,18,16,34
19,4,10,110,76,186
24,4,10,139,96,235
22,2,5,64,44,108
17,2,5,49,34,83
4,2,5,12,8,20
29,2,5,84,58,142
1,2,5,3,2,5
15,2,5,44,30,74
12,2,5,35,24,59
20,2,5,38,40,78
11,2,5,32,22,54
16,2,5,38,32,70
29,2,5,68,58,126
20,4,10,116,80,196
25,2,5,74,50,124
20,2,5,59,40,99
9,2,5,26,18,44
6,2,5,17,12,29
16,7,9,29,112,141
22,7,9,16,154,170
5,7,9,9,35,44
13,7,9,0,91,91
14,7,9,19,98,117
10,3,8,33,30,63
14,8,22,190,112,302
16,8,22,217,128,345
4,8,22,44,32,76
23,8,22,211,184,395
11,8,22,152,88,240
26,8,22,290,208,498
24,8,22,325,192,517
5,9,24,59,45,104
4,13,35,82,52,134
6,13,35,105,78,183
2,13,35,43,26,69
5,13,35,107,65,172
10,13,35,206,130,336
19,13,35,405,247,652
26,13,35,554,338,892
29,13,35,567,377,944
19,13,35,411,247,658
29,13,35,476,377,853
4,13,35,82,52,134
4,13,35,85,52,137
23,21,55,757,483,1240
26,42,54,284,1092,1376
15,42,54,148,630,778
7,42,54,31,294,325
18,42,54,90,756,846
20,38,50,200,760,960
30,42,54,247,1260,1507
24,38,50,24,912,936
2,1252,2295,2040,2504,4544
1,1252,2295,722,1252,1974
1,1252,2295,538,1252,1790
1,1266,2320,752,1266,2018
2,1266,2320,2015,2532,4547
1,1266,2320,892,1266,2158
1,420,769,295,420,715
1,2171,3578,1264,2171,3435
1,487,783,280,487,767
2,1555,2443,1434,3110,4544
3,1083,1701,782,3249,4031
2,713,1120,769,1426,2195
1,2171,3578,620,2171,2791
1,487,783,132,487,619
3,713,1120,1087,2139,3226
22,26,70,752,572,1324
26,26,70,744,676,1420
7,3,9,28,21,49
16,3,9,73,48,121
19,2,5,55,38,93
2,2,5,6,4,10
9,2,5,26,18,44
8,1,2,6,8,14
4,2,5,8,8,16
11,9,25,157,99,256
14,1,2,10,14,24
24,2,5,53,48,101
6,2,5,13,12,25
10,1,2,10,10,20
14,1,2,14,14,28
16,1,2,16,16,32
23,1,2,17,23,40
13,1,2,10,13,23
1,1,2,1,1,2
29,2,5,68,58,126
20,2,5,58,40,98
27,8,21,226,216,442
26,8,21,218,208,426
5,8,21,42,40,82
18,8,21,226,144,370
26,8,21,327,208,535
11,11,30,202,121,323
22,9,25,330,198,528
11,9,25,165,99,264
12,1,4,35,12,47
12,1,4,35,12,47
12,2,5,35,24,59
13,1,2,13,13,26
16,2,5,45,32,77
28,2,5,78,56,134
1,1482,2384,401,1482,1883
3,755,1215,797,2265,3062
1,461,742,266,461,727
1,24,64,27,24,51
5,59,159,325,295,620
18,4,10,70,72,142
20,4,10,78,80,158
24,2,5,56,48,104
5,2,5,12,10,22
26,2,5,77,52,129
18,2,5,53,36,89
28,2,5,55,56,111
7,2,5,14,14,28
2,2,5,6,4,10
7,2,5,20,14,34
20,2,5,56,40,96
15,2,5,42,30,72
22,2,5,65,44,109
18,4,10,104,72,176
17,4,10,99,68,167
16,2,5,46,32,78
17,2,5,49,34,83
17,3,9,99,51,150
17,3,9,99,51,150
25,2,5,48,50,98
21,2,5,40,42,82
29,2,5,81,58,139
3,2,5,8,6,14
12,3,9,70,36,106
11,3,9,64,33,97
15,2,5,35,30,65
24,2,5,56,48,104
11,7,9,18,77,95
17,7,9,10,119,129
17,7,9,6,119,125
7,7,9,5,49,54
19,3,8,93,57,150
21,3,8,102,63,165
27,8,22,366,216,582
18,8,22,244,144,388
7,8,22,64,56,120
26,8,22,238,208,446
26,8,22,353,208,561
17,9,24,165,153,318
22,9,24,214,198,412
22,13,35,322,286,608
10,13,35,213,130,343
18,13,35,314,234,548
2,13,35,43,26,69
13,13,35,281,169,450
27,13,35,585,351,936
17,13,35,350,221,571
3,13,35,52,39,91
9,13,35,195,117,312
10,13,35,217,130,347
10,13,35,206,130,336
23,13,35,401,299,700
10,13,35,213,130,343
6,13,35,128,78,206
9,13,35,129,117,246
1,21,55,33,21,54
2,38,50,22,76,98
4,38,50,40,152,192
13,42,54,44,546,590
1,1252,2295,997,1252,2249
3,420,769,1001,1260,2261
2,420,769,421,840,1261
1,1252,2295,997,1252,2249
1,2171,3578,1264,2171,3435
1,713,1120,362,713,1075
2,713,1120,523,1426,1949
3,487,783,395,1461,1856
1,2171,3578,1335,2171,3506
3,344,540,248,1032,1280
14,26,70,577,364,941
28,3,9,163,84,247
9,3,9,53,27,80
26,2,5,51,52,103
18,2,5,35,36,71
18,1,2,17,18,35
10,1,2,9,10,19
4,1,2,4,4,8
27,2,5,78,54,132
22,2,5,64,44,108
13,2,5,38,26,64
19,2,5,55,38,93
20,9,25,250,180,430
13,9,25,163,117,280
9,2,5,17,18,35
23,13,35,498,299,797
9,12,33,186,108,294
29,12,33,599,348,947
16,12,33,331,192,523
8,12,33,165,96,261
6,12,33,124,72,196
7,2,5,21,14,35
14,9,25,221,126,347
2,11,30,37,22,59
31,1,2,18,31,49
6,1,2,3,6,9
30,2,5,71,60,131
1,2,5,2,2,4
4,1,2,4,4,8
13,1,2,13,13,26
22,8,21,189,176,365
1,8,21,9,8,17
3,9,25,38,27,65
25,9,25,319,225,544
18,9,25,230,162,392
5,8,21,42,40,82
20,8,21,168,160,328
29,2,5,86,58,144
22,2,5,65,44,109
19,2,5,56,38,94
18,1,2,12,18,30
2,1,2,2,2,4
4,8,21,37,32,69
11,8,21,101,88,189
15,2,5,35,30,65
28,2,5,64,56,120
4,2,5,8,8,16
7,2,5,15,14,29
16,2,5,34,32,66
7,1,4,20,7,27
1,1,4,3,1,4
6,2,5,11,12,23
5,9,25,78,45,123
21,9,25,326,189,515
3,1,4,6,3,9
31,1,4,67,31,98
1,1482,2384,807,1482,2289
1,755,1215,302,755,1057
1,461,742,251,461,712
3,1482,2384,2420,4446,6866
7,24,64,217,168,385
27,2,5,78,54,132
23,2,5,67,46,113
8,4,10,45,32,77
23,4,10,129,92,221
21,2,5,49,42,91
6,2,5,12,12,24
29,2,5,59,58,117
22,2,5,65,44,109
12,2,5,35,24,59
20,2,5,58,40,98
28,2,5,81,56,137
22,2,5,52,44,96
7,2,5,14,14,28
29,2,5,57,58,115
5,2,5,12,10,22
3,2,5,8,6,14
12,3,9,48,36,84
6,3,9,35,18,53
12,2,5,23,24,47
8,7,9,13,56,69
15,7,9,8,105,113
14,7,9,10,98,108
16,7,9,22,112,134
21,7,9,34,147,181
9,3,8,35,27,62
28,8,22,386,224,610
9,9,24,94,81,175
3,9,24,29,27,56
19,9,24,185,171,356
14,13,35,205,182,387
16,13,35,346,208,554
26,13,35,536,338,874
4,13,35,78,52,130
10,13,35,157,130,287
3,13,35,59,39,98
15,13,35,325,195,520
18,13,35,257,234,491
10,21,55,269,210,479
26,21,55,855,546,1401
26,21,55,584,546,1130
18,38,50,180,684,864
20,42,54,13,840,853
27,38,50,27,1026,1053
11,42,54,120,462,582
1,1252,2295,630,1252,1882
1,1252,2295,997,1252,2249
1,1266,2320,544,1266,1810
1,1252,2295,745,1252,1997
3,487,783,559,1461,2020
1,1083,1701,244,1083,1327
1,2171,3578,763,2171,2934
1,713,1120,362,713,1075
3,1555,2443,1638,4665,6303
1,1555,2443,546,1555,2101
1,713,1120,396,713,1109
1,1083,1701,499,1083,1582
1,1519,2443,606,1519,2125
2,713,1120,456,1426,1882
1,344,540,83,344,427
1,713,1120,194,713,907
1,2171,3578,1335,2171,3506
19,26,70,823,494,1317
25,26,70,1065,650,1715
24,3,9,116,72,188
30,1,2,17,30,47
3,2,5,9,6,15
10,2,5,29,20,49
31,9,25,333,279,612
14,9,25,151,126,277
10,11,30,148,110,258
13,2,5,25,26,51
13,2,5,25,26,51
6,1,2,4,6,10
26,1,2,19,26,45
26,11,29,438,286,724
1,2,5,2,2,4
18,8,21,155,144,299
23,1,2,21,23,44
30,2,5,89,60,149
18,2,5,53,36,89
7,2,5,16,14,30
8,1,2,8,8,16
8,1,2,8,8,16
5,1,2,3,5,8
4,2,5,8,8,16
16,1,2,12,16,28
22,2,5,46,44,90
31,9,25,326,279,605
1,1482,2384,807,1482,2289
1,1482,2384,854,1482,2336
19,24,64,590,456,1046
4,59,159,375,236,611
8,59,159,635,472,1107
13,2,5,38,26,64
2,2,5,6,4,10
17,2,5,50,34,84
12,2,5,35,24,59
26,2,5,77,52,129
7,2,5,20,14,34
2,2,5,6,4,10
6,3,9,26,18,44
10,3,9,44,30,74
32,2,5,61,64,125
5,2,5,13,10,23
15,2,5,44,30,74
1,2,5,3,2,5
10,4,10,58,40,98
29,4,10,168,116,284
14,4,10,53,56,109
7,2,5,15,14,29
30,2,5,63,60,123
7,3,9,38,21,59
30,3,9,123,90,213
2,3,9,8,6,14
8,2,5,23,16,39
11,2,5,32,22,54
8,7,9,3,56,59
19,7,9,7,133,140
22,7,9,42,154,196
5,7,9,4,35,39
17,7,9,23,119,142
11,3,8,51,33,84
2,3,8,6,6,12
14,8,22,190,112,302
3,8,22,41,24,65
14,8,22,193,112,305
9,9,24,133,81,214
4,9,24,58,36,94
26,9,24,259,234,493
6,13,35,86,78,164
17,13,35,368,221,589
3,13,35,65,39,104
9,13,35,195,117,312
27,13,35,386,351,737
20,13,35,433,260,693
25,13,35,358,325,683
17,13,35,362,221,583
22,13,35,469,286,755
15,13,35,325,195,520
1,13,35,17,13,30
20,13,35,426,260,686
11,13,35,234,143,377
15,21,55,329,315,644
5,21,55,121,105,226
9,38,50,27,342,369
1,42,54,1,42,43
16,38,50,48,608,656
13,38,50,111,494,605
17,42,54,57,714,771
25,38,50,213,950,1163
23,42,54,115,966,1081
18,38,50,90,684,774
2,1266,2320,1922,2532,4454
2,1266,2320,1134,2532,3666
1,1252,2295,997,1252,2249
3,420,769,1024,1260,2284
1,308,565,184,308,492
1,1266,2320,1031,1266,2297
1,295,540,234,295,529
2,295,540,468,590,1058
1,1898,3375,1410,1898,3308
2,1266,2320,1087,2532,3619
1,2171,3578,656,2171,2827
1,344,540,174,344,518
2,713,1120,411,1426,1837
2,1083,1701,1168,2166,3334
1,1083,1701,499,1083,1582
4,26,70,165,104,269
18,26,70,628,468,1096
17,26,70,593,442,1035
14,2,5,41,28,69
18,13,35,390,234,624
2,13,35,43,26,69
17,13,35,362,221,583
21,13,35,447,273,720
7,1,2,7,7,14
5,1,2,5,5,10
2,1,2,2,2,4
11,11,30,206,121,327
13,11,30,243,143,386
5,2,5,15,10,25
16,2,5,47,32,79
20,2,5,39,40,79
23,2,5,45,46,91
13,2,5,38,26,64
15,2,5,44,30,74
2,2,5,6,4,10
21,2,5,40,42,82
30,2,5,57,60,117
19,11,30,287,209,496
27,11,30,408,297,705
5,2,5,12,10,22
1,2,5,2,2,4
9,2,5,21,18,39
13,1,2,10,13,23
10,1,2,7,10,17
13,1,2,8,13,21
1,1,2,1,1,2
19,11,30,355,209,564
27,11,30,505,297,802
26,8,21,316,208,524
17,8,21,207,136,343
25,11,29,399,275,674
7,11,29,112,77,189
18,2,5,53,36,89
14,2,5,41,28,69
6,1,4,14,6,20
10,1,4,23,10,33
3,1,2,2,3,5
6,2,5,11,12,23
23,2,5,44,46,90
3,1482,2384,1419,4446,5865
3,461,742,376,1383,1759
1,1482,2384,878,1482,2360
1,755,1215,241,755,996
1,755,1215,290,755,1045
3,461,742,554,1383,1937
9,45,120,481,405,886
5,45,120,363,225,588
19,2,5,37,38,75
7,2,5,14,14,28
2,2,5,6,4,10
10,4,10,42,40,82
5,4,10,21,20,41
14,2,5,33,28,61
12,2,5,28,24,52
27,3,9,160,81,241
8,3,9,47,24,71
6,2,5,18,12,30
3,2,5,9,6,15
26,3,9,154,78,232
15,3,9,89,45,134
12,2,5,29,24,53
26,2,5,62,52,114
21,4,10,80,84,164
5,2,5,15,10,25
4,2,5,12,8,20
28,3,9,158,84,242
1,3,9,6,3,9
5,7,9,4,35,39
7,7,9,6,49,55
10,7,9,4,70,74
28,7,9,46,196,242
16,7,9,26,112,138
3,3,8,15,9,24
16,8,22,147,128,275
11,8,22,149,88,237
3,8,22,33,24,57
25,8,22,229,200,429
20,9,24,295,180,475
17,13,35,350,221,571
27,13,35,556,351,907
9,13,35,157,117,274
3,13,35,64,39,103
18,13,35,314,234,548
17,13,35,350,221,571
17,13,35,368,221,589
9,13,35,195,117,312
18,13,35,371,234,605
18,13,35,320,234,554
14,13,35,220,182,402
15,13,35,320,195,515
12,13,35,256,156,412
1,13,35,14,13,27
1,13,35,18,13,31
23,13,35,361,299,660
18,13,35,308,234,542
15,21,55,403,315,718
16,21,55,386,336,722
29,38,50,29,1102,1131
4,38,50,40,152,192
4,38,50,46,152,198
24,38,50,24,912,936
15,38,50,173,570,743
15,38,50,150,570,720
1,1252,2295,745,1252,1997
1,1252,2295,1020,1252,2272
2,1252,2295,1489,2504,3993
2,1266,2320,2015,2532,4547
1,420,769,318,420,738
3,1266,2320,1631,3798,5429
1,420,769,249,420,669
1,308,565,246,308,554
1,1519,2443,826,1519,2345
1,2171,3578,1264,2171,3435
3,487,783,583,1461,2044
1,1555,2443,790,1555,2345
1,1083,1701,601,1083,1684
1,1555,2443,570,1555,2125
2,1555,2443,1141,3110,4251
1,1555,2443,448,1555,2003
1,344,540,185,344,529
1,2171,3578,1371,2171,3542
1,344,540,99,344,443
1,344,540,131,344,475
1,344,540,137,344,481
5,26,70,143,130,273
13,3,9,77,39,116
8,3,9,47,24,71
19,1,2,12,19,31
24,8,21,201,192,393
10,2,5,24,20,44
24,2,5,71,48,119
1,1,2,1,1,2
1,1,2,1,1,2
30,2,5,84,60,144
26,1,2,17,26,43
11,1,2,7,11,18
21,1,2,13,21,34
15,1,4,37,15,52
9,1,2,8,9,17
6,1,2,6,6,12
20,2,5,47,40,87
5,1,2,3,5,8
3,1,4,8,3,11
18,2,5,50,36,86
9,2,5,25,18,43
3,1,4,6,3,9
8,1,2,5,8,13
13,1,2,8,13,21
16,1,4,36,16,52
15,1,4,34,15,49
13,2,5,38,26,64
9,12,33,133,108,241
1,1,2,1,1,2
23,1,2,23,23,46
23,1,2,13,23,36
24,1,2,13,24,37
8,8,21,82,64,146
1,11,29,13,11,24
26,11,29,332,286,618
22,1,4,54,22,76
20,9,25,310,180,490
1,1482,2384,616,1482,2098
3,461,742,754,1383,2137
3,1482,2384,1419,4446,5865
1,1482,2384,807,1482,2289
3,1482,2384,1419,4446,5865
1,1482,2384,473,1482,1955
1,1482,2384,568,1482,2050
1,461,742,185,461,646
1,1482,2384,854,1482,2336
17,24,64,484,408,892
11,24,64,433,264,697
28,2,5,83,56,139
24,2,5,50,48,98
14,2,5,27,28,55
1,2,5,2,2,4
5,4,10,29,20,49
14,4,10,64,56,120
22,4,10,101,88,189
18,4,10,104,72,176
14,2,5,27,28,55
22,2,5,42,44,86
16,3,9,93,48,141
1,3,9,6,3,9
17,3,9,99,51,150
13,2,5,31,26,57
32,2,5,75,64,139
28,7,9,46,196,242
17,7,9,28,119,147
11,7,9,20,77,97
12,7,9,10,84,94
24,7,9,39,168,207
20,7,9,0,140,140
7,7,9,13,49,62
16,7,9,29,112,141
26,7,9,10,182,192
6,7,9,5,42,47
28,7,9,11,196,207
20,3,8,98,60,158
22,8,22,298,176,474
10,8,22,136,80,216
25,8,22,279,200,479
4,8,22,40,32,72
7,8,22,78,56,134
3,9,24,44,27,71
7,9,24,103,63,166
3,9,24,44,27,71
8,9,24,95,72,167
15,13,35,320,195,515
24,13,35,419,312,731
26,13,35,536,338,874
24,13,35,494,312,806
15,13,35,215,195,410
1,13,35,22,13,35
11,13,35,227,143,370
25,13,35,393,325,718
20,13,35,349,260,609
11,13,35,157,143,300
27,13,35,528,351,879
26,13,35,508,338,846
14,13,35,288,182,470
16,13,35,251,208,459
10,13,35,147,130,277
10,13,35,143,130,273
8,13,35,170,104,274
17,13,35,350,221,571
26,13,35,508,338,846
30,21,55,806,630,1436
17,21,55,569,357,926
21,38,50,242,798,1040
15,38,50,15,570,585
21,38,50,116,798,914
3,42,54,7,126,133
1,1252,2295,951,1252,2203
3,1266,2320,3023,3798,6821
1,1266,2320,961,1266,2227
1,295,540,223,295,518
1,1266,2320,1008,1266,2274
1,420,769,341,420,761
3,1252,2295,1890,3756,5646
1,420,769,188,420,608
1,1252,2295,882,1252,2134
1,2171,3578,763,2171,2934
1,1083,1701,584,1083,1667
1,1083,1701,584,1083,1667
1,487,783,241,487,728
2,1555,2443,701,3110,3811
1,713,1120,329,713,1042
1,1555,2443,570,1555,2125
1,1555,2443,570,1555,2125
1,1083,1701,499,1083,1582
3,487,783,395,1461,1856
1,344,540,126,344,470
2,344,540,252,688,940
7,26,70,200,182,382
6,26,70,256,156,412
7,26,70,244,182,426
17,26,70,498,442,940
14,3,9,81,42,123
2,1,2,2,2,4
23,8,21,265,184,449
13,8,21,150,104,254
20,9,25,315,180,495
10,9,25,158,90,248
24,2,5,70,48,118
23,2,5,67,46,113
13,2,5,38,26,64
9,2,5,21,18,39
26,13,35,554,338,892
13,13,35,277,169,446
15,2,5,44,30,74
9,2,5,27,18,45
3,11,30,45,33,78
5,11,30,76,55,131
20,1,4,54,20,74
27,1,4,73,27,100
5,1,4,14,5,19
5,9,25,75,45,120
29,2,5,84,58,142
5,2,5,15,10,25
24,1,2,13,24,37
13,1,2,7,13,20
4,8,21,50,32,82
2,1,4,5,2,7
26,12,33,486,312,798
2,12,33,37,24,61
28,11,29,447,308,755
17,2,5,40,34,74
24,1,2,13,24,37
7,1,2,4,7,11
20,1,2,11,20,31
11,1,2,6,11,17
8,1,4,19,8,27
9,12,33,183,108,291
23,12,33,468,276,744
20,1,2,14,20,34
1,1,2,1,1,2
10,1,2,7,10,17
25,2,5,70,50,120
3,2,5,8,6,14
18,2,5,50,36,86
27,8,21,232,216,448
13,1,2,13,13,26
12,1,2,12,12,24
5,1,2,4,5,9
14,1,2,10,14,24
1,461,742,229,461,690
1,1482,2384,807,1482,2289
1,1482,2384,735,1482,2217
1,461,742,251,461,712
9,24,64,285,216,501
27,24,64,700,648,1348
6,24,64,156,144,300
24,4,10,134,96,230
6,4,10,34,24,58
24,3,9,99,72,171
26,3,9,107,78,185
7,2,5,20,14,34
19,2,5,55,38,93
8,2,5,23,16,39
23,4,10,133,92,225
14,4,10,81,56,137
9,2,5,25,18,43
19,2,5,53,38,91
24,2,5,46,48,94
11,2,5,25,22,47
5,3,9,29,15,44
6,3,9,35,18,53
29,2,5,68,58,126
19,2,5,42,38,80
20,2,5,44,40,84
23,2,5,67,46,113
25,2,5,73,50,123
5,2,5,12,10,22
27,4,10,159,108,267
8,4,10,47,32,79
27,2,5,76,54,130
15,2,5,42,30,72
13,2,5,31,26,57
2,2,5,5,4,9
8,2,5,23,16,39
21,2,5,61,42,103
5,7,9,10,35,45
7,7,9,13,49,62
1,7,9,0,7,7
14,7,9,12,98,110
22,7,9,12,154,166
7,3,8,23,21,44
30,3,8,148,90,238
19,8,22,174,152,326
16,8,22,220,128,348
1,8,22,14,8,22
18,9,24,253,162,415
24,9,24,233,216,449
9,9,24,131,81,212
9,9,24,90,81,171
19,9,24,267,171,438
25,13,35,533,325,858
1,13,35,16,13,29
18,13,35,390,234,624
22,13,35,469,286,755
13,13,35,281,169,450
4,13,35,82,52,134
7,13,35,144,91,235
12,13,35,176,156,332
9,13,35,157,117,274
26,13,35,508,338,846
22,13,35,376,286,662
1,13,35,14,13,27
4,13,35,59,52,111
1,13,35,17,13,30
15,21,55,494,315,809
2,21,55,50,42,92
11,21,55,295,231,526
6,42,54,66,252,318
7,38,50,21,266,287
11,42,54,55,462,517
26,38,50,299,988,1287
1,1266,2320,636,1266,1902
2,1266,2320,1087,2532,3619
1,308,565,155,308,463
2,1266,2320,2062,2532,4594
2,420,769,498,840,1338
1,1266,2320,961,1266,2227
2,2171,3578,2528,4342,6870
1,487,783,280,487,767
1,713,1120,261,713,974
1,2171,3578,835,2171,3006
1,713,1120,250,713,963
1,713,1120,205,713,918
1,1555,2443,497,1555,2052
1,344,540,185,344,529
1,1083,1701,550,1083,1633
1,2171,3578,1371,2171,3542
21,26,70,601,546,1147
20,2,5,58,40,98
5,13,35,73,65,138
21,13,35,308,273,581
3,2,5,8,6,14
20,2,5,56,40,96
28,1,2,21,28,49
12,1,2,9,12,21
11,8,21,101,88,189
26,2,5,69,52,121
5,2,5,13,10,23
9,2,5,27,18,45
10,2,5,30,20,50
18,1,2,13,18,31
16,1,2,12,16,28
1,1,2,1,1,2
25,1,2,16,25,41
1,9,25,11,9,20
3,1,2,2,3,5
26,1,2,19,26,45
6,9,25,86,54,140
25,9,25,356,225,581
4,2,5,9,8,17
11,1,4,26,11,37
21,1,4,50,21,71
3,1,2,2,3,5
16,1,4,47,16,63
8,1,4,24,8,32
11,1,4,27,11,38
7,1,4,17,7,24
22,1,2,16,22,38
24,2,5,47,48,95
3,2,5,6,6,12
6,1,4,18,6,24
7,2,5,20,14,34
13,2,5,38,26,64
20,2,5,58,40,98
22,2,5,42,44,86
17,2,5,32,34,66
18,2,5,34,36,70
14,8,21,161,112,273
29,1,2,21,29,50
1,1,2,1,1,2
20,2,5,56,40,96
5,8,21,48,40,88
27,8,21,260,216,476
4,8,21,49,32,81
8,2,5,23,16,39
25,1,4,61,25,86
20,1,4,49,20,69
2,1482,2384,1613,2964,4577
1,1482,2384,568,1482,2050
3,461,742,798,1383,2181
28,24,64,797,672,1469
16,24,64,507,384,891
26,24,64,973,624,1597
26,24,64,1007,624,1631
5,45,120,267,225,492
1,59,159,75,59,134
6,59,159,390,354,744
24,2,5,47,48,95
10,2,5,19,20,39
7,2,5,13,14,27
24,2,5,71,48,119
19,3,9,111,57,168
28,3,9,163,84,247
16,2,5,45,32,77
18,2,5,50,36,86
3,2,5,9,6,15
12,2,5,35,24,59
8,2,5,15,16,31
1,2,5,2,2,4
18,2,5,34,36,70
29,2,5,55,58,113
26,2,5,60,52,112
5,4,10,24,20,44
15,4,10,71,60,131
22,2,5,65,44,109
14,2,5,29,28,57
17,2,5,36,34,70
13,2,5,38,26,64
28,2,5,81,56,137
12,2,5,23,24,47
3,2,5,7,6,13
25,2,5,59,50,109
21,2,5,61,42,103
20,2,5,58,40,98
17,2,5,49,34,83
28,2,5,53,56,109
27,2,5,51,54,105
12,2,5,25,24,49
8,2,5,17,16,33
24,2,5,56,48,104
9,2,5,21,18,39
7,3,9,28,21,49
11,3,9,44,33,77
30,3,9,161,90,251
1,3,9,5,3,8
11,7,9,4,77,81
13,7,9,0,91,91
15,7,9,8,105,113
8,7,9,7,56,63
1,7,9,2,7,9
25,7,9,21,175,196
20,7,9,0,140,140
19,7,9,26,133,159
23,7,9,38,161,199
10,7,9,4,70,74
17,7,9,23,119,142
16,3,8,75,48,123
21,3,8,68,63,131
17,8,22,234,136,370
3,9,24,42,27,69
31,13,35,443,403,846
29,13,35,415,377,792
9,13,35,192,117,309
23,13,35,474,299,773
16,13,35,279,208,487
4,13,35,82,52,134
28,13,35,400,364,764
20,13,35,433,260,693
17,13,35,267,221,488
11,13,35,192,143,335
13,13,35,227,169,396
20,13,35,349,260,609
4,13,35,78,52,130
22,13,35,361,286,647
14,13,35,200,182,382
22,13,35,469,286,755
10,13,35,213,130,343
7,13,35,110,91,201
14,13,35,220,182,402
28,13,35,479,364,843
22,13,35,430,286,716
10,21,55,219,210,429
10,21,55,329,210,539
13,42,54,142,546,688
17,38,50,187,646,833
18,42,54,90,756,846
13,38,50,143,494,637
15,38,50,173,570,743
3,38,50,9,114,123
27,42,54,309,1134,1443
13,38,50,13,494,507
15,38,50,165,570,735
4,42,54,20,168,188
3,38,50,12,114,126
24,42,54,236,1008,1244
22,42,54,50,924,974
7,38,50,77,266,343
1,1266,2320,544,1266,1810
3,295,540,670,885,1555
1,1266,2320,752,1266,2018
2,1266,2320,1922,2532,4454
1,1898,3375,1410,1898,3308
1,2171,3578,1264,2171,3435
1,487,783,280,487,767
1,344,540,185,344,529
1,1555,2443,448,1555,2003
1,1555,2443,717,1555,2272
1,2171,3578,763,2171,2934
1,713,1120,161,713,874
1,344,540,99,344,443
3,344,540,523,1032,1555
1,344,540,174,344,518
1,713,1120,261,713,974
1,344,540,174,344,518
25,26,70,873,650,1523
10,26,70,286,260,546
11,1,2,11,11,22
2,1,2,2,2,4
3,1,2,3,3,6
28,1,2,27,28,55
15,2,5,29,30,59
17,2,5,32,34,66
6,2,5,17,12,29
12,13,35,197,156,353
25,2,5,74,50,124
15,2,5,44,30,74
12,2,5,32,24,56
10,2,5,27,20,47
20,1,2,11,20,31
24,1,2,13,24,37
8,2,5,22,16,38
14,1,2,10,14,24
20,2,5,56,40,96
32,2,5,90,64,154
8,1,2,4,8,12
24,1,2,13,24,37
9,1,2,6,9,15
21,1,2,13,21,34
3,1,2,2,3,5
7,1,2,4,7,11
29,9,25,457,261,718
10,9,25,158,90,248
21,1,4,48,21,69
1,1,4,2,1,3
13,13,35,213,169,382
4,1,2,4,4,8
22,1,2,22,22,44
7,11,29,122,77,199
12,1,2,12,12,24
12,8,21,123,96,219
27,1,4,57,27,84
31,1,4,66,31,97
29,1,2,21,29,50
24,1,2,18,24,42
22,1,2,16,22,38
29,8,21,353,232,585
23,8,21,280,184,464
23,8,21,280,184,464
1,1482,2384,378,1482,1860
1,461,742,266,461,727
3,1482,2384,2563,4446,7009
3,461,742,687,1383,2070
1,24,64,39,24,63
17,24,64,604,408,1012
5,24,64,197,120,317
4,59,159,260,236,496
28,2,5,78,56,134
4,2,5,11,8,19
2,2,5,6,4,10
13,4,10,77,52,129
10,2,5,30,20,50
14,2,5,27,28,55
24,2,5,47,48,95
9,2,5,17,18,35
12,2,5,23,24,47
21,3,9,122,63,185
25,2,5,59,50,109
1,2,5,2,2,4
24,2,5,67,48,115
14,3,9,61,42,103
21,3,9,92,63,155
5,7,9,3,35,38
6,7,9,1,42,43
17,7,9,31,119,150
30,7,9,11,210,221
18,7,9,7,126,133
28,7,9,23,196,219
2,3,8,8,6,14
1,3,8,5,3,8
20,3,8,94,60,154
23,8,22,312,184,496
5,8,22,69,40,109
10,8,22,131,80,211
8,8,22,80,64,144
27,9,24,399,243,642
26,9,24,253,234,487
1,13,35,14,13,27
14,13,35,288,182,470
26,13,35,563,338,901
16,13,35,346,208,554
4,13,35,70,52,122
6,13,35,124,78,202
18,13,35,264,234,498
1,13,35,21,13,34
3,13,35,62,39,101
11,13,35,234,143,377
21,13,35,455,273,728
1,13,35,21,13,34
13,13,35,204,169,373
17,13,35,267,221,488
21,13,35,308,273,581
25,13,35,410,325,735
26,13,35,408,338,746
8,21,55,215,168,383
10,21,55,225,210,435
11,38,50,11,418,429
28,38,50,322,1064,1386
8,42,54,87,336,423
25,42,54,273,1050,1323
12,42,54,27,504,531
12,38,50,120,456,576
18,38,50,180,684,864
17,38,50,94,646,740
3,1252,2295,3060,3756,6816
1,1252,2295,951,1252,2203
2,1252,2295,1122,2504,3626
1,1252,2295,951,1252,2203
2,420,769,421,840,1261
3,308,565,551,924,1475
1,1266,2320,1031,1266,2297
1,420,769,211,420,631
1,1266,2320,1008,1266,2274
2,2171,3578,2313,4342,6655
2,487,783,247,974,1221
2,1083,1701,1168,2166,3334
3,1519,2443,1233,4557,5790
1,487,783,132,487,619
1,487,783,171,487,658
1,344,540,174,344,518
1,26,70,43,26,69
9,26,70,383,234,617
30,3,9,169,90,259
27,1,2,26,27,53
10,2,5,28,20,48
1,2,5,3,2,5
10,2,5,28,20,48
13,1,4,38,13,51
13,1,4,38,13,51
20,9,25,215,180,395
6,9,25,65,54,119
13,2,5,36,26,62
19,2,5,53,38,91
9,2,5,25,18,43
18,9,25,284,162,446
17,2,5,36,34,70
26,2,5,55,52,107
12,9,25,129,108,237
30,2,5,89,60,149
12,2,5,35,24,59
2,2,5,6,4,10
24,12,33,472,288,760
5,12,33,98,60,158
22,2,5,52,44,96
27,2,5,63,54,117
14,2,5,41,28,69
20,2,5,59,40,99
1,2,5,3,2,5
12,1,4,34,12,46
3,1,4,9,3,12
1,12,33,17,12,29
14,12,33,234,168,402
28,2,5,83,56,139
27,2,5,80,54,134
18,11,30,229,198,427
29,1,4,68,29,97
28,1,4,66,28,94
1,1,4,2,1,3
8,2,5,22,16,38
2,1,2,2,2,4
12,1,2,12,12,24
26,1,2,25,26,51
16,1,2,16,16,32
2,2,5,4,4,8
13,1,4,38,13,51
8,1,4,23,8,31
26,1,2,19,26,45
5,1,4,11,5,16
10,1,2,6,10,16
13,1,2,8,13,21
19,8,21,163,152,315
20,8,21,172,160,332
5,8,21,51,40,91
5,8,21,51,40,91
11,2,5,21,22,43
15,1,2,11,15,26
30,1,2,22,30,52
1,1482,2384,592,1482,2074
1,461,742,162,461,623
20,45,120,1188,900,2088
27,2,5,80,54,134
16,2,5,47,32,79
7,3,9,38,21,59
3,3,9,16,9,25
18,2,5,53,36,89
26,2,5,77,52,129
11,2,5,31,22,53
23,2,5,64,46,110
6,2,5,17,12,29
20,2,5,58,40,98
14,2,5,39,28,67
22,2,5,64,44,108
1,2,5,3,2,5
22,2,5,64,44,108
7,2,5,20,14,34
18,2,5,38,36,74
16,2,5,34,32,66
14,2,5,41,28,69
26,2,5,75,52,127
7,2,5,20,14,34
14,2,5,41,28,69
30,2,5,63,60,123
1,3,9,5,3,8
5,3,9,25,15,40
27,2,5,59,54,113
22,2,5,52,44,96
8,2,5,19,16,35
2,7,9,0,14,14
10,7,9,18,70,88
23,7,9,42,161,203
20,7,9,38,140,178
19,7,9,16,133,149
5,7,9,9,35,44
28,8,22,380,224,604
11,8,22,123,88,211
6,8,22,83,48,131
26,8,22,324,208,532
6,8,22,83,48,131
16,8,22,161,128,289
12,9,24,177,108,285
18,9,24,261,162,423
24,9,24,348,216,564
28,9,24,407,252,659
6,9,24,67,54,121
7,13,35,144,91,235
20,13,35,286,260,546
30,13,35,429,390,819
9,13,35,195,117,312
22,13,35,469,286,755
1,13,35,18,13,31
6,13,35,130,78,208
31,13,35,660,403,1063
11,13,35,169,143,312
4,13,35,85,52,137
3,13,35,43,39,82
13,13,35,268,169,437
6,13,35,86,78,164
21,13,35,411,273,684
8,13,35,165,104,269
15,21,55,502,315,817
24,21,55,763,504,1267
13,21,55,292,273,565
14,21,55,461,294,755
26,38,50,260,988,1248
2,42,54,22,84,106
12,42,54,138,504,642
9,38,50,9,342,351
7,38,50,7,266,273
7,42,54,24,294,318
18,42,54,197,756,953
18,38,50,72,684,756
24,38,50,72,912,984
1,42,54,2,42,44
20,42,54,197,840,1037
1,1912,3400,1046,1912,2958
3,1898,3375,3115,5694,8809
1,1252,2295,997,1252,2249
1,1252,2295,997,1252,2249
1,1252,2295,882,1252,2134
1,1266,2320,752,1266,2018
1,1266,2320,1031,1266,2297
1,295,540,207,295,502
1,1266,2320,961,1266,2227
1,1266,2320,1008,1266,2274
2,1266,2320,1922,2532,4454
1,308,565,246,308,554
1,1266,2320,636,1266,1902
1,1898,3375,1410,1898,3308
3,2171,3578,2289,6513,8802
1,713,1120,385,713,1098
3,1555,2443,2371,4665,7036
1,1519,2443,533,1519,2052
1,1555,2443,595,1555,2150
1,344,540,191,344,535
1,2171,3578,1335,2171,3506
1,1083,1701,312,1083,1395
2,487,783,341,974,1315
3,344,540,329,1032,1361
1,2171,3578,620,2171,2791
20,26,70,852,520,1372
19,26,70,543,494,1037
15,26,70,429,390,819
17,26,70,724,442,1166
1,1,2,1,1,2
25,1,2,24,25,49
14,1,2,8,14,22
5,13,35,103,65,168
24,13,35,494,312,806
2,1,2,1,2,3
27,1,2,17,27,44
23,1,2,15,23,38
4,13,35,87,52,139
15,13,35,325,195,520
6,2,5,17,12,29
18,2,5,50,36,86
26,11,30,393,286,679
29,11,30,412,319,731
24,11,30,341,264,605
14,2,5,27,28,55
2,2,5,4,4,8
13,2,5,31,26,57
8,11,30,147,88,235
2,11,30,37,22,59
2,2,5,6,4,10
24,9,25,378,216,594
21,9,25,331,189,520
19,1,2,11,19,30
23,1,2,23,23,46
14,1,2,9,14,23
13,11,29,155,143,298
12,11,29,143,132,275
9,8,21,87,72,159
19,8,21,183,152,335
31,2,5,90,62,152
4,2,5,11,8,19
14,2,5,39,28,67
20,2,5,56,40,96
8,1,2,5,8,13
29,1,2,17,29,46
2,1482,2384,1613,2964,4577
3,755,1215,906,2265,3171
2,755,1215,871,1510,2381
1,755,1215,436,755,1191
1,1482,2384,854,1482,2336
1,1482,2384,807,1482,2289
22,24,64,852,528,1380
3,45,120,211,135,346
28,3,9,128,84,212
18,2,5,53,36,89
13,2,5,38,26,64
6,3,9,34,18,52
23,3,9,130,69,199
13,2,5,36,26,62
24,2,5,70,48,118
8,2,5,23,16,39
6,2,5,16,12,28
2,2,5,5,4,9
13,3,9,70,39,109
14,2,5,39,28,67
3,2,5,8,6,14
24,4,10,115,96,211
20,4,10,96,80,176
1,4,10,6,4,10
26,4,10,146,104,250
30,2,5,71,60,131
20,2,5,47,40,87
29,2,5,84,58,142
26,2,5,75,52,127
26,2,5,57,52,109
26,2,5,77,52,129
16,2,5,47,32,79
4,3,9,23,12,35
9,3,9,52,27,79
27,2,5,62,54,116
5,2,5,12,10,22
19,2,5,36,38,74
24,2,5,46,48,94
20,7,9,36,140,176
12,7,9,9,84,93
9,7,9,15,63,78
25,7,9,46,175,221
25,3,8,117,75,192
26,3,8,97,78,175
16,8,22,150,128,278
2,8,22,28,16,44
14,8,22,184,112,296
18,8,22,236,144,380
2,9,24,29,18,47
1,9,24,10,9,19
3,13,35,52,39,91
14,13,35,244,182,426
17,13,35,249,221,470
6,13,35,92,78,170
21,13,35,366,273,639
12,13,35,260,156,416
13,13,35,190,169,359
13,13,35,268,169,437
16,13,35,346,208,554
26,13,35,463,338,801
7,13,35,115,91,206
22,13,35,361,286,647
2,13,35,34,26,60
3,13,35,64,39,103
9,13,35,195,117,312
6,13,35,124,78,202
20,13,35,286,260,546
20,13,35,349,260,609
11,13,35,215,143,358
31,13,35,606,403,1009
23,13,35,329,299,628
9,42,54,103,378,481
5,42,54,57,210,267
21,42,54,207,882,1089
3,1912,3400,2832,5736,8568
1,1266,2320,752,1266,2018
3,1266,2320,2884,3798,6682
3,1266,2320,2884,3798,6682
2,1266,2320,1087,2532,3619
2,295,540,252,590,842
1,1266,2320,961,1266,2227
1,420,769,295,420,715
1,1252,2295,768,1252,2020
3,1252,2295,2991,3756,6747
2,1266,2320,2062,2532,4594
1,1266,2320,961,1266,2227
1,420,769,295,420,715
1,1266,2320,961,1266,2227
1,1519,2443,606,1519,2125
1,487,783,280,487,767
1,1519,2443,411,1519,1930
1,2171,3578,942,2171,3113
2,713,1120,321,1426,1747
2,1083,1701,692,2166,2858
1,344,540,110,344,454
3,3,9,14,9,23
4,2,5,12,8,20
20,1,2,20,20,40
15,1,2,15,15,30
25,13,35,366,325,691
10,13,35,147,130,277
14,1,4,33,14,47
7,13,35,152,91,243
26,13,35,426,338,764
22,13,35,361,286,647
3,9,25,38,27,65
26,9,25,332,234,566
12,2,5,35,24,59
23,2,5,68,46,114
1,1,2,1,1,2
10,9,25,113,90,203
18,2,5,44,36,80
2,2,5,5,4,9
6,1,2,6,6,12
9,1,2,5,9,14
22,1,2,12,22,34
6,2,5,13,12,25
8,2,5,17,16,33
6,2,5,11,12,23
11,2,5,21,22,43
24,2,5,46,48,94
12,2,5,28,24,52
28,8,21,282,224,506
26,8,21,262,208,470
15,13,35,325,195,520
8,2,5,15,16,31
9,2,5,17,18,35
24,1,2,24,24,48
7,1,2,5,7,12
8,1,2,5,8,13
17,2,5,40,34,74
24,11,30,449,264,713
24,11,30,449,264,713
12,2,5,35,24,59
1,2,5,3,2,5
12,2,5,35,24,59
29,1,2,21,29,50
10,2,5,24,20,44
6,1,2,3,6,9
18,1,2,10,18,28
21,1,4,57,21,78
8,1,4,22,8,30
3,2,5,6,6,12
10,2,5,29,20,49
3,1,2,3,3,6
29,1,2,27,29,56
9,1,4,26,9,35
25,1,4,71,25,96
28,9,25,294,252,546
2,1482,2384,1613,2964,4577
3,1482,2384,2420,4446,6866
2,755,1215,750,1510,2260
1,24,64,39,24,63
18,24,64,513,432,945
6,45,120,292,270,562
1,59,159,98,59,157
17,2,5,40,34,74
1,2,5,3,2,5
17,2,5,36,34,70
17,2,5,36,34,70
14,4,10,55,56,111
6,4,10,23,24,47
26,2,5,55,52,107
1,2,5,2,2,4
13,4,10,75,52,127
9,4,10,52,36,88
2,2,5,6,4,10
1,2,5,3,2,5
22,2,5,42,44,86
13,2,5,25,26,51
28,2,5,81,56,137
6,3,9,34,18,52
30,3,9,169,90,259
22,2,5,51,44,95
2,3,9,8,6,14
7,3,9,27,21,48
25,2,5,59,50,109
12,3,9,53,36,89
8,7,9,15,56,71
1,7,9,2,7,9
9,7,9,17,63,80
3,7,9,0,21,21
28,7,9,1,196,197
23,7,9,13,161,174
15,7,9,6,105,111
1,7,9,2,7,9
12,7,9,23,84,107
13,7,9,24,91,115
15,7,9,12,105,117
2,7,9,3,14,17
11,3,8,54,33,87
14,3,8,55,42,97
2,8,22,20,16,36
29,8,22,266,232,498
2,8,22,28,16,44
13,9,24,189,117,306
25,9,24,363,225,588
9,9,24,126,81,207
29,13,35,628,377,1005
9,13,35,185,117,302
7,13,35,103,91,194
18,13,35,371,234,605
3,13,35,62,39,101
14,13,35,298,182,480
1,13,35,15,13,28
13,13,35,268,169,437
2,13,35,29,26,55
32,13,35,570,416,986
3,13,35,62,39,101
24,13,35,377,312,689
19,21,55,604,399,1003
9,21,55,296,189,485
13,38,50,143,494,637
6,42,54,69,252,321
18,38,50,18,684,702
5,38,50,55,190,245
6,42,54,30,252,282
14,42,54,62,588,650
1,1266,2320,544,1266,1810
1,308,565,246,308,554
3,1555,2443,1638,4665,6303
3,1555,2443,2517,4665,7182
1,2171,3578,656,2171,2827
2,1555,2443,1581,3110,4691
1,1519,2443,484,1519,2003
2,713,1120,724,1426,2150
3,344,540,232,1032,1264
3,344,540,523,1032,1555
1,1555,2443,570,1555,2125
1,713,1120,205,713,918
2,487,783,388,974,1362
1,344,540,99,344,443
1,2171,3578,620,2171,2791
28,26,70,1193,728,1921
30,26,70,1299,780,2079
11,26,70,376,286,662
19,26,70,623,494,1117
19,3,9,83,57,140
13,1,4,38,13,51
8,1,2,8,8,16
20,1,2,20,20,40
1,13,35,17,13,30
8,11,30,150,88,238
23,11,30,430,253,683
16,1,2,15,16,31
6,1,2,6,6,12
12,1,2,12,12,24
3,2,5,8,6,14
8,2,5,22,16,38
5,9,25,79,45,124
3,9,25,47,27,74
3,1,4,7,3,10
3,1,4,7,3,10
19,1,2,11,19,30
14,1,2,8,14,22
18,2,5,50,36,86
23,2,5,64,46,110
12,1,4,30,12,42
13,1,4,28,13,41
16,1,4,34,16,50
5,1,2,3,5,8
13,9,25,166,117,283
27,1,2,15,27,42
29,1,2,16,29,45
7,1,2,4,7,11
24,2,5,67,48,115
2,1,2,1,2,3
22,1,2,14,22,36
24,8,21,206,192,398
26,8,21,223,208,431
19,2,5,36,38,74
25,2,5,48,50,98
13,1,2,13,13,26
18,1,2,18,18,36
27,1,2,26,27,53
14,2,5,41,28,69
2,2,5,6,4,10
11,11,29,160,121,281
14,11,29,203,154,357
7,2,5,13,14,27
29,9,25,363,261,624
1,461,742,251,461,712
1,1482,2384,854,1482,2336
3,1482,2384,1133,4446,5579
1,1482,2384,854,1482,2336
3,461,742,576,1383,1959
13,24,64,387,312,699
10,24,64,317,240,557
4,45,120,290,180,470
9,4,10,53,36,89
29,4,10,171,116,287
14,2,5,41,28,69
15,2,5,32,30,62
17,2,5,36,34,70
16,4,10,66,64,130
13,4,10,53,52,105
27,2,5,51,54,105
12,3,9,71,36,107
12,3,9,71,36,107
18,3,9,105,54,159
5,2,5,11,10,21
14,4,10,81,56,137
2,4,10,12,8,20
5,3,9,20,15,35
15,3,9,60,45,105
29,3,9,119,87,206
4,3,9,16,12,28
26,2,5,73,52,125
6,2,5,13,12,25
5,2,5,11,10,21
19,2,5,55,38,93
21,2,5,61,42,103
17,7,9,6,119,125
19,7,9,26,133,159
5,7,9,1,35,36
10,7,9,7,70,77
7,7,9,6,49,55
16,7,9,22,112,134
19,3,8,93,57,150
19,3,8,86,57,143
2,3,8,10,6,16
25,8,22,339,200,539
16,8,22,168,128,296
24,8,22,262,192,454
1,8,22,14,8,22
21,8,22,262,168,430
25,9,24,369,225,594
1,13,35,22,13,35
9,13,35,157,117,274
4,13,35,66,52,118
22,13,35,376,286,662
23,13,35,450,299,749
17,13,35,332,221,553
16,13,35,234,208,442
12,13,35,235,156,391
11,13,35,227,143,370
6,13,35,128,78,206
7,13,35,122,91,213
20,13,35,349,260,609
1,13,35,14,13,27
11,13,35,173,143,316
8,21,55,268,168,436
12,21,55,269,252,521
7,42,54,5,294,299
4,38,50,4,152,156
30,42,54,101,1260,1361
12,42,54,60,504,564
1,1266,2320,729,1266,1995
1,1898,3375,937,1898,2835
1,1266,2320,915,1266,2181
2,1252,2295,1122,2504,3626
3,308,565,466,924,1390
1,420,769,203,420,623
1,295,540,126,295,421
2,487,783,561,974,1535
1,1083,1701,397,1083,1480
1,2171,3578,942,2171,3113
3,1083,1701,1140,3249,4389
2,1083,1701,1202,2166,3368
1,487,783,241,487,728
1,2171,3578,656,2171,2827
1,1555,2443,497,1555,2052
2,344,540,252,688,940
2,344,540,165,688,853
4,26,70,117,104,221
5,26,70,213,130,343
8,26,70,341,208,549
4,3,9,23,12,35
4,3,9,23,12,35
12,1,2,12,12,24
4,2,5,12,8,20
5,1,2,5,5,10
4,1,2,4,4,8
12,13,35,239,156,395
11,13,35,219,143,362
5,13,35,100,65,165
21,1,2,20,21,41
7,1,2,7,7,14
13,1,2,12,13,25
14,13,35,274,182,456
4,13,35,78,52,130
13,11,30,220,143,363
15,11,30,254,165,419
28,9,25,301,252,553
22,2,5,59,44,103
1,2,5,3,2,5
4,1,2,3,4,7
10,1,2,6,10,16
18,2,5,53,36,89
15,11,30,218,165,383
3,1,2,2,3,5
1,1,2,1,1,2
17,1,2,13,17,30
19,1,2,14,19,33
14,1,2,14,14,28
28,1,2,27,28,55
26,1,2,25,26,51
5,1,2,5,5,10
6,9,25,93,54,147
1,1482,2384,473,1482,1955
1,1482,2384,735,1482,2217
1,1482,2384,735,1482,2217
23,24,64,699,552,1251
7,45,120,407,315,722
17,2,5,49,34,83
22,2,5,64,44,108
7,2,5,20,14,34
1,4,10,6,4,10
24,4,10,142,96,238
16,2,5,34,32,66
27,2,5,57,54,111
13,2,5,38,26,64
5,2,5,15,10,25
9,2,5,19,18,37
12,2,5,25,24,49
10,2,5,29,20,49
9,2,5,19,18,37
1,2,5,2,2,4
5,3,9,27,15,42
14,3,9,75,42,117
20,2,5,38,40,78
5,2,5,15,10,25
20,2,5,59,40,99
25,2,5,73,50,123
21,2,5,61,42,103
10,7,9,16,70,86
5,7,9,8,35,43
11,7,9,18,77,95
19,7,9,31,133,164
4,7,9,8,28,36
21,7,9,17,147,164
23,7,9,44,161,205
21,7,9,38,147,185
25,7,9,48,175,223
23,3,8,102,69,171
5,3,8,23,15,38
11,8,22,110,88,198
28,8,22,380,224,604
18,8,22,244,144,388
18,8,22,165,144,309
20,8,22,223,160,383
16,8,22,217,128,345
3,8,22,41,24,65
3,8,22,39,24,63
8,8,22,108,64,172
1,8,22,10,8,18
9,8,22,124,72,196
27,9,24,262,243,505
23,9,24,224,207,431
28,13,35,381,364,745
15,13,35,325,195,520
17,13,35,350,221,571
12,13,35,256,156,412
16,13,35,330,208,538
7,13,35,144,91,235
21,13,35,433,273,706
18,13,35,257,234,491
14,13,35,298,182,480
18,13,35,383,234,617
23,13,35,313,299,612
13,13,35,218,169,387
12,13,35,209,156,365
27,13,35,575,351,926
18,13,35,383,234,617
23,13,35,474,299,773
24,13,35,343,312,655
26,13,35,372,338,710
1,13,35,14,13,27
11,13,35,173,143,316
19,13,35,312,247,559
3,21,55,99,63,162
21,21,55,564,441,1005
14,21,55,445,294,739
15,21,55,329,315,644
15,38,50,45,570,615
29,42,54,19,1218,1237
20,42,54,67,840,907
17,38,50,196,646,842
19,42,54,43,798,841
5,42,54,57,210,267
12,38,50,132,456,588
14,42,54,70,588,658
1,1252,2295,630,1252,1882
1,1266,2320,752,1266,2018
2,1266,2320,994,2532,3526
1,1252,2295,561,1252,1813
3,308,565,466,924,1390
1,1252,2295,997,1252,2249
1,1266,2320,544,1266,1810
1,295,540,207,295,502
1,420,769,318,420,738
3,308,565,703,924,1627
3,1266,2320,3023,3798,6821
1,308,565,246,308,554
1,1266,2320,961,1266,2227
1,1555,2443,448,1555,2003
1,1083,1701,601,1083,1684
1,713,1120,385,713,1098
1,713,1120,161,713,874
1,713,1120,362,713,1075
1,344,540,158,344,502
1,713,1120,239,713,952
3,2171,3578,4006,6513,10519
10,26,70,286,260,546
1,3,9,6,3,9
21,1,2,12,21,33
13,1,2,7,13,20
24,13,35,343,312,655
1,13,35,14,13,27
21,13,35,447,273,720
27,13,35,575,351,926
28,13,35,596,364,960
5,2,5,10,10,20
1,2,5,2,2,4
17,12,33,335,204,539
23,2,5,67,46,113
10,2,5,29,20,49
18,1,2,17,18,35
6,1,2,6,6,12
2,1,2,1,2,3
12,13,35,256,156,412
20,13,35,426,260,686
7,13,35,149,91,240
8,9,25,86,72,158
5,9,25,54,45,99
16,9,25,172,144,316
14,2,5,41,28,69
20,2,5,59,40,99
21,2,5,40,42,82
23,2,5,41,46,87
20,2,5,36,40,76
5,1,2,4,5,9
4,1,2,3,4,7
2,9,25,22,18,40
6,9,25,65,54,119
20,9,25,215,180,395
30,1,2,28,30,58
8,1,2,7,8,15
6,1,4,14,6,20
4,1,4,9,4,13
14,2,5,33,28,61
3,1,2,3,3,6
19,1,2,13,19,32
30,2,5,87,60,147
14,2,5,41,28,69
27,2,5,78,54,132
2,2,5,6,4,10
15,1,2,11,15,26
1,1,2,1,1,2
4,2,5,11,8,19
13,1,2,11,13,24
3,1,2,3,3,6
18,11,29,314,198,512
1,11,29,17,11,28
1,11,29,17,11,28
10,1,2,6,10,16
17,1,2,10,17,27
12,1,4,34,12,46
10,1,2,9,10,19
22,2,5,62,44,106
29,2,5,68,58,126
19,1,4,55,19,74
21,1,4,61,21,82
15,2,5,44,30,74
21,2,5,61,42,103
15,2,5,44,30,74
1,1482,2384,807,1482,2289
1,755,1215,302,755,1057
3,1482,2384,2420,4446,6866
1,755,1215,436,755,1191
1,1482,2384,854,1482,2336
1,1482,2384,473,1482,1955
14,24,64,399,336,735
5,45,120,375,225,600
26,2,5,73,52,125
13,2,5,36,26,62
27,2,5,53,54,107
10,2,5,20,20,40
18,2,5,34,36,70
8,2,5,15,16,31
12,2,5,34,24,58
26,2,5,73,52,125
28,2,5,81,56,137
18,2,5,52,36,88
10,2,5,21,20,41
8,2,5,17,16,33
25,2,5,66,50,116
16,4,10,94,64,158
8,2,5,17,16,33
14,2,5,29,28,57
17,3,9,74,51,125
4,7,9,2,28,30
14,7,9,23,98,121
12,7,9,20,84,104
19,7,9,31,133,164
24,7,9,18,168,186
27,7,9,22,189,211
19,7,9,35,133,168
9,7,9,0,63,63
16,7,9,13,112,125
27,7,9,52,189,241
4,7,9,2,28,30
20,7,9,17,140,157
14,8,22,128,112,240
8,8,22,87,64,151
24,8,22,331,192,523
2,8,22,22,16,38
3,8,22,41,24,65
17,8,22,234,136,370
11,8,22,144,88,232
29,9,24,421,261,682
2,9,24,29,18,47
30,9,24,436,270,706
2,13,35,43,26,69
16,13,35,313,208,521
1,13,35,21,13,34
18,13,35,257,234,491
9,13,35,157,117,274
27,13,35,424,351,775
30,13,35,618,390,1008
19,13,35,405,247,652
22,13,35,376,286,662
6,13,35,86,78,164
22,13,35,469,286,755
15,13,35,320,195,515
14,13,35,303,182,485
7,13,35,100,91,191
9,13,35,157,117,274
20,13,35,433,260,693
21,13,35,455,273,728
1,13,35,21,13,34
21,13,35,300,273,573
5,13,35,107,65,172
19,13,35,298,247,545
15,42,54,164,630,794
19,38,50,190,722,912
8,42,54,40,336,376
3,42,54,13,126,139
3,42,54,0,126,126
8,38,50,40,304,344
24,42,54,236,1008,1244
19,38,50,105,722,827
27,38,50,149,1026,1175
26,38,50,286,988,1274
17,42,54,195,714,909
20,38,50,170,760,930
15,38,50,173,570,743
17,42,54,167,714,881
2,1252,2295,1076,2504,3580
3,1252,2295,2234,3756,5990
3,1252,2295,3060,3756,6816
3,420,769,563,1260,1823
2,420,769,498,840,1338
2,308,565,311,616,927
1,1252,2295,630,1252,1882
1,1252,2295,1020,1252,2272
1,1252,2295,722,1252,1974
1,1252,2295,722,1252,1974
2,1555,2443,1581,3110,4691
3,344,540,377,1032,1409
1,344,540,174,344,518
1,2171,3578,1335,2171,3506
1,344,540,99,344,443
1,2171,3578,620,2171,2791
6,26,70,209,156,365
6,9,25,65,54,119
1,9,25,11,9,20
16,1,2,9,16,25
7,1,2,4,7,11
16,8,21,137,128,265
23,2,5,48,46,94
17,2,5,36,34,70
15,2,5,44,30,74
25,2,5,74,50,124
7,1,2,4,7,11
18,1,2,12,18,30
20,2,5,39,40,79
10,13,35,213,130,343
2,13,35,43,26,69
1,2,5,3,2,5
4,2,5,12,8,20
3,1,2,3,3,6
17,11,30,211,187,398
15,11,30,186,165,351
30,2,5,84,60,144
24,2,5,67,48,115
8,2,5,15,16,31
16,1,2,15,16,31
19,2,5,36,38,74
30,2,5,57,60,117
30,8,21,346,240,586
21,2,5,44,42,86
8,1,2,8,8,16
3,1,2,3,3,6
6,2,5,18,12,30
11,12,33,155,132,287
25,1,2,23,25,48
16,1,2,15,16,31
10,1,2,10,10,20
3,12,33,49,36,85
19,1,4,46,19,65
6,12,33,122,72,194
14,12,33,285,168,453
4,2,5,8,8,16
25,2,5,48,50,98
13,2,5,25,26,51
18,1,4,38,18,56
11,1,2,11,11,22
17,2,5,48,34,82
3,755,1215,1234,2265,3499
2,1482,2384,1756,2964,4720
1,461,742,185,461,646
1,755,1215,241,755,996
12,24,64,319,288,607
5,24,64,142,120,262
5,59,159,325,295,620
22,3,9,124,66,190
3,3,9,17,9,26
17,2,5,32,34,66
22,2,5,42,44,86
23,2,5,48,46,94
26,2,5,55,52,107
23,3,9,105,69,174
11,3,9,50,33,83
13,4,10,60,52,112
3,4,10,14,12,26
9,2,5,24,18,42
7,2,5,19,14,33
27,4,10,151,108,259
23,4,10,129,92,221
25,2,5,58,50,108
25,2,5,48,50,98
26,2,5,49,52,101
13,7,9,11,91,102
26,7,9,19,182,201
21,7,9,34,147,181
9,7,9,3,63,66
23,3,8,82,69,151
18,8,22,244,144,388
4,8,22,54,32,86
7,8,22,64,56,120
7,8,22,66,56,122
1,9,24,14,9,23
9,9,24,133,81,214
30,9,24,436,270,706
9,9,24,120,81,201
14,9,24,203,126,329
8,9,24,112,72,184
3,13,35,43,39,82
30,13,35,587,390,977
16,13,35,313,208,521
3,13,35,43,39,82
2,13,35,43,26,69
30,13,35,618,390,1008
26,13,35,372,338,710
1,13,35,21,13,34
5,13,35,87,65,152
22,13,35,453,286,739
4,13,35,85,52,137
15,13,35,220,195,415
10,13,35,206,130,336
3,13,35,59,39,98
11,21,55,265,231,496
10,42,54,98,420,518
8,42,54,14,336,350
13,42,54,142,546,688
1,1898,3375,1038,1898,2936
1,1252,2295,882,1252,2134
1,1252,2295,630,1252,1882
1,420,769,318,420,738
1,420,769,334,420,754
1,1266,2320,892,1266,2158
1,1266,2320,961,1266,2227
1,2171,3578,942,2171,3113
1,1519,2443,826,1519,2345
1,487,783,241,487,728
2,1083,1701,1168,2166,3334
1,487,783,265,487,752
1,487,783,147,487,634
1,2171,3578,1335,2171,3506
11,26,70,315,286,601
21,3,9,122,63,185
4,3,9,23,12,35
1,3,9,5,3,8
13,8,21,150,104,254
26,1,2,25,26,51
20,1,2,20,20,40
1,1,2,1,1,2
20,1,2,15,20,35
19,2,5,53,38,91
2,2,5,6,4,10
24,11,30,326,264,590
6,2,5,14,12,26
24,2,5,71,48,119
24,2,5,71,48,119
24,2,5,71,48,119
26,2,5,49,52,101
3,2,5,6,6,12
27,1,4,57,27,84
2,1,4,4,2,6
16,9,25,248,144,392
1,9,25,16,9,25
12,1,4,34,12,46
11,1,4,31,11,42
13,1,4,37,13,50
15,1,4,43,15,58
12,8,21,103,96,199
8,1,2,5,8,13
11,11,30,196,121,317
29,11,30,516,319,835
4,2,5,12,8,20
21,2,5,62,42,104
26,9,25,332,234,566
24,1,2,13,24,37
14,1,2,8,14,22
22,1,4,60,22,82
18,2,5,34,36,70
6,2,5,11,12,23
19,1,4,43,19,62
24,11,29,307,264,571
6,11,29,77,66,143
19,8,21,175,152,327
3,8,21,28,24,52
8,2,5,19,16,35
6,2,5,14,12,26
4,2,5,9,8,17
1,2,5,2,2,4
19,1,2,11,19,30
11,1,2,6,11,17
12,2,5,35,24,59
23,2,5,53,46,99
9,2,5,21,18,39
31,9,25,481,279,760
12,1,4,30,12,42
3,461,742,554,1383,1937
1,1482,2384,378,1482,1860
3,461,742,754,1383,2137
8,45,120,446,360,806
10,2,5,30,20,50
16,2,5,47,32,79
9,2,5,27,18,45
28,2,5,83,56,139
8,2,5,24,16,40
8,2,5,24,16,40
2,4,10,11,8,19
1,4,10,6,4,10
5,2,5,10,10,20
13,2,5,25,26,51
1,2,5,3,2,5
1,2,5,3,2,5
24,2,5,70,48,118
7,2,5,20,14,34
3,4,10,14,12,26
15,4,10,71,60,131
27,4,10,157,108,265
6,4,10,35,24,59
23,2,5,53,46,99
17,2,5,32,34,66
4,2,5,8,8,16
6,4,10,23,24,47
9,3,9,52,27,79
12,3,9,70,36,106
24,7,9,46,168,214
7,7,9,13,49,62
6,7,9,5,42,47
27,7,9,22,189,211
6,7,9,0,42,42
25,7,9,3,175,178
30,3,8,148,90,238
19,8,22,174,152,326
12,8,22,163,96,259
5,8,22,46,40,86
21,8,22,220,168,388
17,8,22,234,136,370
31,8,22,407,248,655
18,8,22,248,144,392
12,9,24,174,108,282
19,9,24,267,171,438
11,9,24,117,99,216
3,9,24,44,27,71
30,13,35,408,390,798
8,13,35,173,104,277
17,13,35,368,221,589
14,13,35,288,182,470
15,13,35,325,195,520
18,13,35,383,234,617
11,13,35,192,143,335
11,13,35,157,143,300
11,13,35,234,143,377
7,13,35,115,91,206
4,13,35,85,52,137
22,13,35,376,286,662
7,13,35,152,91,243
27,13,35,471,351,822
28,13,35,489,364,853
17,13,35,332,221,553
30,21,55,987,630,1617
2,21,55,66,42,108
5,42,54,57,210,267
30,42,54,295,1260,1555
24,38,50,276,912,1188
14,38,50,154,532,686
2,42,54,7,84,91
12,38,50,132,456,588
1,38,50,11,38,49
1,42,54,5,42,47
3,38,50,30,114,144
14,38,50,42,532,574
5,38,50,58,190,248
17,38,50,187,646,833
1,1252,2295,1020,1252,2272
3,1266,2320,2884,3798,6682
1,1266,2320,752,1266,2018
2,1266,2320,1783,2532,4315
3,308,565,737,924,1661
1,1266,2320,961,1266,2227
1,295,540,240,295,535
1,1266,2320,544,1266,1810
1,344,540,66,344,410
1,344,540,191,344,535
1,1555,2443,717,1555,2272
3,713,1120,1154,2139,3293
1,344,540,191,344,535
21,26,70,601,546,1147
16,26,70,469,416,885
28,13,35,479,364,843
17,9,25,217,153,370
13,2,5,38,26,64
27,2,5,80,54,134
15,13,35,325,195,520
11,13,35,238,143,381
18,13,35,390,234,624
4,2,5,8,8,16
3,2,5,6,6,12
14,9,25,161,126,287
24,1,2,22,24,46
11,1,2,10,11,21
25,1,2,23,25,48
17,1,2,17,17,34
10,1,2,6,10,16
13,1,2,8,13,21
16,1,2,9,16,25
9,1,2,9,9,18
11,1,2,11,11,22
19,11,30,338,209,547
20,11,30,356,220,576
11,13,35,161,143,304
11,13,35,161,143,304
20,2,5,58,40,98
16,2,5,46,32,78
25,1,2,17,25,42
10,1,2,7,10,17
11,11,30,130,121,251
2,11,30,24,22,46
6,2,5,14,12,26
1,2,5,2,2,4
24,1,4,70,24,94
1,1,4,3,1,4
20,11,29,354,220,574
25,11,29,443,275,718
25,2,5,59,50,109
1,2,5,2,2,4
14,2,5,33,28,61
16,9,25,248,144,392
15,1,4,44,15,59
19,1,4,55,19,74
22,11,29,243,242,485
5,11,29,55,55,110
3,11,29,38,33,71
12,11,29,153,132,285
1,1482,2384,854,1482,2336
1,755,1215,436,755,1191
3,1482,2384,1776,4446,6222
1,755,1215,436,755,1191
3,1482,2384,1133,4446,5579
10,24,64,394,240,634
11,45,120,799,495,1294
29,2,5,84,58,142
21,2,5,61,42,103
25,2,5,74,50,124
26,2,5,77,52,129
24,2,5,46,48,94
3,2,5,9,6,15
14,2,5,41,28,69
21,3,9,86,63,149
6,3,9,25,18,43
29,4,10,168,116,284
24,3,9,129,72,201
19,2,5,56,38,94
2,2,5,6,4,10
16,2,5,35,32,67
7,2,5,15,14,29
1,7,9,2,7,9
3,7,9,0,21,21
22,7,9,36,154,190
5,7,9,5,35,40
14,3,8,69,42,111
26,3,8,86,78,164
27,3,8,100,81,181
12,3,8,45,36,81
26,8,22,341,208,549
23,8,22,312,184,496
18,8,22,244,144,388
29,8,22,400,232,632
14,9,24,166,126,292
22,9,24,309,198,507
9,9,24,87,81,168
17,13,35,362,221,583
23,13,35,393,299,692
7,13,35,144,91,235
1,13,35,14,13,27
1,13,35,14,13,27
5,13,35,87,65,152
28,13,35,596,364,960
23,13,35,401,299,700
1,13,35,17,13,30
5,13,35,73,65,138
27,13,35,462,351,813
25,13,35,358,325,683
27,21,55,591,567,1158
2,38,50,23,76,99
25,42,54,17,1050,1067
23,38,50,69,874,943
2,42,54,22,84,106
10,42,54,50,420,470
17,42,54,186,714,900
1,1252,2295,538,1252,1790
1,1252,2295,951,1252,2203
1,1252,2295,997,1252,2249
3,1266,2320,3023,3798,6821
1,1266,2320,567,1266,1833
1,1252,2295,997,1252,2249
1,1252,2295,997,1252,2249
3,1252,2295,1890,3756,5646
3,1266,2320,3023,3798,6821
1,1266,2320,1008,1266,2274
1,1266,2320,1008,1266,2274
2,1555,2443,1434,3110,4544
1,1519,2443,582,1519,2101
1,1083,1701,244,1083,1327
1,2171,3578,942,2171,3113
1,713,1120,250,713,963
3,344,540,523,1032,1555
1,487,783,171,487,658
3,2171,3578,4006,6513,10519
21,26,70,895,546,1441
1,26,70,29,26,55
3,26,70,128,78,206
28,3,9,123,84,207
23,3,9,134,69,203
1,3,9,6,3,9
24,2,5,46,48,94
16,2,5,30,32,62
1,2,5,2,2,4
6,13,35,124,78,202
12,13,35,247,156,403
8,1,2,8,8,16
4,1,2,2,4,6
24,1,2,13,24,37
5,1,2,3,5,8
19,1,2,11,19,30
20,1,4,47,20,67
3,9,25,32,27,59
3,13,35,64,39,103
27,13,35,575,351,926
20,1,2,20,20,40
7,11,30,89,77,166
2,11,30,25,22,47
14,12,33,289,168,457
5,2,5,15,10,25
25,2,5,73,50,123
29,9,25,370,261,631
2,9,25,26,18,44
29,12,33,408,348,756
15,1,2,11,15,26
14,1,4,33,14,47
16,1,4,38,16,54
9,1,4,21,9,30
14,2,5,34,28,62
19,2,5,46,38,84
7,1,2,7,7,14
17,1,2,17,17,34
12,1,2,11,12,23
24,1,4,68,24,92
18,1,4,51,18,69
26,8,21,327,208,535
5,9,25,78,45,123
12,1,4,35,12,47
1,1,4,3,1,4
28,1,4,68,28,96
10,1,4,24,10,34
1,1482,2384,807,1482,2289
1,755,1215,193,755,948
1,1482,2384,854,1482,2336
1,1482,2384,854,1482,2336
5,24,64,187,120,307
18,2,5,53,36,89
30,3,9,145,90,235
2,3,9,10,6,16
5,3,9,21,15,36
23,2,5,68,46,114
7,2,5,21,14,35
27,2,5,62,54,116
24,3,9,109,72,181
13,3,9,59,39,98
22,4,10,128,88,216
10,4,10,58,40,98
13,2,5,38,26,64
29,2,5,84,58,142
11,2,5,32,22,54
4,2,5,9,8,17
26,2,5,75,52,127
11,3,9,65,33,98
1,3,9,6,3,9
18,3,9,85,54,139
7,2,5,20,14,34
11,2,5,32,22,54
15,2,5,40,30,70
24,2,5,64,48,112
13,2,5,31,26,57
10,2,5,24,20,44
16,7,9,31,112,143
28,7,9,11,196,207
18,7,9,25,126,151
25,7,9,14,175,189
11,7,9,18,77,95
23,7,9,0,161,161
11,3,8,53,33,86
9,3,8,36,27,63
30,3,8,148,90,238
1,3,8,4,3,7
17,8,22,186,136,322
27,8,22,301,216,517
16,8,22,175,128,303
1,9,24,11,9,20
29,13,35,496,377,873
4,13,35,87,52,139
12,13,35,260,156,416
12,13,35,188,156,344
9,13,35,185,117,302
7,13,35,144,91,235
13,13,35,213,169,382
18,13,35,283,234,517
11,13,35,227,143,370
24,13,35,343,312,655
5,13,35,107,65,172
14,13,35,298,182,480
15,13,35,267,195,462
22,13,35,469,286,755
4,13,35,85,52,137
6,13,35,82,78,160
13,13,35,227,169,396
3,13,35,65,39,104
12,13,35,209,156,365
18,38,50,207,684,891
29,42,54,66,1218,1284
17,38,50,145,646,791
13,38,50,150,494,644
1,42,54,11,42,53
2,42,54,7,84,91
5,42,54,49,210,259
30,42,54,295,1260,1555
3,42,54,0,126,126
4,38,50,16,152,168
3,42,54,33,126,159
15,38,50,0,570,570
3,1252,2295,2165,3756,5921
2,1266,2320,2015,2532,4547
1,1252,2295,745,1252,1997
1,1252,2295,997,1252,2249
1,1519,2443,875,1519,2394
1,2171,3578,1157,2171,3328
3,487,783,794,1461,2255
1,487,783,155,487,642
1,487,783,155,487,642
1,1083,1701,244,1083,1327
1,2171,3578,835,2171,3006
3,713,1120,1154,2139,3293
1,344,540,77,344,421
1,344,540,120,344,464
1,1083,1701,499,1083,1582
3,1555,2443,1491,4665,6156
1,713,1120,273,713,986
1,344,540,77,344,421
2,344,540,370,688,1058
1,713,1120,261,713,974
1,344,540,66,344,410
2,344,540,133,688,821
2,713,1120,523,1426,1949
1,2171,3578,620,2171,2791
17,26,70,700,442,1142
17,26,70,736,442,1178
13,2,5,38,26,64
8,2,5,18,16,34
10,1,2,10,10,20
5,1,2,5,5,10
16,1,2,15,16,31
23,1,2,22,23,45
4,1,2,4,4,8
31,2,5,87,62,149
10,1,4,21,10,31
5,1,4,11,5,16
8,1,2,5,8,13
17,1,2,12,17,29
26,1,2,15,26,41
10,1,2,6,10,16
17,2,5,50,34,84
17,2,5,50,34,84
17,1,2,10,17,27
25,1,2,14,25,39
6,1,2,3,6,9
21,1,2,13,21,34
16,1,2,10,16,26
19,9,25,242,171,413
26,9,25,332,234,566
14,9,25,179,126,305
1,2,5,3,2,5
3,2,5,9,6,15
28,2,5,81,56,137
21,2,5,61,42,103
24,9,25,378,216,594
10,9,25,158,90,248
19,9,25,299,171,470
19,2,5,56,38,94
9,2,5,27,18,45
13,2,5,31,26,57
14,2,5,33,28,61
9,1,2,5,9,14
16,1,2,9,16,25
8,1,2,5,8,13
28,2,5,83,56,139
13,2,5,25,26,51
23,2,5,44,46,90
1,1,2,1,1,2
4,1,4,10,4,14
11,1,4,27,11,38
26,1,2,19,26,45
19,1,2,14,19,33
4,1,2,3,4,7
7,1,2,7,7,14
1,2,5,3,2,5
8,1,4,23,8,31
13,1,4,38,13,51
27,1,4,79,27,106
1,1482,2384,401,1482,1883
1,461,742,251,461,712
3,1482,2384,2563,4446,7009
28,2,5,83,56,139
1,2,5,3,2,5
25,2,5,59,50,109
11,2,5,26,22,48
13,2,5,38,26,64
1,2,5,3,2,5
25,4,10,95,100,195
8,4,10,30,32,62
15,4,10,59,60,119
25,4,10,98,100,198
25,2,5,73,50,123
25,2,5,48,50,98
5,2,5,10,10,20
15,2,5,29,30,59
26,2,5,51,52,103
7,3,9,38,21,59
2,3,9,11,6,17
1,4,10,5,4,9
8,4,10,42,32,74
16,2,5,47,32,79
20,2,5,59,40,99
17,2,5,50,34,84
8,2,5,24,16,40
13,2,5,31,26,57
11,2,5,20,22,42
4,2,5,7,8,15
26,2,5,75,52,127
13,2,5,38,26,64
6,2,5,17,12,29
16,3,9,73,48,121
6,3,9,27,18,45
19,7,9,26,133,159
5,7,9,9,35,44
18,7,9,34,126,160
27,7,9,44,189,233
20,7,9,-3,140,137
10,7,9,8,70,78
21,7,9,38,147,185
11,3,8,51,33,84
23,3,8,111,69,180
1,3,8,3,3,6
6,3,8,19,18,37
26,3,8,84,78,162
1,8,22,14,8,22
15,8,22,141,120,261
15,8,22,187,120,307
21,9,24,249,189,438
10,9,24,145,90,235
3,13,35,49,39,88
18,13,35,257,234,491
18,13,35,390,234,624
2,13,35,39,26,65
23,13,35,337,299,636
12,13,35,260,156,416
11,13,35,234,143,377
6,13,35,117,78,195
24,13,35,419,312,731
27,13,35,386,351,737
7,13,35,149,91,240
3,13,35,62,39,101
27,13,35,528,351,879
3,13,35,52,39,91
29,13,35,425,377,802
10,13,35,136,130,266
6,13,35,86,78,164
8,13,35,131,104,235
4,13,35,63,52,115
16,13,35,330,208,538
21,13,35,359,273,632
6,21,55,145,126,271
18,38,50,207,684,891
25,42,54,246,1050,1296
9,38,50,104,342,446
20,38,50,230,760,990
23,38,50,253,874,1127
3,1266,2320,3092,3798,6890
2,1252,2295,1443,2504,3947
1,1266,2320,636,1266,1902
1,1266,2320,892,1266,2158
1,420,769,318,420,738
1,1266,2320,892,1266,2158
1,1252,2295,882,1252,2134
1,1898,3375,735,1898,2633
1,1266,2320,544,1266,1810
3,2171,3578,2826,6513,9339
3,2171,3578,1967,6513,8480
1,1555,2443,717,1555,2272
3,1083,1701,1803,3249,5052
1,1083,1701,601,1083,1684
1,2171,3578,835,2171,3006
1,713,1120,396,713,1109
1,344,540,66,344,410
1,344,540,99,344,443
1,2171,3578,1371,2171,3542
4,3,9,19,12,31
12,3,9,70,36,106
11,3,9,59,33,92
14,3,9,68,42,110
15,13,35,257,195,452
10,13,35,171,130,301
8,1,2,8,8,16
24,1,2,23,24,47
21,12,33,413,252,665
13,12,33,256,156,412
6,12,33,118,72,190
10,1,2,6,10,16
20,1,2,11,20,31
24,2,5,67,48,115
13,2,5,36,26,62
22,9,25,341,198,539
16,9,25,248,144,392
13,9,25,202,117,319
17,1,2,13,17,30
9,2,5,19,18,37
9,2,5,19,18,37
12,2,5,25,24,49
13,2,5,38,26,64
1,13,35,15,13,28
11,13,35,161,143,304
29,2,5,68,58,126
12,2,5,28,24,52
20,12,33,334,240,574
20,8,21,172,160,332
12,1,2,11,12,23
25,1,2,23,25,48
20,2,5,58,40,98
22,2,5,64,44,108
8,1,2,6,8,14
24,1,2,18,24,42
19,2,5,37,38,75
29,2,5,55,58,113
15,1,4,44,15,59
22,1,4,65,22,87
22,1,2,20,22,42
11,1,2,10,11,21
9,1,2,8,9,17
21,12,33,289,252,541
1,12,33,14,12,26
12,2,5,28,24,52
1,2,5,2,2,4
9,9,25,115,81,196
28,8,21,288,224,512
1,8,21,10,8,18
15,2,5,29,30,59
21,2,5,40,42,82
18,8,21,219,144,363
24,9,25,372,216,588
3,461,742,487,1383,1870
3,1482,2384,2634,4446,7080
1,461,742,251,461,712
1,755,1215,266,755,1021
1,1482,2384,735,1482,2217
2,1482,2384,1709,2964,4673
2,461,742,295,922,1217
1,1482,2384,807,1482,2289
1,1482,2384,807,1482,2289
1,461,742,266,461,727
18,24,64,478,432,910
22,24,64,655,528,1183
2,59,159,197,118,315
5,59,159,397,295,692
8,59,159,571,472,1043
28,2,5,66,56,122
12,2,5,28,24,52
1,2,5,3,2,5
22,2,5,65,44,109
17,2,5,48,34,82
26,2,5,73,52,125
27,2,5,62,54,116
28,2,5,78,56,134
21,2,5,59,42,101
8,2,5,18,16,34
13,2,5,29,26,55
10,2,5,27,20,47
2,2,5,5,4,9
2,2,5,4,4,8
6,2,5,11,12,23
27,2,5,78,54,132
1,2,5,3,2,5
7,4,10,41,28,69
29,4,10,171,116,287
26,2,5,61,52,113
14,2,5,33,28,61
2,2,5,5,4,9
1,2,5,3,2,5
15,2,5,42,30,72
3,3,9,18,9,27
1,3,9,6,3,9
5,2,5,12,10,22
23,2,5,53,46,99
2,2,5,6,4,10
5,2,5,15,10,25
27,2,5,78,54,132
4,2,5,12,8,20
31,2,5,73,62,135
13,2,5,31,26,57
8,3,9,35,24,59
10,3,9,44,30,74
4,2,5,9,8,17
26,2,5,61,52,113
18,2,5,42,36,78
16,3,9,70,48,118
24,3,9,105,72,177
20,2,5,39,40,79
4,2,5,8,8,16
28,2,5,81,56,137
29,2,5,84,58,142
24,3,9,142,72,214
10,3,9,59,30,89
24,7,9,46,168,214
16,7,9,31,112,143
13,7,9,21,91,112
5,7,9,8,35,43
18,7,9,30,126,156
26,7,9,19,182,201
2,7,9,1,14,15
26,7,9,22,182,204
26,7,9,3,182,185
17,7,9,32,119,151
3,3,8,10,9,19
3,3,8,15,9,24
28,8,22,306,224,530
1,8,22,14,8,22
8,8,22,110,64,174
29,8,22,380,232,612
20,8,22,276,160,436
30,9,24,292,270,562
17,9,24,202,153,355
25,9,24,279,225,504
24,9,24,348,216,564
3,13,35,64,39,103
11,13,35,227,143,370
20,13,35,328,260,588
12,13,35,176,156,332
27,13,35,471,351,822
11,13,35,219,143,362
27,13,35,471,351,822
14,13,35,298,182,480
15,13,35,215,195,410
1,13,35,14,13,27
32,13,35,693,416,1109
6,13,35,124,78,202
4,13,35,82,52,134
30,13,35,587,390,977
16,13,35,251,208,459
3,13,35,64,39,103
28,13,35,577,364,941
29,13,35,597,377,974
23,21,55,516,483,999
3,21,55,72,63,135
24,21,55,763,504,1267
19,21,55,510,399,909
4,38,50,34,152,186
3,42,54,34,126,160
23,38,50,127,874,1001
1,42,54,1,42,43
24,38,50,36,912,948
1,42,54,11,42,53
10,42,54,44,420,464
20,42,54,67,840,907
23,42,54,3,966,969
32,42,54,367,1344,1711
20,42,54,197,840,1037
26,38,50,260,988,1248
8,38,50,44,304,348
5,38,50,58,190,248
23,38,50,0,874,874
2,1252,2295,1902,2504,4406
1,420,769,341,420,761
1,1252,2295,1020,1252,2272
3,420,769,1001,1260,2261
1,420,769,249,420,669
1,1252,2295,676,1252,1928
1,1266,2320,636,1266,1902
1,1266,2320,915,1266,2181
1,420,769,249,420,669
1,420,769,188,420,608
3,295,540,703,885,1588
1,308,565,246,308,554
1,487,783,280,487,767
1,1555,2443,790,1555,2345
1,1555,2443,717,1555,2272
1,713,1120,385,713,1098
3,344,540,232,1032,1264
2,344,540,316,688,1004
3,344,540,296,1032,1328
1,713,1120,261,713,974
1,487,783,194,487,681
2,487,783,388,974,1362
1,487,783,132,487,619
3,344,540,572,1032,1604
3,2171,3578,4006,6513,10519
2,26,70,66,52,118
18,26,70,767,468,1235
12,26,70,511,312,823
29,3,9,140,87,227
14,1,2,14,14,28
20,9,25,255,180,435
16,2,5,47,32,79
28,2,5,55,56,111
11,2,5,21,22,43
10,2,5,20,20,40
1,11,29,18,11,29
4,11,29,71,44,115
20,1,4,59,20,79
14,1,4,41,14,55
17,11,29,271,187,458
3,11,29,48,33,81
13,11,29,208,143,351
9,9,25,97,81,178
11,9,25,118,99,217
18,1,2,10,18,28
25,1,2,15,25,40
4,1,2,2,4,6
28,1,2,21,28,49
10,1,2,9,10,19
29,1,2,27,29,56
15,9,25,173,135,308
26,9,25,299,234,533
1,12,33,21,12,33
5,12,33,103,60,163
16,2,5,38,32,70
4,2,5,12,8,20
25,2,5,74,50,124
20,2,5,59,40,99
12,1,4,30,12,42
1,1,4,2,1,3
2,13,35,41,26,67
13,13,35,268,169,437
12,2,5,28,24,52
27,2,5,59,54,113
26,2,5,57,52,109
14,2,5,31,28,59
10,11,30,169,110,279
20,11,30,338,220,558
16,9,25,204,144,348
17,9,25,217,153,370
16,1,2,15,16,31
32,1,2,29,32,61
5,1,2,3,5,8
28,1,2,16,28,44
6,9,25,90,54,144
1,9,25,15,9,24
28,1,4,83,28,111
14,1,4,41,14,55
12,1,4,36,12,48
18,11,30,337,198,535
5,11,30,94,55,149
18,11,30,331,198,529
29,11,30,534,319,853
1,1,2,1,1,2
24,12,33,330,288,618
7,2,5,15,14,29
22,1,2,21,22,43
5,1,2,5,5,10
8,1,4,23,8,31
5,8,21,61,40,101
2,2,5,6,4,10
5,2,5,15,10,25
15,1,2,14,15,29
14,1,2,13,14,27
24,8,21,302,192,494
28,2,5,53,56,109
1,8,21,12,8,20
26,2,5,61,52,113
16,2,5,38,32,70
1,2,5,2,2,4
14,1,4,41,14,55
1,461,742,140,461,601
1,755,1215,375,755,1130
1,461,742,251,461,712
1,461,742,147,461,608
2,461,742,532,922,1454
5,24,64,187,120,307
4,24,64,127,96,223
5,24,64,158,120,278
14,24,64,542,336,878
10,59,159,714,590,1304
27,2,5,80,54,134
27,3,9,123,81,204
6,3,9,27,18,45
13,2,5,38,26,64
8,2,5,24,16,40
3,2,5,9,6,15
28,2,5,81,56,137
22,2,5,65,44,109
30,4,10,174,120,294
28,4,10,162,112,274
24,2,5,43,48,91
14,3,9,61,42,103
1,3,9,4,3,7
10,3,9,58,30,88
23,4,10,129,92,221
2,2,5,5,4,9
14,2,5,33,28,61
9,2,5,25,18,43
1,2,5,3,2,5
20,7,9,15,140,155
22,7,9,42,154,196
19,7,9,31,133,164
4,7,9,7,28,35
30,7,9,11,210,221
16,3,8,66,48,114
26,3,8,93,78,171
3,3,8,15,9,24
32,8,22,321,256,577
16,8,22,175,128,303
3,8,22,27,24,51
19,8,22,258,152,410
1,8,22,14,8,22
16,8,22,220,128,348
14,8,22,193,112,305
6,9,24,58,54,112
15,9,24,211,135,346
31,13,35,660,403,1063
11,13,35,234,143,377
12,13,35,247,156,403
7,13,35,122,91,213
13,13,35,186,169,355
11,13,35,173,143,316
4,13,35,85,52,137
21,13,35,411,273,684
25,13,35,533,325,858
6,13,35,98,78,176
20,13,35,391,260,651
28,21,55,890,588,1478
16,21,55,509,336,845
25,38,50,250,950,1200
1,42,54,0,42,42
15,38,50,75,570,645
5,38,50,28,190,218
7,38,50,81,266,347
28,38,50,322,1064,1386
8,38,50,44,304,348
9,38,50,90,342,432
18,38,50,207,684,891
10,42,54,23,420,443
15,38,50,150,570,720
15,42,54,75,630,705
1,42,54,10,42,52
15,38,50,150,570,720
1,1266,2320,1008,1266,2274
3,1266,2320,2884,3798,6682
1,1266,2320,752,1266,2018
1,420,769,211,420,631
1,1266,2320,1008,1266,2274
1,295,540,240,295,535
1,1266,2320,636,1266,1902
1,308,565,121,308,429
1,1252,2295,630,1252,1882
1,1266,2320,636,1266,1902
1,2171,3578,1013,2171,3184
1,1519,2443,606,1519,2125
1,487,783,194,487,681
1,1555,2443,790,1555,2345
1,487,783,194,487,681
1,1083,1701,601,1083,1684
2,487,783,529,974,1503
1,344,540,77,344,421
2,1083,1701,624,2166,2790
1,487,783,132,487,619
1,344,540,126,344,470
19,26,70,650,494,1144
19,26,70,809,494,1303
12,26,70,352,312,664
16,3,9,64,48,112
20,3,9,95,60,155
24,3,9,142,72,214
26,1,4,77,26,103
21,1,4,62,21,83
32,13,35,693,416,1109
18,13,35,390,234,624
10,2,5,27,20,47
26,13,35,554,338,892
13,13,35,277,169,446
22,13,35,469,286,755
4,1,2,3,4,7
23,1,2,18,23,41
28,8,21,340,224,564
23,2,5,67,46,113
4,2,5,12,8,20
27,2,5,63,54,117
11,2,5,26,22,48
15,2,5,35,30,65
1,1,2,1,1,2
4,1,2,4,4,8
4,1,2,3,4,7
2,1,2,2,2,4
26,1,2,17,26,43
16,1,2,10,16,26
3,1,2,3,3,6
2,1,2,2,2,4
22,11,30,273,242,515
16,11,30,198,176,374
12,2,5,35,24,59
13,1,2,7,13,20
11,8,21,94,88,182
11,1,4,32,11,43
23,1,4,67,23,90
30,11,29,349,330,679
23,1,4,56,23,79
4,1,4,10,4,14
1,1,2,1,1,2
16,1,2,15,16,31
20,1,2,13,20,33
22,1,2,14,22,36
7,1,4,20,7,27
1,1482,2384,473,1482,1955
1,1482,2384,878,1482,2360
1,1482,2384,807,1482,2289
1,755,1215,436,755,1191
2,1482,2384,1709,2964,4673
3,1482,2384,2205,4446,6651
1,24,64,39,24,63
13,24,64,370,312,682
1,59,159,97,59,156
17,2,5,48,34,82
9,2,5,25,18,43
20,4,10,94,80,174
4,4,10,19,16,35
30,2,5,63,60,123
28,2,5,59,56,115
4,2,5,12,8,20
17,2,5,50,34,84
32,3,9,189,96,285
23,2,5,68,46,114
1,2,5,3,2,5
15,2,5,33,30,63
16,2,5,35,32,67
1,3,9,6,3,9
11,2,5,26,22,48
18,2,5,42,36,78
10,3,9,58,30,88
13,3,9,76,39,115
19,2,5,45,38,83
9,2,5,21,18,39
3,2,5,7,6,13
17,7,9,32,119,151
24,7,9,9,168,177
28,7,9,23,196,219
18,7,9,15,126,141
1,7,9,2,7,9
4,7,9,3,28,31
31,7,9,29,217,246
23,7,9,42,161,203
2,3,8,10,6,16
13,3,8,48,39,87
22,8,22,245,176,421
12,8,22,165,96,261
25,9,24,243,225,468
12,9,24,143,108,251
9,9,24,87,81,168
10,13,35,217,130,347
12,13,35,188,156,344
6,13,35,130,78,208
24,13,35,343,312,655
12,13,35,188,156,344
13,13,35,227,169,396
6,13,35,130,78,208
7,13,35,144,91,235
15,13,35,215,195,410
28,13,35,498,364,862
25,42,54,3,1050,1053
3,38,50,9,114,123
1,38,50,2,38,40
27,42,54,134,1134,1268
8,38,50,44,304,348
2,42,54,10,84,94
1,42,54,4,42,46
4,42,54,44,168,212
1,1252,2295,676,1252,1928
1,1555,2443,448,1555,2003
2,2171,3578,1884,4342,6226
16,26,70,469,416,885
7,26,70,200,182,382
1,26,70,34,26,60
30,26,70,984,780,1764
9,3,9,52,27,79
26,1,4,77,26,103
28,1,4,83,28,111
11,1,2,11,11,22
30,13,35,650,390,1040
18,13,35,390,234,624
21,2,5,40,42,82
8,2,5,15,16,31
12,1,2,12,12,24
13,1,2,12,13,25
9,2,5,25,18,43
15,13,35,293,195,488
10,13,35,196,130,326
18,13,35,352,234,586
24,1,2,18,24,42
13,12,33,243,156,399
24,11,30,449,264,713
28,9,25,441,252,693
2,13,35,43,26,69
11,13,35,234,143,377
16,1,2,16,16,32
6,2,5,17,12,29
5,11,30,76,55,131
2,9,25,32,18,50
15,9,25,236,135,371
5,9,25,79,45,124
31,1,4,71,31,102
4,1,4,9,4,13
21,1,2,12,21,33
24,1,2,13,24,37
15,2,5,35,30,65
1,2,5,2,2,4
4,2,5,9,8,17
9,1,4,22,9,31
6,1,4,15,6,21
28,1,2,18,28,46
18,1,2,12,18,30
25,8,21,262,200,462
3,8,21,31,24,55
7,9,25,105,63,168
13,9,25,195,117,312
26,2,5,77,52,129
7,8,21,70,56,126
20,8,21,201,160,361
13,1,2,7,13,20
12,1,2,7,12,19
28,1,2,19,28,47
28,1,2,19,28,47
4,1,2,3,4,7
1,755,1215,411,755,1166
1,755,1215,436,755,1191
1,1482,2384,378,1482,1860
3,461,742,554,1383,1937
7,45,120,491,315,806
4,59,159,387,236,623
5,2,5,15,10,25
1,2,5,3,2,5
18,4,10,104,72,176
21,4,10,122,84,206
19,2,5,45,38,83
6,2,5,14,12,26
23,2,5,53,46,99
12,2,5,35,24,59
11,2,5,32,22,54
13,2,5,38,26,64
22,2,5,43,44,87
23,2,5,45,46,91
9,2,5,26,18,44
6,2,5,17,12,29
13,4,10,60,52,112
12,2,5,23,24,47
3,2,5,6,6,12
30,2,5,57,60,117
10,2,5,19,20,39
9,2,5,26,18,44
12,2,5,35,24,59
22,2,5,65,44,109
13,3,9,73,39,112
16,7,9,22,112,134
18,7,9,15,126,141
1,7,9,1,7,8
21,7,9,38,147,185
19,7,9,35,133,168
29,7,9,53,203,256
17,7,9,28,119,147
25,7,9,48,175,223
28,7,9,51,196,247
28,3,8,136,84,220
1,8,22,14,8,22
4,8,22,37,32,69
28,8,22,306,224,530
9,8,22,122,72,194
29,8,22,393,232,625
12,8,22,163,96,259
1,8,22,14,8,22
13,8,22,145,104,249
10,8,22,138,80,218
8,9,24,89,72,161
30,9,24,436,270,706
8,9,24,116,72,188
25,9,24,363,225,588
31,9,24,309,279,588
4,13,35,78,52,130
4,13,35,85,52,137
10,13,35,164,130,294
4,13,35,85,52,137
2,13,35,34,26,60
31,13,35,454,403,857
22,13,35,469,286,755
7,13,35,144,91,235
13,13,35,204,169,373
21,13,35,433,273,706
28,13,35,489,364,853
26,13,35,445,338,783
6,13,35,105,78,183
1,13,35,21,13,34
25,13,35,515,325,840
12,13,35,260,156,416
22,13,35,476,286,762
26,13,35,554,338,892
18,13,35,390,234,624
11,13,35,227,143,370
24,13,35,343,312,655
14,13,35,200,182,382
3,13,35,44,39,83
10,13,35,171,130,301
27,42,54,295,1134,1429
24,38,50,276,912,1188
4,38,50,44,152,196
17,38,50,187,646,833
1,38,50,1,38,39
15,42,54,164,630,794
16,38,50,176,608,784
12,38,50,132,456,588
17,42,54,11,714,725
1,1252,2295,722,1252,1974
1,1266,2320,1008,1266,2274
3,1266,2320,3023,3798,6821
3,1252,2295,3060,3756,6816
2,1252,2295,1352,2504,3856
3,1252,2295,2165,3756,5921
2,1266,2320,1087,2532,3619
1,1252,2295,951,1252,2203
1,1252,2295,745,1252,1997
3,295,540,703,885,1588
1,1266,2320,961,1266,2227
2,1912,3400,1480,3824,5304
1,487,783,280,487,767
1,713,1120,396,713,1109
1,1519,2443,826,1519,2345
1,2171,3578,942,2171,3113
2,2171,3578,1311,4342,5653
1,713,1120,385,713,1098
2,713,1120,769,1426,2195
1,344,540,158,344,502
1,2171,3578,1371,2171,3542
2,487,783,310,974,1284
2,713,1120,657,1426,2083
1,2171,3578,1335,2171,3506
21,26,70,909,546,1455
9,26,70,295,234,529
5,26,70,213,130,343
8,26,70,229,208,437
22,26,70,722,572,1294
23,3,9,105,69,174
16,3,9,90,48,138
24,3,9,109,72,181
25,1,2,24,25,49
15,1,2,14,15,29
2,1,2,1,2,3
10,1,2,7,10,17
14,1,2,10,14,24
1,11,30,19,11,30
20,11,30,374,220,594
24,13,35,511,312,823
27,13,35,575,351,926
12,2,5,35,24,59
1,2,5,3,2,5
15,2,5,44,30,74
15,1,4,44,15,59
15,2,5,44,30,74
5,2,5,15,10,25
7,11,29,100,77,177
17,11,29,242,187,429
11,1,2,6,11,17
28,1,2,16,28,44
27,2,5,62,54,116
21,2,5,59,42,101
9,1,2,6,9,15
6,11,30,112,66,178
17,11,30,313,187,500
9,11,30,166,99,265
22,9,25,347,198,545
12,9,25,189,108,297
26,2,5,73,52,125
24,2,5,67,48,115
20,1,2,19,20,39
26,1,2,25,26,51
15,8,21,154,120,274
23,8,21,236,184,420
23,2,5,48,46,94
19,2,5,40,38,78
24,2,5,50,48,98
9,2,5,19,18,37
21,2,5,44,42,86
16,2,5,46,32,78
1,1482,2384,473,1482,1955
1,1482,2384,807,1482,2289
2,1482,2384,1709,2964,4673
2,1482,2384,1709,2964,4673
1,1482,2384,378,1482,1860
26,24,64,824,624,1448
26,24,64,1007,624,1631
22,24,64,697,528,1225
1,45,120,70,45,115
27,3,9,152,81,233
20,3,9,113,60,173
32,2,5,90,64,154
28,2,5,59,56,115
8,2,5,17,16,33
14,2,5,39,28,67
3,4,10,14,12,26
5,2,5,14,10,24
18,2,5,49,36,85
21,2,5,49,42,91
9,2,5,21,18,39
4,2,5,9,8,17
6,2,5,14,12,26
16,2,5,38,32,70
7,2,5,16,14,30
28,4,10,165,112,277
11,4,10,65,44,109
8,2,5,17,16,33
26,4,10,151,104,255
8,4,10,46,32,78
24,2,5,70,48,118
7,2,5,20,14,34
20,3,9,116,60,176
1,3,9,6,3,9
21,3,9,124,63,187
15,2,5,44,30,74
27,2,5,78,54,132
4,7,9,7,28,35
15,7,9,12,105,117
16,7,9,29,112,141
26,7,9,43,182,225
27,7,9,20,189,209
19,7,9,36,133,169
12,7,9,5,84,89
4,3,8,20,12,32
23,3,8,86,69,155
9,3,8,44,27,71
19,8,22,207,152,359
12,8,22,163,96,259
5,8,22,68,40,108
19,8,22,249,152,401
26,8,22,261,208,469
24,9,24,256,216,472
26,9,24,278,234,512
16,9,24,159,144,303
14,13,35,200,182,382
31,13,35,660,403,1063
28,13,35,557,364,921
5,13,35,98,65,163
10,13,35,206,130,336
25,13,35,393,325,718
15,13,35,309,195,504
4,13,35,70,52,122
7,13,35,149,91,240
11,13,35,188,143,331
22,13,35,345,286,631
27,13,35,528,351,879
7,13,35,100,91,191
24,13,35,352,312,664
23,13,35,474,299,773
11,13,35,234,143,377
23,13,35,474,299,773
17,13,35,249,221,470
3,13,35,52,39,91
8,21,55,215,168,383
27,38,50,297,1026,1323
5,38,50,55,190,245
8,42,54,40,336,376
32,42,54,73,1344,1417
9,42,54,45,378,423
2,38,50,20,76,96
23,38,50,115,874,989
1,1252,2295,722,1252,1974
1,1252,2295,997,1252,2249
3,1252,2295,2854,3756,6610
1,1252,2295,905,1252,2157
1,1266,2320,892,1266,2158
3,1266,2320,2884,3798,6682
1,420,769,318,420,738
1,420,769,249,420,669
1,1266,2320,1008,1266,2274
2,308,565,311,616,927
3,2171,3578,1860,6513,8373
2,1083,1701,624,2166,2790
1,2171,3578,942,2171,3113
3,1083,1701,935,3249,4184
3,487,783,794,1461,2255
1,344,540,185,344,529
3,713,1120,515,2139,2654
18,26,70,742,468,1210
4,26,70,170,104,274
29,26,70,992,754,1746
4,26,70,131,104,235
24,3,9,114,72,186
14,2,5,41,28,69
12,2,5,35,24,59
18,9,25,216,162,378
21,2,5,40,42,82
6,1,2,3,6,9
22,2,5,62,44,106
8,2,5,22,16,38
15,1,2,10,15,25
15,1,2,10,15,25
28,9,25,301,252,553
29,1,2,17,29,46
18,2,5,53,36,89
22,2,5,62,44,106
10,2,5,28,20,48
4,9,25,46,36,82
1,9,25,12,9,21
13,9,25,185,117,302
18,9,25,257,162,419
19,13,35,391,247,638
22,13,35,453,286,739
12,1,2,8,12,20
18,1,2,13,18,31
29,1,2,21,29,50
29,8,21,292,232,524
15,8,21,151,120,271
15,8,21,151,120,271
1,2,5,2,2,4
13,2,5,25,26,51
26,2,5,49,52,101
3,1,2,3,3,6
2,1,2,2,2,4
27,1,2,25,27,52
4,1,2,3,4,7
3,1,2,2,3,5
21,2,5,41,42,83
3,2,5,6,6,12
29,2,5,84,58,142
24,11,30,449,264,713
14,11,30,262,154,416
26,1,4,71,26,97
8,1,2,5,8,13
4,2,5,8,8,16
18,2,5,34,36,70
1,1,4,3,1,4
19,1,4,54,19,73
21,1,2,19,21,40
8,2,5,23,16,39
10,2,5,29,20,49
8,2,5,23,16,39
12,1,4,29,12,41
1,1482,2384,401,1482,1883
1,461,742,185,461,646
3,461,742,754,1383,2137
2,755,1215,750,1510,2260
1,1482,2384,807,1482,2289
3,1482,2384,1419,4446,5865
1,461,742,185,461,646
1,461,742,266,461,727
1,24,64,39,24,63
5,2,5,15,10,25
4,2,5,12,8,20
10,2,5,27,20,47
20,2,5,53,40,93
10,2,5,28,20,48
28,2,5,78,56,134
18,4,10,104,72,176
26,4,10,151,104,255
31,2,5,73,62,135
30,2,5,71,60,131
24,2,5,56,48,104
22,2,5,52,44,96
2,2,5,6,4,10
14,3,9,81,42,123
1,3,9,6,3,9
12,2,5,35,24,59
18,3,9,72,54,126
11,3,9,44,33,77
27,3,9,152,81,233
21,2,5,46,42,88
21,2,5,46,42,88
19,3,9,83,57,140
25,3,9,110,75,185
28,2,5,62,56,118
16,2,5,38,32,70
3,2,5,7,6,13
12,7,9,7,84,91
6,7,9,10,42,52
18,7,9,7,126,133
11,7,9,0,77,77
1,7,9,1,7,8
13,7,9,-2,91,89
25,3,8,123,75,198
4,3,8,19,12,31
19,8,22,258,152,410
23,8,22,211,184,395
32,8,22,321,256,577
25,8,22,339,200,539
21,8,22,192,168,360
9,13,35,192,117,309
4,13,35,68,52,120
7,13,35,137,91,228
15,13,35,236,195,431
13,13,35,177,169,346
11,13,35,173,143,316
28,13,35,400,364,764
28,13,35,459,364,823
13,13,35,204,169,373
11,13,35,192,143,335
10,13,35,213,130,343
14,13,35,298,182,480
14,13,35,288,182,470
16,13,35,341,208,549
16,13,35,330,208,538
12,13,35,247,156,403
10,13,35,213,130,343
31,13,35,671,403,1074
3,42,54,33,126,159
17,42,54,195,714,909
1,42,54,2,42,44
26,38,50,26,988,1014
16,38,50,16,608,624
12,38,50,66,456,522
2,38,50,2,76,78
8,38,50,8,304,312
17,42,54,30,714,744
15,42,54,67,630,697
8,38,50,80,304,384
8,42,54,18,336,354
1,1266,2320,1031,1266,2297
1,1252,2295,1020,1252,2272
1,1266,2320,636,1266,1902
3,420,769,955,1260,2215
1,308,565,184,308,492
2,1252,2295,1994,2504,4498
1,1252,2295,538,1252,1790
1,1266,2320,892,1266,2158
1,1555,2443,717,1555,2272
1,1555,2443,448,1555,2003
1,1555,2443,546,1555,2101
3,1555,2443,1345,4665,6010
2,487,783,529,974,1503
3,1555,2443,1271,4665,5936
2,344,540,133,688,821
6,26,70,256,156,412
24,3,9,140,72,212
30,2,5,57,60,117
5,13,35,107,65,172
9,1,2,5,9,14
24,1,2,13,24,37
8,2,5,19,16,35
21,2,5,49,42,91
20,2,5,47,40,87
14,1,2,9,14,23
27,1,2,26,27,53
10,1,2,10,10,20
19,8,21,231,152,383
30,1,2,22,30,52
2,1,2,1,2,3
12,1,2,7,12,19
3,2,5,7,6,13
16,2,5,37,32,69
17,2,5,39,34,73
23,12,33,453,276,729
28,2,5,64,56,120
25,2,5,58,50,108
9,2,5,21,18,39
13,1,2,7,13,20
16,1,2,9,16,25
20,1,2,15,20,35
23,2,5,67,46,113
24,2,5,70,48,118
1,9,25,14,9,23
19,2,5,56,38,94
4,2,5,12,8,20
15,1,2,15,15,30
30,1,2,29,30,59
21,1,2,13,21,34
21,1,2,13,21,34
21,2,5,59,42,101
3,2,5,8,6,14
7,1,2,6,7,13
4,1,4,10,4,14
2,1,4,5,2,7
20,1,2,15,20,35
28,2,5,83,56,139
21,2,5,62,42,104
22,2,5,65,44,109
7,11,30,129,77,206
4,11,30,74,44,118
29,1,2,16,29,45
7,8,21,60,56,116
25,8,21,215,200,415
20,8,21,172,160,332
10,9,25,105,90,195
23,9,25,242,207,449
21,1,2,15,21,36
23,1,2,17,23,40
26,1,2,19,26,45
14,1,2,10,14,24
23,2,5,67,46,113
28,2,5,81,56,137
10,2,5,29,20,49
5,1,4,15,5,20
18,1,4,53,18,71
6,1,4,17,6,23
11,1,4,31,11,42
1,1482,2384,592,1482,2074
1,755,1215,290,755,1045
16,24,64,620,384,1004
17,24,64,484,408,892
25,2,5,59,50,109
30,2,5,89,60,149
25,2,5,59,50,109
23,2,5,54,46,100
31,2,5,82,62,144
16,2,5,42,32,74
15,2,5,42,30,72
27,2,5,76,54,130
6,2,5,11,12,23
23,2,5,64,46,110
2,2,5,6,4,10
10,2,5,29,20,49
18,2,5,52,36,88
14,2,5,29,28,57
28,2,5,59,56,115
13,3,9,52,39,91
15,3,9,60,45,105
20,3,9,116,60,176
9,2,5,21,18,39
21,2,5,49,42,91
29,2,5,81,58,139
24,2,5,67,48,115
3,2,5,8,6,14
1,2,5,3,2,5
11,7,9,18,77,95
16,7,9,29,112,141
1,7,9,0,7,7
2,7,9,3,14,17
25,7,9,1,175,176
17,7,9,31,119,150
20,7,9,8,140,148
19,3,8,75,57,132
4,8,22,54,32,86
21,8,22,285,168,453
11,8,22,149,88,237
8,8,22,73,64,137
8,8,22,89,64,153
23,8,22,256,184,440
27,9,24,399,243,642
32,9,24,372,288,660
6,9,24,84,54,138
20,9,24,290,180,470
6,13,35,130,78,208
1,13,35,21,13,34
20,13,35,349,260,609
2,13,35,43,26,69
8,13,35,173,104,277
4,13,35,78,52,130
1,13,35,14,13,27
15,13,35,309,195,504
17,13,35,368,221,589
7,13,35,110,91,201
11,13,35,180,143,323
7,13,35,144,91,235
1,13,35,21,13,34
17,13,35,297,221,518
16,13,35,229,208,437
20,13,35,342,260,602
22,13,35,315,286,601
25,13,35,515,325,840
11,38,50,110,418,528
19,42,54,207,798,1005
18,42,54,197,756,953
26,38,50,26,988,1014
13,38,50,143,494,637
1,42,54,11,42,53
24,38,50,240,912,1152
25,38,50,75,950,1025
3,1266,2320,2257,3798,6055
2,1266,2320,1922,2532,4454
2,1252,2295,1994,2504,4498
2,420,769,667,840,1507
2,1266,2320,2015,2532,4547
1,1252,2295,745,1252,1997
2,1555,2443,1434,3110,4544
1,487,783,108,487,595
1,487,783,265,487,752
1,1083,1701,380,1083,1463
1,713,1120,396,713,1109
2,2171,3578,1669,4342,6011
2,1555,2443,1727,3110,4837
1,344,540,77,344,421
2,487,783,388,974,1362
1,487,783,288,487,775
1,344,540,174,344,518
1,344,540,174,344,518
1,2171,3578,620,2171,2791
1,2171,3578,620,2171,2791
1,2171,3578,1335,2171,3506
6,26,70,256,156,412
14,26,70,400,364,764
11,26,70,345,286,631
12,13,35,197,156,353
25,1,2,25,25,50
32,1,2,31,32,63
21,1,2,20,21,41
7,1,2,7,7,14
17,1,2,17,17,34
26,13,35,554,338,892
1,2,5,3,2,5
26,1,4,64,26,90
14,1,4,35,14,49
19,2,5,40,38,78
19,1,2,19,19,38
1,1,2,1,1,2
26,1,2,25,26,51
7,1,4,21,7,28
18,1,2,10,18,28
7,8,21,88,56,144
21,8,21,194,168,362
26,2,5,75,52,127
20,2,5,58,40,98
21,2,5,61,42,103
7,2,5,16,14,30
25,2,5,58,50,108
17,2,5,39,34,73
15,1,2,14,15,29
27,1,2,25,27,52
7,1,2,6,7,13
1,8,21,9,8,17
17,8,21,153,136,289
16,8,21,184,128,312
14,8,21,161,112,273
20,2,5,58,40,98
1,2,5,3,2,5
24,2,5,64,48,112
18,2,5,48,36,84
5,2,5,13,10,23
1,1482,2384,592,1482,2074
3,461,742,442,1383,1825
1,1482,2384,807,1482,2289
3,1482,2384,1133,4446,5579
1,461,742,229,461,690
26,24,64,824,624,1448
4,45,120,290,180,470
20,2,5,47,40,87
24,2,5,56,48,104
25,2,5,66,50,116
8,2,5,21,16,37
25,2,5,48,50,98
1,2,5,2,2,4
30,2,5,69,60,129
18,2,5,52,36,88
19,2,5,55,38,93
26,2,5,51,52,103
3,2,5,7,6,13
7,2,5,16,14,30
16,2,5,35,32,67
8,2,5,18,16,34
24,2,5,56,48,104
26,2,5,61,52,113
13,2,5,31,26,57
29,2,5,68,58,126
19,3,9,107,57,164
5,3,9,28,15,43
12,7,9,20,84,104
19,7,9,26,133,159
28,7,9,38,196,234
15,7,9,6,105,111
17,7,9,13,119,132
10,3,8,33,30,63
25,3,8,83,75,158
26,3,8,115,78,193
18,3,8,71,54,125
22,8,22,206,176,382
28,8,22,281,224,505
12,8,22,110,96,206
16,8,22,168,128,296
22,9,24,325,198,523
14,9,24,139,126,265
25,9,24,297,225,522
1,9,24,12,9,21
22,9,24,319,198,517
26,13,35,426,338,764
4,13,35,70,52,122
11,13,35,180,143,323
23,13,35,498,299,797
1,13,35,16,13,29
26,13,35,536,338,874
17,13,35,350,221,571
31,13,35,660,403,1063
21,13,35,366,273,639
18,13,35,295,234,529
29,13,35,567,377,944
17,13,35,332,221,553
1,13,35,16,13,29
12,13,35,260,156,416
8,13,35,114,104,218
10,13,35,213,130,343
20,13,35,349,260,609
27,13,35,556,351,907
9,21,55,286,189,475
20,21,55,449,420,869
20,42,54,100,840,940
21,42,54,105,882,987
6,42,54,59,252,311
1,1252,2295,951,1252,2203
1,1252,2295,630,1252,1882
1,1266,2320,892,1266,2158
1,1252,2295,630,1252,1882
1,2171,3578,620,2171,2791
1,2171,3578,1264,2171,3435
1,713,1120,396,713,1109
1,1519,2443,753,1519,2272
1,1555,2443,570,1555,2125
3,1519,2443,2479,4557,7036
1,1083,1701,601,1083,1684
1,2171,3578,620,2171,2791
2,344,540,154,688,842
1,344,540,126,344,470
1,713,1120,261,713,974
3,487,783,583,1461,2044
1,344,540,126,344,470
2,344,540,349,688,1037
10,13,35,147,130,277
17,13,35,249,221,470
29,1,2,28,29,57
13,2,5,38,26,64
13,2,5,38,26,64
12,1,2,8,12,20
9,2,5,25,18,43
1,2,5,3,2,5
6,2,5,17,12,29
7,2,5,20,14,34
3,1,2,2,3,5
25,2,5,74,50,124
4,2,5,12,8,20
1,1,4,2,1,3
21,1,4,48,21,69
12,2,5,34,24,58
4,2,5,11,8,19
31,1,4,77,31,108
9,2,5,17,18,35
21,2,5,59,42,101
15,2,5,42,30,72
27,2,5,76,54,130
4,2,5,11,8,19
22,1,2,16,22,38
18,2,5,41,36,77
8,2,5,23,16,39
6,2,5,17,12,29
19,1,2,13,19,32
10,1,2,7,10,17
8,1,2,5,8,13
24,1,2,18,24,42
15,1,2,13,15,28
16,1,2,14,16,30
17,2,5,36,34,70
28,2,5,59,56,115
30,1,2,28,30,58
28,1,2,26,28,54
8,1,2,4,8,12
12,11,30,149,132,281
8,11,30,99,88,187
3,11,30,37,33,70
7,2,5,13,14,27
8,2,5,15,16,31
21,2,5,40,42,82
8,1,4,18,8,26
29,1,4,66,29,95
7,1,4,16,7,23
29,1,2,21,29,50
6,1,2,4,6,10
21,1,2,16,21,37
7,1,2,5,7,12
14,1,2,10,14,24
1,9,25,13,9,22
22,9,25,275,198,473
20,1,4,50,20,70
23,1,4,57,23,80
21,1,2,18,21,39
20,1,2,17,20,37
29,1,4,85,29,114
5,1,4,15,5,20
30,1,2,22,30,52
12,2,5,35,24,59
11,9,25,171,99,270
2,9,25,31,18,49
24,1,4,68,24,92
29,1,4,82,29,111
1,1482,2384,807,1482,2289
1,755,1215,411,755,1166
1,461,742,266,461,727
1,755,1215,375,755,1130
2,461,742,547,922,1469
25,24,64,712,600,1312
28,24,64,995,672,1667
4,59,159,394,236,630
16,2,5,47,32,79
1,2,5,3,2,5
27,2,5,78,54,132
24,2,5,70,48,118
1,2,5,3,2,5
11,2,5,26,22,48
22,2,5,53,44,97
31,2,5,90,62,152
11,2,5,32,22,54
12,2,5,34,24,58
15,4,10,66,60,126
25,3,9,121,75,196
2,3,9,10,6,16
6,2,5,14,12,26
23,2,5,54,46,100
28,3,9,128,84,212
2,7,9,1,14,15
9,7,9,7,63,70
24,7,9,39,168,207
17,7,9,23,119,142
6,7,9,10,42,52
6,7,9,6,42,48
12,3,8,48,36,84
23,3,8,111,69,180
21,8,22,285,168,453
29,8,22,400,232,632
14,8,22,193,112,305
26,9,24,253,234,487
5,9,24,73,45,118
21,9,24,249,189,438
2,13,35,43,26,69
6,13,35,128,78,206
16,13,35,229,208,437
11,13,35,157,143,300
3,13,35,64,39,103
28,13,35,547,364,911
20,13,35,426,260,686
14,13,35,230,182,412
25,13,35,366,325,691
22,13,35,392,286,678
22,13,35,384,286,670
13,13,35,227,169,396
1,13,35,21,13,34
20,21,55,658,420,1078
4,42,54,3,168,171
7,42,54,69,294,363
27,38,50,297,1026,1323
23,42,54,15,966,981
11,42,54,37,462,499
12,42,54,27,504,531
25,42,54,273,1050,1323
3,1266,2320,2257,3798,6055
1,1252,2295,997,1252,2249
3,1266,2320,3023,3798,6821
1,1266,2320,1031,1266,2297
1,2171,3578,1335,2171,3506
1,713,1120,261,713,974
2,1083,1701,1202,2166,3368
1,713,1120,385,713,1098
1,1555,2443,497,1555,2052
2,2171,3578,2742,4342,7084
1,1555,2443,497,1555,2052
2,713,1120,545,1426,1971
1,344,540,185,344,529
1,487,783,194,487,681
1,2171,3578,620,2171,2791
3,2171,3578,4006,6513,10519
1,2171,3578,1335,2171,3506
6,8,21,75,48,123
25,8,21,315,200,515
29,2,5,84,58,142
14,2,5,41,28,69
27,13,35,575,351,926
15,1,2,9,15,24
21,1,2,12,21,33
16,1,2,9,16,25
18,2,5,41,36,77
22,1,2,13,22,35
1,1,2,1,1,2
22,2,5,58,44,102
12,2,5,32,24,56
22,2,5,42,44,86
26,2,5,49,52,101
18,2,5,50,36,86
1,2,5,2,2,4
9,2,5,21,18,39
4,2,5,9,8,17
26,1,4,64,26,90
14,1,4,35,14,49
5,2,5,11,10,21
27,2,5,57,54,111
15,2,5,32,30,62
1,13,35,22,13,35
26,11,30,330,286,616
26,11,30,330,286,616
2,11,30,25,22,47
1,1,4,2,1,3
5,1,4,12,5,17
13,2,5,38,26,64
2,2,5,6,4,10
22,1,2,22,22,44
11,1,2,11,11,22
26,2,5,77,52,129
18,2,5,53,36,89
19,1,2,11,19,30
11,1,4,25,11,36
13,1,4,30,13,43
2,1,4,5,2,7
6,1,4,13,6,19
5,1,4,11,5,16
28,1,4,82,28,110
8,2,5,22,16,38
8,2,5,22,16,38
29,1,2,21,29,50
24,1,2,17,24,41
15,2,5,32,30,62
3,2,5,6,6,12
27,1,2,26,27,53
8,1,4,23,8,31
1,461,742,162,461,623
1,461,742,147,461,608
1,1482,2384,592,1482,2074
1,461,742,266,461,727
3,59,159,295,177,472
13,4,10,61,52,113
10,4,10,53,40,93
20,4,10,106,80,186
14,2,5,39,28,67
29,2,5,55,58,113
15,2,5,29,30,59
28,4,10,157,112,269
14,4,10,78,56,134
4,2,5,12,8,20
27,2,5,80,54,134
5,2,5,12,10,22
18,2,5,52,36,88
7,2,5,21,14,35
26,2,5,77,52,129
8,2,5,15,16,31
15,2,5,44,30,74
7,2,5,16,14,30
2,2,5,5,4,9
25,7,9,34,175,209
28,7,9,1,196,197
5,7,9,9,35,44
14,3,8,66,42,108
15,3,8,49,45,94
1,8,22,9,8,17
25,8,22,345,200,545
14,8,22,184,112,296
15,8,22,207,120,327
6,8,22,79,48,127
17,8,22,234,136,370
11,9,24,131,99,230
16,9,24,236,144,380
8,9,24,118,72,190
3,9,24,29,27,56
8,13,35,173,104,277
7,13,35,122,91,213
1,13,35,22,13,35
15,13,35,309,195,504
29,13,35,618,377,995
11,13,35,238,143,381
2,13,35,39,26,65
10,13,35,157,130,287
18,13,35,390,234,624
9,13,35,148,117,265
7,13,35,152,91,243
12,13,35,260,156,416
13,13,35,281,169,450
18,13,35,257,234,491
21,13,35,374,273,647
13,13,35,186,169,355
29,13,35,597,377,974
18,21,55,483,378,861
8,38,50,88,304,392
16,42,54,80,672,752
26,38,50,26,988,1014
10,38,50,55,380,435
20,42,54,229,840,1069
7,42,54,80,294,374
15,38,50,165,570,735
19,42,54,95,798,893
26,42,54,45,1092,1137
1,38,50,10,38,48
3,42,54,25,126,151
1,1266,2320,752,1266,2018
1,1266,2320,892,1266,2158
3,1252,2295,2991,3756,6747
3,420,769,1024,1260,2284
2,1252,2295,2040,2504,4544
1,1266,2320,1008,1266,2274
1,295,540,223,295,518
3,308,565,703,924,1627
1,295,540,240,295,535
2,1252,2295,1260,2504,3764
1,1266,2320,961,1266,2227
2,1555,2443,1434,3110,4544
1,1083,1701,499,1083,1582
1,2171,3578,942,2171,3113
1,2171,3578,835,2171,3006
3,487,783,794,1461,2255
1,713,1120,205,713,918
1,1519,2443,900,1519,2419
1,344,540,174,344,518
13,26,70,563,338,901
12,26,70,511,312,823
2,26,70,57,52,109
30,3,9,177,90,267
8,3,9,32,24,56
4,3,9,16,12,28
23,3,9,130,69,199
12,9,25,144,108,252
16,9,25,192,144,336
16,2,5,47,32,79
25,2,5,74,50,124
13,1,2,13,13,26
9,1,2,9,9,18
1,2,5,3,2,5
12,2,5,35,24,59
8,13,35,173,104,277
3,13,35,65,39,104
19,1,2,18,19,37
17,1,2,16,17,33
5,2,5,14,10,24
26,2,5,73,52,125
3,9,25,32,27,59
7,2,5,20,14,34
29,2,5,84,58,142
22,9,25,341,198,539
28,11,30,498,308,806
3,1,2,3,3,6
19,1,2,16,19,35
15,1,2,14,15,29
7,1,2,6,7,13
23,1,4,68,23,91
1,1,4,3,1,4
6,1,2,4,6,10
16,12,33,252,192,444
27,12,33,424,324,748
2,11,30,36,22,58
28,1,2,16,28,44
15,1,2,8,15,23
3,8,21,31,24,55
1,12,33,17,12,29
28,8,21,352,224,576
1,8,21,13,8,21
14,8,21,176,112,288
15,1,2,13,15,28
20,1,2,17,20,37
28,2,5,53,56,109
18,1,2,17,18,35
10,8,21,126,80,206
28,11,29,358,308,666
1,11,29,13,11,24
1,1482,2384,592,1482,2074
1,1482,2384,878,1482,2360
3,1482,2384,2634,4446,7080
2,1482,2384,1184,2964,4148
27,24,64,700,648,1348
3,24,64,112,72,184
7,45,120,391,315,706
2,45,120,148,90,238
10,59,159,650,590,1240
26,2,5,49,52,101
2,2,5,4,4,8
30,2,5,57,60,117
21,2,5,61,42,103
4,2,5,8,8,16
13,2,5,25,26,51
16,2,5,38,32,70
26,2,5,61,52,113
7,2,5,15,14,29
18,2,5,38,36,74
5,2,5,15,10,25
17,2,5,49,34,83
27,3,9,145,81,226
27,3,9,145,81,226
4,2,5,9,8,17
24,2,5,56,48,104
15,7,9,29,105,134
3,7,9,0,21,21
5,7,9,4,35,39
26,7,9,43,182,225
9,7,9,7,63,70
13,7,9,24,91,115
6,7,9,5,42,47
23,7,9,17,161,178
20,8,22,262,160,422
11,8,22,123,88,211
20,9,24,295,180,475
12,13,35,188,156,344
23,13,35,393,299,692
18,13,35,257,234,491
3,13,35,43,39,82
2,13,35,29,26,55
20,13,35,412,260,672
4,13,35,82,52,134
6,13,35,124,78,202
10,13,35,206,130,336
18,13,35,383,234,617
5,13,35,72,65,137
22,38,50,220,836,1056
29,42,54,332,1218,1550
12,38,50,120,456,576
21,42,54,3,882,885
22,38,50,220,836,1056
17,38,50,145,646,791
16,42,54,175,672,847
29,42,54,317,1218,1535
26,42,54,3,1092,1095
26,38,50,299,988,1287
1,42,54,2,42,44
4,38,50,4,152,156
2,1266,2320,1922,2532,4454
3,1252,2295,1890,3756,5646
1,1252,2295,538,1252,1790
1,1252,2295,951,1252,2203
1,420,769,318,420,738
1,2171,3578,1264,2171,3435
1,344,540,185,344,529
1,1519,2443,900,1519,2419
1,487,783,241,487,728
3,487,783,794,1461,2255
1,1083,1701,295,1083,1378
29,26,70,1256,754,2010
1,26,70,43,26,69
9,26,70,383,234,617
22,26,70,629,572,1201
11,1,2,11,11,22
8,1,2,8,8,16
12,13,35,205,156,361
1,13,35,17,13,30
26,2,5,49,52,101
10,2,5,19,20,39
16,2,5,30,32,62
3,2,5,6,6,12
17,1,2,11,17,28
5,11,29,89,55,144
24,2,5,46,48,94
10,2,5,19,20,39
21,2,5,59,42,101
21,2,5,59,42,101
19,2,5,55,38,93
10,2,5,29,20,49
1,2,5,3,2,5
12,2,5,26,24,50
22,2,5,48,44,92
21,13,35,433,273,706
28,13,35,577,364,941
18,13,35,295,234,529
2,13,35,33,26,59
32,1,4,93,32,125
14,12,33,192,168,360
18,8,21,166,144,310
26,8,21,240,208,448
15,8,21,189,120,309
30,8,21,377,240,617
22,8,21,277,176,453
18,12,33,301,216,517
3,12,33,50,36,86
1,755,1215,448,755,1203
1,1482,2384,735,1482,2217
1,1482,2384,807,1482,2289
2,1482,2384,1613,2964,4577
7,45,120,508,315,823
8,59,159,622,472,1094
20,2,5,58,40,98
10,2,5,29,20,49
29,2,5,84,58,142
27,4,10,113,108,221
19,2,5,55,38,93
4,2,5,12,8,20
21,2,5,61,42,103
25,2,5,73,50,123
20,4,10,116,80,196
25,4,10,145,100,245
25,2,5,49,50,99
14,2,5,39,28,67
15,2,5,42,30,72
17,2,5,48,34,82
19,7,9,36,133,169
13,3,8,61,39,100
17,3,8,55,51,106
21,8,22,183,168,351
11,8,22,152,88,240
18,8,22,244,144,388
24,8,22,325,192,517
13,8,22,119,104,223
24,8,22,325,192,517
15,8,22,207,120,327
26,8,22,358,208,566
18,9,24,166,162,328
22,9,24,309,198,507
5,9,24,50,45,95
3,13,35,62,39,101
8,13,35,170,104,274
17,13,35,368,221,589
5,13,35,103,65,168
18,13,35,383,234,617
13,13,35,277,169,446
27,13,35,575,351,926
20,13,35,391,260,651
4,13,35,57,52,109
28,13,35,596,364,960
17,13,35,368,221,589
6,13,35,130,78,208
27,13,35,556,351,907
12,13,35,209,156,365
17,13,35,362,221,583
15,13,35,309,195,504
16,13,35,341,208,549
5,13,35,73,65,138
28,13,35,440,364,804
11,13,35,180,143,323
20,38,50,230,760,990
5,38,50,15,190,205
10,38,50,110,380,490
2,38,50,11,76,87
10,42,54,115,420,535
2,1912,3400,2704,3824,6528
1,1898,3375,937,1898,2835
3,1252,2295,1477,3756,5233
2,1252,2295,2040,2504,4544
1,420,769,334,420,754
2,1266,2320,1134,2532,3666
1,420,769,318,420,738
2,1266,2320,1087,2532,3619
1,1266,2320,1031,1266,2297
1,1266,2320,1031,1266,2297
1,295,540,234,295,529
1,1266,2320,1008,1266,2274
1,713,1120,385,713,1098
1,713,1120,261,713,974
3,713,1120,1154,2139,3293
1,713,1120,172,713,885
2,1083,1701,1100,2166,3266
1,1555,2443,864,1555,2419
1,344,540,174,344,518
2,344,540,349,688,1037
3,26,70,130,78,208
9,3,9,43,27,70
13,1,2,12,13,25
30,1,2,28,30,58
8,1,2,7,8,15
21,1,2,20,21,41
3,1,2,3,3,6
2,1,2,2,2,4
18,2,5,53,36,89
2,13,35,43,26,69
7,13,35,152,91,243
12,13,35,260,156,416
18,9,25,194,162,356
13,9,25,140,117,257
19,9,25,299,171,470
31,9,25,488,279,767
21,1,4,62,21,83
1,1,4,3,1,4
2,1,4,6,2,8
7,1,4,21,7,28
29,2,5,86,58,144
18,11,29,230,198,428
1,11,29,13,11,24
23,11,29,294,253,547
15,13,35,293,195,488
15,13,35,293,195,488
2,1,2,1,2,3
23,1,2,16,23,39
2,2,5,5,4,9
4,2,5,9,8,17
10,1,2,10,10,20
13,1,2,12,13,25
5,1,2,4,5,9
1,1,2,1,1,2
31,2,5,73,62,135
31,2,5,59,62,121
23,2,5,44,46,90
24,2,5,71,48,119
26,2,5,77,52,129
1,2,5,3,2,5
28,2,5,83,56,139
1,2,5,3,2,5
1,2,5,3,2,5
25,1,4,74,25,99
21,1,4,62,21,83
25,1,4,74,25,99
22,1,4,64,22,86
26,9,25,312,234,546
7,9,25,84,63,147
9,1,2,9,9,18
2,1,2,2,2,4
1,12,33,14,12,26
22,12,33,302,264,566
16,2,5,45,32,77
14,2,5,39,28,67
7,2,5,15,14,29
10,2,5,29,20,49
4,2,5,12,8,20
18,1,2,13,18,31
25,1,2,18,25,43
4,2,5,8,8,16
15,2,5,29,30,59
2,2,5,5,4,9
11,2,5,25,22,47
19,1,4,55,19,74
6,1,4,18,6,24
4,1,4,12,4,16
5,1,4,11,5,16
3,1,4,7,3,10
1,755,1215,266,755,1021
1,755,1215,302,755,1057
3,1482,2384,2563,4446,7009
1,1482,2384,854,1482,2336
13,24,64,512,312,824
1,59,159,98,59,157
5,59,159,413,295,708
12,4,10,50,48,98
20,4,10,84,80,164
29,4,10,136,116,252
21,4,10,99,84,183
20,2,5,58,40,98
10,2,5,24,20,44
30,2,5,87,60,147
4,2,5,12,8,20
29,4,10,162,116,278
13,4,10,73,52,125
26,2,5,73,52,125
13,2,5,36,26,62
9,3,9,48,27,75
10,3,9,54,30,84
5,2,5,10,10,20
24,2,5,46,48,94
25,4,10,95,100,195
24,4,10,91,96,187
23,2,5,51,46,97
18,2,5,40,36,76
5,4,10,23,20,43
4,4,10,18,16,34
4,2,5,12,8,20
25,2,5,73,50,123
23,2,5,48,46,94
19,2,5,40,38,78
10,7,9,10,70,80
17,7,9,14,119,133
27,7,9,15,189,204
10,7,9,6,70,76
16,7,9,12,112,124
5,7,9,9,35,44
24,7,9,9,168,177
24,7,9,33,168,201
29,7,9,40,203,243
8,7,9,15,56,71
16,3,8,63,48,111
29,3,8,140,87,227
20,8,22,262,160,422
8,8,22,89,64,153
4,8,22,54,32,86
1,8,22,11,8,19
26,8,22,284,208,492
12,8,22,110,96,206
10,8,22,92,80,172
19,8,22,212,152,364
1,8,22,9,8,17
7,8,22,66,56,122
25,8,22,251,200,451
17,8,22,159,136,295
28,9,24,393,252,645
4,9,24,47,36,83
26,9,24,378,234,612
18,9,24,261,162,423
27,13,35,471,351,822
2,13,35,43,26,69
11,13,35,173,143,316
15,13,35,309,195,504
30,13,35,618,390,1008
10,13,35,213,130,343
30,13,35,513,390,903
9,13,35,185,117,302
7,13,35,100,91,191
14,13,35,244,182,426
5,13,35,107,65,172
4,13,35,63,52,115
12,13,35,205,156,361
2,13,35,35,26,61
32,13,35,682,416,1098
25,13,35,428,325,753
12,13,35,260,156,416
2,13,35,43,26,69
1,13,35,21,13,34
30,13,35,639,390,1029
31,13,35,541,403,944
15,42,54,34,630,664
18,42,54,12,756,768
17,38,50,94,646,740
15,42,54,148,630,778
8,38,50,88,304,392
2,42,54,20,84,104
19,42,54,2,798,800
29,38,50,319,1102,1421
6,38,50,30,228,258
2,42,54,9,84,93
2,1912,3400,1548,3824,5372
2,1266,2320,1783,2532,4315
2,1252,2295,1076,2504,3580
2,1252,2295,1260,2504,3764
1,1252,2295,1020,1252,2272
1,1252,2295,951,1252,2203
3,1252,2295,2234,3756,5990
1,1266,2320,1008,1266,2274
1,308,565,184,308,492
1,295,540,148,295,443
1,420,769,318,420,738
2,1266,2320,1922,2532,4454
1,1252,2295,745,1252,1997
2,308,565,491,616,1107
1,1252,2295,630,1252,1882
1,1555,2443,546,1555,2101
3,487,783,371,1461,1832
3,713,1120,986,2139,3125
2,1519,2443,1066,3038,4104
3,713,1120,1154,2139,3293
1,344,540,120,344,464
3,1555,2443,1711,4665,6376
1,713,1120,205,713,918
20,26,70,572,520,1092
2,26,70,85,52,137
15,3,9,89,45,134
12,3,9,57,36,93
8,1,2,4,8,12
30,1,2,29,30,59
3,1,2,3,3,6
3,1,2,3,3,6
22,1,2,22,22,44
5,1,2,5,5,10
18,2,5,52,36,88
13,2,5,38,26,64
16,2,5,46,32,78
17,9,25,255,153,408
25,9,25,375,225,600
11,2,5,26,22,48
16,2,5,38,32,70
4,1,2,4,4,8
4,1,2,4,4,8
1,1,2,1,1,2
23,1,2,22,23,45
22,1,2,14,22,36
29,2,5,86,58,144
15,2,5,44,30,74
3,2,5,8,6,14
25,2,5,66,50,116
8,9,25,120,72,192
17,2,5,39,34,73
28,1,2,27,28,55
16,1,2,12,16,28
28,1,2,20,28,48
25,1,2,14,25,39
19,1,2,11,19,30
21,1,4,48,21,69
25,1,4,57,25,82
28,12,33,468,336,804
17,12,33,284,204,488
8,1,2,5,8,13
16,1,2,10,16,26
11,2,5,32,22,54
27,2,5,78,54,132
7,11,30,125,77,202
18,2,5,42,36,78
8,2,5,19,16,35
21,11,30,330,231,561
15,11,30,236,165,401
1,1,4,3,1,4
17,12,33,284,204,488
17,12,33,284,204,488
14,1,4,41,14,55
25,1,4,73,25,98
25,1,4,62,25,87
22,1,4,55,22,77
7,1,2,5,7,12
13,1,2,10,13,23
21,2,5,56,42,98
27,2,5,78,54,132
18,8,21,208,144,352
1,8,21,12,8,20
1,1482,2384,521,1482,2003
1,755,1215,436,755,1191
1,461,742,266,461,727
23,24,64,905,552,1457
30,24,64,931,720,1651
12,24,64,311,288,599
5,59,159,397,295,692
16,3,9,95,48,143
29,2,5,86,58,144
16,2,5,47,32,79
24,2,5,70,48,118
27,2,5,78,54,132
13,2,5,30,26,56
13,2,5,30,26,56
21,2,5,59,42,101
17,2,5,40,34,74
13,2,5,31,26,57
24,2,5,70,48,118
11,2,5,25,22,47
27,2,5,62,54,116
3,2,5,9,6,15
4,2,5,12,8,20
12,2,5,35,24,59
11,2,5,32,22,54
3,2,5,9,6,15
22,2,5,64,44,108
13,2,5,38,26,64
20,2,5,59,40,99
28,3,9,135,84,219
8,3,9,39,24,63
27,7,9,52,189,241
14,7,9,27,98,125
24,7,9,44,168,212
20,7,9,-3,140,137
8,3,8,32,24,56
26,3,8,103,78,181
14,8,22,165,112,277
27,9,24,392,243,635
6,9,24,84,54,138
25,9,24,291,225,516
19,13,35,278,247,525
10,13,35,213,130,343
10,13,35,217,130,347
26,13,35,563,338,901
31,13,35,574,403,977
11,13,35,234,143,377
28,13,35,577,364,941
27,13,35,585,351,936
7,13,35,103,91,194
12,13,35,176,156,332
4,13,35,63,52,115
21,13,35,359,273,632
27,13,35,528,351,879
3,13,35,64,39,103
11,13,35,234,143,377
12,13,35,209,156,365
6,13,35,124,78,202
9,13,35,192,117,309
6,13,35,94,78,172
16,21,55,430,336,766
3,21,55,90,63,153
20,38,50,200,760,960
1,42,54,11,42,53
12,42,54,131,504,635
13,38,50,143,494,637
15,42,54,75,630,705
4,42,54,39,168,207
14,42,54,-13,588,575
1,1266,2320,1008,1266,2274
1,1252,2295,997,1252,2249
1,1252,2295,561,1252,1813
3,1266,2320,3023,3798,6821
1,1252,2295,997,1252,2249
2,1252,2295,2040,2504,4544
1,1252,2295,630,1252,1882
1,2171,3578,1335,2171,3506
2,2171,3578,2313,4342,6655
1,487,783,186,487,673
1,1083,1701,380,1083,1463
1,487,783,155,487,642
1,487,783,265,487,752
1,713,1120,362,713,1075
1,487,783,194,487,681
2,487,783,388,974,1362
2,487,783,388,974,1362
14,26,70,596,364,960
24,26,70,821,624,1445
17,26,70,736,442,1178
25,3,9,101,75,176
15,3,9,62,45,107
19,3,9,111,57,168
12,3,9,57,36,93
9,13,35,195,117,312
1,13,35,22,13,35
1,11,30,16,11,27
18,11,30,288,198,486
19,13,35,405,247,652
19,2,5,56,38,94
9,2,5,27,18,45
24,2,5,71,48,119
4,2,5,12,8,20
25,2,5,53,50,103
4,2,5,8,8,16
9,1,2,5,9,14
6,1,4,14,6,20
12,1,4,27,12,39
24,2,5,70,48,118
19,2,5,55,38,93
17,1,2,15,17,32
19,1,2,16,19,35
18,2,5,52,36,88
24,2,5,70,48,118
26,1,2,25,26,51
6,1,2,6,6,12
15,1,2,14,15,29
31,1,2,18,31,49
10,1,2,6,10,16
18,1,2,13,18,31
29,2,5,68,58,126
23,2,5,54,46,100
10,2,5,24,20,44
7,8,21,88,56,144
1,11,29,14,11,25
11,11,29,157,121,278
17,1,4,50,17,67
5,1,4,15,5,20
13,2,5,25,26,51
10,1,2,6,10,16
17,2,5,36,34,70
10,9,25,125,90,215
15,2,5,42,30,72
19,2,5,40,38,78
32,2,5,67,64,131
1,1482,2384,401,1482,1883
1,1482,2384,807,1482,2289
2,461,742,295,922,1217
1,1482,2384,592,1482,2074
1,461,742,266,461,727
9,24,64,348,216,564
7,45,120,407,315,722
22,45,120,1544,990,2534
20,3,9,113,60,173
16,4,10,70,64,134
5,4,10,22,20,42
2,3,9,9,6,15
9,2,5,21,18,39
9,2,5,21,18,39
13,4,10,69,52,121
15,4,10,80,60,140
19,2,5,50,38,88
12,2,5,32,24,56
16,2,5,33,32,65
29,2,5,55,58,113
15,2,5,29,30,59
9,2,5,17,18,35
9,2,5,19,18,37
10,3,9,44,30,74
26,2,5,75,52,127
25,2,5,73,50,123
14,3,9,79,42,121
26,2,5,61,52,113
25,2,5,59,50,109
17,2,5,49,34,83
10,2,5,29,20,49
6,3,9,34,18,52
19,3,9,107,57,164
23,7,9,19,161,180
2,7,9,2,14,16
6,7,9,11,42,53
12,7,9,9,84,93
19,7,9,14,133,147
4,7,9,0,28,28
26,3,8,86,78,164
15,3,8,59,45,104
1,8,22,9,8,17
1,8,22,11,8,19
10,8,22,131,80,211
24,8,22,299,192,491
14,8,22,184,112,296
13,8,22,179,104,283
22,8,22,298,176,474
29,9,24,407,261,668
24,9,24,320,216,536
13,9,24,183,117,300
19,9,24,276,171,447
8,9,24,78,72,150
14,13,35,298,182,480
17,13,35,297,221,518
8,13,35,156,104,260
3,13,35,64,39,103
5,13,35,107,65,172
8,13,35,140,104,244
23,13,35,329,299,628
21,13,35,447,273,720
11,13,35,238,143,381
25,13,35,393,325,718
25,13,35,436,325,761
15,13,35,267,195,462
29,13,35,415,377,792
7,13,35,149,91,240
19,13,35,411,247,658
6,13,35,124,78,202
26,13,35,554,338,892
17,13,35,368,221,589
27,38,50,270,1026,1296
25,38,50,288,950,1238
6,38,50,6,228,234
20,38,50,230,760,990
5,42,54,49,210,259
2,1266,2320,1505,2532,4037
1,1252,2295,538,1252,1790
1,1252,2295,951,1252,2203
1,1266,2320,636,1266,1902
3,1266,2320,2884,3798,6682
1,1252,2295,997,1252,2249
1,1266,2320,544,1266,1810
1,2171,3578,1157,2171,3328
1,2171,3578,1157,2171,3328
1,344,540,120,344,464
1,2171,3578,942,2171,3113
2,344,540,349,688,1037
1,344,540,174,344,518
1,1519,2443,606,1519,2125
1,344,540,99,344,443
1,487,783,194,487,681
1,487,783,194,487,681
14,26,70,489,364,853
17,26,70,724,442,1166
4,3,9,23,12,35
3,3,9,18,9,27
31,3,9,180,93,273
25,2,5,48,50,98
24,2,5,46,48,94
16,1,2,16,16,32
20,1,2,20,20,40
25,1,2,18,25,43
7,1,2,5,7,12
20,1,2,15,20,35
20,2,5,47,40,87
20,2,5,47,40,87
18,11,30,337,198,535
21,11,30,393,231,624
26,11,30,486,286,772
8,2,5,24,16,40
8,12,33,120,96,216
22,12,33,331,264,595
17,1,2,17,17,34
3,1,2,3,3,6
7,1,4,15,7,22
6,1,4,13,6,19
11,2,5,26,22,48
14,2,5,33,28,61
8,2,5,23,16,39
27,2,5,78,54,132
1,1,2,1,1,2
14,1,2,10,14,24
20,1,4,59,20,79
16,1,2,9,16,25
2,1,2,1,2,3
6,8,21,73,48,121
7,8,21,85,56,141
19,2,5,56,38,94
27,2,5,80,54,134
8,9,25,102,72,174
4,9,25,51,36,87
16,1,2,16,16,32
1,1,2,1,1,2
22,1,2,22,22,44
19,11,29,270,209,479
11,11,29,157,121,278
14,2,5,41,28,69
5,1,2,4,5,9
19,1,2,14,19,33
26,8,21,327,208,535
6,8,21,75,48,123
4,1,4,11,4,15
30,1,4,85,30,115
1,461,742,185,461,646
1,1482,2384,878,1482,2360
1,1482,2384,378,1482,1860
1,1482,2384,854,1482,2336
1,461,742,162,461,623
9,24,64,320,216,536
21,24,64,813,504,1317
5,45,120,267,225,492
25,3,9,141,75,216
17,3,9,96,51,147
2,2,5,4,4,8
5,2,5,11,10,21
13,2,5,38,26,64
5,3,9,29,15,44
31,3,9,180,93,273
26,3,9,147,78,225
1,3,9,6,3,9
21,2,5,48,42,90
24,2,5,53,48,101
19,2,5,42,38,80
11,4,10,64,44,108
26,2,5,60,52,112
27,2,5,59,54,113
1,2,5,2,2,4
10,2,5,29,20,49
9,2,5,26,18,44
2,3,9,12,6,18
6,3,9,35,18,53
17,2,5,40,34,74
14,2,5,33,28,61
1,2,5,2,2,4
10,3,9,56,30,86
14,3,9,56,42,98
3,3,9,12,9,21
21,2,5,49,42,91
1,2,5,2,2,4
4,7,9,8,28,36
23,7,9,13,161,174
32,7,9,12,224,236
25,7,9,41,175,216
20,7,9,17,140,157
24,7,9,44,168,212
10,7,9,0,70,70
23,7,9,38,161,199
24,3,8,95,72,167
24,8,22,220,192,412
30,8,22,413,240,653
21,8,22,220,168,388
12,8,22,163,96,259
22,8,22,202,176,378
22,8,22,245,176,421
28,8,22,281,224,505
22,9,24,325,198,523
18,9,24,179,162,341
2,9,24,21,18,39
14,9,24,166,126,292
18,9,24,261,162,423
11,13,35,157,143,300
1,13,35,21,13,34
17,13,35,249,221,470
19,13,35,405,247,652
11,13,35,227,143,370
4,13,35,63,52,115
23,13,35,474,299,773
11,13,35,173,143,316
1,13,35,17,13,30
9,13,35,195,117,312
9,13,35,185,117,302
28,13,35,400,364,764
18,13,35,371,234,605
17,13,35,291,221,512
25,13,35,410,325,735
3,13,35,61,39,100
1,13,35,21,13,34
25,42,54,3,1050,1053
15,38,50,165,570,735
8,38,50,24,304,328
23,38,50,23,874,897
2,38,50,23,76,99
13,42,54,58,546,604
14,38,50,56,532,588
29,38,50,87,1102,1189
28,38,50,280,1064,1344
30,38,50,90,1140,1230
25,42,54,3,1050,1053
1,1252,2295,630,1252,1882
1,1266,2320,1008,1266,2274
1,420,769,318,420,738
3,308,565,466,924,1390
3,1266,2320,2884,3798,6682
1,1252,2295,997,1252,2249
3,1083,1701,1038,3249,4287
3,344,540,556,1032,1588
1,713,1120,362,713,1075
1,1555,2443,351,1555,1906
1,1555,2443,546,1555,2101
3,1083,1701,782,3249,4031
2,713,1120,523,1426,1949
3,2171,3578,1860,6513,8373
1,2171,3578,1335,2171,3506
1,344,540,174,344,518
8,26,70,346,208,554
2,26,70,57,52,109
1,3,9,4,3,7
24,3,9,96,72,168
30,3,9,121,90,211
16,8,21,201,128,329
28,8,21,352,224,576
23,1,2,22,23,45
5,1,2,5,5,10
30,1,4,64,30,94
17,1,4,36,17,53
8,1,4,17,8,25
6,2,5,11,12,23
4,2,5,8,8,16
26,13,35,554,338,892
11,11,29,185,121,306
8,11,29,135,88,223
1,2,5,3,2,5
24,2,5,67,48,115
18,2,5,50,36,86
32,1,2,19,32,51
17,1,2,10,17,27
17,1,2,10,17,27
4,1,2,3,4,7
5,1,2,3,5,8
1,1,2,1,1,2
12,1,2,8,12,20
23,1,2,15,23,38
28,1,2,24,28,52
13,1,2,10,13,23
21,1,2,16,21,37
12,2,5,35,24,59
21,1,2,13,21,34
11,1,2,7,11,18
28,2,5,81,56,137
11,12,33,184,132,316
27,12,33,451,324,775
23,2,5,68,46,114
9,2,5,27,18,45
20,1,2,13,20,33
22,1,2,14,22,36
6,1,2,4,6,10
11,1,2,11,11,22
14,1,2,14,14,28
13,1,2,13,13,26
2,1,2,2,2,4
29,11,30,534,319,853
1,11,30,18,11,29
15,1,4,35,15,50
9,1,2,8,9,17
4,9,25,60,36,96
15,9,25,225,135,360
22,9,25,330,198,528
19,8,21,163,152,315
28,8,21,241,224,465
24,1,2,15,24,39
13,1,2,12,13,25
23,1,2,21,23,44
8,1,2,7,8,15
31,8,21,286,248,534
30,1,4,73,30,103
4,1,4,10,4,14
2,461,742,250,922,1172
1,1482,2384,807,1482,2289
1,1482,2384,473,1482,1955
2,1482,2384,1756,2964,4720
1,1482,2384,807,1482,2289
1,1482,2384,473,1482,1955
1,1482,2384,807,1482,2289
1,1482,2384,473,1482,1955
1,1482,2384,473,1482,1955
17,24,64,528,408,936
7,24,64,271,168,439
3,59,159,214,177,391
19,4,10,112,76,188
15,4,10,89,60,149
15,3,9,66,45,111
27,3,9,118,81,199
2,2,5,4,4,8
3,4,10,14,12,26
1,4,10,5,4,9
4,2,5,11,8,19
24,2,5,67,48,115
21,2,5,48,42,90
24,2,5,55,48,103
22,2,5,65,44,109
28,3,9,123,84,207
1,3,9,4,3,7
28,2,5,53,56,109
16,3,9,90,48,138
4,3,9,23,12,35
8,3,9,45,24,69
3,3,9,17,9,26
3,2,5,6,6,12
1,2,5,2,2,4
29,2,5,84,58,142
18,2,5,52,36,88
28,2,5,59,56,115
17,2,5,36,34,70
19,2,5,53,38,91
13,2,5,36,26,62
10,3,9,47,30,77
1,3,9,5,3,8
13,2,5,38,26,64
31,2,5,90,62,152
16,3,9,95,48,143
6,3,9,35,18,53
29,3,9,156,87,243
26,3,9,140,78,218
9,2,5,21,18,39
8,2,5,18,16,34
12,3,9,70,36,106
24,3,9,140,72,212
21,2,5,61,42,103
2,2,5,4,4,8
8,2,5,17,16,33
19,2,5,53,38,91
17,2,5,48,34,82
23,7,9,44,161,205
23,7,9,42,161,203
1,7,9,0,7,7
30,7,9,49,210,259
6,7,9,10,42,52
3,3,8,12,9,21
20,3,8,98,60,158
23,8,22,251,184,435
15,8,22,203,120,323
10,8,22,136,80,216
11,8,22,149,88,237
8,8,22,108,64,172
13,8,22,171,104,275
5,8,22,46,40,86
5,8,22,66,40,106
16,8,22,147,128,275
15,8,22,167,120,287
17,9,24,251,153,404
9,9,24,120,81,201
29,9,24,282,261,543
11,9,24,154,99,253
25,9,24,363,225,588
7,9,24,102,63,165
15,9,24,218,135,353
1,13,35,14,13,27
12,13,35,239,156,395
26,13,35,536,338,874
14,13,35,244,182,426
20,13,35,412,260,672
14,13,35,288,182,470
18,13,35,371,234,605
3,13,35,47,39,86
8,13,35,170,104,274
24,13,35,494,312,806
21,13,35,455,273,728
16,13,35,330,208,538
14,13,35,298,182,480
23,13,35,490,299,789
27,13,35,424,351,775
1,13,35,21,13,34
9,13,35,176,117,293
6,21,55,131,126,257
19,21,55,604,399,1003
19,38,50,209,722,931
15,42,54,123,630,753
10,38,50,100,380,480
1,38,50,3,38,41
17,42,54,2,714,716
7,42,54,16,294,310
2,42,54,10,84,94
10,42,54,115,420,535
20,42,54,164,840,1004
3,1266,2320,1909,3798,5707
1,1252,2295,745,1252,1997
1,308,565,217,308,525
1,1266,2320,544,1266,1810
3,308,565,551,924,1475
2,420,769,636,840,1476
3,1266,2320,1631,3798,5429
1,420,769,211,420,631
2,1266,2320,1922,2532,4454
1,1266,2320,752,1266,2018
2,1266,2320,1922,2532,4454
3,295,540,703,885,1588
1,295,540,126,295,421
1,420,769,249,420,669
1,1266,2320,544,1266,1810
1,2171,3578,1335,2171,3506
1,2171,3578,1371,2171,3542
2,1555,2443,897,3110,4007
3,1555,2443,1345,4665,6010
1,1519,2443,826,1519,2345
1,2171,3578,942,2171,3113
3,713,1120,1154,2139,3293
1,344,540,185,344,529
1,1555,2443,790,1555,2345
1,1083,1701,499,1083,1582
2,344,540,381,688,1069
1,26,70,43,26,69
19,26,70,809,494,1303
1,26,70,29,26,55
3,26,70,86,78,164
1,26,70,35,26,61
22,3,9,88,66,154
19,2,5,40,38,78
19,1,2,14,19,33
12,1,2,7,12,19
8,1,2,4,8,12
23,13,35,458,299,757
24,13,35,478,312,790
14,1,2,10,14,24
12,1,2,9,12,21
4,12,33,79,48,127
19,12,33,374,228,602
3,1,2,3,3,6
23,1,2,22,23,45
29,2,5,68,58,126
15,2,5,35,30,65
8,2,5,24,16,40
7,2,5,20,14,34
21,2,5,59,42,101
17,11,30,313,187,500
16,1,2,15,16,31
5,1,2,3,5,8
31,1,2,20,31,51
15,2,5,32,30,62
4,2,5,8,8,16
13,2,5,27,26,53
3,2,5,9,6,15
4,2,5,12,8,20
16,1,4,45,16,61
19,1,4,54,19,73
26,9,25,403,234,637
19,9,25,295,171,466
9,11,30,160,99,259
27,2,5,78,54,132
3,2,5,9,6,15
11,2,5,32,22,54
13,1,2,7,13,20
19,1,2,11,19,30
10,1,2,6,10,16
29,1,2,28,29,57
4,1,2,4,4,8
29,1,2,28,29,57
17,1,2,17,17,34
26,1,2,25,26,51
10,2,5,21,20,41
10,2,5,21,20,41
8,1,2,7,8,15
6,1,2,3,6,9
11,1,2,6,11,17
1,2,5,3,2,5
11,2,5,32,22,54
4,2,5,12,8,20
12,2,5,34,24,58
16,2,5,45,32,77
10,2,5,24,20,44
16,2,5,38,32,70
17,8,21,214,136,350
29,8,21,365,232,597
9,8,21,113,72,185
2,9,25,31,18,49
3,9,25,47,27,74
27,9,25,311,243,554
27,9,25,311,243,554
1,1482,2384,473,1482,1955
2,1482,2384,1518,2964,4482
3,461,742,754,1383,2137
3,1482,2384,2420,4446,6866
3,1482,2384,1419,4446,5865
1,755,1215,375,755,1130
3,461,742,598,1383,1981
1,461,742,147,461,608
11,24,64,341,264,605
4,24,64,104,96,200
9,24,64,348,216,564
6,45,120,421,270,691
1,45,120,74,45,119
1,59,159,79,59,138
27,4,10,159,108,267
24,4,10,142,96,238
3,2,5,6,6,12
4,2,5,8,8,16
15,2,5,44,30,74
12,2,5,35,24,59
15,3,9,68,45,113
7,3,9,32,21,53
23,2,5,61,46,107
23,2,5,61,46,107
12,3,9,49,36,85
26,3,9,107,78,185
19,3,9,111,57,168
20,3,9,116,60,176
24,3,9,140,72,212
1,3,9,6,3,9
25,4,10,95,100,195
21,4,10,80,84,164
10,2,5,24,20,44
27,2,5,63,54,117
24,2,5,56,48,104
19,2,5,45,38,83
18,2,5,48,36,84
13,2,5,34,26,60
19,2,5,56,38,94
22,3,9,90,66,156
3,3,9,12,9,21
20,2,5,59,40,99
17,7,9,32,119,151
4,7,9,8,28,36
2,7,9,3,14,17
23,7,9,32,161,193
22,7,9,2,154,156
1,3,8,5,3,8
6,3,8,28,18,46
4,8,22,54,32,86
16,8,22,217,128,345
25,8,22,312,200,512
18,9,24,179,162,341
26,9,24,259,234,493
25,9,24,243,225,468
13,9,24,173,117,290
25,9,24,363,225,588
1,13,35,16,13,29
15,13,35,325,195,520
9,13,35,157,117,274
11,13,35,227,143,370
8,13,35,173,104,277
11,13,35,157,143,300
9,13,35,157,117,274
4,13,35,78,52,130
12,13,35,176,156,332
19,13,35,298,247,545
14,13,35,298,182,480
2,13,35,31,26,57
26,13,35,536,338,874
10,13,35,147,130,277
2,13,35,29,26,55
28,13,35,459,364,823
5,13,35,107,65,172
19,13,35,278,247,525
6,21,55,201,126,327
5,21,55,165,105,270
23,38,50,230,874,1104
6,42,54,20,252,272
6,42,54,30,252,282
15,42,54,10,630,640
1,38,50,2,38,40
1,38,50,9,38,47
13,38,50,143,494,637
29,42,54,317,1218,1535
1,1252,2295,1020,1252,2272
1,1252,2295,1020,1252,2272
1,1266,2320,752,1266,2018
2,1252,2295,1765,2504,4269
1,1252,2295,997,1252,2249
3,420,769,747,1260,2007
1,1266,2320,636,1266,1902
1,308,565,217,308,525
1,1252,2295,630,1252,1882
1,308,565,246,308,554
3,1555,2443,2371,4665,7036
1,2171,3578,942,2171,3113
1,1555,2443,717,1555,2272
1,487,783,155,487,642
1,487,783,265,487,752
1,713,1120,161,713,874
1,344,540,185,344,529
1,344,540,174,344,518
1,1083,1701,397,1083,1480
1,487,783,171,487,658
1,2171,3578,1335,2171,3506
12,26,70,511,312,823
31,26,70,1321,806,2127
18,3,9,79,54,133
1,3,9,6,3,9
26,9,25,280,234,514
20,9,25,215,180,395
26,1,2,18,26,44
19,1,2,13,19,32
3,8,21,38,24,62
29,1,2,16,29,45
11,1,2,11,11,22
18,1,2,10,18,28
3,2,5,7,6,13
3,2,5,7,6,13
14,2,5,41,28,69
20,2,5,59,40,99
31,2,5,91,62,153
5,2,5,11,10,21
26,1,2,25,26,51
6,1,2,6,6,12
13,1,2,12,13,25
2,2,5,6,4,10
12,1,2,11,12,23
16,11,30,285,176,461
18,11,30,320,198,518
10,11,30,178,110,288
26,1,2,25,26,51
7,1,2,7,7,14
15,1,2,15,15,30
16,1,2,11,16,27
7,1,2,5,7,12
11,1,2,11,11,22
12,1,2,12,12,24
23,11,30,423,253,676
29,2,5,84,58,142
12,11,30,149,132,281
15,11,30,186,165,351
17,11,30,211,187,398
22,11,29,313,242,555
1,11,29,14,11,25
26,1,2,24,26,50
6,1,2,6,6,12
1,1,2,1,1,2
5,1,4,15,5,20
9,1,4,26,9,35
6,1,2,6,6,12
4,1,2,4,4,8
16,9,25,204,144,348
20,9,25,255,180,435
24,2,5,56,48,104
26,2,5,61,52,113
15,2,5,44,30,74
8,2,5,23,16,39
1,1482,2384,401,1482,1883
3,1482,2384,1776,4446,6222
3,755,1215,615,2265,2880
2,1482,2384,1756,2964,4720
1,1482,2384,401,1482,1883
3,755,1215,578,2265,2843
3,1482,2384,1204,4446,5650
19,24,64,711,456,1167
7,59,159,678,413,1091
6,4,10,34,24,58
24,4,10,134,96,230
1,2,5,3,2,5
20,2,5,38,40,78
19,2,5,36,38,74
21,2,5,61,42,103
21,2,5,61,42,103
3,2,5,9,6,15
17,3,9,70,51,121
4,3,9,16,12,28
18,2,5,52,36,88
21,4,10,80,84,164
7,4,10,27,28,55
10,2,5,24,20,44
27,2,5,63,54,117
4,2,5,9,8,17
17,2,5,40,34,74
25,2,5,59,50,109
10,2,5,29,20,49
13,2,5,25,26,51
20,7,9,36,140,176
14,7,9,2,98,100
6,7,9,11,42,53
7,7,9,6,49,55
26,7,9,36,182,218
7,7,9,13,49,62
4,7,9,2,28,30
24,3,8,118,72,190
11,8,22,123,88,211
21,9,24,305,189,494
12,9,24,177,108,285
26,13,35,381,338,719
4,13,35,85,52,137
16,13,35,341,208,549
28,13,35,596,364,960
32,13,35,558,416,974
10,13,35,213,130,343
20,13,35,426,260,686
8,13,35,140,104,244
26,13,35,454,338,792
15,13,35,320,195,515
13,13,35,277,169,446
20,13,35,314,260,574
1,13,35,14,13,27
21,13,35,433,273,706
4,13,35,63,52,115
5,13,35,72,65,137
24,13,35,410,312,722
30,21,55,1004,630,1634
13,38,50,150,494,644
10,38,50,10,380,390
18,38,50,198,684,882
11,42,54,120,462,582
1,1266,2320,1031,1266,2297
1,1252,2295,538,1252,1790
3,420,769,1024,1260,2284
1,420,769,318,420,738
1,308,565,234,308,542
1,1555,2443,839,1555,2394
3,713,1120,616,2139,2755
1,1555,2443,570,1555,2125
2,713,1120,456,1426,1882
1,2171,3578,1335,2171,3506
5,26,70,175,130,305
27,26,70,1169,702,1871
26,26,70,1126,676,1802
9,2,5,26,18,44
19,1,2,11,19,30
17,1,2,10,17,27
28,8,21,241,224,465
26,1,2,25,26,51
3,1,2,3,3,6
1,1,2,1,1,2
28,13,35,606,364,970
25,13,35,541,325,866
9,13,35,195,117,312
19,1,2,18,19,37
23,1,2,13,23,36
31,1,2,17,31,48
1,1,4,3,1,4
20,1,4,57,20,77
20,9,25,315,180,495
3,1,2,3,3,6
3,1,2,3,3,6
18,1,2,17,18,35
29,1,2,28,29,57
13,2,5,31,26,57
24,2,5,56,48,104
25,1,2,23,25,48
1,1,2,1,1,2
5,1,2,5,5,10
27,1,2,26,27,53
28,1,2,27,28,55
28,2,5,83,56,139
23,2,5,68,46,114
13,1,4,32,13,45
29,1,2,16,29,45
7,1,2,4,7,11
11,2,5,32,22,54
22,2,5,64,44,108
8,2,5,23,16,39
26,11,30,478,286,764
6,11,29,105,66,171
10,11,29,174,110,284
2,8,21,18,16,34
9,8,21,83,72,155
18,8,21,166,144,310
14,2,5,41,28,69
10,2,5,30,20,50
16,2,5,38,32,70
5,2,5,12,10,22
1,1482,2384,878,1482,2360
2,461,742,354,922,1276
3,1482,2384,2563,4446,7009
1,461,742,266,461,727
2,461,742,295,922,1217
19,24,64,748,456,1204
6,24,64,232,144,376
4,45,120,199,180,379
4,2,5,8,8,16
14,2,5,29,28,57
29,2,5,86,58,144
19,2,5,45,38,83
3,2,5,7,6,13
27,4,10,157,108,265
12,4,10,70,48,118
3,4,10,17,12,29
13,4,10,75,52,127
1,2,5,3,2,5
19,2,5,45,38,83
30,2,5,71,60,131
22,2,5,65,44,109
15,3,9,68,45,113
21,3,9,96,63,159
1,2,5,2,2,4
12,3,9,57,36,93
10,3,9,47,30,77
15,2,5,44,30,74
2,2,5,6,4,10
15,2,5,42,30,72
9,2,5,25,18,43
13,2,5,31,26,57
27,2,5,63,54,117
28,7,9,23,196,219
15,7,9,21,105,126
14,7,9,0,98,98
10,7,9,18,70,88
24,7,9,44,168,212
8,7,9,6,56,62
3,7,9,6,21,27
25,3,8,99,75,174
23,8,22,216,184,400
14,8,22,190,112,302
14,8,22,190,112,302
19,8,22,237,152,389
2,8,22,28,16,44
18,9,24,261,162,423
18,9,24,214,162,376
15,9,24,178,135,313
10,9,24,145,90,235
1,9,24,15,9,24
20,13,35,426,260,686
25,13,35,366,325,691
16,13,35,346,208,554
17,13,35,350,221,571
16,13,35,341,208,549
22,13,35,345,286,631
23,13,35,329,299,628
26,13,35,508,338,846
23,13,35,498,299,797
21,13,35,433,273,706
21,13,35,366,273,639
4,13,35,85,52,137
4,13,35,78,52,130
18,13,35,314,234,548
5,13,35,107,65,172
23,13,35,474,299,773
12,13,35,260,156,416
25,13,35,445,325,770
1,13,35,17,13,30
27,13,35,471,351,822
30,13,35,639,390,1029
26,13,35,454,338,792
1,21,55,25,21,46
10,21,55,335,210,545
1,21,55,26,21,47
7,42,54,76,294,370
4,38,50,44,152,196
3,38,50,9,114,123
5,38,50,58,190,248
5,38,50,50,190,240
28,42,54,276,1176,1452
4,42,54,13,168,181
17,38,50,51,646,697
20,38,50,30,760,790
1,1898,3375,937,1898,2835
3,1912,3400,2832,5736,8568
1,1252,2295,561,1252,1813
3,1252,2295,2854,3756,6610
1,420,769,295,420,715
1,1266,2320,961,1266,2227
1,1266,2320,1008,1266,2274
1,1266,2320,961,1266,2227
1,1555,2443,839,1555,2394
2,1083,1701,488,2166,2654
2,2171,3578,1311,4342,5653
1,713,1120,161,713,874
1,344,540,191,344,535
1,344,540,131,344,475
1,1083,1701,312,1083,1395
1,487,783,132,487,619
1,344,540,110,344,454
12,26,70,343,312,655
16,26,70,682,416,1098
14,1,2,14,14,28
1,1,2,1,1,2
17,1,2,17,17,34
31,1,2,30,31,61
10,2,5,30,20,50
32,2,5,94,64,158
4,1,2,4,4,8
8,1,2,8,8,16
17,1,2,15,17,32
26,1,2,19,26,45
21,2,5,61,42,103
24,13,35,511,312,823
3,13,35,64,39,103
5,2,5,10,10,20
9,1,4,24,9,33
15,1,4,41,15,56
24,1,4,65,24,89
26,2,5,73,52,125
19,1,2,17,19,36
3,2,5,7,6,13
19,2,5,45,38,83
19,2,5,45,38,83
2,9,25,29,18,47
11,9,25,157,99,256
10,2,5,28,20,48
15,1,2,14,15,29
10,8,21,126,80,206
24,1,2,24,24,48
6,1,4,14,6,20
27,8,21,232,216,448
24,1,2,13,24,37
13,1,2,7,13,20
1,2,5,2,2,4
20,2,5,49,40,89
17,2,5,42,34,76
7,1,2,5,7,12
20,1,2,15,20,35
1,1,2,1,1,2
17,1,2,9,17,26
10,1,4,25,10,35
1,1,4,2,1,3
14,11,29,224,154,378
25,11,29,399,275,674
7,2,5,15,14,29
31,2,5,65,62,127
1,1482,2384,592,1482,2074
1,461,742,229,461,690
3,1482,2384,1419,4446,5865
2,1482,2384,1470,2964,4434
1,461,742,251,461,712
1,1482,2384,473,1482,1955
3,461,742,442,1383,1825
1,1482,2384,854,1482,2336
2,1482,2384,1709,2964,4673
1,461,742,274,461,735
3,1482,2384,1776,4446,6222
3,461,742,554,1383,1937
17,24,64,636,408,1044
17,24,64,506,408,914
13,45,120,632,585,1217
11,59,159,1065,649,1714
8,59,159,596,472,1068
2,4,10,7,8,15
14,3,9,68,42,110
29,3,9,140,87,227
16,4,10,61,64,125
1,4,10,4,4,8
16,3,9,93,48,141
11,3,9,64,33,97
28,2,5,81,56,137
3,2,5,6,6,12
4,2,5,9,8,17
10,2,5,24,20,44
1,4,10,4,4,8
13,4,10,49,52,101
24,3,9,96,72,168
27,2,5,80,54,134
11,2,5,31,22,53
6,2,5,17,12,29
17,2,5,33,34,67
12,7,9,23,84,107
23,7,9,44,161,205
7,7,9,0,49,49
1,7,9,0,7,7
11,7,9,18,77,95
20,7,9,0,140,140
16,7,9,0,112,112
5,3,8,24,15,39
23,3,8,75,69,144
27,8,22,301,216,517
5,8,22,68,40,108
15,8,22,151,120,271
16,9,24,236,144,380
3,9,24,36,27,63
23,9,24,273,207,480
22,9,24,214,198,412
20,9,24,290,180,470
26,9,24,378,234,612
3,13,35,41,39,80
15,13,35,293,195,488
23,13,35,337,299,636
3,13,35,64,39,103
15,13,35,220,195,415
16,13,35,279,208,487
19,13,35,411,247,658
26,13,35,372,338,710
11,13,35,157,143,300
20,13,35,314,260,574
5,13,35,72,65,137
27,13,35,471,351,822
25,13,35,533,325,858
27,13,35,471,351,822
23,13,35,498,299,797
11,13,35,161,143,304
20,13,35,426,260,686
21,13,35,411,273,684
11,13,35,184,143,327
20,13,35,412,260,672
27,13,35,575,351,926
13,13,35,254,169,423
20,13,35,433,260,693
22,13,35,453,286,739
10,21,55,269,210,479
28,21,55,921,588,1509
10,21,55,318,210,528
26,38,50,286,988,1274
30,38,50,345,1140,1485
2,38,50,11,76,87
5,38,50,8,190,198
28,42,54,321,1176,1497
28,38,50,154,1064,1218
29,38,50,319,1102,1421
9,38,50,90,342,432
28,42,54,64,1176,1240
1,1252,2295,630,1252,1882
1,1266,2320,497,1266,1763
1,1266,2320,961,1266,2227
1,1252,2295,745,1252,1997
1,1266,2320,567,1266,1833
1,1252,2295,997,1252,2249
3,1266,2320,3023,3798,6821
1,1266,2320,752,1266,2018
1,1252,2295,630,1252,1882
1,713,1120,205,713,918
1,2171,3578,1264,2171,3435
1,713,1120,385,713,1098
2,713,1120,523,1426,1949
2,487,783,529,974,1503
1,1555,2443,497,1555,2052
1,1555,2443,570,1555,2125
1,344,540,174,344,518
1,344,540,158,344,502
1,344,540,164,344,508
1,344,540,83,344,427
3,487,783,395,1461,1856
3,344,540,377,1032,1409
1,344,540,174,344,518
1,2171,3578,620,2171,2791
18,26,70,779,468,1247
11,26,70,469,286,755
8,26,70,341,208,549
20,26,70,572,520,1092
9,26,70,257,234,491
30,3,9,145,90,235
11,3,9,65,33,98
2,3,9,8,6,14
11,1,2,6,11,17
12,11,29,160,132,292
25,11,29,334,275,609
6,11,29,80,66,146
19,1,2,14,19,33
9,1,2,7,9,16
7,2,5,20,14,34
19,2,5,53,38,91
4,9,25,43,36,79
31,9,25,333,279,612
8,9,25,86,72,158
14,1,2,13,14,27
14,12,33,289,168,457
18,2,5,34,36,70
13,2,5,31,26,57
23,2,5,54,46,100
11,2,5,26,22,48
9,9,25,142,81,223
25,9,25,394,225,619
14,1,2,13,14,27
6,2,5,16,12,28
3,2,5,8,6,14
7,2,5,16,14,30
7,8,21,82,56,138
15,8,21,176,120,296
6,8,21,70,48,118
15,1,4,41,15,56
15,1,4,41,15,56
2,1,4,5,2,7
24,1,4,58,24,82
13,1,2,12,13,25
4,1,2,4,4,8
14,11,29,199,154,353
5,1,4,11,5,16
8,1,4,18,8,26
8,2,5,16,16,32
31,2,5,60,62,122
7,2,5,13,14,27
23,2,5,44,46,90
12,9,25,153,108,261
11,9,25,140,99,239
19,1,2,18,19,37
6,1,2,6,6,12
21,1,4,60,21,81
17,1,4,48,17,65
4,2,5,9,8,17
18,2,5,42,36,78
11,9,25,171,99,270
12,9,25,186,108,294
16,1,4,47,16,63
1,1,4,3,1,4
3,1482,2384,1204,4446,5650
1,461,742,274,461,735
1,1482,2384,330,1482,1812
1,461,742,229,461,690
1,1482,2384,378,1482,1860
1,461,742,118,461,579
17,24,64,636,408,1044
24,24,64,929,576,1505
13,24,64,370,312,682
4,45,120,199,180,379
1,59,159,89,59,148
10,2,5,21,20,41
3,2,5,6,6,12
1,4,10,4,4,8
21,4,10,76,84,160
1,2,5,3,2,5
24,2,5,67,48,115
11,4,10,52,44,96
17,4,10,80,68,148
18,2,5,52,36,88
15,2,5,44,30,74
7,2,5,21,14,35
1,2,5,3,2,5
21,2,5,62,42,104
19,2,5,56,38,94
20,2,5,38,40,78
24,2,5,46,48,94
12,2,5,23,24,47
26,2,5,49,52,101
24,3,9,109,72,181
25,3,9,114,75,189
24,2,5,70,48,118
5,2,5,15,10,25
9,2,5,26,18,44
1,2,5,3,2,5
10,2,5,28,20,48
9,2,5,25,18,43
7,2,5,20,14,34
28,2,5,81,56,137
6,7,9,2,42,44
27,3,8,133,81,214
25,3,8,117,75,192
7,8,22,73,56,129
25,8,22,273,200,473
1,8,22,11,8,19
15,9,24,146,135,281
1,9,24,11,9,20
1,9,24,11,9,20
6,9,24,60,54,114
9,9,24,105,81,186
11,9,24,107,99,206
3,9,24,42,27,69
14,9,24,150,126,276
11,9,24,131,99,230
28,13,35,577,364,941
18,13,35,371,234,605
8,13,35,173,104,277
6,13,35,130,78,208
22,13,35,453,286,739
1,13,35,17,13,30
13,13,35,277,169,446
24,13,35,394,312,706
9,13,35,129,117,246
16,13,35,229,208,437
30,13,35,618,390,1008
15,13,35,320,195,515
24,13,35,394,312,706
10,13,35,164,130,294
7,13,35,115,91,206
25,13,35,340,325,665
8,13,35,170,104,274
20,13,35,433,260,693
4,13,35,57,52,109
6,13,35,86,78,164
23,13,35,490,299,789
10,13,35,157,130,287
22,13,35,453,286,739
2,42,54,23,84,107
30,38,50,345,1140,1485
4,42,54,18,168,186
4,42,54,46,168,214
7,38,50,70,266,336
1,42,54,10,42,52
28,38,50,84,1064,1148
3,1912,3400,2832,5736,8568
2,1252,2295,984,2504,3488
3,1252,2295,2165,3756,5921
1,1252,2295,561,1252,1813
1,1252,2295,997,1252,2249
1,420,769,318,420,738
1,1252,2295,745,1252,1997
1,1266,2320,1008,1266,2274
1,1252,2295,676,1252,1928
1,1266,2320,544,1266,1810
2,1266,2320,2062,2532,4594
3,2171,3578,2718,6513,9231
1,2171,3578,1264,2171,3435
1,1555,2443,864,1555,2419
1,1555,2443,717,1555,2272
1,1083,1701,550,1083,1633
2,344,540,349,688,1037
2,487,783,388,974,1362
1,487,783,171,487,658
1,2171,3578,1335,2171,3506
3,2171,3578,4006,6513,10519
2,2171,3578,2671,4342,7013
27,26,70,791,702,1493
13,3,9,77,39,116
27,3,9,157,81,238
21,1,2,12,21,33
20,1,2,18,20,38
4,9,25,43,36,79
31,9,25,333,279,612
9,1,2,7,9,16
9,1,2,9,9,18
18,13,35,383,234,617
29,13,35,618,377,995
15,1,4,41,15,56
8,1,4,22,8,30
17,1,4,50,17,67
1,9,25,13,9,22
6,9,25,75,54,129
5,2,5,15,10,25
1,2,5,3,2,5
27,2,5,76,54,130
18,2,5,50,36,86
21,1,2,12,21,33
25,1,2,24,25,49
6,1,2,6,6,12
6,13,35,94,78,172
10,13,35,157,130,287
24,1,2,13,24,37
5,1,2,3,5,8
28,1,2,19,28,47
5,1,2,3,5,8
7,11,29,118,77,195
7,11,29,118,77,195
26,9,25,390,234,624
24,9,25,360,216,576
13,1,4,30,13,43
1,1,4,2,1,3
1,12,33,16,12,28
4,1,2,3,4,7
19,1,2,13,19,32
21,2,5,46,42,88
26,2,5,57,52,109
13,1,4,31,13,44
18,1,4,42,18,60
8,1,4,19,8,27
6,1,2,3,6,9
19,1,2,11,19,30
1,2,5,3,2,5
30,2,5,84,60,144
4,2,5,12,8,20
24,2,5,70,48,118
24,2,5,70,48,118
8,1,2,4,8,12
13,1,2,7,13,20
26,11,30,322,286,608
25,12,33,344,300,644
20,12,33,275,240,515
28,1,4,82,28,110
4,1,4,12,4,16
25,12,33,344,300,644
32,2,5,93,64,157
3,2,5,9,6,15
3,2,5,6,6,12
5,2,5,11,10,21
14,2,5,29,28,57
1,1482,2384,473,1482,1955
2,1482,2384,1613,2964,4577
1,1482,2384,807,1482,2289
8,59,159,635,472,1107
7,2,5,16,14,30
30,2,5,62,60,122
14,2,5,29,28,57
18,2,5,53,36,89
20,2,5,58,40,98
13,4,10,60,52,112
18,4,10,83,72,155
26,3,9,140,78,218
3,3,9,16,9,25
30,2,5,84,60,144
2,2,5,6,4,10
9,4,10,48,36,84
18,4,10,101,72,173
18,2,5,42,36,78
28,2,5,66,56,122
15,3,9,87,45,132
1,3,9,6,3,9
1,2,5,2,2,4
9,2,5,27,18,45
25,2,5,74,50,124
10,2,5,30,20,50
16,2,5,42,32,74
19,2,5,50,38,88
30,2,5,71,60,131
1,2,5,2,2,4
26,2,5,75,52,127
15,2,5,44,30,74
30,3,9,169,90,259
10,2,5,20,20,40
14,2,5,27,28,55
4,2,5,12,8,20
16,2,5,46,32,78
1,2,5,2,2,4
1,2,5,2,2,4
25,7,9,48,175,223
12,7,9,22,84,106
1,7,9,2,7,9
2,7,9,4,14,18
21,7,9,38,147,185
21,7,9,17,147,164
13,7,9,18,91,109
2,3,8,10,6,16
31,3,8,150,93,243
9,3,8,32,27,59
25,3,8,117,75,192
13,3,8,63,39,102
6,8,22,60,48,108
1,8,22,9,8,17
1,8,22,12,8,20
2,8,22,19,16,35
8,9,24,118,72,190
21,9,24,209,189,398
1,9,24,10,9,19
17,9,24,251,153,404
3,9,24,36,27,63
3,9,24,36,27,63
8,9,24,93,72,165
21,9,24,305,189,494
13,13,35,277,169,446
10,13,35,213,130,343
1,13,35,17,13,30
23,13,35,353,299,652
12,13,35,176,156,332
26,13,35,381,338,719
22,13,35,338,286,624
1,13,35,22,13,35
21,13,35,300,273,573
4,13,35,70,52,122
3,13,35,54,39,93
23,13,35,498,299,797
18,13,35,257,234,491
14,13,35,244,182,426
22,13,35,453,286,739
19,13,35,371,247,618
9,13,35,157,117,274
23,13,35,450,299,749
3,13,35,52,39,91
10,13,35,143,130,273
6,13,35,98,78,176
14,13,35,200,182,382
26,13,35,536,338,874
14,21,55,445,294,739
5,21,55,165,105,270
14,21,55,353,294,647
13,38,50,65,494,559
15,42,54,10,630,640
22,38,50,253,836,1089
4,42,54,20,168,188
4,38,50,26,152,178
22,38,50,22,836,858
24,42,54,120,1008,1128
12,38,50,120,456,576
1,1266,2320,567,1266,1833
3,1266,2320,2884,3798,6682
1,295,540,234,295,529
1,1266,2320,961,1266,2227
1,1912,3400,1420,1912,3332
1,1519,2443,387,1519,1906
2,1519,2443,1066,3038,4104
1,1555,2443,717,1555,2272
2,487,783,420,974,1394
1,713,1120,385,713,1098
1,713,1120,385,713,1098
1,713,1120,161,713,874
1,487,783,265,487,752
1,1555,2443,570,1555,2125
1,2171,3578,1335,2171,3506
3,713,1120,986,2139,3125
1,1555,2443,570,1555,2125
1,1555,2443,570,1555,2125
1,713,1120,329,713,1042
2,713,1120,344,1426,1770
1,713,1120,261,713,974
1,2171,3578,1335,2171,3506
29,26,70,1235,754,1989
7,26,70,303,182,485
4,3,9,23,12,35
2,8,21,17,16,33
10,13,35,213,130,343
14,13,35,298,182,480
21,2,5,40,42,82
30,2,5,57,60,117
11,2,5,21,22,43
2,1,2,1,2,3
5,1,2,3,5,8
24,1,2,24,24,48
1,1,2,1,1,2
3,1,2,3,3,6
6,1,2,3,6,9
32,1,4,95,32,127
11,1,4,33,11,44
20,1,2,12,20,32
3,1,2,2,3,5
5,2,5,15,10,25
15,2,5,44,30,74
23,1,2,20,23,43
20,2,5,42,40,82
9,2,5,19,18,37
22,1,4,55,22,77
26,2,5,61,52,113
5,2,5,12,10,22
11,1,2,10,11,21
25,2,5,53,50,103
7,13,35,115,91,206
7,13,35,115,91,206
28,1,2,27,28,55
26,2,5,49,52,101
20,2,5,38,40,78
3,2,5,8,6,14
13,2,5,36,26,62
21,2,5,59,42,101
31,1,2,21,31,52
21,1,2,14,21,35
22,1,4,50,22,72
8,1,2,8,8,16
11,1,2,11,11,22
9,1,4,26,9,35
30,1,4,85,30,115
4,1,2,3,4,7
17,1,2,13,17,30
15,1,4,43,15,58
10,1,4,28,10,38
11,9,25,171,99,270
21,1,2,12,21,33
2,461,742,295,922,1217
8,4,10,31,32,63
11,4,10,43,44,87
17,2,5,50,34,84
16,2,5,30,32,62
19,2,5,36,38,74
12,2,5,34,24,58
3,2,5,8,6,14
26,2,5,61,52,113
5,2,5,12,10,22
13,2,5,38,26,64
22,2,5,64,44,108
14,2,5,41,28,69
19,2,5,56,38,94
7,2,5,16,14,30
18,7,9,2,126,128
6,7,9,11,42,53
13,7,9,24,91,115
28,3,8,136,84,220
8,8,22,108,64,172
15,8,22,207,120,327
1,8,22,11,8,19
19,8,22,174,152,326
22,8,22,303,176,479
8,9,24,80,72,152
16,9,24,236,144,380
27,9,24,249,243,492
24,9,24,337,216,553
2,13,35,29,26,55
13,13,35,277,169,446
11,13,35,238,143,381
3,13,35,59,39,98
17,13,35,243,221,464
18,13,35,257,234,491
24,13,35,494,312,806
9,13,35,148,117,265
6,13,35,86,78,164
25,13,35,358,325,683
25,13,35,515,325,840
16,13,35,229,208,437
1,13,35,21,13,34
24,13,35,419,312,731
8,21,55,268,168,436
10,21,55,335,210,545
5,21,55,159,105,264
11,38,50,110,418,528
13,42,54,65,546,611
8,42,54,92,336,428
18,38,50,198,684,882
13,38,50,143,494,637
3,42,54,15,126,141
27,38,50,297,1026,1323
28,38,50,308,1064,1372
22,38,50,242,836,1078
1,1912,3400,1046,1912,2958
1,1912,3400,1046,1912,2958
3,1266,2320,3023,3798,6821
1,420,769,341,420,761
3,1266,2320,3092,3798,6890
1,1252,2295,745,1252,1997
2,1252,2295,1260,2504,3764
1,1252,2295,997,1252,2249
2,308,565,311,616,927
2,1266,2320,994,2532,3526
1,1266,2320,1008,1266,2274
1,308,565,246,308,554
1,1252,2295,951,1252,2203
1,1555,2443,717,1555,2272
2,2171,3578,1240,4342,5582
1,487,783,124,487,611
1,713,1120,385,713,1098
1,1555,2443,570,1555,2125
1,1555,2443,497,1555,2052
1,344,540,174,344,518
1,1083,1701,346,1083,1429
3,2171,3578,4114,6513,10627
1,487,783,171,487,658
1,487,783,194,487,681
1,713,1120,261,713,974
5,26,70,213,130,343
2,26,70,85,52,137
13,26,70,554,338,892
7,26,70,303,182,485
24,2,5,47,48,95
3,2,5,6,6,12
12,2,5,23,24,47
9,8,21,113,72,185
8,1,2,8,8,16
15,1,2,14,15,29
16,1,2,15,16,31
25,1,2,24,25,49
30,1,2,26,30,56
21,1,2,18,21,39
27,2,5,76,54,130
1,2,5,3,2,5
19,2,5,53,38,91
6,2,5,18,12,30
23,2,5,68,46,114
28,1,2,20,28,48
23,1,2,17,23,40
5,1,2,4,5,9
25,13,35,436,325,761
15,11,30,281,165,446
7,11,30,131,77,208
27,2,5,80,54,134
4,11,29,71,44,115
20,11,29,354,220,574
17,1,4,39,17,56
11,2,5,21,22,43
24,12,33,496,288,784
29,1,2,21,29,50
11,1,2,8,11,19
7,1,2,5,7,12
1,11,30,13,11,24
19,1,2,10,19,29
22,2,5,62,44,106
27,1,4,57,27,84
4,8,21,49,32,81
8,8,21,97,64,161
23,8,21,212,184,396
2,8,21,18,16,34
7,1,2,7,7,14
10,11,30,124,110,234
8,11,30,99,88,187
15,2,5,40,30,70
14,1,4,29,14,43
26,1,2,15,26,41
23,1,2,13,23,36
9,1,2,6,9,15
1,1,2,1,1,2
27,2,5,63,54,117
24,2,5,56,48,104
1,2,5,3,2,5
15,2,5,44,30,74
1,461,742,125,461,586
2,461,742,236,922,1158
1,1482,2384,807,1482,2289
1,461,742,229,461,690
2,1482,2384,755,2964,3719
1,1482,2384,854,1482,2336
3,461,742,376,1383,1759
2,461,742,532,922,1454
19,24,64,736,456,1192
8,24,64,315,192,507
1,45,120,73,45,118
3,45,120,178,135,313
7,45,120,517,315,832
6,59,159,400,354,754
19,4,10,80,76,156
14,4,10,59,56,115
14,4,10,66,56,122
25,4,10,118,100,218
27,2,5,51,54,105
27,2,5,76,54,130
24,2,5,67,48,115
17,4,10,65,68,133
24,4,10,91,96,187
5,3,9,24,15,39
6,3,9,29,18,47
30,4,10,174,120,294
11,4,10,64,44,108
27,2,5,62,54,116
1,2,5,3,2,5
10,3,9,59,30,89
8,3,9,47,24,71
19,2,5,45,38,83
2,2,5,5,4,9
19,2,5,45,38,83
25,2,5,59,50,109
5,2,5,12,10,22
7,2,5,16,14,30
1,7,9,0,7,7
1,7,9,2,7,9
2,7,9,2,14,16
5,7,9,8,35,43
31,7,9,59,217,276
26,7,9,10,182,192
22,7,9,40,154,194
8,7,9,13,56,69
6,7,9,0,42,42
1,3,8,4,3,7
16,3,8,63,48,111
17,8,22,231,136,367
16,8,22,150,128,278
11,8,22,149,88,237
1,8,22,10,8,18
4,8,22,54,32,86
10,8,22,136,80,216
18,8,22,248,144,392
20,9,24,194,180,374
32,9,24,380,288,668
17,9,24,202,153,355
25,9,24,297,225,522
15,13,35,236,195,431
13,13,35,277,169,446
30,13,35,471,390,861
20,13,35,286,260,546
1,13,35,15,13,28
18,13,35,390,234,624
12,13,35,172,156,328
27,13,35,424,351,775
20,13,35,426,260,686
13,13,35,277,169,446
17,13,35,362,221,583
18,13,35,283,234,517
18,13,35,390,234,624
21,13,35,330,273,603
30,13,35,618,390,1008
2,13,35,35,26,61
24,13,35,436,312,748
21,13,35,366,273,639
6,13,35,94,78,172
16,38,50,184,608,792
26,42,54,129,1092,1221
21,38,50,179,798,977
5,38,50,15,190,205
14,38,50,119,532,651
28,42,54,64,1176,1240
7,42,54,24,294,318
4,38,50,44,152,196
9,42,54,98,378,476
1,1252,2295,722,1252,1974
1,1266,2320,1008,1266,2274
1,1252,2295,630,1252,1882
1,1252,2295,630,1252,1882
1,1252,2295,1020,1252,2272
1,420,769,341,420,761
1,420,769,295,420,715
1,1266,2320,961,1266,2227
1,1266,2320,1031,1266,2297
3,1252,2295,1890,3756,5646
1,1266,2320,1008,1266,2274
2,2171,3578,1526,4342,5868
1,2171,3578,942,2171,3113
1,487,783,124,487,611
1,1083,1701,584,1083,1667
2,1083,1701,998,2166,3164
2,2171,3578,1311,4342,5653
1,487,783,155,487,642
1,344,540,174,344,518
1,1083,1701,397,1083,1480
1,713,1120,261,713,974
2,344,540,252,688,940
15,26,70,650,390,1040
28,3,9,165,84,249
18,3,9,79,54,133
6,3,9,32,18,50
16,3,9,93,48,141
27,1,2,20,27,47
21,1,2,16,21,37
3,1,2,3,3,6
2,13,35,43,26,69
23,13,35,498,299,797
1,13,35,22,13,35
2,9,25,22,18,40
28,9,25,301,252,553
10,9,25,108,90,198
15,2,5,29,30,59
25,2,5,49,50,99
9,1,4,21,9,30
25,1,4,57,25,82
16,1,4,36,16,52
8,1,2,6,8,14
5,1,2,4,5,9
9,1,2,5,9,14
15,1,2,8,15,23
1,2,5,3,2,5
12,1,2,12,12,24
6,1,2,6,6,12
11,1,2,11,11,22
7,1,2,7,7,14
4,1,2,3,4,7
2,1,2,1,2,3
15,2,5,44,30,74
21,2,5,61,42,103
5,11,30,94,55,149
22,1,4,62,22,84
13,1,4,37,13,50
8,2,5,23,16,39
18,11,30,223,198,421
11,11,30,136,121,257
11,1,2,9,11,20
2,1,2,2,2,4
10,2,5,23,20,43
16,2,5,37,32,69
14,1,4,40,14,54
2,1,4,6,2,8
30,9,25,450,270,720
24,11,29,307,264,571
8,2,5,23,16,39
5,2,5,15,10,25
15,1,2,10,15,25
5,1,2,3,5,8
1,461,742,162,461,623
1,1482,2384,807,1482,2289
1,755,1215,302,755,1057
3,461,742,554,1383,1937
1,1482,2384,378,1482,1860
1,1482,2384,378,1482,1860
3,1482,2384,1133,4446,5579
13,24,64,512,312,824
1,24,64,31,24,55
5,59,159,492,295,787
8,59,159,749,472,1221
6,59,159,562,354,916
8,3,9,39,24,63
11,3,9,53,33,86
8,4,10,37,32,69
17,4,10,100,68,168
6,4,10,35,24,59
11,2,5,32,22,54
5,2,5,15,10,25
4,4,10,23,16,39
4,4,10,23,16,39
27,2,5,59,54,113
18,2,5,40,36,76
27,4,10,159,108,267
1,4,10,6,4,10
17,2,5,48,34,82
1,2,5,3,2,5
22,2,5,64,44,108
26,2,5,75,52,127
1,2,5,3,2,5
24,2,5,71,48,119
22,4,10,128,88,216
22,4,10,128,88,216
14,3,9,81,42,123
28,2,5,81,56,137
23,2,5,67,46,113
12,2,5,32,24,56
9,2,5,24,18,42
23,3,9,101,69,170
18,3,9,79,54,133
28,2,5,78,56,134
20,2,5,56,40,96
5,3,9,20,15,35
6,2,5,13,12,25
12,2,5,26,24,50
9,7,9,7,63,70
16,7,9,13,112,125
15,7,9,25,105,130
17,7,9,31,119,150
8,7,9,15,56,71
17,7,9,28,119,147
30,7,9,55,210,265
17,7,9,10,119,129
13,3,8,51,39,90
19,3,8,74,57,131
23,3,8,111,69,180
14,8,22,184,112,296
23,8,22,312,184,496
22,8,22,202,176,378
23,8,22,251,184,435
21,8,22,285,168,453
8,8,22,84,64,148
14,8,22,190,112,302
24,8,22,325,192,517
9,8,22,118,72,190
1,8,22,10,8,18
22,8,22,245,176,421
20,9,24,290,180,470
5,9,24,74,45,119
26,9,24,290,234,524
1,9,24,12,9,21
8,9,24,118,72,190
28,9,24,333,252,585
3,9,24,29,27,56
10,9,24,145,90,235
4,9,24,40,36,76
15,13,35,220,195,415
28,13,35,577,364,941
16,13,35,313,208,521
1,13,35,17,13,30
7,13,35,152,91,243
10,13,35,213,130,343
8,13,35,170,104,274
10,13,35,213,130,343
21,13,35,455,273,728
5,13,35,108,65,173
3,13,35,64,39,103
5,13,35,82,65,147
9,13,35,195,117,312
2,13,35,41,26,67
11,13,35,238,143,381
27,13,35,471,351,822
3,13,35,62,39,101
23,13,35,474,299,773
30,13,35,650,390,1040
28,13,35,489,364,853
1,13,35,16,13,29
25,13,35,489,325,814
6,13,35,86,78,164
24,21,55,803,504,1307
21,21,55,552,441,993
31,21,55,679,651,1330
23,38,50,127,874,1001
12,42,54,60,504,564
26,42,54,284,1092,1376
6,42,54,30,252,282
22,42,54,240,924,1164
14,42,54,2,588,590
6,42,54,49,252,301
1,1252,2295,951,1252,2203
1,1266,2320,1008,1266,2274
3,420,769,747,1260,2007
2,1252,2295,1994,2504,4498
1,420,769,318,420,738
2,420,769,636,840,1476
3,420,769,1001,1260,2261
3,1252,2295,1614,3756,5370
2,1266,2320,2015,2532,4547
2,1252,2295,2040,2504,4544
1,2171,3578,1264,2171,3435
1,1519,2443,900,1519,2419
1,2171,3578,942,2171,3113
1,1083,1701,584,1083,1667
1,713,1120,362,713,1075
2,713,1120,792,1426,2218
2,1555,2443,1727,3110,4837
1,2171,3578,1335,2171,3506
12,26,70,343,312,655
9,26,70,314,234,548
15,3,9,68,45,113
1,2,5,2,2,4
22,1,2,20,22,42
17,1,2,16,17,33
13,13,35,277,169,446
14,13,35,298,182,480
15,2,5,29,30,59
12,2,5,23,24,47
26,13,35,508,338,846
7,13,35,137,91,228
21,2,5,62,42,104
28,13,35,606,364,970
17,13,35,368,221,589
14,1,2,14,14,28
25,1,2,25,25,50
7,1,2,7,7,14
4,9,25,43,36,79
29,1,2,28,29,57
26,1,2,25,26,51
28,1,2,27,28,55
11,13,35,227,143,370
5,13,35,103,65,168
17,2,5,40,34,74
30,1,2,28,30,58
16,1,2,15,16,31
1,1,2,1,1,2
22,2,5,46,44,90
9,1,4,27,9,36
30,1,2,26,30,56
3,1,2,3,3,6
12,9,25,171,108,279
2,9,25,29,18,47
22,2,5,65,44,109
23,2,5,68,46,114
23,1,2,23,23,46
1,2,5,3,2,5
1,1,2,1,1,2
29,1,2,20,29,49
22,1,2,15,22,37
23,2,5,54,46,100
24,1,2,24,24,48
25,1,2,25,25,50
24,8,21,221,192,413
26,2,5,51,52,103
24,2,5,47,48,95
32,1,2,23,32,55
24,1,2,24,24,48
22,1,4,64,22,86
25,1,4,73,25,98
9,1,4,26,9,35
17,11,29,198,187,385
5,11,29,58,55,113
11,2,5,31,22,53
16,2,5,45,32,77
23,2,5,64,46,110
31,1,2,27,31,58
4,1,2,3,4,7
24,8,21,292,192,484
12,8,21,146,96,242
3,1482,2384,2420,4446,6866
2,755,1215,531,1510,2041
1,755,1215,436,755,1191
1,755,1215,436,755,1191
1,461,742,229,461,690
3,461,742,687,1383,2070
1,1482,2384,592,1482,2074
19,24,64,492,456,948
1,45,120,49,45,94
1,45,120,70,45,115
2,59,159,194,118,312
6,2,5,17,12,29
18,2,5,52,36,88
26,2,5,51,52,103
11,2,5,21,22,43
21,2,5,62,42,104
5,2,5,15,10,25
26,2,5,55,52,107
15,2,5,32,30,62
26,4,10,151,104,255
25,4,10,145,100,245
18,2,5,38,36,74
25,2,5,53,50,103
5,2,5,11,10,21
2,2,5,4,4,8
8,4,10,46,32,78
27,2,5,80,54,134
15,2,5,44,30,74
12,2,5,23,24,47
16,2,5,45,32,77
23,2,5,64,46,110
14,2,5,33,28,61
27,2,5,63,54,117
19,7,9,35,133,168
1,7,9,2,7,9
8,7,9,0,56,56
24,7,9,39,168,207
9,7,9,0,63,63
20,7,9,36,140,176
10,3,8,39,30,69
24,3,8,95,72,167
9,3,8,44,27,71
17,3,8,56,51,107
27,8,22,366,216,582
27,8,22,253,216,469
7,8,22,96,56,152
1,8,22,14,8,22
5,8,22,56,40,96
16,9,24,236,144,380
6,13,35,128,78,206
24,13,35,520,312,832
2,13,35,43,26,69
14,13,35,303,182,485
1,13,35,14,13,27
2,13,35,43,26,69
7,13,35,149,91,240
31,13,35,671,403,1074
19,13,35,411,247,658
6,13,35,128,78,206
18,13,35,264,234,498
14,13,35,220,182,402
20,13,35,433,260,693
26,13,35,408,338,746
8,13,35,140,104,244
9,13,35,157,117,274
21,13,35,433,273,706
10,13,35,206,130,336
12,13,35,256,156,412
31,13,35,660,403,1063
15,21,55,477,315,792
7,21,55,176,147,323
9,38,50,99,342,441
5,42,54,49,210,259
14,42,54,32,588,620
4,42,54,20,168,188
22,38,50,242,836,1078
4,42,54,44,168,212
5,42,54,55,210,265
23,42,54,251,966,1217
13,38,50,130,494,624
1,1912,3400,1352,1912,3264
1,1266,2320,1008,1266,2274
3,1266,2320,1909,3798,5707
3,420,769,1024,1260,2284
1,420,769,341,420,761
1,1266,2320,613,1266,1879
1,1252,2295,997,1252,2249
1,1266,2320,636,1266,1902
1,308,565,155,308,463
1,1266,2320,752,1266,2018
1,295,540,148,295,443
1,2171,3578,1335,2171,3506
1,487,783,108,487,595
1,713,1120,362,713,1075
3,1083,1701,1191,3249,4440
1,344,540,174,344,518
1,1555,2443,570,1555,2125
1,1519,2443,900,1519,2419
1,344,540,174,344,518
12,26,70,520,312,832
5,26,70,175,130,305
18,26,70,767,468,1235
20,26,70,572,520,1092
14,26,70,596,364,960
6,26,70,256,156,412
24,3,9,116,72,188
7,3,9,41,21,62
10,3,9,48,30,78
27,1,4,77,27,104
19,1,4,54,19,73
29,2,5,86,58,144
9,2,5,27,18,45
3,2,5,7,6,13
22,2,5,48,44,92
1,11,30,19,11,30
2,1,2,1,2,3
24,1,2,14,24,38
16,2,5,38,32,70
7,2,5,16,14,30
6,2,5,14,12,26
10,2,5,24,20,44
14,2,5,33,28,61
12,2,5,28,24,52
16,2,5,38,32,70
24,2,5,56,48,104
7,8,21,70,56,126
26,1,2,14,26,40
20,1,2,10,20,30
17,13,35,350,221,571
11,13,35,227,143,370
23,9,25,293,207,500
5,9,25,64,45,109
4,1,2,4,4,8
8,1,2,7,8,15
6,1,2,5,6,11
11,1,2,8,11,19
11,1,4,27,11,38
4,1,4,10,4,14
29,2,5,68,58,126
5,2,5,12,10,22
1,2,5,2,2,4
4,2,5,12,8,20
25,2,5,73,50,123
13,1,2,10,13,23
3,1,2,3,3,6
19,1,2,11,19,30
24,11,29,418,264,682
2,11,29,35,22,57
23,1,2,23,23,46
1,1,2,1,1,2
12,1,4,25,12,37
10,2,5,29,20,49
27,9,25,419,243,662
11,2,5,32,22,54
6,2,5,17,12,29
2,1482,2384,1756,2964,4720
5,45,120,369,225,594
22,3,9,100,66,166
13,3,9,59,39,98
18,3,9,87,54,141
12,3,9,58,36,94
26,2,5,75,52,127
5,2,5,15,10,25
28,2,5,83,56,139
5,2,5,15,10,25
8,2,5,23,16,39
26,4,10,151,104,255
30,4,10,174,120,294
24,2,5,55,48,103
4,2,5,9,8,17
17,2,5,49,34,83
11,2,5,32,22,54
5,3,9,21,15,36
6,2,5,17,12,29
26,3,9,126,78,204
18,3,9,87,54,141
24,4,10,110,96,206
29,2,5,68,58,126
12,2,5,34,24,58
28,3,9,135,84,219
23,2,5,67,46,113
3,2,5,8,6,14
16,2,5,45,32,77
3,7,9,5,21,26
4,7,9,3,28,31
19,7,9,31,133,164
22,7,9,36,154,190
14,7,9,27,98,125
1,7,9,0,7,7
8,7,9,13,56,69
18,7,9,30,126,156
10,3,8,49,30,79
32,3,8,150,96,246
2,3,8,9,6,15
13,3,8,64,39,103
18,8,22,244,144,388
19,8,22,212,152,364
13,8,22,119,104,223
27,8,22,295,216,511
1,8,22,9,8,17
6,8,22,79,48,127
8,8,22,84,64,148
4,8,22,52,32,84
3,8,22,33,24,57
15,9,24,218,135,353
4,9,24,59,36,95
25,13,35,515,325,840
6,13,35,94,78,172
30,13,35,429,390,819
9,13,35,129,117,246
13,13,35,281,169,450
27,13,35,556,351,907
5,13,35,107,65,172
6,13,35,105,78,183
17,13,35,350,221,571
23,13,35,401,299,700
3,13,35,65,39,104
8,13,35,114,104,218
26,13,35,454,338,792
28,13,35,577,364,941
14,13,35,239,182,421
12,13,35,197,156,353
8,13,35,114,104,218
16,13,35,279,208,487
25,21,55,548,525,1073
2,21,55,53,42,95
12,21,55,395,252,647
30,38,50,300,1140,1440
2,42,54,5,84,89
1,1252,2295,538,1252,1790
1,1266,2320,961,1266,2227
1,1252,2295,722,1252,1974
1,420,769,318,420,738
1,1252,2295,951,1252,2203
3,1266,2320,1631,3798,5429
1,1252,2295,745,1252,1997
1,1252,2295,951,1252,2203
1,1266,2320,1008,1266,2274
1,1266,2320,1008,1266,2274
2,1252,2295,1902,2504,4406
2,295,540,479,590,1069
2,308,565,367,616,983
1,2171,3578,1264,2171,3435
2,2171,3578,2528,4342,6870
1,487,783,265,487,752
2,1555,2443,994,3110,4104
1,713,1120,385,713,1098
2,344,540,349,688,1037
1,1083,1701,550,1083,1633
1,344,540,110,344,454
1,344,540,99,344,443
4,26,70,137,104,241
19,26,70,823,494,1317
15,26,70,513,390,903
18,3,9,74,54,128
27,8,21,232,216,448
7,8,21,60,56,116
21,2,5,40,42,82
8,2,5,15,16,31
23,2,5,44,46,90
7,13,35,115,91,206
4,13,35,66,52,118
9,1,2,9,9,18
6,1,2,6,6,12
14,11,30,262,154,416
11,11,30,206,121,327
31,11,30,580,341,921
3,2,5,9,6,15
23,2,5,68,46,114
8,2,5,22,16,38
8,1,2,5,8,13
14,1,2,9,14,23
20,1,2,12,20,32
7,1,2,4,7,11
3,1,2,2,3,5
18,1,2,10,18,28
16,1,2,9,16,25
23,2,5,64,46,110
28,2,5,78,56,134
9,1,4,26,9,35
5,1,4,14,5,19
19,9,25,271,171,442
1,1,2,1,1,2
1,1,2,1,1,2
26,9,25,410,234,644
25,9,25,394,225,619
29,2,5,86,58,144
11,2,5,32,22,54
25,11,30,423,275,698
19,11,30,321,209,530
2,1,4,5,2,7
11,1,4,25,11,36
3,1,4,7,3,10
23,1,2,13,23,36
4,2,5,8,8,16
20,1,4,42,20,62
9,11,30,160,99,259
27,11,30,481,297,778
2,11,30,36,22,58
19,1,4,47,19,66
23,12,33,468,276,744
1,2,5,2,2,4
17,2,5,32,34,66
9,2,5,21,18,39
3,2,5,7,6,13
21,1,2,21,21,42
1,2,5,3,2,5
10,2,5,29,20,49
1,755,1215,436,755,1191
5,24,64,187,120,307
27,24,64,855,648,1503
11,24,64,341,264,605
17,24,64,539,408,947
28,24,64,1084,672,1756
1,59,159,65,59,124
5,59,159,325,295,620
9,2,5,27,18,45
28,3,9,128,84,212
10,3,9,46,30,76
27,2,5,78,54,132
23,2,5,67,46,113
10,2,5,29,20,49
20,3,9,107,60,167
25,3,9,134,75,209
6,2,5,11,12,23
1,2,5,2,2,4
26,2,5,64,52,116
26,2,5,77,52,129
21,2,5,62,42,104
29,4,10,171,116,287
29,4,10,171,116,287
25,2,5,66,50,116
16,2,5,42,32,74
10,4,10,58,40,98
8,2,5,23,16,39
11,2,5,26,22,48
1,2,5,3,2,5
11,2,5,32,22,54
15,2,5,35,30,65
9,2,5,19,18,37
21,2,5,44,42,86
29,2,5,81,58,139
23,2,5,64,46,110
16,4,10,93,64,157
21,2,5,49,42,91
14,2,5,33,28,61
23,2,5,64,46,110
15,2,5,32,30,62
19,2,5,40,38,78
16,2,5,47,32,79
13,2,5,38,26,64
23,2,5,48,46,94
11,2,5,23,22,45
22,3,9,106,66,172
3,3,9,14,9,23
16,7,9,26,112,138
8,7,9,15,56,71
7,7,9,11,49,60
1,7,9,1,7,8
24,7,9,20,168,188
20,7,9,33,140,173
6,7,9,10,42,52
24,7,9,20,168,188
8,7,9,3,56,59
27,3,8,107,81,188
30,3,8,116,90,206
1,3,8,4,3,7
10,3,8,48,30,78
31,8,22,284,248,532
6,8,22,55,48,103
20,8,22,183,160,343
5,8,22,55,40,95
9,8,22,90,72,162
7,8,22,95,56,151
4,8,22,54,32,86
3,9,24,36,27,63
31,9,24,368,279,647
1,9,24,12,9,21
28,9,24,299,252,551
4,9,24,58,36,94
14,13,35,288,182,470
7,13,35,122,91,213
13,13,35,281,169,450
22,13,35,476,286,762
14,13,35,288,182,470
25,13,35,366,325,691
8,13,35,137,104,241
10,13,35,143,130,273
22,13,35,315,286,601
8,13,35,126,104,230
12,13,35,209,156,365
8,13,35,165,104,269
25,13,35,436,325,761
10,13,35,175,130,305
4,13,35,70,52,122
24,13,35,377,312,689
25,13,35,489,325,814
26,13,35,563,338,901
17,13,35,297,221,518
25,13,35,393,325,718
23,13,35,401,299,700
19,13,35,332,247,579
6,13,35,128,78,206
17,13,35,362,221,583
3,13,35,52,39,91
14,13,35,190,182,372
5,13,35,87,65,152
16,21,55,535,336,871
2,21,55,67,42,109
23,21,55,757,483,1240
24,21,55,724,504,1228
2,21,55,66,42,108
1,42,54,11,42,53
6,42,54,30,252,282
19,42,54,43,798,841
11,38,50,121,418,539
21,42,54,105,882,987
16,38,50,160,608,768
10,42,54,23,420,443
14,42,54,70,588,658
1,1266,2320,799,1266,2065
1,1266,2320,497,1266,1763
1,1266,2320,752,1266,2018
3,1266,2320,3023,3798,6821
1,1266,2320,544,1266,1810
1,1266,2320,1031,1266,2297
1,420,769,211,420,631
2,295,540,350,590,940
1,1252,2295,997,1252,2249
1,420,769,249,420,669
1,1266,2320,1008,1266,2274
1,295,540,234,295,529
1,1252,2295,882,1252,2134
1,420,769,211,420,631
1,1252,2295,997,1252,2249
1,1252,2295,997,1252,2249
3,713,1120,1087,2139,3226
1,1555,2443,717,1555,2272
3,2171,3578,3470,6513,9983
1,713,1120,205,713,918
1,2171,3578,656,2171,2827
1,1519,2443,606,1519,2125
1,2171,3578,942,2171,3113
1,713,1120,205,713,918
2,2171,3578,1526,4342,5868
2,713,1120,411,1426,1837
2,487,783,310,974,1284
3,1555,2443,2517,4665,7182
1,713,1120,205,713,918
3,344,540,475,1032,1507
3,713,1120,1087,2139,3226
3,344,540,523,1032,1555
3,344,540,523,1032,1555
1,713,1120,261,713,974
3,487,783,583,1461,2044
1,344,540,126,344,470
1,344,540,99,344,443
31,26,70,1082,806,1888
8,1,4,24,8,32
18,1,4,53,18,71
6,1,2,4,6,10
8,1,2,6,8,14
26,2,5,55,52,107
1,2,5,3,2,5
25,2,5,70,50,120
10,2,5,28,20,48
15,2,5,42,30,72
1,1,2,1,1,2
2,2,5,5,4,9
9,2,5,27,18,45
17,2,5,50,34,84
11,1,2,11,11,22
3,1,2,3,3,6
20,2,5,58,40,98
3,2,5,6,6,12
15,2,5,29,30,59
27,2,5,51,54,105
13,12,33,269,156,425
17,2,5,45,34,79
30,1,2,29,30,59
26,1,2,25,26,51
21,9,25,299,189,488
1,1,2,1,1,2
1,1,2,1,1,2
1,1,2,1,1,2
29,1,2,28,29,57
8,1,2,8,8,16
19,1,2,18,19,37
4,2,5,8,8,16
18,2,5,34,36,70
13,2,5,25,26,51
1,13,35,14,13,27
1,13,35,14,13,27
11,1,2,7,11,18
17,1,2,12,17,29
4,1,2,3,4,7
1,2,5,2,2,4
24,2,5,56,48,104
26,2,5,57,52,109
22,8,21,203,176,379
11,1,2,7,11,18
24,11,30,442,264,706
20,9,25,210,180,390
1,9,25,11,9,20
16,1,2,16,16,32
13,2,5,38,26,64
29,12,33,485,348,833
20,12,33,334,240,574
14,8,21,144,112,256
19,2,5,37,38,75
14,2,5,27,28,55
2,1,4,4,2,6
7,1,4,15,7,22
10,1,2,6,10,16
1,755,1215,411,755,1166
1,461,742,162,461,623
1,1482,2384,878,1482,2360
2,1482,2384,1184,2964,4148
1,461,742,185,461,646
1,1482,2384,854,1482,2336
1,1482,2384,854,1482,2336
2,1482,2384,1709,2964,4673
3,461,742,554,1383,1937
12,24,64,465,288,753
30,24,64,950,720,1670
6,45,120,335,270,605
9,45,120,664,405,1069
17,2,5,37,34,71
8,4,10,46,32,78
13,4,10,75,52,127
29,2,5,84,58,142
2,2,5,6,4,10
1,2,5,3,2,5
31,2,5,90,62,152
27,3,9,157,81,238
8,3,9,47,24,71
17,2,5,49,34,83
15,2,5,44,30,74
10,2,5,29,20,49
21,2,5,61,42,103
9,2,5,26,18,44
5,2,5,15,10,25
27,7,9,44,189,233
14,7,9,25,98,123
28,7,9,21,196,217
30,7,9,11,210,221
3,7,9,0,21,21
8,3,8,39,24,63
8,3,8,39,24,63
14,3,8,62,42,104
10,3,8,33,30,63
1,3,8,5,3,8
18,8,22,248,144,392
31,8,22,420,248,668
29,8,22,400,232,632
8,8,22,89,64,153
15,8,22,207,120,327
20,9,24,295,180,475
29,9,24,428,261,689
14,9,24,203,126,329
18,9,24,261,162,423
15,9,24,218,135,353
14,9,24,207,126,333
16,13,35,279,208,487
4,13,35,66,52,118
9,13,35,157,117,274
16,13,35,229,208,437
24,13,35,469,312,781
16,13,35,279,208,487
17,13,35,362,221,583
1,13,35,22,13,35
1,13,35,22,13,35
9,13,35,192,117,309
14,13,35,288,182,470
4,13,35,87,52,139
26,13,35,426,338,764
14,21,55,314,294,608
23,21,55,618,483,1101
21,38,50,231,798,1029
27,38,50,149,1026,1175
5,42,54,55,210,265
9,42,54,21,378,399
3,1252,2295,3060,3756,6816
3,1266,2320,1700,3798,5498
1,420,769,295,420,715
1,420,769,226,420,646
2,1252,2295,1994,2504,4498
2,1555,2443,1434,3110,4544
1,713,1120,205,713,918
3,487,783,794,1461,2255
1,344,540,185,344,529
1,713,1120,228,713,941
3,344,540,556,1032,1588
1,2171,3578,1335,2171,3506
1,2171,3578,1335,2171,3506
32,26,70,1094,832,1926
21,26,70,601,546,1147
26,26,70,1126,676,1802
16,3,9,93,48,141
4,1,2,4,4,8
20,1,2,20,20,40
27,13,35,575,351,926
12,12,33,236,144,380
8,9,25,126,72,198
10,9,25,158,90,248
26,2,5,77,52,129
25,1,2,22,25,47
12,1,2,10,12,22
28,1,2,24,28,52
4,13,35,70,52,122
7,1,2,5,7,12
15,1,2,14,15,29
10,1,2,9,10,19
17,2,5,49,34,83
29,2,5,84,58,142
17,12,33,284,204,488
24,12,33,401,288,689
16,12,33,267,192,459
1,1,2,1,1,2
9,1,2,7,9,16
10,1,2,7,10,17
8,1,2,6,8,14
25,2,5,74,50,124
11,2,5,32,22,54
27,2,5,57,54,111
16,2,5,34,32,66
13,2,5,27,26,53
11,1,2,7,11,18
23,2,5,67,46,113
26,2,5,75,52,127
29,8,21,365,232,597
25,2,5,73,50,123
11,2,5,32,22,54
2,1,2,2,2,4
30,1,4,88,30,118
18,1,4,53,18,71
3,1,2,2,3,5
13,1,2,7,13,20
2,11,29,35,22,57
18,11,29,314,198,512
24,8,21,292,192,484
23,8,21,280,184,464
3,8,21,36,24,60
20,8,21,172,160,332
28,8,21,241,224,465
30,2,5,87,60,147
24,2,5,70,48,118
15,2,5,44,30,74
13,8,21,164,104,268
8,2,5,23,16,39
19,2,5,55,38,93
11,2,5,32,22,54
9,2,5,26,18,44
29,8,21,365,232,597
10,1,2,6,10,16
29,1,2,16,29,45
2,461,742,369,922,1291
24,24,64,929,576,1505
14,45,120,1016,630,1646
16,45,120,854,720,1574
3,45,120,218,135,353
3,59,159,214,177,391
24,3,9,116,72,188
12,3,9,58,36,94
11,2,5,21,22,43
21,2,5,40,42,82
8,4,10,45,32,77
24,4,10,134,96,230
6,2,5,17,12,29
14,2,5,39,28,67
3,2,5,7,6,13
8,2,5,19,16,35
19,2,5,55,38,93
25,2,5,73,50,123
26,2,5,64,52,116
4,2,5,10,8,18
17,2,5,32,34,66
6,2,5,11,12,23
16,2,5,37,32,69
7,2,5,16,14,30
22,2,5,62,44,106
18,2,5,50,36,86
28,2,5,66,56,122
8,2,5,19,16,35
10,2,5,24,20,44
1,2,5,2,2,4
25,2,5,70,50,120
15,2,5,35,30,65
14,7,9,25,98,123
10,7,9,18,70,88
23,7,9,32,161,193
18,7,9,0,126,126
9,7,9,12,63,75
25,7,9,3,175,178
14,7,9,25,98,123
11,7,9,6,77,83
14,7,9,25,98,123
12,3,8,48,36,84
27,8,22,366,216,582
10,8,22,92,80,172
10,8,22,109,80,189
7,8,22,92,56,148
6,8,22,67,48,115
3,8,22,31,24,55
8,8,22,110,64,174
28,8,22,386,224,610
25,9,24,249,225,474
12,9,24,168,108,276
29,13,35,506,377,883
5,13,35,87,65,152
1,13,35,17,13,30
21,13,35,447,273,720
7,13,35,149,91,240
26,13,35,563,338,901
28,13,35,577,364,941
5,13,35,108,65,173
1,13,35,16,13,29
18,13,35,371,234,605
11,13,35,188,143,331
2,13,35,39,26,65
15,13,35,309,195,504
27,13,35,471,351,822
9,21,55,301,189,490
10,21,55,329,210,539
16,21,55,430,336,766
15,38,50,128,570,698
8,42,54,79,336,415
10,38,50,115,380,495
2,38,50,23,76,99
24,42,54,262,1008,1270
1,38,50,5,38,43
13,38,50,52,494,546
9,38,50,99,342,441
3,1252,2295,2991,3756,6747
1,1252,2295,997,1252,2249
1,1266,2320,1008,1266,2274
1,1266,2320,961,1266,2227
3,1252,2295,2234,3756,5990
1,1266,2320,544,1266,1810
3,1266,2320,3023,3798,6821
1,1252,2295,997,1252,2249
1,420,769,334,420,754
3,295,540,719,885,1604
3,1266,2320,2884,3798,6682
3,1266,2320,2396,3798,6194
2,420,769,421,840,1261
3,420,769,632,1260,1892
2,2171,3578,2671,4342,7013
2,1555,2443,1581,3110,4691
1,1555,2443,790,1555,2345
1,1555,2443,375,1555,1930
1,1519,2443,411,1519,1930
1,2171,3578,620,2171,2791
2,1555,2443,994,3110,4104
1,1555,2443,570,1555,2125
1,344,540,174,344,518
2,344,540,198,688,886
2,2171,3578,2671,4342,7013
23,26,70,980,598,1578
11,26,70,469,286,755
30,26,70,1278,780,2058
7,26,70,298,182,480
7,26,70,298,182,480
2,26,70,59,52,111
23,26,70,722,598,1320
15,3,9,85,45,130
6,3,9,35,18,53
28,3,9,165,84,249
23,1,2,22,23,45
16,2,5,34,32,66
17,2,5,36,34,70
5,1,4,14,5,19
21,1,4,60,21,81
21,1,4,60,21,81
6,2,5,13,12,25
4,1,2,3,4,7
18,1,2,13,18,31
17,13,35,368,221,589
21,13,35,455,273,728
17,1,2,16,17,33
6,1,2,6,6,12
13,1,4,38,13,51
17,1,4,50,17,67
29,1,2,21,29,50
16,1,2,15,16,31
31,1,2,30,31,61
15,1,2,14,15,29
27,2,5,51,54,105
8,2,5,15,16,31
32,2,5,61,64,125
28,2,5,59,56,115
23,2,5,48,46,94
7,1,2,6,7,13
1,1,4,2,1,3
17,1,4,39,17,56
14,2,5,41,28,69
28,1,2,16,28,44
4,1,2,3,4,7
18,1,2,12,18,30
10,9,25,150,90,240
3,1,4,8,3,11
14,1,4,38,14,52
8,2,5,19,16,35
1,1,4,2,1,3
31,1,4,71,31,102
16,8,21,201,128,329
5,9,25,78,45,123
11,2,5,32,22,54
24,2,5,70,48,118
2,2,5,6,4,10
1,1482,2384,592,1482,2074
1,461,742,251,461,712
1,461,742,251,461,712
1,1482,2384,807,1482,2289
1,1482,2384,807,1482,2289
1,755,1215,448,755,1203
2,461,742,458,922,1380
1,1482,2384,854,1482,2336
3,1482,2384,1776,4446,6222
3,24,64,112,72,184
16,45,120,1162,720,1882
17,45,120,1010,765,1775
7,45,120,466,315,781
1,59,159,79,59,138
3,59,159,295,177,472
18,2,5,35,36,71
3,3,9,13,9,22
6,3,9,26,18,44
15,2,5,44,30,74
2,2,5,6,4,10
21,4,10,124,84,208
18,4,10,106,72,178
22,2,5,62,44,106
2,2,5,6,4,10
2,2,5,6,4,10
12,2,5,34,24,58
18,2,5,52,36,88
22,2,5,64,44,108
20,3,9,116,60,176
21,3,9,122,63,185
11,2,5,32,22,54
9,2,5,26,18,44
25,2,5,73,50,123
11,2,5,32,22,54
27,2,5,51,54,105
21,2,5,40,42,82
23,2,5,54,46,100
16,2,5,38,32,70
12,2,5,35,24,59
21,2,5,62,42,104
15,3,9,85,45,130
16,3,9,90,48,138
2,2,5,6,4,10
6,2,5,17,12,29
14,3,9,64,42,106
23,3,9,105,69,174
8,7,9,15,56,71
8,7,9,13,56,69
23,7,9,44,161,205
20,7,9,38,140,178
12,7,9,20,84,104
7,7,9,13,49,62
20,7,9,36,140,176
25,7,9,3,175,178
12,7,9,23,84,107
20,7,9,20,140,160
15,3,8,58,45,103
5,8,22,69,40,109
3,8,22,41,24,65
2,9,24,29,18,47
5,9,24,56,45,101
20,9,24,194,180,374
28,9,24,407,252,659
26,9,24,309,234,543
17,13,35,279,221,500
9,13,35,192,117,309
13,13,35,227,169,396
16,13,35,274,208,482
27,13,35,585,351,936
16,13,35,330,208,538
9,13,35,129,117,246
17,13,35,297,221,518
14,13,35,298,182,480
28,13,35,596,364,960
9,13,35,192,117,309
19,13,35,272,247,519
4,13,35,70,52,122
13,13,35,277,169,446
28,13,35,596,364,960
7,13,35,149,91,240
23,13,35,490,299,789
24,13,35,494,312,806
16,13,35,251,208,459
19,13,35,371,247,618
24,13,35,436,312,748
1,13,35,21,13,34
6,13,35,124,78,202
18,21,55,592,378,970
10,38,50,100,380,480
31,38,50,357,1178,1535
22,38,50,220,836,1056
31,38,50,93,1178,1271
3,42,54,34,126,160
7,42,54,5,294,299
8,38,50,88,304,392
9,38,50,99,342,441
11,38,50,110,418,528
12,38,50,132,456,588
1,1252,2295,951,1252,2203
1,1252,2295,561,1252,1813
2,1266,2320,2062,2532,4594
1,1266,2320,961,1266,2227
1,1266,2320,1031,1266,2297
1,308,565,184,308,492
2,295,540,252,590,842
3,1252,2295,2647,3756,6403
1,1252,2295,997,1252,2249
1,487,783,280,487,767
1,344,540,185,344,529
3,1555,2443,2371,4665,7036
1,1083,1701,584,1083,1667
1,344,540,120,344,464
3,2171,3578,2289,6513,8802
1,713,1120,385,713,1098
1,1555,2443,375,1555,1930
3,344,540,377,1032,1409
1,713,1120,172,713,885
1,713,1120,396,713,1109
3,713,1120,1087,2139,3226
1,713,1120,362,713,1075
30,26,70,1299,780,2079
20,26,70,866,520,1386
21,26,70,895,546,1441
27,26,70,772,702,1474
10,3,9,58,30,88
14,8,21,176,112,288
16,8,21,201,128,329
11,1,2,6,11,17
5,1,2,3,5,8
7,1,2,5,7,12
14,13,35,298,182,480
12,13,35,256,156,412
30,13,35,639,390,1029
30,2,5,71,60,131
5,2,5,12,10,22
17,2,5,33,34,67
7,13,35,149,91,240
9,13,35,192,117,309
20,13,35,349,260,609
23,13,35,401,299,700
22,11,29,313,242,555
4,1,2,4,4,8
1,2,5,2,2,4
21,2,5,48,42,90
7,1,2,4,7,11
1,1,2,1,1,2
24,1,2,15,24,39
15,1,2,14,15,29
30,1,2,28,30,58
17,1,2,10,17,27
22,1,2,13,22,35
4,11,30,60,44,104
10,11,30,151,110,261
12,11,30,181,132,313
14,11,30,258,154,412
9,11,30,166,99,265
23,1,2,23,23,46
15,1,2,15,15,30
12,1,4,34,12,46
9,1,4,26,9,35
27,2,5,80,54,134
20,2,5,59,40,99
23,8,21,212,184,396
15,8,21,138,120,258
9,2,5,24,18,42
28,1,4,64,28,92
1,2,5,2,2,4
3,2,5,7,6,13
14,2,5,32,28,60
14,1,2,10,14,24
1,1,2,1,1,2
11,1,4,32,11,43
18,1,4,53,18,71
10,1,4,29,10,39
19,1,2,14,19,33
17,1,2,12,17,29
28,1,2,20,28,48
29,2,5,84,58,142
17,1,2,17,17,34
27,1,2,26,27,53
22,1,4,62,22,84
15,1,4,43,15,58
1,1482,2384,401,1482,1883
1,461,742,147,461,608
1,1482,2384,521,1482,2003
1,461,742,251,461,712
1,1482,2384,473,1482,1955
1,1482,2384,854,1482,2336
2,1482,2384,1709,2964,4673
1,1482,2384,640,1482,2122
1,1482,2384,854,1482,2336
1,1482,2384,592,1482,2074
1,755,1215,411,755,1166
1,24,64,39,24,63
13,24,64,512,312,824
7,45,120,517,315,832
1,45,120,73,45,118
12,3,9,68,36,104
27,3,9,152,81,233
22,4,10,117,88,205
18,4,10,95,72,167
20,3,9,88,60,148
9,3,9,39,27,66
8,4,10,30,32,62
12,2,5,35,24,59
3,2,5,9,6,15
3,2,5,9,6,15
20,4,10,92,80,172
32,4,10,147,128,275
14,2,5,41,28,69
12,2,5,35,24,59
19,2,5,56,38,94
23,2,5,68,46,114
19,4,10,72,76,148
13,4,10,49,52,101
5,4,10,27,20,47
14,4,10,74,56,130
2,4,10,9,8,17
4,4,10,18,16,34
32,2,5,93,64,157
8,2,5,23,16,39
29,2,5,86,58,144
13,2,5,38,26,64
21,4,10,99,84,183
12,2,5,34,24,58
12,2,5,34,24,58
11,2,5,32,22,54
9,2,5,27,18,45
24,2,5,70,48,118
28,2,5,81,56,137
26,7,9,47,182,229
18,7,9,33,126,159
30,7,9,25,210,235
15,7,9,21,105,126
25,7,9,7,175,182
15,7,9,12,105,117
25,7,9,1,175,176
19,7,9,26,133,159
2,7,9,4,14,18
12,7,9,0,84,84
16,8,22,217,128,345
10,8,22,136,80,216
25,8,22,229,200,429
7,8,22,96,56,152
12,8,22,113,96,209
4,8,22,45,32,77
6,9,24,70,54,124
27,9,24,360,243,603
4,9,24,56,36,92
10,9,24,145,90,235
24,9,24,285,216,501
6,9,24,89,54,143
8,13,35,140,104,244
24,13,35,469,312,781
16,13,35,251,208,459
1,13,35,22,13,35
13,13,35,281,169,450
12,13,35,188,156,344
18,13,35,264,234,498
23,13,35,401,299,700
4,13,35,85,52,137
29,13,35,618,377,995
19,13,35,411,247,658
18,13,35,383,234,617
12,13,35,256,156,412
7,13,35,122,91,213
1,13,35,20,13,33
19,13,35,391,247,638
26,13,35,536,338,874
26,13,35,563,338,901
15,13,35,320,195,515
4,13,35,85,52,137
20,13,35,286,260,546
13,13,35,204,169,373
29,13,35,567,377,944
13,13,35,222,169,391
15,21,55,337,315,652
16,21,55,403,336,739
6,38,50,60,228,288
3,42,54,15,126,141
19,42,54,218,798,1016
32,42,54,367,1344,1711
3,38,50,35,114,149
1,1252,2295,882,1252,2134
1,1252,2295,561,1252,1813
3,1266,2320,2257,3798,6055
1,1252,2295,997,1252,2249
1,420,769,334,420,754
1,1266,2320,636,1266,1902
1,420,769,318,420,738
1,308,565,251,308,559
1,1266,2320,752,1266,2018
1,1252,2295,630,1252,1882
1,295,540,234,295,529
1,1266,2320,892,1266,2158
3,1898,3375,2204,5694,7898
1,1252,2295,997,1252,2249
3,2171,3578,3470,6513,9983
2,2171,3578,2528,4342,6870
1,487,783,124,487,611
1,2171,3578,1264,2171,3435
1,1555,2443,839,1555,2394
1,2171,3578,942,2171,3113
1,487,783,155,487,642
1,2171,3578,835,2171,3006
1,487,783,265,487,752
1,713,1120,261,713,974
1,487,783,194,487,681
1,487,783,194,487,681
3,344,540,329,1032,1361
1,2171,3578,906,2171,3077
22,26,70,937,572,1509
26,26,70,1126,676,1802
12,3,9,64,36,100
28,3,9,163,84,247
21,3,9,92,63,155
2,2,5,5,4,9
11,2,5,26,22,48
21,9,25,268,189,457
8,9,25,102,72,174
9,9,25,115,81,196
30,1,2,17,30,47
2,1,2,1,2,3
14,2,5,37,28,65
3,1,2,2,3,5
20,1,2,15,20,35
14,1,2,10,14,24
13,2,5,38,26,64
11,2,5,32,22,54
9,1,2,9,9,18
6,1,2,6,6,12
1,2,5,3,2,5
2,2,5,6,4,10
11,2,5,32,22,54
7,2,5,16,14,30
5,2,5,12,10,22
6,9,25,95,54,149
17,1,2,10,17,27
16,1,2,9,16,25
28,1,2,21,28,49
12,2,5,35,24,59
18,11,30,331,198,529
25,11,30,460,275,735
24,1,4,68,24,92
24,1,4,68,24,92
25,1,2,22,25,47
5,1,2,4,5,9
7,1,4,19,7,26
21,1,4,57,21,78
2,1,4,6,2,8
20,1,2,18,20,38
20,1,2,18,20,38
18,2,5,38,36,74
20,11,29,319,220,539
7,1,2,4,7,11
27,1,2,15,27,42
14,1,2,8,14,22
26,1,2,15,26,41
5,1,2,3,5,8
2,11,30,25,22,47
11,11,30,136,121,257
6,1,2,4,6,10
14,1,2,10,14,24
24,1,2,16,24,40
12,1,2,9,12,21
3,1,2,2,3,5
18,2,5,52,36,88
11,2,5,32,22,54
15,2,5,44,30,74
24,1,4,70,24,94
1,1,4,3,1,4
31,2,5,59,62,121
29,2,5,55,58,113
5,2,5,15,10,25
20,2,5,59,40,99
11,1,4,32,11,43
3,1482,2384,1776,4446,6222
1,755,1215,411,755,1166
2,755,1215,823,1510,2333
3,1482,2384,2420,4446,6866
2,1482,2384,946,2964,3910
1,1482,2384,878,1482,2360
3,755,1215,578,2265,2843
3,755,1215,1307,2265,3572
1,755,1215,241,755,996
1,755,1215,436,755,1191
25,24,64,936,600,1536
16,24,64,620,384,1004
14,24,64,444,336,780
1,45,120,70,45,115
10,45,120,726,450,1176
14,4,10,64,56,120
21,2,5,41,42,83
11,2,5,32,22,54
18,2,5,53,36,89
20,4,10,118,80,198
11,2,5,32,22,54
9,2,5,26,18,44
5,2,5,15,10,25
15,2,5,44,30,74
12,2,5,35,24,59
11,2,5,26,22,48
14,2,5,39,28,67
18,2,5,50,36,86
12,2,5,34,24,58
17,2,5,48,34,82
6,2,5,17,12,29
3,2,5,9,6,15
1,2,5,3,2,5
1,2,5,3,2,5
23,2,5,67,46,113
3,7,9,6,21,27
21,7,9,34,147,181
28,7,9,53,196,249
10,8,22,92,80,172
15,8,22,167,120,287
11,8,22,152,88,240
1,8,22,14,8,22
3,8,22,39,24,63
29,9,24,428,261,689
19,9,24,276,171,447
4,9,24,59,36,95
20,9,24,290,180,470
19,9,24,221,171,392
15,9,24,175,135,310
1,13,35,21,13,34
10,13,35,143,130,273
2,13,35,43,26,69
18,13,35,295,234,529
23,13,35,329,299,628
17,13,35,243,221,464
19,13,35,411,247,658
22,13,35,476,286,762
13,13,35,222,169,391
17,13,35,368,221,589
27,13,35,556,351,907
3,13,35,44,39,83
27,13,35,462,351,813
27,13,35,424,351,775
4,13,35,70,52,122
20,13,35,426,260,686
4,13,35,85,52,137
20,13,35,412,260,672
2,13,35,41,26,67
15,13,35,262,195,457
10,13,35,157,130,287
20,13,35,314,260,574
3,13,35,51,39,90
24,13,35,511,312,823
23,13,35,329,299,628
5,42,54,55,210,265
6,42,54,66,252,318
1,38,50,1,38,39
18,38,50,198,684,882
28,42,54,64,1176,1240
17,38,50,170,646,816
1,1912,3400,1046,1912,2958
3,1266,2320,1492,3798,5290
2,1252,2295,1902,2504,4406
2,1266,2320,1087,2532,3619
1,1266,2320,729,1266,1995
1,1252,2295,561,1252,1813
1,420,769,334,420,754
3,420,769,1001,1260,2261
1,1266,2320,1031,1266,2297
1,295,540,240,295,535
2,308,565,469,616,1085
2,1083,1701,1100,2166,3266
1,2171,3578,1371,2171,3542
1,487,783,124,487,611
2,1083,1701,488,2166,2654
1,713,1120,250,713,963
2,713,1120,411,1426,1837
1,1083,1701,312,1083,1395
1,344,540,174,344,518
1,344,540,174,344,518
1,713,1120,329,713,1042
2,344,540,349,688,1037
1,487,783,171,487,658
1,1555,2443,864,1555,2419
1,344,540,174,344,518
18,26,70,767,468,1235
28,3,9,135,84,219
27,1,2,26,27,53
13,1,2,12,13,25
7,1,2,7,7,14
27,1,2,26,27,53
20,1,2,15,20,35
5,1,2,4,5,9
24,1,2,17,24,41
28,1,2,20,28,48
30,1,2,22,30,52
10,1,2,5,10,15
23,1,2,12,23,35
15,1,2,8,15,23
24,1,2,17,24,41
16,1,2,12,16,28
26,2,5,77,52,129
18,2,5,53,36,89
5,2,5,15,10,25
19,11,29,270,209,479
9,11,29,128,99,227
3,2,5,7,6,13
1,2,5,2,2,4
9,2,5,21,18,39
6,1,2,4,6,10
6,2,5,17,12,29
11,2,5,32,22,54
25,2,5,74,50,124
20,1,4,50,20,70
19,1,2,13,19,32
31,12,33,641,372,1013
18,2,5,52,36,88
4,2,5,12,8,20
8,8,21,80,64,144
19,1,2,14,19,33
26,1,2,24,26,50
5,1,2,5,5,10
6,13,35,88,78,166
24,1,2,18,24,42
18,1,2,13,18,31
20,2,5,42,40,82
17,2,5,36,34,70
17,1,2,12,17,29
15,1,2,10,15,25
8,1,2,5,8,13
18,2,5,52,36,88
6,2,5,17,12,29
31,1,4,71,31,102
6,1,4,14,6,20
18,12,33,336,216,552
28,12,33,523,336,859
13,1,2,12,13,25
27,1,2,25,27,52
29,1,2,27,29,56
8,2,5,15,16,31
12,2,5,35,24,59
7,1,2,4,7,11
11,1,2,6,11,17
18,2,5,40,36,76
6,1,2,3,6,9
1,1482,2384,592,1482,2074
1,461,742,147,461,608
3,1482,2384,2420,4446,6866
1,1482,2384,854,1482,2336
1,755,1215,436,755,1191
1,1482,2384,378,1482,1860
2,461,742,532,922,1454
1,461,742,266,461,727
29,24,64,1141,696,1837
6,45,120,436,270,706
17,3,9,100,51,151
27,2,5,49,54,103
1,2,5,2,2,4
28,3,9,163,84,247
9,2,5,21,18,39
10,2,5,24,20,44
27,2,5,63,54,117
1,2,5,2,2,4
15,2,5,44,30,74
11,2,5,32,22,54
6,2,5,17,12,29
27,2,5,76,54,130
29,2,5,55,58,113
20,2,5,38,40,78
25,3,9,141,75,216
11,3,9,52,33,85
12,3,9,57,36,93
22,2,5,52,44,96
13,2,5,31,26,57
11,2,5,32,22,54
6,2,5,17,12,29
12,2,5,28,24,52
15,2,5,35,30,65
9,3,9,36,27,63
12,3,9,58,36,94
17,3,9,82,51,133
6,3,9,29,18,47
29,3,9,140,87,227
27,7,9,20,189,209
17,7,9,23,119,142
27,7,9,1,189,190
15,7,9,25,105,130
16,7,9,13,112,125
21,7,9,40,147,187
25,7,9,41,175,216
28,3,8,93,84,177
15,3,8,53,45,98
4,3,8,15,12,27
3,3,8,15,9,24
25,3,8,99,75,174
26,3,8,84,78,162
15,3,8,49,45,94
20,8,22,271,160,431
23,8,22,312,184,496
7,8,22,61,56,117
5,8,22,66,40,106
15,8,22,157,120,277
19,8,22,178,152,330
21,9,24,305,189,494
5,9,24,70,45,115
5,9,24,59,45,104
9,9,24,131,81,212
27,9,24,392,243,635
22,13,35,384,286,670
24,13,35,494,312,806
12,13,35,235,156,391
23,13,35,498,299,797
20,13,35,412,260,672
10,13,35,175,130,305
14,13,35,244,182,426
26,13,35,454,338,792
29,13,35,567,377,944
17,13,35,332,221,553
12,13,35,235,156,391
13,13,35,227,169,396
22,13,35,453,286,739
26,13,35,563,338,901
9,13,35,185,117,302
10,13,35,213,130,343
18,13,35,283,234,517
4,13,35,87,52,139
11,13,35,180,143,323
24,13,35,511,312,823
31,13,35,443,403,846
18,21,55,572,378,950
8,21,55,180,168,348
28,21,55,613,588,1201
24,38,50,276,912,1188
21,38,50,210,798,1008
6,38,50,66,228,294
3,38,50,26,114,140
13,38,50,150,494,644
7,38,50,39,266,305
11,42,54,1,462,463
13,38,50,72,494,566
26,42,54,59,1092,1151
1,1898,3375,937,1898,2835
1,1252,2295,538,1252,1790
1,1266,2320,961,1266,2227
3,1266,2320,1909,3798,5707
2,1266,2320,1366,2532,3898
2,420,769,636,840,1476
1,420,769,318,420,738
1,1252,2295,882,1252,2134
1,420,769,249,420,669
1,1252,2295,997,1252,2249
1,1266,2320,961,1266,2227
1,713,1120,161,713,874
1,2171,3578,1371,2171,3542
1,1555,2443,790,1555,2345
3,2171,3578,1967,6513,8480
1,1555,2443,570,1555,2125
1,344,540,158,344,502
1,1083,1701,601,1083,1684
3,1083,1701,1497,3249,4746
1,713,1120,138,713,851
1,713,1120,261,713,974
2,487,783,388,974,1362
1,1555,2443,864,1555,2419
13,26,70,536,338,874
9,26,70,257,234,491
19,26,70,597,494,1091
21,3,9,118,63,181
15,3,9,87,45,132
16,11,29,204,176,380
19,11,29,243,209,452
27,11,29,345,297,642
19,12,33,286,228,514
14,12,33,211,168,379
22,12,33,331,264,595
22,1,2,14,22,36
13,11,29,230,143,373
28,11,29,496,308,804
16,2,5,46,32,78
17,2,5,50,34,84
19,2,5,56,38,94
11,2,5,21,22,43
18,2,5,35,36,71
11,2,5,31,22,53
8,2,5,22,16,38
18,2,5,38,36,74
3,2,5,7,6,13
17,2,5,40,34,74
11,9,25,173,99,272
9,9,25,142,81,223
20,1,4,50,20,70
4,1,4,10,4,14
19,1,2,13,19,32
20,1,2,13,20,33
15,8,21,154,120,274
21,8,21,216,168,384
30,8,21,308,240,548
18,8,21,185,144,329
13,8,21,134,104,238
22,1,4,64,22,86
29,1,4,85,29,114
2,2,5,4,4,8
21,2,5,40,42,82
1,2,5,2,2,4
11,11,30,136,121,257
2,11,30,25,22,47
17,11,30,313,187,500
2,11,30,37,22,59
12,2,5,35,24,59
4,12,33,55,48,103
8,1,2,8,8,16
32,1,2,31,32,63
27,1,2,14,27,41
11,1,2,6,11,17
13,1,2,7,13,20
5,1,2,3,5,8
1,1,2,1,1,2
1,1482,2384,592,1482,2074
2,1482,2384,1184,2964,4148
1,1482,2384,592,1482,2074
1,755,1215,375,755,1130
3,461,742,442,1383,1825
3,755,1215,615,2265,2880
1,461,742,229,461,690
17,24,64,539,408,947
15,45,120,1089,675,1764
1,59,159,97,59,156
22,2,5,65,44,109
21,2,5,61,42,103
1,2,5,3,2,5
20,2,5,58,40,98
7,2,5,13,14,27
23,2,5,44,46,90
22,2,5,42,44,86
9,2,5,17,18,35
9,2,5,27,18,45
30,2,5,89,60,149
20,3,9,80,60,140
25,3,9,101,75,176
28,4,10,162,112,274
15,2,5,44,30,74
20,2,5,47,40,87
16,2,5,38,32,70
27,2,5,63,54,117
17,2,5,40,34,74
30,2,5,87,60,147
12,7,9,10,84,94
17,7,9,10,119,129
5,7,9,8,35,43
1,7,9,0,7,7
23,7,9,42,161,203
8,7,9,0,56,56
12,7,9,20,84,104
7,3,8,34,21,55
2,3,8,7,6,13
18,3,8,87,54,141
14,3,8,45,42,87
1,3,8,4,3,7
1,3,8,3,3,6
7,3,8,28,21,49
6,3,8,29,18,47
5,8,22,68,40,108
20,8,22,188,160,348
16,8,22,210,128,338
9,8,22,124,72,196
16,8,22,220,128,348
12,9,24,174,108,282
7,9,24,70,63,133
14,9,24,136,126,262
10,9,24,145,90,235
16,9,24,213,144,357
4,13,35,85,52,137
2,13,35,43,26,69
1,13,35,21,13,34
5,13,35,72,65,137
5,13,35,108,65,173
27,13,35,528,351,879
29,13,35,425,377,802
2,13,35,29,26,55
24,13,35,419,312,731
3,13,35,64,39,103
14,13,35,298,182,480
15,13,35,320,195,515
29,13,35,476,377,853
13,13,35,177,169,346
22,13,35,469,286,755
31,13,35,454,403,857
27,13,35,386,351,737
1,13,35,17,13,30
10,13,35,171,130,301
3,21,55,100,63,163
27,21,55,903,567,1470
23,21,55,580,483,1063
9,38,50,99,342,441
8,38,50,80,304,384
6,38,50,18,228,246
3,38,50,35,114,149
23,38,50,92,874,966
1,42,54,11,42,53
28,42,54,64,1176,1240
2,1266,2320,2015,2532,4547
1,1266,2320,1031,1266,2297
1,420,769,334,420,754
1,1252,2295,1020,1252,2272
1,1252,2295,676,1252,1928
1,295,540,240,295,535
1,1252,2295,997,1252,2249
3,1266,2320,1631,3798,5429
1,295,540,126,295,421
1,295,540,126,295,421
1,1266,2320,961,1266,2227
1,295,540,234,295,529
1,295,540,240,295,535
2,1252,2295,1076,2504,3580
1,487,783,280,487,767
2,1083,1701,794,2166,2960
1,2171,3578,942,2171,3113
1,713,1120,261,713,974
1,344,540,77,344,421
1,1555,2443,497,1555,2052
1,344,540,77,344,421
2,713,1120,724,1426,2150
1,487,783,132,487,619
2,2171,3578,2671,4342,7013
24,26,70,989,624,1613
24,26,70,1022,624,1646
17,26,70,724,442,1166
1,26,70,31,26,57
11,1,2,6,11,17
7,1,2,4,7,11
26,9,25,410,234,644
19,9,25,299,171,470
25,1,2,24,25,49
6,1,2,6,6,12
13,1,2,12,13,25
8,13,35,170,104,274
14,13,35,298,182,480
8,1,4,24,8,32
13,1,4,38,13,51
7,1,4,21,7,28
5,1,2,4,5,9
18,1,2,15,18,33
25,2,5,59,50,109
29,2,5,86,58,144
9,2,5,27,18,45
28,1,2,27,28,55
23,1,2,22,23,45
2,2,5,6,4,10
2,2,5,6,4,10
15,1,2,15,15,30
17,1,2,17,17,34
31,2,5,59,62,121
19,2,5,50,38,88
13,2,5,34,26,60
3,1,2,2,3,5
12,1,2,7,12,19
11,13,35,157,143,300
14,13,35,200,182,382
8,1,2,5,8,13
26,1,2,15,26,41
1,13,35,21,13,34
19,1,4,45,19,64
17,1,4,40,17,57
12,1,2,6,12,18
23,1,2,12,23,35
6,1,2,6,6,12
24,1,2,22,24,46
17,2,5,49,34,83
3,2,5,9,6,15
11,2,5,32,22,54
12,2,5,35,24,59
6,2,5,17,12,29
9,11,30,133,99,232
7,11,30,104,77,181
31,12,33,426,372,798
10,12,33,137,120,257
11,2,5,31,22,53
1,2,5,3,2,5
23,2,5,64,46,110
28,1,4,68,28,96
1,1,4,2,1,3
13,2,5,31,26,57
21,1,2,12,21,33
20,1,2,11,20,31
5,1,4,15,5,20
17,1,4,50,17,67
10,1,4,29,10,39
15,1,2,14,15,29
18,1,2,17,18,35
1,1,2,1,1,2
6,11,29,96,66,162
26,11,29,415,286,701
22,11,29,351,242,593
20,2,5,46,40,86
13,2,5,30,26,56
19,1,4,55,19,74
8,1,4,23,8,31
1,461,742,185,461,646
1,461,742,251,461,712
1,461,742,229,461,690
1,755,1215,241,755,996
1,24,64,26,24,50
2,45,120,145,90,235
11,2,5,26,22,48
25,2,5,73,50,123
13,2,5,38,26,64
29,2,5,55,58,113
1,2,5,3,2,5
8,2,5,24,16,40
29,2,5,67,58,125
26,2,5,75,52,127
22,2,5,64,44,108
15,2,5,44,30,74
23,2,5,67,46,113
12,4,10,70,48,118
29,4,10,168,116,284
29,2,5,77,58,135
19,4,10,80,76,156
12,2,5,23,24,47
13,2,5,25,26,51
20,4,10,106,80,186
16,4,10,85,64,149
14,4,10,53,56,109
23,4,10,87,92,179
2,2,5,6,4,10
20,2,5,58,40,98
25,2,5,51,50,101
1,2,5,2,2,4
15,2,5,42,30,72
14,2,5,39,28,67
13,2,5,36,26,62
4,2,5,11,8,19
8,3,9,47,24,71
19,2,5,45,38,83
1,7,9,2,7,9
20,7,9,2,140,142
9,7,9,0,63,63
1,7,9,1,7,8
26,7,9,50,182,232
29,7,9,40,203,243
24,7,9,44,168,212
31,7,9,56,217,273
19,7,9,36,133,169
7,3,8,23,21,44
24,3,8,116,72,188
16,3,8,71,48,119
29,3,8,94,87,181
9,8,22,98,72,170
4,8,22,54,32,86
18,8,22,248,144,392
11,8,22,149,88,237
26,8,22,238,208,446
19,8,22,174,152,326
14,8,22,193,112,305
1,8,22,13,8,21
3,9,24,35,27,62
28,9,24,393,252,645
21,9,24,305,189,494
10,13,35,143,130,273
27,13,35,575,351,926
26,13,35,536,338,874
1,13,35,22,13,35
8,13,35,126,104,230
23,13,35,490,299,789
22,13,35,384,286,670
8,13,35,126,104,230
2,13,35,43,26,69
9,13,35,195,117,312
1,13,35,20,13,33
1,13,35,20,13,33
13,13,35,268,169,437
2,13,35,35,26,61
11,13,35,234,143,377
14,13,35,239,182,421
14,13,35,239,182,421
11,38,50,121,418,539
21,42,54,229,882,1111
28,38,50,308,1064,1372
5,38,50,55,190,245
2,38,50,23,76,99
17,38,50,196,646,842
15,42,54,67,630,697
21,42,54,3,882,885
20,42,54,218,840,1058
1,1252,2295,538,1252,1790
1,420,769,341,420,761
3,1252,2295,2165,3756,5921
1,1252,2295,607,1252,1859
2,1266,2320,1551,2532,4083
1,1266,2320,636,1266,1902
1,1252,2295,1020,1252,2272
2,420,769,667,840,1507
1,1266,2320,636,1266,1902
1,1252,2295,997,1252,2249
1,1266,2320,544,1266,1810
1,295,540,234,295,529
1,1266,2320,636,1266,1902
2,1266,2320,1783,2532,4315
1,1252,2295,722,1252,1974
1,1266,2320,1008,1266,2274
1,1252,2295,538,1252,1790
1,2171,3578,620,2171,2791
1,2171,3578,1335,2171,3506
1,487,783,194,487,681
1,487,783,280,487,767
1,487,783,265,487,752
2,487,783,529,974,1503
1,344,540,185,344,529
3,487,783,583,1461,2044
1,26,70,29,26,55
19,26,70,823,494,1317
8,26,70,229,208,437
16,3,9,90,48,138
11,1,2,11,11,22
15,1,2,15,15,30
12,1,2,12,12,24
4,1,2,4,4,8
18,13,35,295,234,529
13,1,2,8,13,21
20,1,2,15,20,35
4,1,2,3,4,7
16,1,2,12,16,28
26,2,5,77,52,129
3,2,5,9,6,15
7,11,30,131,77,208
6,13,35,103,78,181
19,13,35,325,247,572
6,13,35,103,78,181
9,1,4,27,9,36
14,2,5,33,28,61
27,2,5,63,54,117
23,2,5,48,46,94
6,2,5,13,12,25
5,2,5,15,10,25
25,2,5,74,50,124
15,2,5,29,30,59
15,1,2,10,15,25
6,1,2,4,6,10
1,1,2,1,1,2
26,1,2,22,26,48
14,1,2,8,14,22
9,1,4,27,9,36
8,2,5,17,16,33
16,2,5,34,32,66
3,2,5,6,6,12
7,9,25,100,63,163
10,9,25,143,90,233
20,9,25,285,180,465
28,1,2,27,28,55
3,2,5,6,6,12
26,2,5,73,52,125
8,1,2,5,8,13
23,1,2,22,23,45
18,1,2,17,18,35
29,1,2,21,29,50
19,1,2,14,19,33
7,8,21,88,56,144
6,2,5,17,12,29
6,2,5,17,12,29
19,2,5,55,38,93
28,2,5,81,56,137
7,2,5,20,14,34
14,2,5,34,28,62
7,1,4,15,7,22
1,1,4,2,1,3
9,9,25,140,81,221
15,9,25,233,135,368
1,461,742,266,461,727
1,461,742,251,461,712
2,755,1215,896,1510,2406
2,1482,2384,1709,2964,4673
1,461,742,266,461,727
1,1482,2384,568,1482,2050
1,1482,2384,568,1482,2050
1,461,742,251,461,712
1,461,742,266,461,727
3,24,64,78,72,150
1,45,120,73,45,118
11,59,159,1065,649,1714
3,59,159,195,177,372
12,2,5,35,24,59
3,2,5,9,6,15
14,2,5,39,28,67
9,4,10,52,36,88
12,4,10,70,48,118
17,4,10,95,68,163
11,4,10,62,44,106
12,2,5,28,24,52
24,2,5,71,48,119
8,2,5,24,16,40
18,2,5,49,36,85
10,4,10,56,40,96
8,4,10,45,32,77
24,2,5,70,48,118
25,2,5,73,50,123
19,2,5,55,38,93
13,2,5,38,26,64
29,4,10,110,116,226
3,4,10,11,12,23
7,2,5,20,14,34
11,2,5,32,22,54
22,2,5,64,44,108
1,2,5,2,2,4
17,2,5,31,34,65
13,7,9,10,91,101
23,7,9,42,161,203
9,7,9,17,63,80
16,3,8,77,48,125
17,3,8,80,51,131
11,3,8,54,33,87
14,8,22,190,112,302
27,8,22,366,216,582
12,8,22,163,96,259
21,8,22,276,168,444
15,8,22,137,120,257
21,8,22,285,168,453
5,8,22,69,40,109
5,8,22,46,40,86
19,9,24,280,171,451
9,9,24,133,81,214
22,9,24,256,198,454
30,13,35,650,390,1040
27,13,35,424,351,775
27,13,35,367,351,718
6,13,35,128,78,206
8,13,35,126,104,230
2,13,35,36,26,62
3,13,35,52,39,91
5,13,35,107,65,172
8,13,35,126,104,230
20,21,55,658,420,1078
14,21,55,468,294,762
7,38,50,81,266,347
1,38,50,5,38,43
3,38,50,17,114,131
21,38,50,231,798,1029
21,42,54,241,882,1123
6,42,54,69,252,321
12,38,50,60,456,516
2,1266,2320,2015,2532,4547
1,1252,2295,951,1252,2203
2,420,769,667,840,1507
1,420,769,334,420,754
1,420,769,341,420,761
1,295,540,223,295,518
3,1266,2320,2884,3798,6682
1,1252,2295,997,1252,2249
3,295,540,719,885,1604
1,1266,2320,961,1266,2227
1,1266,2320,1031,1266,2297
1,1912,3400,740,1912,2652
1,713,1120,362,713,1075
1,487,783,124,487,611
3,2171,3578,2289,6513,8802
1,2171,3578,942,2171,3113
3,713,1120,751,2139,2890
2,713,1120,411,1426,1837
1,487,783,132,487,619
1,344,540,174,344,518
1,2171,3578,1335,2171,3506
4,26,70,173,104,277
1,26,70,34,26,60
12,26,70,520,312,832
23,3,9,130,69,199
20,2,5,44,40,84
18,2,5,40,36,76
2,2,5,4,4,8
1,1,2,1,1,2
10,1,2,9,10,19
31,2,5,91,62,153
32,2,5,94,64,158
11,1,2,11,11,22
17,1,2,16,17,33
10,1,2,9,10,19
11,11,30,206,121,327
17,11,30,318,187,505
9,11,30,168,99,267
5,11,30,94,55,149
18,2,5,52,36,88
18,2,5,52,36,88
19,9,25,295,171,466
31,1,2,30,31,61
25,1,2,25,25,50
10,11,30,127,110,237
17,2,5,36,34,70
9,2,5,19,18,37
12,1,4,30,12,42
17,1,4,43,17,60
19,9,25,219,171,390
11,9,25,127,99,226
16,2,5,46,32,78
17,1,2,16,17,33
18,2,5,41,36,77
29,2,5,67,58,125
12,1,2,12,12,24
1,1,2,1,1,2
14,1,4,41,14,55
3,1,4,9,3,12
2,1,2,1,2,3
27,1,2,15,27,42
1,1,4,2,1,3
17,1,4,37,17,54
13,2,5,25,26,51
26,2,5,49,52,101
4,1,2,4,4,8
17,2,5,32,34,66
16,2,5,30,32,62
26,2,5,49,52,101
3,1,2,2,3,5
12,1,2,7,12,19
1,8,21,13,8,21
1,8,21,13,8,21
29,2,5,61,58,119
2,1,4,6,2,8
12,1,4,34,12,46
18,2,5,38,36,74
6,2,5,13,12,25
1,1482,2384,854,1482,2336
1,1482,2384,854,1482,2336
27,45,120,1960,1215,3175
8,45,120,562,360,922
6,59,159,390,354,744
5,3,9,24,15,39
31,3,9,150,93,243
16,2,5,47,32,79
3,2,5,9,6,15
24,2,5,71,48,119
23,2,5,68,46,114
9,2,5,17,18,35
22,2,5,64,44,108
3,2,5,9,6,15
13,4,10,69,52,121
24,4,10,127,96,223
22,4,10,97,88,185
26,4,10,114,104,218
20,2,5,44,40,84
8,2,5,18,16,34
5,2,5,14,10,24
32,2,5,90,64,154
20,3,9,82,60,142
7,3,9,29,21,50
10,2,5,28,20,48
26,7,9,3,182,185
1,7,9,2,7,9
4,7,9,3,28,31
28,7,9,46,196,242
31,7,9,1,217,218
8,7,9,15,56,71
19,7,9,0,133,133
5,7,9,7,35,42
7,3,8,34,21,55
11,3,8,53,33,86
14,3,8,62,42,104
21,3,8,83,63,146
2,8,22,19,16,35
10,8,22,111,80,191
16,8,22,161,128,289
24,8,22,325,192,517
5,8,22,69,40,109
17,8,22,234,136,370
31,8,22,311,248,559
23,9,24,339,207,546
7,9,24,75,63,138
23,13,35,490,299,789
11,13,35,192,143,335
26,13,35,563,338,901
18,13,35,390,234,624
22,13,35,453,286,739
15,13,35,220,195,415
25,13,35,436,325,761
14,13,35,220,182,402
17,13,35,362,221,583
1,13,35,22,13,35
28,13,35,400,364,764
18,13,35,390,234,624
2,13,35,43,26,69
1,13,35,22,13,35
6,13,35,124,78,202
12,13,35,247,156,403
9,13,35,185,117,302
6,21,55,197,126,323
26,38,50,78,988,1066
26,38,50,260,988,1248
30,42,54,101,1260,1361
9,38,50,104,342,446
20,38,50,20,760,780
18,38,50,198,684,882
24,38,50,276,912,1188
6,42,54,1,252,253
3,1266,2320,3023,3798,6821
2,1266,2320,1922,2532,4454
2,1252,2295,1122,2504,3626
1,1252,2295,951,1252,2203
2,420,769,667,840,1507
1,1252,2295,561,1252,1813
1,420,769,318,420,738
1,420,769,318,420,738
1,1252,2295,997,1252,2249
1,1898,3375,1443,1898,3341
2,1252,2295,1765,2504,4269
1,420,769,211,420,631
1,1898,3375,735,1898,2633
2,1252,2295,1443,2504,3947
1,1252,2295,630,1252,1882
1,713,1120,396,713,1109
1,2171,3578,942,2171,3113
2,1555,2443,1727,3110,4837
1,1519,2443,484,1519,2003
1,1519,2443,826,1519,2345
1,2171,3578,835,2171,3006
3,344,540,523,1032,1555
1,713,1120,329,713,1042
3,713,1120,616,2139,2755
3,344,540,296,1032,1328
14,26,70,596,364,960
22,3,9,124,66,190
18,1,2,17,18,35
8,1,2,8,8,16
26,1,2,17,26,43
22,12,33,368,264,632
10,12,33,167,120,287
13,11,29,230,143,373
2,11,29,35,22,57
2,12,33,39,24,63
22,12,33,433,264,697
15,2,5,44,30,74
29,2,5,84,58,142
30,2,5,87,60,147
28,2,5,83,56,139
26,12,33,512,312,824
27,12,33,558,324,882
13,1,2,9,13,22
10,2,5,30,20,50
2,2,5,6,4,10
12,2,5,35,24,59
24,2,5,70,48,118
20,1,4,50,20,70
11,1,2,11,11,22
22,1,2,22,22,44
3,1,2,3,3,6
12,13,35,247,156,403
15,13,35,309,195,504
22,2,5,62,44,106
1,2,5,3,2,5
20,11,30,356,220,576
18,11,30,320,198,518
15,11,30,267,165,432
10,1,2,7,10,17
8,1,2,6,8,14
2,1,2,1,2,3
5,1,2,5,5,10
19,1,2,11,19,30
15,1,2,10,15,25
7,1,2,4,7,11
26,1,2,17,26,43
13,1,2,8,13,21
15,2,5,35,30,65
1,2,5,2,2,4
18,1,4,51,18,69
1,1,4,3,1,4
4,2,5,8,8,16
27,2,5,51,54,105
6,9,25,77,54,131
5,9,25,64,45,109
13,9,25,166,117,283
20,9,25,255,180,435
9,1,2,6,9,15
8,1,2,5,8,13
3,1,4,6,3,9
2,461,742,250,922,1172
1,461,742,162,461,623
1,1482,2384,854,1482,2336
1,1482,2384,854,1482,2336
1,461,742,118,461,579
26,2,5,55,52,107
5,2,5,11,10,21
10,2,5,28,20,48
22,4,10,84,88,172
16,4,10,61,64,125
27,4,10,103,108,211
15,2,5,44,30,74
10,2,5,30,20,50
25,2,5,59,50,109
23,2,5,54,46,100
6,2,5,17,12,29
4,2,5,11,8,19
20,2,5,53,40,93
11,3,9,64,33,97
4,3,9,23,12,35
24,2,5,70,48,118
3,2,5,7,6,13
14,2,5,33,28,61
22,3,9,130,66,196
15,3,9,60,45,105
17,3,9,68,51,119
10,2,5,24,20,44
18,2,5,42,36,78
29,2,5,81,58,139
27,2,5,76,54,130
25,7,9,10,175,185
31,7,9,51,217,268
6,7,9,11,42,53
23,7,9,9,161,170
30,7,9,11,210,221
16,7,9,31,112,143
5,7,9,0,35,35
18,7,9,33,126,159
27,7,9,20,189,209
11,3,8,41,33,74
7,3,8,24,21,45
11,3,8,44,33,77
31,3,8,100,93,193
27,3,8,126,81,207
1,8,22,14,8,22
18,8,22,244,144,388
6,8,22,66,48,114
9,8,22,118,72,190
11,8,22,103,88,191
11,8,22,101,88,189
6,8,22,66,48,114
25,9,24,243,225,468
29,9,24,407,261,668
4,9,24,58,36,94
29,13,35,567,377,944
3,13,35,64,39,103
1,13,35,17,13,30
5,13,35,103,65,168
19,13,35,405,247,652
14,13,35,303,182,485
6,13,35,94,78,172
2,13,35,29,26,55
2,13,35,43,26,69
6,13,35,94,78,172
10,13,35,217,130,347
3,13,35,64,39,103
4,13,35,82,52,134
27,13,35,556,351,907
6,13,35,124,78,202
23,13,35,490,299,789
1,13,35,21,13,34
7,13,35,110,91,201
11,13,35,161,143,304
18,13,35,257,234,491
20,13,35,286,260,546
12,13,35,172,156,328
5,21,55,134,105,239
2,21,55,50,42,92
7,21,55,188,147,335
28,21,55,613,588,1201
14,21,55,468,294,762
3,42,54,33,126,159
23,38,50,230,874,1104
17,42,54,85,714,799
3,42,54,2,126,128
2,1266,2320,2015,2532,4547
2,1252,2295,1122,2504,3626
2,420,769,683,840,1523
2,308,565,311,616,927
1,1266,2320,636,1266,1902
1,420,769,203,420,623
1,1266,2320,544,1266,1810
3,420,769,955,1260,2215
1,1252,2295,997,1252,2249
1,1252,2295,997,1252,2249
1,1252,2295,538,1252,1790
1,420,769,249,420,669
2,1252,2295,1076,2504,3580
1,713,1120,362,713,1075
1,1555,2443,717,1555,2272
1,1555,2443,790,1555,2345
3,2171,3578,1967,6513,8480
3,487,783,794,1461,2255
3,344,540,232,1032,1264
3,713,1120,784,2139,2923
1,1519,2443,900,1519,2419
1,344,540,83,344,427
28,26,70,801,728,1529
31,26,70,1321,806,2127
13,26,70,554,338,892
14,13,35,298,182,480
26,13,35,554,338,892
4,8,21,34,32,66
4,8,21,34,32,66
1,1,2,1,1,2
6,1,2,3,6,9
12,13,35,256,156,412
1,13,35,21,13,34
7,12,33,117,84,201
7,12,33,117,84,201
3,1,2,2,3,5
2,1,2,1,2,3
14,1,2,9,14,23
13,2,5,38,26,64
23,2,5,67,46,113
3,2,5,9,6,15
12,1,2,12,12,24
4,1,2,4,4,8
4,2,5,8,8,16
5,2,5,10,10,20
27,9,25,425,243,668
13,1,2,12,13,25
17,1,2,17,17,34
10,1,2,9,10,19
5,9,25,75,45,120
6,9,25,90,54,144
15,9,25,225,135,360
10,2,5,29,20,49
11,2,5,32,22,54
6,1,2,6,6,12
6,1,2,6,6,12
2,11,29,35,22,57
26,2,5,75,52,127
5,2,5,15,10,25
24,12,33,330,288,618
13,12,33,179,156,335
8,1,4,20,8,28
16,1,4,39,16,55
13,1,2,12,13,25
10,1,2,10,10,20
14,1,4,30,14,44
8,1,4,17,8,25
16,1,4,35,16,51
9,1,4,21,9,30
29,1,4,66,29,95
12,1,2,7,12,19
5,2,5,14,10,24
10,2,5,28,20,48
10,2,5,28,20,48
24,9,25,360,216,576
7,9,25,105,63,168
4,9,25,60,36,96
6,8,21,62,48,110
25,8,21,257,200,457
18,1,2,10,18,28
6,9,25,77,54,131
5,2,5,15,10,25
26,2,5,75,52,127
1,461,742,147,461,608
3,1482,2384,2205,4446,6651
3,1482,2384,1776,4446,6222
1,461,742,185,461,646
3,1482,2384,1419,4446,5865
1,1482,2384,854,1482,2336
1,1482,2384,568,1482,2050
23,24,64,729,552,1281
16,24,64,630,384,1014
23,24,64,596,552,1148
15,24,64,475,360,835
4,24,64,127,96,223
9,45,120,664,405,1069
6,59,159,447,354,801
4,59,159,317,236,553
15,2,5,29,30,59
16,2,5,30,32,62
21,3,9,124,63,187
23,3,9,136,69,205
15,2,5,42,30,72
28,2,5,78,56,134
24,4,10,127,96,223
2,4,10,11,8,19
4,2,5,8,8,16
17,2,5,36,34,70
22,2,5,42,44,86
7,2,5,20,14,34
10,2,5,30,20,50
21,4,10,99,84,183
15,4,10,71,60,131
20,2,5,58,40,98
19,2,5,55,38,93
18,4,10,95,72,167
26,4,10,138,104,242
19,4,10,84,76,160
1,4,10,4,4,8
16,2,5,46,32,78
6,2,5,17,12,29
12,2,5,28,24,52
21,2,5,49,42,91
9,2,5,17,18,35
30,2,5,57,60,117
18,2,5,34,36,70
11,7,9,21,77,98
4,7,9,7,28,35
16,7,9,6,112,118
1,7,9,1,7,8
1,7,9,1,7,8
1,3,8,5,3,8
4,3,8,19,12,31
11,3,8,44,33,77
22,8,22,289,176,465
23,8,22,241,184,425
2,8,22,22,16,38
24,8,22,325,192,517
5,8,22,69,40,109
19,8,22,262,152,414
20,8,22,249,160,409
21,8,22,220,168,388
15,9,24,211,135,346
6,9,24,58,54,112
17,9,24,202,153,355
23,9,24,306,207,513
14,9,24,136,126,262
12,9,24,120,108,228
13,13,35,281,169,450
1,13,35,20,13,33
2,13,35,41,26,67
9,13,35,148,117,265
22,13,35,384,286,670
11,13,35,157,143,300
8,13,35,126,104,230
21,13,35,300,273,573
16,13,35,279,208,487
2,13,35,34,26,60
18,13,35,314,234,548
3,13,35,47,39,86
17,13,35,332,221,553
13,13,35,227,169,396
20,13,35,286,260,546
8,13,35,156,104,260
30,13,35,429,390,819
8,13,35,137,104,241
15,21,55,502,315,817
3,21,55,95,63,158
21,21,55,460,441,901
6,21,55,151,126,277
22,38,50,22,836,858
11,38,50,61,418,479
17,38,50,170,646,816
20,38,50,200,760,960
27,38,50,270,1026,1296
24,42,54,120,1008,1128
9,38,50,50,342,392
21,42,54,105,882,987
11,38,50,121,418,539
3,42,54,10,126,136
14,42,54,47,588,635
23,38,50,115,874,989
3,1266,2320,3023,3798,6821
1,1252,2295,882,1252,2134
1,420,769,341,420,761
2,1266,2320,1922,2532,4454
1,420,769,318,420,738
1,295,540,240,295,535
1,1266,2320,752,1266,2018
1,295,540,240,295,535
1,2171,3578,1157,2171,3328
1,1519,2443,484,1519,2003
1,2171,3578,942,2171,3113
1,1555,2443,839,1555,2394
1,1083,1701,312,1083,1395
1,487,783,265,487,752
1,1519,2443,606,1519,2125
1,344,540,185,344,529
1,344,540,158,344,502
1,1083,1701,499,1083,1582
1,487,783,171,487,658
1,2171,3578,1335,2171,3506
3,26,70,86,78,164
10,3,9,40,30,70
27,3,9,123,81,204
28,1,4,83,28,111
11,1,4,33,11,44
3,1,2,3,3,6
26,1,2,25,26,51
28,1,2,16,28,44
8,2,5,22,16,38
16,2,5,45,32,77
24,13,35,394,312,706
20,1,2,15,20,35
14,1,2,13,14,27
10,12,33,197,120,317
21,13,35,359,273,632
21,2,5,59,42,101
32,2,5,90,64,154
4,2,5,11,8,19
7,2,5,19,14,33
18,1,2,17,18,35
1,1,2,1,1,2
9,9,25,128,81,209
4,11,30,75,44,119
4,11,30,75,44,119
24,11,30,449,264,713
22,2,5,65,44,109
26,2,5,77,52,129
27,2,5,63,54,117
29,2,5,68,58,126
15,11,30,281,165,446
9,2,5,27,18,45
7,1,2,4,7,11
7,1,2,6,7,13
1,1,2,1,1,2
21,2,5,48,42,90
27,2,5,62,54,116
5,1,4,12,5,17
28,1,4,68,28,96
29,2,5,67,58,125
18,2,5,41,36,77
28,2,5,64,56,120
30,2,5,69,60,129
12,1,4,30,12,42
14,1,4,35,14,49
30,9,25,465,270,735
2,461,742,369,922,1291
1,1482,2384,592,1482,2074
3,1482,2384,1776,4446,6222
3,24,64,116,72,188
1,45,120,74,45,119
8,59,159,787,472,1259
1,59,159,71,59,130
4,2,5,11,8,19
3,2,5,8,6,14
14,2,5,41,28,69
26,4,10,120,104,224
13,4,10,60,52,112
4,4,10,18,16,34
31,2,5,90,62,152
15,2,5,44,30,74
20,2,5,42,40,82
17,2,5,36,34,70
26,3,9,119,78,197
21,3,9,96,63,159
11,4,10,43,44,87
1,4,10,4,4,8
19,2,5,55,38,93
16,2,5,34,32,66
16,3,9,70,48,118
9,2,5,27,18,45
7,2,5,21,14,35
5,3,9,21,15,36
27,3,9,111,81,192
12,3,9,48,36,84
17,4,10,66,68,134
25,4,10,98,100,198
11,7,9,1,77,78
11,7,9,9,77,86
4,7,9,3,28,31
24,7,9,9,168,177
30,7,9,55,210,265
14,7,9,25,98,123
12,7,9,10,84,94
1,7,9,0,7,7
24,3,8,95,72,167
27,3,8,87,81,168
21,8,22,285,168,453
18,8,22,248,144,392
15,8,22,151,120,271
2,8,22,27,16,43
32,8,22,349,256,605
26,8,22,353,208,561
25,8,22,345,200,545
30,9,24,436,270,706
24,9,24,348,216,564
9,13,35,129,117,246
3,13,35,65,39,104
7,13,35,149,91,240
1,13,35,21,13,34
30,13,35,587,390,977
5,13,35,87,65,152
9,13,35,141,117,258
14,13,35,303,182,485
30,13,35,440,390,830
6,13,35,117,78,195
14,13,35,298,182,480
5,13,35,103,65,168
1,13,35,22,13,35
28,13,35,606,364,970
1,13,35,21,13,34
25,13,35,541,325,866
19,13,35,411,247,658
19,13,35,298,247,545
20,13,35,426,260,686
11,13,35,234,143,377
14,21,55,461,294,755
22,38,50,253,836,1089
16,38,50,184,608,792
26,38,50,78,988,1066
3,42,54,7,126,133
25,38,50,25,950,975
10,38,50,85,380,465
12,38,50,36,456,492
2,38,50,11,76,87
3,42,54,13,126,139
15,42,54,123,630,753
18,38,50,198,684,882
15,38,50,165,570,735
28,38,50,252,1064,1316
15,38,50,165,570,735
14,42,54,9,588,597
3,1252,2295,3060,3756,6816
1,420,769,334,420,754
1,1252,2295,997,1252,2249
1,1266,2320,1008,1266,2274
1,1252,2295,630,1252,1882
1,1555,2443,546,1555,2101
1,2171,3578,1264,2171,3435
1,344,540,185,344,529
2,1555,2443,1727,3110,4837
2,1555,2443,1581,3110,4691
1,1083,1701,244,1083,1327
1,487,783,155,487,642
2,487,783,482,974,1456
1,344,540,158,344,502
3,344,540,475,1032,1507
3,344,540,296,1032,1328
1,713,1120,205,713,918
1,487,783,155,487,642
3,487,783,395,1461,1856
1,487,783,194,487,681
3,344,540,523,1032,1555
1,26,70,43,26,69
3,26,70,86,78,164
2,26,70,85,52,137
13,26,70,517,338,855
25,13,35,358,325,683
19,13,35,272,247,519
14,13,35,200,182,382
12,9,25,189,108,297
30,8,21,258,240,498
21,2,5,61,42,103
12,2,5,35,24,59
16,1,4,47,16,63
7,1,4,21,7,28
26,2,5,61,52,113
11,2,5,26,22,48
14,2,5,41,28,69
14,1,4,41,14,55
8,2,5,18,16,34
19,13,35,332,247,579
15,13,35,262,195,457
1,13,35,17,13,30
31,1,2,30,31,61
28,13,35,596,364,960
8,13,35,170,104,274
6,2,5,18,12,30
19,2,5,56,38,94
28,1,2,27,28,55
26,1,2,19,26,45
3,1,2,2,3,5
21,8,21,211,168,379
20,2,5,42,40,82
22,2,5,46,44,90
5,2,5,11,10,21
17,2,5,40,34,74
1,2,5,2,2,4
17,2,5,50,34,84
20,2,5,59,40,99
8,1,2,8,8,16
23,1,2,23,23,46
16,1,2,12,16,28
25,12,33,344,300,644
6,12,33,82,72,154
22,12,33,447,264,711
14,12,33,285,168,453
23,12,33,468,276,744
17,11,29,296,187,483
16,1,4,36,16,52
6,1,2,6,6,12
7,1,2,7,7,14
25,1,2,25,25,50
5,1,2,5,5,10
3,1,2,3,3,6
1,2,5,3,2,5
18,1,4,53,18,71
7,1,4,20,7,27
22,1,4,62,22,84
16,1,4,45,16,61
15,1,4,43,15,58
6,2,5,15,12,27
18,2,5,44,36,80
2,1482,2384,1613,2964,4577
1,755,1215,411,755,1166
1,461,742,125,461,586
3,1482,2384,1419,4446,5865
1,1482,2384,854,1482,2336
1,1482,2384,854,1482,2336
1,1482,2384,378,1482,1860
3,1482,2384,1133,4446,5579
1,461,742,229,461,690
1,755,1215,205,755,960
1,755,1215,302,755,1057
2,461,742,250,922,1172
29,24,64,1123,696,1819
9,24,64,279,216,495
5,45,120,297,225,522
1,45,120,70,45,115
9,3,9,53,27,80
25,4,10,105,100,205
23,4,10,97,92,189
14,4,10,81,56,137
6,3,9,32,18,50
17,2,5,49,34,83
1,2,5,3,2,5
5,2,5,10,10,20
4,2,5,8,8,16
2,2,5,6,4,10
12,2,5,35,24,59
3,2,5,9,6,15
7,2,5,20,14,34
7,2,5,20,14,34
9,4,10,52,36,88
1,2,5,2,2,4
12,2,5,28,24,52
20,2,5,42,40,82
19,2,5,55,38,93
13,2,5,38,26,64
31,2,5,73,62,135
25,3,9,101,75,176
22,3,9,88,66,154
14,2,5,27,28,55
11,7,9,1,77,78
2,7,9,4,14,18
23,7,9,44,161,205
17,7,9,31,119,150
29,7,9,55,203,258
18,7,9,0,126,126
7,7,9,0,49,49
15,7,9,6,105,111
12,7,9,10,84,94
4,7,9,7,28,35
26,7,9,50,182,232
29,3,8,115,87,202
6,8,22,55,48,103
14,8,22,184,112,296
26,8,22,244,208,452
10,8,22,100,80,180
17,8,22,234,136,370
20,8,22,183,160,343
25,9,24,369,225,594
1,9,24,12,9,21
6,9,24,58,54,112
23,13,35,490,299,789
12,13,35,260,156,416
17,13,35,267,221,488
20,13,35,328,260,588
11,13,35,238,143,381
4,13,35,87,52,139
8,13,35,165,104,269
24,13,35,520,312,832
7,13,35,149,91,240
15,13,35,262,195,457
12,13,35,172,156,328
4,13,35,63,52,115
29,13,35,506,377,883
1,13,35,21,13,34
13,13,35,277,169,446
11,13,35,161,143,304
21,13,35,330,273,603
18,13,35,383,234,617
24,21,55,763,504,1267
5,21,55,134,105,239
22,42,54,50,924,974
11,38,50,33,418,451
4,38,50,46,152,198
20,38,50,230,760,990
15,42,54,50,630,680
4,42,54,39,168,207
14,38,50,154,532,686
3,38,50,3,114,117
11,38,50,110,418,528
19,42,54,2,798,800
23,38,50,69,874,943
11,42,54,55,462,517
20,42,54,229,840,1069
20,42,54,218,840,1058
2,1266,2320,1505,2532,4037
3,1266,2320,1909,3798,5707
1,1252,2295,745,1252,1997
1,1252,2295,1020,1252,2272
1,1266,2320,729,1266,1995
2,420,769,636,840,1476
1,1266,2320,567,1266,1833
1,1252,2295,997,1252,2249
1,1252,2295,676,1252,1928
3,308,565,466,924,1390
1,420,769,334,420,754
2,1266,2320,1087,2532,3619
1,1252,2295,997,1252,2249
1,1252,2295,538,1252,1790
1,2171,3578,620,2171,2791
2,2171,3578,2528,4342,6870
1,1519,2443,826,1519,2345
1,1083,1701,244,1083,1327
3,1083,1701,1650,3249,4899
1,344,540,77,344,421
3,344,540,296,1032,1328
1,713,1120,261,713,974
3,344,540,572,1032,1604
1,713,1120,261,713,974
1,487,783,194,487,681
1,2171,3578,620,2171,2791
2,713,1120,411,1426,1837
7,26,70,230,182,412
22,26,70,937,572,1509
18,26,70,779,468,1247
19,26,70,823,494,1317
14,3,9,75,42,117
8,8,21,69,64,133
3,8,21,26,24,50
23,13,35,490,299,789
22,13,35,469,286,755
22,2,5,65,44,109
16,2,5,38,32,70
5,2,5,15,10,25
8,2,5,24,16,40
16,2,5,47,32,79
28,2,5,83,56,139
17,2,5,50,34,84
9,2,5,27,18,45
9,1,4,21,9,30
3,2,5,9,6,15
3,2,5,9,6,15
26,2,5,49,52,101
15,2,5,29,30,59
23,2,5,44,46,90
19,1,4,47,19,66
28,1,4,69,28,97
26,1,2,25,26,51
17,1,2,17,17,34
9,1,2,9,9,18
3,2,5,9,6,15
13,2,5,38,26,64
17,11,30,282,187,469
13,11,30,216,143,359
15,8,21,154,120,274
7,11,29,112,77,189
8,11,29,142,88,230
20,11,29,354,220,574
22,1,2,12,22,34
27,12,33,371,324,695
24,12,33,330,288,618
14,12,33,285,168,453
19,11,29,331,209,540
31,1,2,17,31,48
12,1,2,7,12,19
28,8,21,340,224,564
20,8,21,243,160,403
15,1,2,9,15,24
18,8,21,166,144,310
5,1,2,5,5,10
2,1,2,2,2,4
23,8,21,289,184,473
18,8,21,226,144,370
20,8,21,252,160,412
3,461,742,554,1383,1937
2,1482,2384,1041,2964,4005
3,1482,2384,2634,4446,7080
1,1482,2384,592,1482,2074
2,1482,2384,1709,2964,4673
1,755,1215,436,755,1191
1,1482,2384,854,1482,2336
1,1482,2384,854,1482,2336
6,24,64,190,144,334
29,24,64,1123,696,1819
15,45,120,1107,675,1782
8,45,120,427,360,787
2,45,120,116,90,206
24,2,5,56,48,104
14,2,5,33,28,61
11,2,5,21,22,43
27,4,10,157,108,265
2,4,10,12,8,20
26,4,10,109,104,213
1,4,10,4,4,8
21,2,5,61,42,103
9,2,5,17,18,35
5,2,5,10,10,20
14,2,5,31,28,59
10,2,5,22,20,42
4,2,5,11,8,19
3,2,5,8,6,14
10,2,5,19,20,39
11,2,5,21,22,43
25,4,10,115,100,215
1,2,5,2,2,4
13,2,5,25,26,51
11,2,5,25,22,47
26,2,5,60,52,112
11,4,10,65,44,109
6,4,10,35,24,59
6,2,5,11,12,23
20,7,9,8,140,148
30,7,9,1,210,211
12,7,9,10,84,94
19,7,9,26,133,159
24,3,8,118,72,190
21,3,8,81,63,144
22,8,22,202,176,378
15,8,22,203,120,323
9,8,22,84,72,156
3,8,22,30,24,54
28,8,22,256,224,480
26,8,22,238,208,446
16,8,22,178,128,306
5,9,24,70,45,115
9,9,24,107,81,188
2,9,24,28,18,46
16,9,24,225,144,369
17,13,35,350,221,571
9,13,35,192,117,309
17,13,35,291,221,512
31,13,35,508,403,911
4,13,35,87,52,139
17,13,35,362,221,583
26,13,35,554,338,892
16,13,35,330,208,538
23,13,35,329,299,628
1,13,35,14,13,27
21,13,35,447,273,720
20,13,35,349,260,609
7,13,35,100,91,191
12,13,35,247,156,403
25,13,35,393,325,718
17,13,35,368,221,589
20,13,35,426,260,686
14,13,35,205,182,387
8,13,35,114,104,218
3,13,35,52,39,91
6,13,35,86,78,164
1,13,35,17,13,30
19,13,35,332,247,579
16,13,35,218,208,426
10,13,35,175,130,305
18,13,35,283,234,517
9,21,55,237,189,426
25,21,55,671,525,1196
1,21,55,21,21,42
27,42,54,134,1134,1268
1,38,50,9,38,47
15,38,50,165,570,735
2,38,50,22,76,98
14,42,54,47,588,635
12,42,54,53,504,557
29,38,50,160,1102,1262
13,42,54,107,546,653
21,38,50,210,798,1008
1,1252,2295,722,1252,1974
2,1266,2320,1087,2532,3619
1,1252,2295,538,1252,1790
1,1252,2295,997,1252,2249
2,1266,2320,1134,2532,3666
1,308,565,133,308,441
1,420,769,318,420,738
1,308,565,184,308,492
1,1266,2320,544,1266,1810
3,1252,2295,2165,3756,5921
1,308,565,184,308,492
1,1912,3400,1420,1912,3332
1,1898,3375,1410,1898,3308
1,1912,3400,740,1912,2652
1,2171,3578,620,2171,2791
3,2171,3578,2826,6513,9339
3,2171,3578,4114,6513,10627
1,1083,1701,584,1083,1667
1,487,783,194,487,681
1,344,540,185,344,529
2,344,540,370,688,1058
2,713,1120,657,1426,2083
1,487,783,194,487,681
3,344,540,377,1032,1409
2,713,1120,724,1426,2150
1,344,540,99,344,443
23,26,70,980,598,1578
9,26,70,314,234,548
11,26,70,384,286,670
8,3,9,47,24,71
25,3,9,110,75,185
7,1,2,5,7,12
10,1,4,30,10,40
7,1,2,4,7,11
3,13,35,64,39,103
19,2,5,53,38,91
4,1,2,2,4,6
6,1,2,3,6,9
17,2,5,39,34,73
10,2,5,30,20,50
10,2,5,30,20,50
27,2,5,80,54,134
6,1,4,18,6,24
24,1,4,71,24,95
24,2,5,71,48,119
5,2,5,15,10,25
25,13,35,533,325,858
27,13,35,575,351,926
3,1,2,2,3,5
4,13,35,63,52,115
6,1,2,3,6,9
25,1,2,14,25,39
4,1,2,2,4,6
17,2,5,50,34,84
24,1,2,22,24,46
7,9,25,110,63,173
11,9,25,173,99,272
6,9,25,95,54,149
20,2,5,47,40,87
23,2,5,54,46,100
13,1,2,12,13,25
14,1,2,13,14,27
16,11,30,218,176,394
5,11,30,68,55,123
20,1,2,11,20,31
26,1,2,15,26,41
5,1,2,3,5,8
29,1,2,16,29,45
13,1,4,35,13,48
28,11,30,515,308,823
3,11,30,55,33,88
8,8,21,97,64,161
18,1,4,42,18,60
1,1,4,2,1,3
13,9,25,150,117,267
16,9,25,184,144,328
28,2,5,53,56,109
12,2,5,23,24,47
7,1,4,15,7,22
13,1,4,28,13,41
7,1,2,4,7,11
3,1,2,2,3,5
13,1,2,11,13,24
8,1,2,7,8,15
23,2,5,67,46,113
15,2,5,44,30,74
1,461,742,185,461,646
2,1482,2384,1613,2964,4577
2,755,1215,823,1510,2333
1,755,1215,241,755,996
1,1482,2384,878,1482,2360
1,755,1215,193,755,948
1,1482,2384,378,1482,1860
2,461,742,206,922,1128
1,1482,2384,854,1482,2336
1,1482,2384,592,1482,2074
8,45,120,590,360,950
2,45,120,145,90,235
2,45,120,133,90,223
14,45,120,932,630,1562
10,59,159,936,590,1526
9,2,5,24,18,42
22,2,5,58,44,102
21,2,5,44,42,86
23,2,5,48,46,94
5,2,5,14,10,24
11,2,5,31,22,53
9,2,5,26,18,44
9,2,5,26,18,44
11,2,5,26,22,48
13,2,5,31,26,57
21,2,5,48,42,90
5,2,5,12,10,22
28,4,10,106,112,218
29,4,10,110,116,226
15,2,5,44,30,74
5,2,5,15,10,25
25,2,5,74,50,124
9,2,5,27,18,45
11,2,5,32,22,54
16,3,9,93,48,141
4,3,9,23,12,35
17,2,5,50,34,84
16,2,5,47,32,79
27,2,5,63,54,117
27,2,5,63,54,117
21,7,9,40,147,187
18,7,9,30,126,156
16,3,8,53,48,101
12,3,8,59,36,95
4,3,8,18,12,30
13,3,8,64,39,103
17,8,22,212,136,348
23,8,22,256,184,440
18,8,22,197,144,341
10,8,22,136,80,216
7,8,22,95,56,151
31,8,22,386,248,634
15,8,22,167,120,287
25,8,22,279,200,479
14,8,22,193,112,305
22,9,24,325,198,523
4,13,35,57,52,109
17,13,35,267,221,488
17,13,35,350,221,571
15,13,35,262,195,457
2,13,35,43,26,69
1,13,35,21,13,34
10,13,35,147,130,277
28,13,35,400,364,764
23,13,35,490,299,789
19,13,35,278,247,525
25,13,35,515,325,840
25,13,35,358,325,683
6,13,35,107,78,185
18,13,35,371,234,605
13,13,35,281,169,450
23,13,35,393,299,692
5,13,35,73,65,138
22,13,35,476,286,762
8,13,35,170,104,274
25,13,35,515,325,840
28,13,35,489,364,853
19,13,35,405,247,652
11,13,35,192,143,335
5,13,35,79,65,144
19,13,35,332,247,579
18,13,35,314,234,548
1,38,50,6,38,44
28,38,50,322,1064,1386
15,38,50,173,570,743
11,38,50,33,418,451
9,38,50,99,342,441
1,1252,2295,882,1252,2134
1,1266,2320,752,1266,2018
1,1252,2295,997,1252,2249
1,1252,2295,561,1252,1813
1,308,565,217,308,525
1,420,769,188,420,608
3,1266,2320,2675,3798,6473
1,420,769,249,420,669
2,295,540,468,590,1058
1,1252,2295,768,1252,2020
1,1266,2320,636,1266,1902
2,1519,2443,1653,3038,4691
1,487,783,155,487,642
1,1555,2443,864,1555,2419
1,1555,2443,448,1555,2003
1,2171,3578,620,2171,2791
3,1083,1701,1752,3249,5001
1,1555,2443,570,1555,2125
1,2171,3578,1335,2171,3506
3,344,540,377,1032,1409
5,3,9,30,15,45
17,3,9,82,51,133
11,3,9,52,33,85
22,2,5,64,44,108
27,2,5,78,54,132
6,2,5,18,12,30
3,1,2,3,3,6
15,1,2,13,15,28
27,2,5,76,54,130
31,2,5,87,62,149
5,1,4,15,5,20
31,12,33,518,372,890
29,2,5,67,58,125
1,2,5,2,2,4
8,2,5,23,16,39
5,2,5,15,10,25
4,2,5,12,8,20
6,2,5,17,12,29
13,1,4,28,13,41
10,11,30,151,110,261
4,1,2,3,4,7
19,1,2,14,19,33
20,2,5,42,40,82
1,2,5,2,2,4
16,1,2,10,16,26
4,1,2,3,4,7
7,1,2,6,7,13
6,1,4,17,6,23
20,1,4,57,20,77
1,1,2,1,1,2
5,1,2,5,5,10
9,1,2,6,9,15
10,1,2,7,10,17
8,1,2,5,8,13
19,1,4,47,19,66
18,1,4,45,18,63
8,1,2,5,8,13
23,1,2,16,23,39
28,2,5,81,56,137
7,11,30,106,77,183
21,11,30,317,231,548
16,11,30,242,176,418
9,1,4,26,9,35
4,1,2,4,4,8
21,1,2,20,21,41
4,1,2,4,4,8
1,11,30,18,11,29
1,11,30,18,11,29
27,11,30,497,297,794
18,1,2,15,18,33
15,1,2,13,15,28
25,2,5,70,50,120
24,2,5,67,48,115
9,2,5,25,18,43
2,1,2,1,2,3
22,1,2,13,22,35
3,2,5,8,6,14
17,2,5,48,34,82
1,2,5,2,2,4
3,1482,2384,2205,4446,6651
1,1482,2384,592,1482,2074
1,1482,2384,807,1482,2289
1,461,742,185,461,646
1,461,742,125,461,586
30,2,5,59,60,119
10,2,5,20,20,40
18,3,9,87,54,141
16,3,9,73,48,121
7,3,9,32,21,53
27,2,5,78,54,132
11,2,5,32,22,54
16,2,5,34,32,66
1,2,5,2,2,4
12,2,5,28,24,52
14,2,5,33,28,61
20,2,5,58,40,98
14,2,5,27,28,55
14,2,5,27,28,55
22,2,5,58,44,102
28,2,5,74,56,130
18,2,5,52,36,88
16,2,5,46,32,78
24,2,5,67,48,115
1,7,9,2,7,9
31,3,8,150,93,243
9,3,8,44,27,71
18,3,8,71,54,125
3,8,22,41,24,65
27,8,22,366,216,582
5,8,22,68,40,108
4,8,22,54,32,86
11,8,22,137,88,225
1,9,24,12,9,21
32,9,24,342,288,630
2,9,24,24,18,42
13,13,35,254,169,423
29,13,35,597,377,974
29,13,35,597,377,974
27,13,35,471,351,822
11,13,35,238,143,381
27,13,35,556,351,907
11,13,35,227,143,370
17,13,35,350,221,571
1,13,35,16,13,29
4,13,35,85,52,137
20,13,35,335,260,595
26,13,35,554,338,892
5,13,35,100,65,165
12,13,35,188,156,344
14,13,35,190,182,372
22,13,35,376,286,662
11,21,55,362,231,593
8,42,54,87,336,423
20,42,54,2,840,842
20,42,54,197,840,1037
5,42,54,57,210,267
10,38,50,115,380,495
9,38,50,45,342,387
26,38,50,130,988,1118
11,38,50,55,418,473
3,420,769,1001,1260,2261
2,1266,2320,1505,2532,4037
1,1266,2320,1008,1266,2274
1,308,565,155,308,463
1,1266,2320,1008,1266,2274
1,420,769,334,420,754
1,1252,2295,882,1252,2134
3,2171,3578,1860,6513,8373
1,487,783,155,487,642
3,487,783,465,1461,1926
2,713,1120,500,1426,1926
1,344,540,174,344,518
1,1555,2443,570,1555,2125
1,487,783,194,487,681
1,1555,2443,864,1555,2419
2,1083,1701,1032,2166,3198
2,713,1120,411,1426,1837
3,344,540,523,1032,1555
1,713,1120,329,713,1042
28,26,70,801,728,1529
12,3,9,58,36,94
31,1,2,29,31,60
16,8,21,137,128,265
19,8,21,163,152,315
17,8,21,146,136,282
7,9,25,89,63,152
7,9,25,89,63,152
5,2,5,15,10,25
18,2,5,53,36,89
6,12,33,90,72,162
8,1,2,7,8,15
23,1,4,52,23,75
16,1,4,36,16,52
24,1,4,55,24,79
10,8,21,126,80,206
15,1,4,34,15,49
5,1,4,11,5,16
9,1,4,21,9,30
30,1,4,72,30,102
12,1,4,29,12,41
12,1,2,8,12,20
19,1,4,55,19,74
13,12,33,213,156,369
13,12,33,213,156,369
26,2,5,51,52,103
5,2,5,10,10,20
1,2,5,3,2,5
26,2,5,73,52,125
22,1,2,16,22,38
25,1,2,19,25,44
31,2,5,84,62,146
14,2,5,38,28,66
1,2,5,3,2,5
10,2,5,30,20,50
26,2,5,77,52,129
9,9,25,115,81,196
3,9,25,38,27,65
17,1,2,9,17,26
16,1,2,14,16,30
21,1,2,18,21,39
1,461,742,125,461,586
1,461,742,162,461,623
3,1482,2384,2563,4446,7009
1,755,1215,375,755,1130
1,1482,2384,473,1482,1955
6,24,64,225,144,369
3,2,5,8,6,14
14,2,5,37,28,65
1,2,5,3,2,5
24,2,5,71,48,119
10,2,5,30,20,50
13,2,5,38,26,64
23,2,5,68,46,114
20,3,9,97,60,157
25,3,9,121,75,196
1,4,10,5,4,9
23,2,5,64,46,110
14,2,5,39,28,67
9,2,5,25,18,43
30,2,5,84,60,144
1,2,5,3,2,5
25,2,5,70,50,120
1,4,10,6,4,10
23,2,5,67,46,113
17,4,10,99,68,167
15,4,10,87,60,147
23,2,5,51,46,97
17,2,5,37,34,71
17,2,5,45,34,79
26,3,9,151,78,229
4,3,9,23,12,35
25,2,5,73,50,123
16,3,9,90,48,138
4,3,9,23,12,35
17,7,9,31,119,150
7,7,9,10,49,59
19,7,9,36,133,169
26,7,9,50,182,232
2,7,9,3,14,17
20,7,9,36,140,176
3,7,9,2,21,23
26,3,8,122,78,200
31,3,8,153,93,246
26,3,8,128,78,206
1,8,22,12,8,20
11,8,22,149,88,237
6,8,22,81,48,129
31,8,22,427,248,675
27,8,22,366,216,582
21,8,22,234,168,402
18,8,22,248,144,392
13,8,22,171,104,275
12,9,24,177,108,285
18,9,24,261,162,423
9,9,24,131,81,212
12,9,24,174,108,282
17,9,24,247,153,400
18,9,24,214,162,376
19,9,24,267,171,438
22,9,24,246,198,444
26,9,24,365,234,599
7,13,35,122,91,213
2,13,35,43,26,69
15,13,35,293,195,488
5,13,35,79,65,144
20,13,35,412,260,672
2,13,35,41,26,67
15,13,35,320,195,515
6,13,35,128,78,206
27,13,35,575,351,926
19,13,35,371,247,618
9,13,35,195,117,312
10,13,35,213,130,343
18,13,35,383,234,617
6,13,35,128,78,206
29,13,35,618,377,995
19,13,35,332,247,579
6,38,50,60,228,288
11,38,50,110,418,528
8,42,54,40,336,376
30,38,50,300,1140,1440
12,42,54,131,504,635
11,42,54,120,462,582
7,38,50,77,266,343
25,42,54,246,1050,1296
15,42,54,75,630,705
10,38,50,115,380,495
9,42,54,30,378,408
21,38,50,231,798,1029
1,1266,2320,892,1266,2158
1,1252,2295,1020,1252,2272
1,1252,2295,745,1252,1997
1,1252,2295,951,1252,2203
1,420,769,318,420,738
1,295,540,240,295,535
1,308,565,234,308,542
1,1266,2320,961,1266,2227
1,1266,2320,1008,1266,2274
2,1266,2320,2015,2532,4547
2,2171,3578,1526,4342,5868
1,487,783,280,487,767
1,487,783,280,487,767
1,1555,2443,864,1555,2419
1,1555,2443,790,1555,2345
1,1555,2443,790,1555,2345
2,487,783,310,974,1284
1,487,783,194,487,681
2,344,540,370,688,1058
1,1083,1701,550,1083,1633
1,1519,2443,533,1519,2052
1,1555,2443,497,1555,2052
1,2171,3578,1335,2171,3506
3,344,540,523,1032,1555
3,713,1120,1087,2139,3226
15,26,70,639,390,1029
3,26,70,130,78,208
27,26,70,1169,702,1871
13,26,70,554,338,892
23,26,70,996,598,1594
19,1,2,13,19,32
21,1,2,15,21,36
25,1,2,18,25,43
28,1,2,20,28,48
7,2,5,20,14,34
23,12,33,453,276,729
18,12,33,354,216,570
7,2,5,20,14,34
13,2,5,36,26,62
14,2,5,39,28,67
8,2,5,17,16,33
1,2,5,2,2,4
2,12,33,33,24,57
10,12,33,167,120,287
15,1,2,14,15,29
22,1,2,20,22,42
3,1,2,2,3,5
5,1,2,3,5,8
6,8,21,75,48,123
29,8,21,365,232,597
1,11,30,18,11,29
1,11,30,18,11,29
22,1,2,12,22,34
25,1,2,14,25,39
12,1,4,29,12,41
21,1,4,51,21,72
23,1,2,22,23,45
24,1,2,23,24,47
11,2,5,32,22,54
4,2,5,12,8,20
17,2,5,50,34,84
28,2,5,81,56,137
8,1,2,6,8,14
3,1,2,2,3,5
1,1,2,1,1,2
4,1,4,12,4,16
4,1,4,8,4,12
4,1,4,8,4,12
25,9,25,319,225,544
2,2,5,5,4,9
6,2,5,14,12,26
2,1482,2384,1184,2964,4148
2,1482,2384,1184,2964,4148
1,1482,2384,807,1482,2289
3,755,1215,1307,2265,3572
1,461,742,266,461,727
10,24,64,394,240,634
5,24,64,158,120,278
2,45,120,107,90,197
1,45,120,73,45,118
30,2,5,63,60,123
18,2,5,38,36,74
27,2,5,62,54,116
22,2,5,51,44,95
16,2,5,45,32,77
24,2,5,67,48,115
5,4,10,27,20,47
20,2,5,59,40,99
7,2,5,21,14,35
11,3,9,53,33,86
6,3,9,29,18,47
20,3,9,113,60,173
24,3,9,135,72,207
22,2,5,42,44,86
2,2,5,4,4,8
28,2,5,53,56,109
11,2,5,21,22,43
16,2,5,46,32,78
12,3,9,71,36,107
4,3,9,23,12,35
28,3,9,163,84,247
24,2,5,55,48,103
29,2,5,67,58,125
3,3,9,16,9,25
28,3,9,150,84,234
6,2,5,14,12,26
6,2,5,14,12,26
7,2,5,20,14,34
6,2,5,17,12,29
18,7,9,13,126,139
21,7,9,34,147,181
8,7,9,15,56,71
25,3,8,97,75,172
16,8,22,217,128,345
22,8,22,298,176,474
14,8,22,174,112,286
13,8,22,145,104,249
30,8,22,275,240,515
7,8,22,76,56,132
1,8,22,14,8,22
14,8,22,193,112,305
12,9,24,120,108,228
20,9,24,290,180,470
26,9,24,365,234,599
10,9,24,148,90,238
5,9,24,59,45,104
17,9,24,239,153,392
5,13,35,107,65,172
27,13,35,528,351,879
1,13,35,17,13,30
19,13,35,371,247,618
1,13,35,14,13,27
6,13,35,86,78,164
27,13,35,585,351,936
12,13,35,188,156,344
12,13,35,188,156,344
3,13,35,65,39,104
5,13,35,73,65,138
8,13,35,165,104,269
29,13,35,425,377,802
30,13,35,471,390,861
12,13,35,256,156,412
29,13,35,597,377,974
1,13,35,21,13,34
24,13,35,511,312,823
15,13,35,204,195,399
27,13,35,575,351,926
20,13,35,286,260,546
6,13,35,88,78,166
6,21,55,191,126,317
9,21,55,227,189,416
10,21,55,269,210,479
4,38,50,12,152,164
20,42,54,218,840,1058
26,38,50,260,988,1248
28,38,50,238,1064,1302
14,42,54,2,588,590
25,38,50,275,950,1225
17,42,54,186,714,900
16,38,50,136,608,744
27,42,54,266,1134,1400
20,38,50,230,760,990
1,1266,2320,1008,1266,2274
3,420,769,886,1260,2146
1,420,769,334,420,754
2,1252,2295,1902,2504,4406
2,1266,2320,2015,2532,4547
1,1252,2295,676,1252,1928
1,1252,2295,538,1252,1790
1,1266,2320,544,1266,1810
3,1252,2295,2165,3756,5921
2,308,565,503,616,1119
1,1266,2320,752,1266,2018
1,1252,2295,722,1252,1974
1,1555,2443,448,1555,2003
3,487,783,841,1461,2302
1,1083,1701,244,1083,1327
3,2171,3578,2826,6513,9339
1,487,783,155,487,642
1,487,783,155,487,642
1,713,1120,161,713,874
1,713,1120,385,713,1098
2,713,1120,769,1426,2195
3,344,540,475,1032,1507
2,2171,3578,1240,4342,5582
2,344,540,349,688,1037
1,1083,1701,550,1083,1633
1,344,540,158,344,502
1,487,783,194,487,681
1,26,70,41,26,67
15,26,70,639,390,1029
9,26,70,383,234,617
24,3,9,116,72,188
29,3,9,132,87,219
22,3,9,130,66,196
15,2,5,29,30,59
6,2,5,12,12,24
13,1,2,12,13,25
20,2,5,53,40,93
6,2,5,16,12,28
28,1,2,27,28,55
29,1,4,82,29,111
19,1,4,54,19,73
14,1,2,8,14,22
19,1,2,11,19,30
13,1,2,8,13,21
27,1,2,16,27,43
15,1,2,14,15,29
2,1,2,2,2,4
17,2,5,45,34,79
24,2,5,64,48,112
13,1,2,12,13,25
7,13,35,122,91,213
21,13,35,366,273,639
20,9,25,300,180,480
25,2,5,53,50,103
3,2,5,7,6,13
18,2,5,42,36,78
28,13,35,489,364,853
4,1,4,9,4,13
1,1,4,2,1,3
32,1,2,19,32,51
16,1,2,9,16,25
9,11,30,128,99,227
8,1,2,6,8,14
22,1,2,16,22,38
21,1,2,12,21,33
26,1,2,25,26,51
4,1,2,2,4,6
8,1,4,17,8,25
12,1,4,26,12,38
13,9,25,195,117,312
17,9,25,255,153,408
32,2,5,74,64,138
23,2,5,53,46,99
16,8,21,201,128,329
13,8,21,164,104,268
2,2,5,4,4,8
30,2,5,57,60,117
3,1482,2384,1562,4446,6008
3,1482,2384,2205,4446,6651
1,1482,2384,401,1482,1883
1,755,1215,302,755,1057
1,1482,2384,807,1482,2289
3,461,742,821,1383,2204
1,1482,2384,330,1482,1812
1,461,742,266,461,727
2,1482,2384,1709,2964,4673
1,461,742,118,461,579
13,24,64,404,312,716
27,24,64,1045,648,1693
18,24,64,559,432,991
1,24,64,32,24,56
3,59,159,214,177,391
4,3,9,15,12,27
11,3,9,42,33,75
9,2,5,19,18,37
2,2,5,4,4,8
11,4,10,65,44,109
10,4,10,59,40,99
15,2,5,44,30,74
19,2,5,55,38,93
28,2,5,78,56,134
12,2,5,34,24,58
30,2,5,87,60,147
16,3,9,90,48,138
9,2,5,26,18,44
14,2,5,41,28,69
7,2,5,20,14,34
23,2,5,67,46,113
25,2,5,59,50,109
8,2,5,19,16,35
7,2,5,21,14,35
25,3,9,146,75,221
7,4,10,41,28,69
8,2,5,18,16,34
8,2,5,18,16,34
16,2,5,38,32,70
19,2,5,45,38,83
27,7,9,44,189,233
2,7,9,2,14,16
5,7,9,7,35,42
24,7,9,18,168,186
21,7,9,38,147,185
27,7,9,52,189,241
23,7,9,32,161,193
22,3,8,106,66,172
8,3,8,37,24,61
23,3,8,86,69,155
18,8,22,244,144,388
4,8,22,38,32,70
5,8,22,68,40,108
11,8,22,115,88,203
27,8,22,366,216,582
8,8,22,108,64,172
3,8,22,30,24,54
10,8,22,109,80,189
1,8,22,11,8,19
19,8,22,258,152,410
8,8,22,80,64,144
11,8,22,137,88,225
29,9,24,268,261,529
13,9,24,151,117,268
9,9,24,133,81,214
1,9,24,15,9,24
23,13,35,393,299,692
13,13,35,213,169,382
18,13,35,390,234,624
26,13,35,536,338,874
6,13,35,94,78,172
6,13,35,128,78,206
32,13,35,659,416,1075
22,13,35,469,286,755
30,13,35,618,390,1008
6,13,35,128,78,206
24,13,35,520,312,832
11,13,35,157,143,300
2,13,35,43,26,69
21,13,35,359,273,632
24,13,35,520,312,832
13,13,35,268,169,437
19,13,35,411,247,658
26,13,35,554,338,892
4,13,35,85,52,137
24,13,35,511,312,823
8,13,35,140,104,244
30,13,35,471,390,861
16,13,35,251,208,459
26,13,35,536,338,874
4,13,35,87,52,139
24,13,35,511,312,823
7,13,35,149,91,240
3,13,35,47,39,86
6,13,35,117,78,195
15,21,55,337,315,652
13,21,55,428,273,701
25,42,54,125,1050,1175
30,38,50,90,1140,1230
8,42,54,36,336,372
22,42,54,15,924,939
10,38,50,110,380,490
6,38,50,51,228,279
1,1252,2295,951,1252,2203
1,1252,2295,951,1252,2203
2,1266,2320,1505,2532,4037
3,1252,2295,2165,3756,5921
1,420,769,341,420,761
1,1252,2295,997,1252,2249
1,420,769,241,420,661
1,1266,2320,567,1266,1833
1,420,769,249,420,669
1,1252,2295,538,1252,1790
3,1266,2320,2884,3798,6682
1,295,540,207,295,502
3,1912,3400,3036,5736,8772
1,1252,2295,538,1252,1790
1,2171,3578,1371,2171,3542
3,1555,2443,2591,4665,7256
2,344,540,349,688,1037
2,344,540,252,688,940
1,1083,1701,550,1083,1633
1,344,540,99,344,443
1,487,783,132,487,619
2,344,540,381,688,1069
1,344,540,99,344,443
1,713,1120,329,713,1042
13,3,9,76,39,115
6,3,9,35,18,53
14,3,9,81,42,123
31,2,5,90,62,152
12,2,5,35,24,59
17,2,5,49,34,83
4,2,5,12,8,20
24,1,4,57,24,81
11,12,33,227,132,359
28,12,33,579,336,915
15,13,35,257,195,452
4,1,4,11,4,15
12,11,30,221,132,353
9,11,30,166,99,265
2,9,25,30,18,48
3,9,25,45,27,72
28,1,4,69,28,97
29,2,5,86,58,144
11,1,4,31,11,42
25,1,4,71,25,96
27,1,4,77,27,104
26,1,2,17,26,43
30,13,35,492,390,882
23,13,35,377,299,676
14,2,5,41,28,69
22,1,2,21,22,43
7,2,5,16,14,30
17,2,5,40,34,74
25,1,4,73,25,98
11,1,4,32,11,43
1,1,4,3,1,4
5,1,4,15,5,20
1,1,4,2,1,3
5,1,2,3,5,8
30,2,5,87,60,147
3,1,2,2,3,5
6,1,2,3,6,9
25,1,4,71,25,96
7,1,4,17,7,24
26,2,5,49,52,101
23,8,21,265,184,449
9,8,21,104,72,176
16,11,29,256,176,432
26,11,29,415,286,701
22,1,4,64,22,86
24,1,4,70,24,94
3,1482,2384,990,4446,5436
1,1482,2384,807,1482,2289
1,1482,2384,807,1482,2289
1,755,1215,411,755,1166
2,1482,2384,1041,2964,4005
1,1482,2384,473,1482,1955
1,1482,2384,878,1482,2360
1,755,1215,436,755,1191
1,755,1215,290,755,1045
3,461,742,798,1383,2181
5,24,64,133,120,253
2,45,120,100,90,190
8,45,120,581,360,941
2,45,120,92,90,182
18,45,120,1048,810,1858
3,59,159,238,177,415
15,2,5,44,30,74
18,2,5,50,36,86
1,2,5,3,2,5
19,2,5,55,38,93
10,2,5,29,20,49
23,2,5,61,46,107
8,2,5,21,16,37
9,2,5,25,18,43
1,2,5,3,2,5
23,4,10,129,92,221
22,4,10,123,88,211
9,2,5,21,18,39
19,3,9,102,57,159
10,2,5,30,20,50
26,3,9,107,78,185
3,3,9,12,9,21
20,7,9,8,140,148
20,7,9,18,140,158
6,7,9,10,42,52
13,3,8,63,39,102
6,8,22,56,48,104
7,8,22,95,56,151
27,8,22,366,216,582
26,8,22,358,208,566
28,9,24,333,252,585
20,9,24,281,180,461
24,9,24,348,216,564
18,9,24,261,162,423
4,13,35,59,52,111
26,13,35,381,338,719
3,13,35,62,39,101
24,13,35,410,312,722
17,13,35,362,221,583
3,13,35,62,39,101
11,13,35,234,143,377
26,13,35,399,338,737
19,13,35,332,247,579
13,13,35,277,169,446
9,13,35,192,117,309
6,13,35,124,78,202
12,13,35,214,156,370
26,13,35,554,338,892
7,13,35,100,91,191
6,13,35,105,78,183
20,13,35,391,260,651
2,13,35,43,26,69
15,21,55,494,315,809
24,21,55,790,504,1294
11,38,50,110,418,528
28,38,50,308,1064,1372
14,42,54,9,588,597
10,38,50,110,380,490
25,38,50,250,950,1200
26,42,54,17,1092,1109
1,1912,3400,774,1912,2686
1,1252,2295,882,1252,2134
2,1266,2320,1922,2532,4454
2,1266,2320,1273,2532,3805
1,1266,2320,752,1266,2018
1,308,565,251,308,559
1,295,540,234,295,529
1,1266,2320,497,1266,1763
1,420,769,295,420,715
1,2171,3578,1264,2171,3435
2,1519,2443,1506,3038,4544
1,713,1120,329,713,1042
1,344,540,158,344,502
1,487,783,265,487,752
3,344,540,523,1032,1555
1,2171,3578,1371,2171,3542
1,344,540,77,344,421
1,344,540,174,344,518
3,487,783,395,1461,1856
13,26,70,408,338,746
12,3,9,49,36,85
9,1,2,9,9,18
14,1,2,9,14,23
18,1,2,12,18,30
8,1,2,8,8,16
1,1,2,1,1,2
7,1,2,7,7,14
26,1,2,19,26,45
2,1,2,1,2,3
16,1,2,9,16,25
15,1,2,9,15,24
1,1,2,1,1,2
18,2,5,41,36,77
24,2,5,67,48,115
21,2,5,59,42,101
28,2,5,78,56,134
27,1,2,19,27,46
23,1,2,17,23,40
15,2,5,35,30,65
15,2,5,35,30,65
13,1,2,10,13,23
17,1,2,13,17,30
22,2,5,64,44,108
27,2,5,78,54,132
5,9,25,71,45,116
17,2,5,50,34,84
32,9,25,368,288,656
20,9,25,230,180,410
19,2,5,55,38,93
27,11,30,335,297,632
22,11,30,273,242,515
6,1,2,3,6,9
14,1,2,8,14,22
7,1,2,7,7,14
7,8,21,67,56,123
7,8,21,67,56,123
23,8,21,222,184,406
12,2,5,23,24,47
26,1,2,25,26,51
15,1,2,14,15,29
8,1,4,20,8,28
25,8,21,315,200,515
12,8,21,151,96,247
22,1,2,16,22,38
11,1,2,8,11,19
1,1482,2384,401,1482,1883
1,461,742,140,461,601
1,1482,2384,807,1482,2289
1,1482,2384,616,1482,2098
1,1482,2384,401,1482,1883
3,1482,2384,2563,4446,7009
2,1482,2384,1136,2964,4100
1,1482,2384,854,1482,2336
1,1482,2384,854,1482,2336
1,461,742,266,461,727
16,24,64,568,384,952
23,45,120,1697,1035,2732
3,45,120,218,135,353
16,3,9,95,48,143
28,3,9,165,84,249
4,4,10,16,16,32
14,2,5,27,28,55
28,2,5,53,56,109
25,2,5,59,50,109
13,2,5,31,26,57
5,2,5,11,10,21
1,2,5,2,2,4
13,2,5,25,26,51
25,2,5,48,50,98
22,4,10,128,88,216
14,4,10,81,56,137
15,2,5,29,30,59
23,2,5,45,46,91
24,2,5,67,48,115
32,3,9,132,96,228
8,3,9,33,24,57
4,2,5,12,8,20
26,3,9,147,78,225
14,7,9,23,98,121
18,7,9,34,126,160
6,7,9,11,42,53
10,7,9,8,70,78
8,7,9,0,56,56
18,3,8,64,54,118
1,8,22,9,8,17
10,8,22,92,80,172
25,8,22,273,200,473
22,8,22,303,176,479
24,9,24,268,216,484
28,9,24,326,252,578
9,9,24,90,81,171
2,13,35,41,26,67
22,13,35,361,286,647
30,13,35,618,390,1008
18,13,35,283,234,517
21,13,35,308,273,581
25,13,35,489,325,814
4,13,35,57,52,109
20,13,35,391,260,651
14,13,35,239,182,421
19,13,35,332,247,579
2,13,35,43,26,69
7,13,35,103,91,194
2,13,35,29,26,55
25,13,35,410,325,735
26,13,35,554,338,892
8,13,35,170,104,274
12,13,35,197,156,353
22,13,35,384,286,670
27,13,35,585,351,936
15,13,35,320,195,515
14,13,35,205,182,387
3,13,35,62,39,101
16,21,55,509,336,845
18,38,50,180,684,864
7,38,50,81,266,347
3,42,54,2,126,128
7,42,54,35,294,329
1,42,54,10,42,52
26,42,54,3,1092,1095
12,42,54,131,504,635
2,38,50,20,76,96
1,1252,2295,538,1252,1790
1,1266,2320,1031,1266,2297
1,295,540,126,295,421
3,1266,2320,1700,3798,5498
1,1252,2295,722,1252,1974
1,2171,3578,1264,2171,3435
1,2171,3578,1335,2171,3506
1,1519,2443,753,1519,2272
1,2171,3578,942,2171,3113
1,1083,1701,244,1083,1327
1,2171,3578,835,2171,3006
3,2171,3578,1967,6513,8480
1,713,1120,329,713,1042
1,1555,2443,497,1555,2052
1,1555,2443,497,1555,2052
1,1519,2443,533,1519,2052
1,1519,2443,411,1519,1930
1,1083,1701,397,1083,1480
1,344,540,77,344,421
1,344,540,185,344,529
1,1083,1701,261,1083,1344
3,487,783,395,1461,1856
3,344,540,523,1032,1555
29,26,70,1195,754,1949
16,26,70,693,416,1109
29,26,70,992,754,1746
30,3,9,177,90,267
22,3,9,128,66,194
26,3,9,126,78,204
20,3,9,95,60,155
20,2,5,58,40,98
25,2,5,73,50,123
3,2,5,9,6,15
11,1,2,6,11,17
7,1,2,4,7,11
5,13,35,107,65,172
6,11,29,80,66,146
20,11,29,267,220,487
16,13,35,330,208,538
7,13,35,144,91,235
13,9,25,156,117,273
23,1,2,23,23,46
18,1,4,49,18,67
14,2,5,27,28,55
18,2,5,34,36,70
5,2,5,11,10,21
18,2,5,38,36,74
11,1,4,27,11,38
26,2,5,77,52,129
23,2,5,68,46,114
1,1,4,3,1,4
21,1,4,57,21,78
1,1,4,3,1,4
1,2,5,3,2,5
16,2,5,47,32,79
20,1,2,19,20,39
27,1,2,26,27,53
13,1,4,31,13,44
17,8,21,175,136,311
3,8,21,36,24,60
14,2,5,27,28,55
3,2,5,6,6,12
5,11,29,58,55,113
18,2,5,38,36,74
2,2,5,4,4,8
6,8,21,73,48,121
1,755,1215,448,755,1203
1,1482,2384,473,1482,1955
1,461,742,125,461,586
1,1482,2384,854,1482,2336
1,1482,2384,854,1482,2336
1,755,1215,436,755,1191
1,1482,2384,854,1482,2336
1,461,742,125,461,586
2,461,742,369,922,1291
1,1482,2384,568,1482,2050
1,1482,2384,854,1482,2336
2,461,742,503,922,1425
6,24,64,159,144,303
15,24,64,562,360,922
9,45,120,502,405,907
18,2,5,50,36,86
17,2,5,48,34,82
5,2,5,13,10,23
5,2,5,13,10,23
15,3,9,89,45,134
21,3,9,124,63,187
14,2,5,41,28,69
3,2,5,9,6,15
12,2,5,34,24,58
2,4,10,12,8,20
6,4,10,35,24,59
26,4,10,122,104,226
12,2,5,25,24,49
18,2,5,38,36,74
32,4,10,186,128,314
31,4,10,180,124,304
8,2,5,18,16,34
10,2,5,23,20,43
2,3,9,11,6,17
19,3,9,102,57,159
32,2,5,93,64,157
24,2,5,70,48,118
25,3,9,103,75,178
19,3,9,78,57,135
18,2,5,52,36,88
9,2,5,26,18,44
13,7,9,25,91,116
15,7,9,12,105,117
19,7,9,16,133,149
11,7,9,20,77,97
4,7,9,3,28,31
20,7,9,36,140,176
11,7,9,0,77,77
19,7,9,35,133,168
25,3,8,111,75,186
24,8,22,220,192,412
12,8,22,126,96,222
1,8,22,14,8,22
12,8,22,163,96,259
9,8,22,94,72,166
26,8,22,358,208,566
11,8,22,149,88,237
26,8,22,261,208,469
6,8,22,55,48,103
18,8,22,248,144,392
5,8,22,69,40,109
6,8,22,83,48,131
20,8,22,276,160,436
1,9,24,12,9,21
7,9,24,93,63,156
5,9,24,67,45,112
28,9,24,272,252,524
2,9,24,29,18,47
2,13,35,29,26,55
8,13,35,137,104,241
12,13,35,209,156,365
14,13,35,205,182,387
19,13,35,411,247,658
18,13,35,390,234,624
6,13,35,94,78,172
2,13,35,35,26,61
8,13,35,170,104,274
1,13,35,20,13,33
2,13,35,29,26,55
26,13,35,445,338,783
20,13,35,328,260,588
1,13,35,16,13,29
9,13,35,176,117,293
21,13,35,433,273,706
14,21,55,468,294,762
1,21,55,33,21,54
8,21,55,180,168,348
21,38,50,231,798,1029
17,38,50,94,646,740
16,38,50,176,608,784
29,42,54,238,1218,1456
21,42,54,3,882,885
24,38,50,264,912,1176
13,42,54,149,546,695
25,42,54,111,1050,1161
20,42,54,46,840,886
24,42,54,16,1008,1024
3,1252,2295,2991,3756,6747
1,1252,2295,882,1252,2134
1,1252,2295,882,1252,2134
1,1252,2295,676,1252,1928
2,1252,2295,1994,2504,4498
1,1266,2320,1008,1266,2274
2,1252,2295,1352,2504,3856
2,1266,2320,2062,2532,4594
3,1252,2295,1683,3756,5439
1,1266,2320,752,1266,2018
1,1266,2320,892,1266,2158
1,1266,2320,544,1266,1810
1,1252,2295,997,1252,2249
3,1252,2295,1614,3756,5370
1,1898,3375,1038,1898,2936
3,2171,3578,4006,6513,10519
1,487,783,194,487,681
1,1555,2443,839,1555,2394
1,2171,3578,1335,2171,3506
2,1555,2443,750,3110,3860
1,1519,2443,533,1519,2052
1,344,540,120,344,464
2,713,1120,344,1426,1770
2,2171,3578,2671,4342,7013
1,26,70,41,26,67
23,26,70,980,598,1578
20,3,9,118,60,178
26,3,9,126,78,204
11,3,9,62,33,95
6,3,9,24,18,42
5,13,35,108,65,173
13,13,35,281,169,450
21,9,25,226,189,415
15,11,30,281,165,446
28,11,30,524,308,832
19,9,25,299,171,470
26,9,25,410,234,644
15,1,2,14,15,29
16,1,2,12,16,28
22,2,5,52,44,96
5,13,35,72,65,137
7,1,4,19,7,26
8,1,4,22,8,30
13,1,2,9,13,22
17,1,2,12,17,29
26,2,5,77,52,129
7,2,5,21,14,35
2,1,2,1,2,3
26,1,2,15,26,41
23,12,33,316,276,592
9,1,4,26,9,35
22,1,4,55,22,77
23,1,4,57,23,80
18,1,4,45,18,63
5,1,2,5,5,10
1,461,742,177,461,638
3,1482,2384,2420,4446,6866
1,1482,2384,592,1482,2074
1,755,1215,302,755,1057
1,1482,2384,807,1482,2289
1,1482,2384,854,1482,2336
1,755,1215,436,755,1191
1,1482,2384,592,1482,2074
3,1482,2384,1419,4446,5865
1,461,742,251,461,712
10,24,64,394,240,634
5,59,159,468,295,763
15,4,10,71,60,131
1,4,10,5,4,9
9,2,5,19,18,37
7,2,5,15,14,29
22,2,5,62,44,106
27,2,5,76,54,130
28,2,5,81,56,137
7,4,10,32,28,60
1,4,10,5,4,9
1,4,10,6,4,10
13,4,10,73,52,125
23,2,5,51,46,97
9,2,5,20,18,38
4,2,5,8,8,16
15,2,5,35,30,65
31,2,5,73,62,135
8,2,5,23,16,39
12,2,5,35,24,59
9,4,10,34,36,70
6,2,5,11,12,23
6,2,5,11,12,23
13,2,5,38,26,64
22,2,5,64,44,108
22,2,5,48,44,92
8,2,5,18,16,34
21,2,5,49,42,91
23,2,5,54,46,100
6,2,5,11,12,23
26,2,5,49,52,101
14,2,5,31,28,59
13,2,5,29,26,55
19,2,5,45,38,83
13,2,5,31,26,57
11,2,5,31,22,53
23,2,5,64,46,110
26,7,9,24,182,206
27,7,9,10,189,199
20,7,9,38,140,178
4,7,9,7,28,35
16,7,9,6,112,118
18,7,9,33,126,159
14,7,9,8,98,106
19,7,9,26,133,159
18,3,8,87,54,141
16,3,8,77,48,125
13,3,8,50,39,89
16,3,8,79,48,127
28,3,8,111,84,195
27,3,8,107,81,188
16,8,22,217,128,345
10,8,22,138,80,218
10,9,24,119,90,209
19,9,24,221,171,392
3,9,24,29,27,56
16,9,24,171,144,315
5,9,24,49,45,94
16,9,24,186,144,330
27,9,24,314,243,557
14,13,35,200,182,382
19,13,35,391,247,638
20,13,35,342,260,602
20,13,35,314,260,574
4,13,35,57,52,109
2,13,35,43,26,69
21,13,35,411,273,684
12,13,35,172,156,328
15,13,35,309,195,504
4,13,35,87,52,139
4,13,35,87,52,139
28,13,35,596,364,960
25,13,35,393,325,718
26,13,35,445,338,783
19,13,35,405,247,652
14,13,35,298,182,480
4,13,35,87,52,139
8,13,35,137,104,241
27,13,35,528,351,879
8,13,35,156,104,260
27,13,35,471,351,822
13,21,55,413,273,686
11,21,55,295,231,526
27,42,54,309,1134,1443
1,42,54,4,42,46
24,42,54,275,1008,1283
10,42,54,17,420,437
21,42,54,14,882,896
1,1252,2295,997,1252,2249
3,420,769,724,1260,1984
1,308,565,155,308,463
1,1266,2320,729,1266,1995
3,295,540,703,885,1588
1,295,540,240,295,535
1,308,565,251,308,559
1,1252,2295,997,1252,2249
1,2171,3578,978,2171,3149
1,1555,2443,351,1555,1906
1,1555,2443,717,1555,2272
1,713,1120,385,713,1098
1,487,783,288,487,775
1,1555,2443,570,1555,2125
1,713,1120,385,713,1098
1,2171,3578,620,2171,2791
1,344,540,185,344,529
1,1083,1701,584,1083,1667
1,487,783,132,487,619
1,713,1120,205,713,918
3,344,540,523,1032,1555
20,26,70,572,520,1092
27,3,9,118,81,199
2,3,9,9,6,15
25,3,9,146,75,221
16,8,21,205,128,333
21,8,21,269,168,437
27,9,25,425,243,668
17,1,2,16,17,33
6,1,2,6,6,12
4,1,2,4,4,8
13,1,2,13,13,26
9,1,2,9,9,18
1,1,2,1,1,2
2,13,35,43,26,69
24,13,35,511,312,823
20,2,5,48,40,88
26,2,5,55,52,107
10,2,5,21,20,41
30,1,2,22,30,52
24,1,2,17,24,41
4,1,2,3,4,7
23,1,2,17,23,40
9,1,2,6,9,15
5,1,2,5,5,10
14,1,2,14,14,28
11,11,30,196,121,317
14,11,30,249,154,403
30,9,25,428,270,698
9,9,25,128,81,209
25,1,2,17,25,42
3,11,30,45,33,78
7,12,33,103,84,187
6,2,5,17,12,29
25,2,5,73,50,123
16,1,2,16,16,32
6,9,25,90,54,144
8,9,25,120,72,192
29,1,2,28,29,57
13,1,2,13,13,26
12,1,2,12,12,24
16,1,2,16,16,32
4,1,2,4,4,8
24,1,4,59,24,83
3,1,4,7,3,10
21,1,2,18,21,39
25,8,21,288,200,488
22,8,21,254,176,430
16,8,21,184,128,312
22,2,5,64,44,108
22,2,5,58,44,102
21,2,5,56,42,98
24,2,5,55,48,103
23,2,5,53,46,99
26,1,2,19,26,45
28,11,29,309,308,617
1,1482,2384,521,1482,2003
2,1482,2384,1613,2964,4577
1,1482,2384,807,1482,2289
3,1482,2384,2420,4446,6866
1,755,1215,436,755,1191
11,59,159,873,649,1522
23,2,5,44,46,90
14,2,5,27,28,55
1,2,5,2,2,4
21,2,5,41,42,83
21,2,5,49,42,91
27,2,5,63,54,117
23,2,5,61,46,107
4,2,5,11,8,19
10,4,10,59,40,99
25,4,10,95,100,195
14,2,5,27,28,55
30,2,5,89,60,149
15,2,5,35,30,65
10,2,5,24,20,44
3,2,5,9,6,15
5,2,5,15,10,25
17,2,5,48,34,82
7,2,5,20,14,34
25,2,5,73,50,123
15,2,5,44,30,74
5,2,5,10,10,20
2,2,5,4,4,8
2,2,5,6,4,10
24,2,5,70,48,118
24,2,5,70,48,118
3,2,5,9,6,15
10,4,10,38,40,78
23,2,5,45,46,91
26,2,5,61,52,113
11,2,5,26,22,48
1,2,5,3,2,5
19,2,5,55,38,93
1,2,5,3,2,5
5,3,9,23,15,38
4,3,9,18,12,30
15,7,9,27,105,132
16,7,9,0,112,112
13,7,9,1,91,92
1,7,9,0,7,7
30,7,9,1,210,211
26,3,8,128,78,206
10,3,8,44,30,74
26,3,8,86,78,164
6,3,8,29,18,47
1,3,8,3,3,6
30,3,8,119,90,209
6,3,8,24,18,42
4,8,22,44,32,76
12,8,22,163,96,259
17,8,22,234,136,370
7,8,22,76,56,132
17,8,22,231,136,367
19,8,22,174,152,326
8,8,22,75,64,139
16,9,24,236,144,380
21,9,24,295,189,484
26,9,24,278,234,512
15,13,35,262,195,457
27,13,35,396,351,747
5,13,35,103,65,168
5,13,35,108,65,173
31,13,35,639,403,1042
4,13,35,82,52,134
2,13,35,41,26,67
28,13,35,410,364,774
25,13,35,533,325,858
6,13,35,128,78,206
1,13,35,21,13,34
13,13,35,222,169,391
25,13,35,541,325,866
16,13,35,274,208,482
17,21,55,569,357,926
10,21,55,269,210,479
1,21,55,22,21,43
11,42,54,55,462,517
18,42,54,177,756,933
7,38,50,77,266,343
14,38,50,119,532,651
22,42,54,15,924,939
27,42,54,62,1134,1196
25,42,54,246,1050,1296
18,38,50,180,684,864
12,38,50,132,456,588
26,38,50,78,988,1066
27,42,54,91,1134,1225
8,38,50,88,304,392
3,1266,2320,3023,3798,6821
1,1252,2295,882,1252,2134
1,420,769,334,420,754
1,1252,2295,607,1252,1859
2,295,540,479,590,1069
1,295,540,207,295,502
1,1252,2295,951,1252,2203
1,420,769,249,420,669
1,295,540,234,295,529
1,295,540,234,295,529
1,713,1120,362,713,1075
1,344,540,99,344,443
3,1519,2443,1599,4557,6156
1,487,783,288,487,775
3,1,2,3,3,6
21,13,35,447,273,720
2,13,35,43,26,69
11,2,5,31,22,53
17,2,5,48,34,82
20,2,5,38,40,78
1,2,5,2,2,4
23,2,5,53,46,99
23,2,5,44,46,90
20,2,5,38,40,78
2,9,25,31,18,49
28,9,25,434,252,686
20,9,25,310,180,490
25,2,5,48,50,98
24,2,5,46,48,94
28,1,2,16,28,44
19,1,2,11,19,30
3,1,4,9,3,12
28,1,4,80,28,108
13,13,35,268,169,437
17,13,35,350,221,571
27,13,35,556,351,907
21,2,5,62,42,104
21,2,5,62,42,104
7,2,5,20,14,34
22,2,5,64,44,108
25,9,25,394,225,619
16,9,25,252,144,396
5,1,2,3,5,8
6,1,2,3,6,9
6,11,30,107,66,173
14,1,4,41,14,55
9,1,4,27,9,36
10,8,21,92,80,172
26,1,2,19,26,45
24,11,29,418,264,682
19,1,4,45,19,64
21,8,21,255,168,423
11,8,21,134,88,222
25,2,5,70,50,120
13,1,2,8,13,21
24,9,25,306,216,522
16,9,25,204,144,348
7,1,2,5,7,12
19,1,2,19,19,38
16,1,2,14,16,30
12,1,2,10,12,22
31,2,5,87,62,149
16,1,4,40,16,56
26,2,5,55,52,107
1,2,5,2,2,4
4,1,4,11,4,15
3,1,4,9,3,12
28,1,4,68,28,96
14,1,4,34,14,48
29,1,2,21,29,50
1,1482,2384,401,1482,1883
1,1482,2384,401,1482,1883
1,1482,2384,807,1482,2289
2,1482,2384,803,2964,3767
3,461,742,554,1383,1937
2,24,64,52,48,100
6,24,64,236,144,380
3,24,64,89,72,161
9,59,159,886,531,1417
8,2,5,24,16,40
28,2,5,81,56,137
23,2,5,67,46,113
27,2,5,78,54,132
22,3,9,88,66,154
13,3,9,52,39,91
10,2,5,24,20,44
21,2,5,49,42,91
15,7,9,8,105,113
1,7,9,1,7,8
18,7,9,2,126,128
14,7,9,5,98,103
6,7,9,11,42,53
21,7,9,38,147,185
4,7,9,3,28,31
14,3,8,68,42,110
4,8,22,54,32,86
15,8,22,203,120,323
16,8,22,217,128,345
22,8,22,289,176,465
28,8,22,281,224,505
1,8,22,9,8,17
23,8,22,317,184,501
18,9,24,240,162,402
11,9,24,110,99,209
23,9,24,224,207,431
22,9,24,293,198,491
17,9,24,239,153,392
10,13,35,175,130,305
8,13,35,173,104,277
17,13,35,362,221,583
19,13,35,272,247,519
11,13,35,192,143,335
16,13,35,341,208,549
10,13,35,213,130,343
21,13,35,447,273,720
9,13,35,157,117,274
21,13,35,366,273,639
1,13,35,21,13,34
31,13,35,606,403,1009
11,13,35,157,143,300
24,13,35,511,312,823
19,13,35,332,247,579
4,13,35,57,52,109
18,13,35,264,234,498
17,21,55,382,357,739
6,21,55,197,126,323
28,21,55,921,588,1509
28,21,55,675,588,1263
1,42,54,11,42,53
15,38,50,128,570,698
11,42,54,1,462,463
27,42,54,266,1134,1400
8,38,50,88,304,392
24,38,50,72,912,984
14,38,50,154,532,686
1,1252,2295,538,1252,1790
1,1252,2295,997,1252,2249
1,1252,2295,745,1252,1997
1,420,769,334,420,754
2,1252,2295,1122,2504,3626
1,1266,2320,1008,1266,2274
1,1266,2320,892,1266,2158
2,420,769,421,840,1261
3,2171,3578,3470,6513,9983
2,487,783,561,974,1535
3,1555,2443,1711,4665,6376
1,713,1120,261,713,974
1,2171,3578,656,2171,2827
1,713,1120,385,713,1098
1,344,540,174,344,518
1,2171,3578,620,2171,2791
21,26,70,895,546,1441
19,1,4,56,19,75
23,1,4,68,23,91
16,1,2,9,16,25
30,1,2,17,30,47
7,1,2,4,7,11
10,2,5,30,20,50
7,2,5,21,14,35
17,1,2,16,17,33
13,1,2,12,13,25
1,1,2,1,1,2
6,1,2,4,6,10
22,1,2,16,22,38
6,1,2,5,6,11
9,2,5,17,18,35
15,2,5,29,30,59
19,2,5,36,38,74
17,2,5,32,34,66
9,13,35,192,117,309
32,13,35,682,416,1098
25,2,5,74,50,124
3,2,5,9,6,15
7,1,4,17,7,24
17,1,2,16,17,33
4,1,2,4,4,8
16,11,30,218,176,394
24,1,2,18,24,42
12,1,2,9,12,21
18,11,30,245,198,443
4,11,30,54,44,98
11,11,30,173,121,294
6,1,4,15,6,21
29,1,2,17,29,46
23,12,33,346,276,622
4,1,4,12,4,16
9,12,33,124,108,232
9,12,33,124,108,232
28,2,5,74,56,130
25,2,5,66,50,116
24,1,2,18,24,42
6,1,4,13,6,19
26,1,2,15,26,41
6,9,25,77,54,131
12,9,25,153,108,261
30,11,29,383,330,713
21,11,29,268,231,499
12,11,29,153,132,285
14,9,25,217,126,343
24,1,2,18,24,42
18,1,2,13,18,31
1,1482,2384,521,1482,2003
1,461,742,185,461,646
1,1482,2384,592,1482,2074
3,1482,2384,1419,4446,5865
6,45,120,356,270,626
25,4,10,118,100,218
21,4,10,99,84,183
2,2,5,5,4,9
24,2,5,56,48,104
2,4,10,9,8,17
17,2,5,49,34,83
18,2,5,52,36,88
12,2,5,35,24,59
3,4,10,17,12,29
25,4,10,145,100,245
11,2,5,32,22,54
27,2,5,80,54,134
21,2,5,59,42,101
5,2,5,14,10,24
18,2,5,40,36,76
27,2,5,59,54,113
24,2,5,67,48,115
1,2,5,3,2,5
2,7,9,4,14,18
21,7,9,40,147,187
27,7,9,22,189,211
26,7,9,-4,182,178
1,7,9,2,7,9
9,7,9,0,63,63
30,7,9,57,210,267
25,7,9,48,175,223
7,3,8,23,21,44
27,3,8,87,81,168
4,3,8,19,12,31
23,8,22,251,184,435
18,8,22,165,144,309
28,8,22,386,224,610
10,8,22,131,80,211
18,8,22,248,144,392
1,9,24,12,9,21
25,9,24,297,225,522
1,9,24,12,9,21
25,9,24,279,225,504
3,13,35,41,39,80
5,13,35,72,65,137
1,13,35,16,13,29
20,13,35,349,260,609
26,13,35,454,338,792
4,13,35,78,52,130
6,13,35,130,78,208
7,13,35,122,91,213
10,13,35,175,130,305
7,13,35,144,91,235
29,13,35,496,377,873
8,13,35,126,104,230
18,13,35,371,234,605
12,13,35,247,156,403
6,13,35,128,78,206
14,13,35,220,182,402
15,13,35,325,195,520
9,13,35,192,117,309
1,13,35,16,13,29
10,13,35,175,130,305
28,13,35,459,364,823
16,13,35,279,208,487
15,13,35,309,195,504
19,13,35,332,247,579
17,13,35,297,221,518
17,21,55,372,357,729
21,21,55,506,441,947
24,38,50,132,912,1044
14,38,50,42,532,574
15,38,50,173,570,743
25,38,50,138,950,1088
1,38,50,10,38,48
18,42,54,197,756,953
26,38,50,143,988,1131
2,1252,2295,1902,2504,4406
2,1266,2320,994,2532,3526
1,1266,2320,544,1266,1810
1,1252,2295,538,1252,1790
2,1266,2320,1458,2532,3990
1,420,769,334,420,754
2,1266,2320,1505,2532,4037
3,420,769,632,1260,1892
1,1266,2320,961,1266,2227
2,1252,2295,1765,2504,4269
1,1266,2320,636,1266,1902
2,1252,2295,1260,2504,3764
1,2171,3578,942,2171,3113
1,2171,3578,1264,2171,3435
1,1519,2443,606,1519,2125
1,487,783,155,487,642
1,713,1120,362,713,1075
1,487,783,265,487,752
3,2171,3578,2504,6513,9017
1,344,540,185,344,529
1,344,540,185,344,529
1,1519,2443,533,1519,2052
1,713,1120,396,713,1109
1,344,540,126,344,470
2,487,783,341,974,1315
3,344,540,523,1032,1555
26,26,70,1126,676,1802
7,3,9,34,21,55
15,3,9,60,45,105
23,3,9,136,69,205
27,3,9,130,81,211
23,13,35,490,299,789
20,13,35,426,260,686
15,2,5,29,30,59
20,2,5,59,40,99
6,2,5,13,12,25
9,2,5,19,18,37
27,9,25,425,243,668
30,11,30,453,330,783
28,11,30,423,308,731
11,11,29,141,121,262
9,9,25,104,81,185
18,9,25,207,162,369
5,2,5,13,10,23
24,2,5,64,48,112
17,12,33,256,204,460
16,1,2,12,16,28
22,1,2,16,22,38
5,1,4,10,5,15
25,1,2,19,25,44
12,1,2,9,12,21
3,2,5,9,6,15
13,1,2,12,13,25
24,1,2,16,24,40
16,1,2,11,16,27
6,1,2,4,6,10
6,2,5,13,12,25
26,2,5,55,52,107
28,1,4,76,28,104
1,1,4,3,1,4
13,1,2,12,13,25
17,2,5,39,34,73
4,2,5,9,8,17
8,2,5,17,16,33
21,2,5,44,42,86
12,8,21,146,96,242
6,8,21,73,48,121
9,8,21,109,72,181
24,12,33,330,288,618
29,8,21,280,232,512
21,2,5,62,42,104
29,2,5,86,58,144
17,2,5,49,34,83
8,2,5,23,16,39
8,1,2,6,8,14
24,1,2,18,24,42
17,1,4,48,17,65
28,1,4,80,28,108
4,1,4,11,4,15
9,1,2,6,9,15
28,2,5,81,56,137
2,1482,2384,1184,2964,4148
1,461,742,185,461,646
1,1482,2384,735,1482,2217
2,1482,2384,1756,2964,4720
1,1482,2384,592,1482,2074
4,59,159,375,236,611
10,59,159,936,590,1526
28,4,10,109,112,221
25,3,9,114,75,189
30,3,9,137,90,227
14,2,5,33,28,61
12,2,5,34,24,58
5,2,5,14,10,24
8,4,10,30,32,62
25,2,5,70,50,120
16,2,5,45,32,77
22,2,5,52,44,96
8,2,5,19,16,35
25,2,5,70,50,120
16,2,5,45,32,77
11,2,5,25,22,47
2,2,5,5,4,9
26,2,5,57,52,109
22,2,5,48,44,92
19,2,5,56,38,94
10,2,5,30,20,50
19,2,5,55,38,93
15,2,5,44,30,74
21,3,9,84,63,147
26,3,9,105,78,183
13,7,9,18,91,109
14,7,9,12,98,110
14,7,9,5,98,103
12,8,22,134,96,230
5,8,22,50,40,90
8,8,22,108,64,172
1,8,22,13,8,21
21,8,22,234,168,402
7,8,22,66,56,122
16,8,22,147,128,275
5,8,22,52,40,92
1,8,22,10,8,18
10,9,24,100,90,190
1,9,24,14,9,23
15,9,24,211,135,346
11,13,35,215,143,358
28,13,35,400,364,764
6,13,35,86,78,164
21,13,35,381,273,654
28,13,35,606,364,970
21,13,35,330,273,603
6,13,35,86,78,164
27,13,35,556,351,907
15,13,35,220,195,415
16,13,35,251,208,459
4,13,35,70,52,122
12,13,35,209,156,365
24,13,35,343,312,655
10,13,35,157,130,287
12,13,35,256,156,412
24,13,35,520,312,832
20,13,35,342,260,602
18,21,55,454,378,832
25,42,54,125,1050,1175
7,38,50,39,266,305
6,42,54,30,252,282
29,42,54,144,1218,1362
6,42,54,59,252,311
1,42,54,2,42,44
10,42,54,50,420,470
14,38,50,70,532,602
1,1252,2295,538,1252,1790
3,1266,2320,1631,3798,5429
3,1266,2320,2257,3798,6055
3,1266,2320,1909,3798,5707
1,1252,2295,951,1252,2203
1,1266,2320,961,1266,2227
1,1252,2295,722,1252,1974
2,308,565,469,616,1085
2,1266,2320,2062,2532,4594
1,713,1120,362,713,1075
2,2171,3578,1884,4342,6226
1,2171,3578,763,2171,2934
2,487,783,310,974,1284
1,487,783,265,487,752
1,713,1120,250,713,963
1,344,540,120,344,464
1,713,1120,261,713,974
3,344,540,523,1032,1555
2,487,783,310,974,1284
1,1555,2443,864,1555,2419
1,487,783,132,487,619
1,2171,3578,1335,2171,3506
1,2171,3578,1335,2171,3506
1,26,70,34,26,60
7,8,21,88,56,144
1,13,35,14,13,27
17,1,2,16,17,33
24,1,2,23,24,47
3,1,2,3,3,6
13,1,2,13,13,26
9,1,2,9,9,18
6,11,30,112,66,178
16,11,30,299,176,475
31,11,30,459,341,800
12,2,5,34,24,58
9,2,5,25,18,43
17,2,5,42,34,76
16,2,5,39,32,71
4,1,2,2,4,6
17,1,2,10,17,27
16,1,4,40,16,56
1,1,2,1,1,2
4,1,2,3,4,7
26,9,25,390,234,624
11,9,25,165,99,264
15,1,2,11,15,26
26,1,4,71,26,97
18,1,2,12,18,30
2,1,2,1,2,3
17,1,2,16,17,33
31,1,2,23,31,54
21,2,5,62,42,104
4,11,30,74,44,118
9,1,4,21,9,30
27,1,4,62,27,89
2,1,4,5,2,7
8,1,4,23,8,31
18,1,4,53,18,71
5,11,29,58,55,113
22,11,29,256,242,498
6,11,29,70,66,136
27,2,5,51,54,105
9,2,5,17,18,35
24,2,5,70,48,118
12,2,5,35,24,59
18,12,33,301,216,517
3,1482,2384,2205,4446,6651
2,1482,2384,755,2964,3719
3,1482,2384,1776,4446,6222
1,24,64,26,24,50
24,24,64,622,576,1198
2,45,120,145,90,235
19,4,10,101,76,177
28,2,5,81,56,137
13,2,5,38,26,64
18,2,5,52,36,88
23,2,5,67,46,113
21,2,5,61,42,103
28,2,5,66,56,122
2,2,5,5,4,9
23,2,5,61,46,107
15,2,5,40,30,70
28,2,5,53,56,109
2,2,5,4,4,8
18,2,5,52,36,88
4,2,5,12,8,20
26,2,5,69,52,121
23,2,5,68,46,114
27,2,5,80,54,134
1,3,9,6,3,9
5,3,9,28,15,43
5,2,5,15,10,25
25,2,5,74,50,124
20,2,5,59,40,99
2,2,5,6,4,10
9,7,9,7,63,70
28,7,9,23,196,219
17,7,9,0,119,119
8,7,9,15,56,71
10,7,9,14,70,84
21,7,9,8,147,155
9,3,8,40,27,67
18,3,8,87,54,141
18,8,22,244,144,388
1,8,22,14,8,22
20,8,22,183,160,343
6,8,22,67,48,115
6,8,22,81,48,129
13,8,22,171,104,275
25,8,22,279,200,479
19,9,24,185,171,356
11,9,24,160,99,259
11,9,24,160,99,259
21,9,24,280,189,469
1,13,35,21,13,34
27,13,35,556,351,907
7,13,35,125,91,216
20,13,35,314,260,574
17,13,35,332,221,553
23,13,35,329,299,628
24,13,35,511,312,823
16,13,35,313,208,521
19,13,35,272,247,519
3,13,35,44,39,83
10,13,35,143,130,273
25,13,35,533,325,858
24,13,35,494,312,806
3,13,35,47,39,86
16,13,35,234,208,442
15,13,35,293,195,488
12,21,55,395,252,647
5,21,55,159,105,264
11,21,55,295,231,526
16,21,55,430,336,766
20,21,55,669,420,1089
17,38,50,187,646,833
3,1266,2320,3023,3798,6821
1,1266,2320,1008,1266,2274
2,1252,2295,1902,2504,4406
3,1252,2295,2234,3756,5990
1,420,769,334,420,754
3,420,769,886,1260,2146
1,1252,2295,951,1252,2203
1,1252,2295,997,1252,2249
3,420,769,678,1260,1938
2,1252,2295,1765,2504,4269
1,1252,2295,882,1252,2134
1,1252,2295,1020,1252,2272
1,295,540,148,295,443
1,1252,2295,538,1252,1790
3,2171,3578,2826,6513,9339
1,2171,3578,656,2171,2827
1,1519,2443,411,1519,1930
1,2171,3578,1371,2171,3542
1,344,540,77,344,421
2,344,540,370,688,1058
1,713,1120,362,713,1075
1,2171,3578,1335,2171,3506
3,344,540,475,1032,1507
12,26,70,494,312,806
27,26,70,1150,702,1852
24,1,2,14,24,38
15,1,2,14,15,29
9,1,2,9,9,18
22,1,2,21,22,43
29,1,2,17,29,46
19,1,2,11,19,30
6,1,2,6,6,12
19,13,35,391,247,638
15,13,35,309,195,504
14,13,35,303,182,485
11,13,35,238,143,381
23,12,33,430,276,706
14,12,33,262,168,430
11,2,5,21,22,43
6,2,5,11,12,23
27,2,5,53,54,107
27,2,5,53,54,107
25,9,25,356,225,581
4,9,25,57,36,93
4,1,4,9,4,13
7,1,4,17,7,24
15,1,2,13,15,28
2,1,2,2,2,4
26,1,2,25,26,51
24,2,5,70,48,118
12,2,5,35,24,59
6,1,2,6,6,12
7,1,2,7,7,14
5,1,2,5,5,10
13,1,2,7,13,20
8,1,4,23,8,31
27,1,4,79,27,106
21,1,4,61,21,82
25,1,2,23,25,48
12,1,2,11,12,23
1,1,2,1,1,2
12,12,33,165,144,309
13,12,33,179,156,335
20,1,2,12,20,32
8,1,2,5,8,13
29,1,4,66,29,95
25,1,4,57,25,82
2,8,21,18,16,34
14,8,21,129,112,241
22,2,5,42,44,86
20,2,5,38,40,78
4,1,2,2,4,6
14,2,5,41,28,69
21,2,5,62,42,104
5,1,2,4,5,9
20,1,2,15,20,35
5,9,25,64,45,109
10,2,5,29,20,49
29,2,5,84,58,142
26,9,25,403,234,637
1,461,742,118,461,579
1,1482,2384,401,1482,1883
1,461,742,251,461,712
1,1482,2384,854,1482,2336
7,24,64,181,168,349
1,59,159,79,59,138
27,4,10,159,108,267
7,4,10,41,28,69
17,2,5,32,34,66
10,3,9,46,30,76
9,2,5,25,18,43
2,2,5,6,4,10
2,2,5,6,4,10
5,2,5,15,10,25
1,2,5,3,2,5
1,2,5,3,2,5
30,2,5,87,60,147
14,2,5,33,28,61
13,4,10,49,52,101
19,4,10,72,76,148
19,2,5,55,38,93
5,2,5,15,10,25
1,3,9,6,3,9
21,3,9,122,63,185
14,3,9,56,42,98
8,3,9,32,24,56
25,3,9,148,75,223
4,3,9,24,12,36
27,3,9,160,81,241
14,3,9,79,42,121
19,3,9,78,57,135
10,3,9,41,30,71
14,3,9,75,42,117
25,3,9,134,75,209
16,7,9,31,112,143
3,7,9,0,21,21
15,7,9,29,105,134
24,7,9,44,168,212
8,7,9,7,56,63
16,7,9,13,112,125
21,7,9,34,147,181
9,7,9,17,63,80
7,7,9,6,49,55
8,7,9,15,56,71
20,7,9,17,140,157
16,3,8,62,48,110
12,3,8,48,36,84
16,3,8,71,48,119
3,3,8,10,9,19
25,8,22,251,200,451
1,8,22,11,8,19
16,8,22,220,128,348
2,9,24,30,18,48
25,9,24,363,225,588
9,9,24,131,81,212
23,9,24,301,207,508
27,13,35,585,351,936
14,13,35,303,182,485
20,13,35,293,260,553
18,13,35,257,234,491
7,13,35,144,91,235
22,13,35,453,286,739
2,13,35,41,26,67
7,13,35,149,91,240
22,13,35,322,286,608
9,13,35,185,117,302
24,13,35,419,312,731
10,13,35,171,130,301
7,13,35,100,91,191
11,13,35,192,143,335
30,13,35,524,390,914
27,13,35,575,351,926
6,13,35,128,78,206
14,13,35,303,182,485
21,13,35,455,273,728
6,13,35,128,78,206
20,13,35,433,260,693
1,13,35,22,13,35
19,13,35,332,247,579
3,13,35,64,39,103
3,13,35,65,39,104
4,13,35,77,52,129
6,13,35,103,78,181
9,13,35,192,117,309
19,21,55,416,399,815
11,21,55,368,231,599
4,38,50,22,152,174
15,38,50,60,570,630
11,38,50,127,418,545
15,38,50,45,570,615
17,42,54,85,714,799
12,42,54,131,504,635
17,38,50,145,646,791
1,1252,2295,997,1252,2249
1,420,769,249,420,669
2,1252,2295,1260,2504,3764
1,420,769,249,420,669
1,1266,2320,729,1266,1995
1,1266,2320,544,1266,1810
1,1266,2320,1008,1266,2274
2,1266,2320,1273,2532,3805
3,1555,2443,1052,4665,5717
2,713,1120,523,1426,1949
1,2171,3578,1264,2171,3435
3,1083,1701,1191,3249,4440
1,487,783,280,487,767
1,2171,3578,656,2171,2827
3,487,783,724,1461,2185
3,1555,2443,1711,4665,6376
2,2171,3578,2742,4342,7084
1,344,540,77,344,421
1,2171,3578,1335,2171,3506
24,3,9,96,72,168
13,3,9,57,39,96
25,3,9,119,75,194
5,8,21,64,40,104
26,1,2,25,26,51
15,13,35,257,195,452
2,13,35,34,26,60
4,1,2,3,4,7
28,2,5,81,56,137
14,2,5,41,28,69
17,2,5,37,34,71
17,2,5,37,34,71
6,1,2,6,6,12
17,1,2,16,17,33
3,2,5,7,6,13
7,1,2,4,7,11
14,1,2,8,14,22
26,12,33,512,312,824
8,2,5,17,16,33
24,2,5,67,48,115
7,1,2,4,7,11
2,2,5,5,4,9
25,2,5,59,50,109
7,13,35,100,91,191
30,13,35,429,390,819
16,9,25,252,144,396
21,9,25,331,189,520
28,1,2,27,28,55
17,1,2,16,17,33
14,13,35,220,182,402
13,13,35,204,169,373
26,1,2,25,26,51
3,1,2,3,3,6
3,2,5,9,6,15
2,2,5,6,4,10
28,8,21,352,224,576
2,8,21,25,16,41
17,2,5,49,34,83
26,2,5,75,52,127
1,1,2,1,1,2
29,1,2,28,29,57
6,1,2,4,6,10
24,1,4,70,24,94
21,1,4,61,21,82
30,8,21,377,240,617
4,8,21,50,32,82
12,8,21,136,96,232
23,8,21,260,184,444
23,2,5,54,46,100
20,2,5,58,40,98
25,1,4,62,25,87
1,461,742,162,461,623
3,461,742,554,1383,1937
1,461,742,185,461,646
1,1482,2384,854,1482,2336
1,1482,2384,378,1482,1860
1,1482,2384,854,1482,2336
3,461,742,687,1383,2070
1,1482,2384,854,1482,2336
1,1482,2384,568,1482,2050
13,24,64,337,312,649
7,59,159,466,413,879
16,3,9,70,48,118
12,3,9,53,36,89
18,2,5,42,36,78
26,2,5,61,52,113
15,2,5,42,30,72
21,2,5,59,42,101
1,2,5,2,2,4
24,2,5,56,48,104
13,2,5,36,26,62
1,2,5,3,2,5
20,2,5,59,40,99
9,2,5,27,18,45
17,4,10,65,68,133
21,4,10,80,84,164
13,4,10,69,52,121
4,4,10,21,16,37
24,3,9,142,72,214
1,3,9,4,3,7
16,7,9,9,112,121
9,7,9,16,63,79
1,7,9,1,7,8
23,7,9,32,161,193
25,7,9,19,175,194
13,7,9,25,91,116
22,7,9,42,154,196
28,7,9,3,196,199
23,3,8,111,69,180
1,3,8,4,3,7
22,3,8,103,66,169
7,3,8,28,21,49
1,8,22,11,8,19
24,8,22,220,192,412
17,8,22,234,136,370
10,9,24,148,90,238
14,9,24,136,126,262
1,9,24,15,9,24
7,13,35,152,91,243
9,13,35,195,117,312
8,13,35,140,104,244
25,13,35,436,325,761
17,13,35,297,221,518
12,13,35,247,156,403
2,13,35,39,26,65
11,13,35,157,143,300
7,13,35,137,91,228
23,13,35,401,299,700
21,13,35,447,273,720
20,13,35,286,260,546
25,13,35,541,325,866
19,13,35,405,247,652
7,13,35,144,91,235
23,13,35,329,299,628
22,13,35,322,286,608
21,42,54,105,882,987
22,42,54,240,924,1164
3,42,54,2,126,128
16,42,54,71,672,743
22,42,54,252,924,1176
7,38,50,81,266,347
18,38,50,153,684,837
18,42,54,2,756,758
17,42,54,2,714,716
26,38,50,299,988,1287
12,38,50,12,456,468
29,38,50,319,1102,1421
16,42,54,11,672,683
3,1252,2295,2165,3756,5921
3,1252,2295,2234,3756,5990
1,1266,2320,544,1266,1810
1,1252,2295,951,1252,2203
3,1252,2295,2647,3756,6403
1,1266,2320,544,1266,1810
1,1266,2320,1008,1266,2274
3,1083,1701,935,3249,4184
1,2171,3578,1264,2171,3435
1,2171,3578,620,2171,2791
1,1555,2443,839,1555,2394
1,2171,3578,942,2171,3113
2,2171,3578,2313,4342,6655
2,2171,3578,1311,4342,5653
1,2171,3578,942,2171,3113
3,1555,2443,2591,4665,7256
1,487,783,265,487,752
1,2171,3578,1335,2171,3506
1,713,1120,205,713,918
1,1555,2443,864,1555,2419
12,26,70,520,312,832
6,3,9,35,18,53
10,1,2,6,10,16
12,1,2,7,12,19
30,1,2,29,30,59
13,1,2,13,13,26
22,13,35,469,286,755
4,13,35,85,52,137
26,1,2,15,26,41
3,1,2,2,3,5
18,12,33,301,216,517
6,12,33,100,72,172
4,2,5,8,8,16
20,1,2,20,20,40
1,2,5,3,2,5
14,2,5,41,28,69
15,2,5,44,30,74
2,2,5,5,4,9
6,2,5,14,12,26
20,2,5,47,40,87
9,1,2,8,9,17
32,1,2,29,32,61
22,1,2,12,22,34
11,9,25,171,99,270
11,9,25,171,99,270
27,1,4,67,27,94
28,1,4,69,28,97
25,1,2,15,25,40
6,1,2,3,6,9
13,1,2,8,13,21
3,1482,2384,1776,4446,6222
2,1482,2384,1184,2964,4148
1,1482,2384,878,1482,2360
16,4,10,78,64,142
27,2,5,57,54,111
18,2,5,53,36,89
1,2,5,3,2,5
11,2,5,25,22,47
19,2,5,44,38,82
3,4,10,11,12,23
13,2,5,25,26,51
30,2,5,57,60,117
20,2,5,59,40,99
20,2,5,59,40,99
1,3,9,6,3,9
1,3,9,6,3,9
23,2,5,51,46,97
26,2,5,57,52,109
27,2,5,72,54,126
14,2,5,37,28,65
3,7,9,0,21,21
25,7,9,46,175,221
28,7,9,51,196,247
19,7,9,11,133,144
4,7,9,3,28,31
24,3,8,78,72,150
14,3,8,69,42,111
17,8,22,156,136,292
27,8,22,366,216,582
20,8,22,271,160,431
11,8,22,110,88,198
11,8,22,137,88,225
10,8,22,100,80,180
16,8,22,220,128,348
6,9,24,89,54,143
17,9,24,226,153,379
11,13,35,238,143,381
24,13,35,436,312,748
9,13,35,129,117,246
12,13,35,209,156,365
18,13,35,314,234,548
15,13,35,236,195,431
15,13,35,262,195,457
4,13,35,68,52,120
21,13,35,330,273,603
19,13,35,405,247,652
6,13,35,86,78,164
7,13,35,149,91,240
3,13,35,52,39,91
1,21,55,24,21,45
1,42,54,11,42,53
6,42,54,27,252,279
21,38,50,105,798,903
21,38,50,231,798,1029
29,42,54,129,1218,1347
8,42,54,40,336,376
14,42,54,153,588,741
21,38,50,21,798,819
14,42,54,70,588,658
9,38,50,9,342,351
1,42,54,11,42,53
3,42,54,30,126,156
1,420,769,295,420,715
2,420,769,483,840,1323
1,295,540,126,295,421
2,420,769,421,840,1261
3,1266,2320,2884,3798,6682
3,1266,2320,1631,3798,5429
1,295,540,223,295,518
2,308,565,469,616,1085
1,295,540,148,295,443
1,1083,1701,380,1083,1463
1,1555,2443,790,1555,2345
1,2171,3578,942,2171,3113
2,1555,2443,1141,3110,4251
1,344,540,185,344,529
1,344,540,110,344,454
1,344,540,126,344,470
1,344,540,126,344,470
15,26,70,513,390,903
23,26,70,787,598,1385
1,26,70,43,26,69
19,26,70,663,494,1157
13,3,9,52,39,91
26,1,4,77,26,103
3,1,4,9,3,12
29,9,25,457,261,718
19,1,2,14,19,33
28,1,2,21,28,49
3,2,5,8,6,14
21,1,2,21,21,42
20,1,2,20,20,40
21,1,4,52,21,73
22,1,4,55,22,77
17,2,5,32,34,66
19,1,2,18,19,37
21,1,2,20,21,41
25,11,30,378,275,653
5,11,30,76,55,131
29,2,5,86,58,144
15,1,2,13,15,28
11,2,5,31,22,53
10,1,2,7,10,17
14,1,2,10,14,24
8,1,4,24,8,32
30,1,4,89,30,119
7,1,4,16,7,23
14,11,30,262,154,416
12,11,30,224,132,356
13,11,30,243,143,386
9,1,2,9,9,18
30,1,2,29,30,59
6,1,2,3,6,9
3,1,2,2,3,5
19,1,4,43,19,62
21,1,4,48,21,69
28,1,4,64,28,92
27,1,2,26,27,53
9,1,2,9,9,18
19,2,5,40,38,78
15,1,2,14,15,29
8,1,2,7,8,15
1,1,2,1,1,2
24,1,2,18,24,42
5,2,5,14,10,24
12,2,5,34,24,58
17,2,5,48,34,82
27,1,2,15,27,42
10,1,2,6,10,16
3,461,742,353,1383,1736
1,1482,2384,807,1482,2289
1,1482,2384,378,1482,1860
24,24,64,622,576,1198
22,24,64,781,528,1309
3,45,120,218,135,353
10,59,159,984,590,1574
28,2,5,74,56,130
31,2,5,82,62,144
18,4,10,70,72,142
14,4,10,55,56,111
31,3,9,175,93,268
28,3,9,158,84,242
28,3,9,128,84,212
7,3,9,32,21,53
20,4,10,116,80,196
22,4,10,128,88,216
20,4,10,116,80,196
19,2,5,55,38,93
19,2,5,53,38,91
17,2,5,48,34,82
17,2,5,49,34,83
20,2,5,58,40,98
27,2,5,63,54,117
20,2,5,58,40,98
30,2,5,54,60,114
22,2,5,40,44,84
25,2,5,59,50,109
16,2,5,38,32,70
22,3,9,130,66,196
17,2,5,37,34,71
11,2,5,24,22,46
18,3,9,102,54,156
13,3,9,63,39,102
1,3,9,4,3,7
26,3,9,107,78,185
20,7,9,38,140,178
14,7,9,12,98,110
2,7,9,4,14,18
13,7,9,5,91,96
11,7,9,20,77,97
22,7,9,12,154,166
8,7,9,7,56,63
26,3,8,128,78,206
22,3,8,106,66,172
17,3,8,67,51,118
1,3,8,3,3,6
14,8,22,156,112,268
22,8,22,206,176,382
11,8,22,149,88,237
1,9,24,11,9,20
18,9,24,214,162,376
1,9,24,14,9,23
15,9,24,146,135,281
9,9,24,107,81,188
25,9,24,249,225,474
19,13,35,371,247,618
8,13,35,114,104,218
2,13,35,41,26,67
7,13,35,122,91,213
29,13,35,597,377,974
15,13,35,257,195,452
1,13,35,17,13,30
25,13,35,515,325,840
8,13,35,114,104,218
13,13,35,281,169,450
18,13,35,314,234,548
18,13,35,390,234,624
9,13,35,129,117,246
18,13,35,257,234,491
18,13,35,314,234,548
6,13,35,94,78,172
18,21,55,454,378,832
13,21,55,413,273,686
5,21,55,134,105,239
9,21,55,202,189,391
11,42,54,37,462,499
7,38,50,28,266,294
30,42,54,295,1260,1555
12,42,54,8,504,512
15,42,54,10,630,640
20,38,50,230,760,990
22,42,54,252,924,1176
14,42,54,138,588,726
11,38,50,11,418,429
10,42,54,50,420,470
26,42,54,284,1092,1376
10,38,50,110,380,490
25,38,50,275,950,1225
18,42,54,90,756,846
1,1252,2295,951,1252,2203
2,1266,2320,1922,2532,4454
3,1252,2295,1683,3756,5439
1,1252,2295,676,1252,1928
1,1252,2295,676,1252,1928
1,1266,2320,752,1266,2018
1,420,769,334,420,754
1,1266,2320,567,1266,1833
1,420,769,318,420,738
1,1252,2295,745,1252,1997
1,420,769,318,420,738
1,295,540,223,295,518
3,1266,2320,1909,3798,5707
1,295,540,234,295,529
1,1252,2295,561,1252,1813
1,1266,2320,1008,1266,2274
2,2171,3578,2671,4342,7013
3,1083,1701,1497,3249,4746
2,2171,3578,2671,4342,7013
1,2171,3578,656,2171,2827
3,2171,3578,2826,6513,9339
1,344,540,174,344,518
3,713,1120,784,2139,2923
1,344,540,99,344,443
1,344,540,66,344,410
1,713,1120,329,713,1042
2,1083,1701,794,2166,2960
1,487,783,132,487,619
2,487,783,388,974,1362
1,344,540,126,344,470
1,2171,3578,1335,2171,3506
1,2171,3578,1335,2171,3506
1,1555,2443,864,1555,2419
28,26,70,1193,728,1921
23,26,70,658,598,1256
2,3,9,8,6,14
13,1,4,38,13,51
24,1,4,71,24,95
26,1,2,25,26,51
15,1,2,15,15,30
11,1,2,11,11,22
18,1,2,13,18,31
25,1,2,23,25,48
14,2,5,41,28,69
27,2,5,78,54,132
22,2,5,64,44,108
20,2,5,59,40,99
24,1,2,18,24,42
21,1,2,16,21,37
26,1,2,19,26,45
23,11,30,313,253,566
10,11,30,136,110,246
2,2,5,5,4,9
2,2,5,5,4,9
6,1,2,4,6,10
17,1,2,12,17,29
4,2,5,9,8,17
3,2,5,7,6,13
4,1,4,10,4,14
1,1,4,2,1,3
12,9,25,189,108,297
6,9,25,95,54,149
19,9,25,299,171,470
13,1,2,11,13,24
8,1,2,7,8,15
6,12,33,122,72,194
29,12,33,590,348,938
6,2,5,17,12,29
5,2,5,12,10,22
22,1,2,12,22,34
16,1,2,9,16,25
14,1,2,14,14,28
10,8,21,122,80,202
13,8,21,158,104,262
26,1,2,19,26,45
19,1,2,14,19,33
5,1,2,4,5,9
3,1482,2384,2420,4446,6866
2,461,742,325,922,1247
3,461,742,554,1383,1937
1,1482,2384,878,1482,2360
1,755,1215,411,755,1166
11,24,64,391,264,655
18,4,10,106,72,178
15,4,10,89,60,149
24,2,5,64,48,112
30,2,5,80,60,140
3,3,9,14,9,23
10,3,9,46,30,76
2,2,5,4,4,8
19,2,5,55,38,93
14,2,5,41,28,69
1,2,5,3,2,5
24,2,5,64,48,112
9,4,10,38,36,74
16,4,10,67,64,131
17,4,10,65,68,133
23,4,10,87,92,179
10,3,9,40,30,70
12,3,9,48,36,84
8,2,5,23,16,39
10,2,5,29,20,49
14,3,9,75,42,117
22,3,9,118,66,184
31,2,5,73,62,135
28,2,5,66,56,122
19,7,9,7,133,140
6,7,9,0,42,42
11,7,9,9,77,86
15,7,9,0,105,105
6,7,9,5,42,47
9,3,8,40,27,67
26,3,8,97,78,175
1,3,8,4,3,7
11,8,22,149,88,237
15,8,22,137,120,257
17,8,22,156,136,292
7,8,22,96,56,152
18,9,24,266,162,428
26,9,24,303,234,537
7,9,24,68,63,131
22,9,24,235,198,433
1,13,35,14,13,27
27,13,35,585,351,936
18,13,35,383,234,617
9,13,35,157,117,274
5,13,35,108,65,173
2,13,35,43,26,69
12,13,35,235,156,391
25,13,35,541,325,866
14,13,35,303,182,485
26,13,35,508,338,846
6,13,35,94,78,172
11,13,35,227,143,370
6,13,35,86,78,164
13,13,35,213,169,382
24,21,55,605,504,1109
5,21,55,110,105,215
2,38,50,11,76,87
26,38,50,78,988,1066
25,38,50,288,950,1238
10,38,50,30,380,410
11,42,54,126,462,588
24,38,50,276,912,1188
23,38,50,23,874,897
24,42,54,120,1008,1128
18,42,54,41,756,797
3,38,50,3,114,117
12,42,54,60,504,564
26,38,50,39,988,1027
3,1912,3400,3138,5736,8874
1,1252,2295,630,1252,1882
3,1252,2295,1614,3756,5370
3,308,565,652,924,1576
1,1266,2320,961,1266,2227
1,1266,2320,892,1266,2158
1,1266,2320,1031,1266,2297
1,420,769,249,420,669
2,1912,3400,2024,3824,5848
1,1266,2320,892,1266,2158
3,713,1120,1154,2139,3293
1,1519,2443,484,1519,2003
2,2171,3578,1884,4342,6226
1,1083,1701,244,1083,1327
3,2171,3578,2826,6513,9339
3,713,1120,1187,2139,3326
1,1555,2443,448,1555,2003
1,2171,3578,1371,2171,3542
1,1519,2443,411,1519,1930
1,2171,3578,620,2171,2791
17,26,70,593,442,1035
2,26,70,85,52,137
19,26,70,823,494,1317
14,26,70,489,364,853
25,26,70,1083,650,1733
19,26,70,823,494,1317
2,3,9,10,6,16
28,13,35,400,364,764
26,13,35,372,338,710
19,1,2,19,19,38
19,2,5,55,38,93
16,9,25,204,144,348
27,1,2,26,27,53
23,1,2,23,23,46
6,1,2,6,6,12
15,1,4,44,15,59
15,2,5,44,30,74
13,2,5,38,26,64
22,2,5,43,44,87
23,2,5,45,46,91
1,11,30,12,11,23
11,11,30,136,121,257
9,9,25,115,81,196
28,9,25,357,252,609
29,1,2,20,29,49
21,2,5,40,42,82
25,9,25,319,225,544
7,9,25,89,63,152
25,9,25,319,225,544
14,9,25,179,126,305
6,1,4,14,6,20
6,1,2,6,6,12
15,1,2,14,15,29
17,1,2,16,17,33
15,2,5,32,30,62
4,2,5,8,8,16
3,2,5,7,6,13
15,2,5,35,30,65
3,2,5,7,6,13
15,8,21,182,120,302
32,2,5,90,64,154
15,2,5,42,30,72
16,2,5,45,32,77
27,2,5,63,54,117
2,1482,2384,946,2964,3910
1,1482,2384,878,1482,2360
1,1482,2384,473,1482,1955
1,461,742,118,461,579
1,461,742,147,461,608
1,461,742,229,461,690
15,24,64,581,360,941
15,45,120,873,675,1548
5,45,120,267,225,492
8,45,120,581,360,941
6,59,159,562,354,916
20,2,5,59,40,99
5,2,5,15,10,25
4,2,5,8,8,16
12,2,5,25,24,49
17,4,10,100,68,168
22,4,10,130,88,218
9,2,5,25,18,43
17,2,5,48,34,82
5,4,10,28,20,48
9,2,5,24,18,42
1,2,5,3,2,5
18,2,5,53,36,89
9,2,5,20,18,38
14,2,5,31,28,59
21,2,5,48,42,90
30,2,5,69,60,129
11,2,5,24,22,46
1,2,5,2,2,4
19,4,10,110,76,186
22,2,5,64,44,108
12,2,5,35,24,59
30,3,9,137,90,227
10,3,9,46,30,76
22,2,5,62,44,106
4,2,5,11,8,19
18,2,5,50,36,86
11,2,5,26,22,48
24,2,5,56,48,104
14,2,5,29,28,57
10,2,5,21,20,41
29,2,5,68,58,126
23,2,5,54,46,100
23,7,9,44,161,205
1,7,9,2,7,9
21,7,9,40,147,187
2,7,9,1,14,15
28,7,9,53,196,249
25,7,9,41,175,216
21,7,9,8,147,155
3,7,9,0,21,21
32,7,9,12,224,236
15,7,9,8,105,113
17,7,9,0,119,119
15,7,9,6,105,111
27,3,8,87,81,168
24,3,8,118,72,190
19,8,22,258,152,410
21,8,22,229,168,397
9,8,22,82,72,154
10,8,22,131,80,211
19,8,22,262,152,414
5,8,22,56,40,96
4,9,24,37,36,73
10,9,24,148,90,238
26,9,24,303,234,537
5,9,24,70,45,115
13,13,35,213,169,382
2,13,35,29,26,55
24,13,35,377,312,689
22,13,35,476,286,762
22,13,35,315,286,601
32,13,35,693,416,1109
17,13,35,332,221,553
8,13,35,165,104,269
19,13,35,411,247,658
18,13,35,371,234,605
9,13,35,141,117,258
18,13,35,352,234,586
30,13,35,408,390,798
24,13,35,520,312,832
7,13,35,110,91,201
6,13,35,86,78,164
30,13,35,492,390,882
31,13,35,541,403,944
3,13,35,43,39,82
24,13,35,377,312,689
25,13,35,393,325,718
10,13,35,157,130,287
9,21,55,296,189,485
23,21,55,618,483,1101
4,38,50,46,152,198
6,42,54,59,252,311
14,42,54,153,588,741
2,42,54,10,84,94
4,38,50,46,152,198
25,42,54,111,1050,1161
6,42,54,66,252,318
1,38,50,1,38,39
26,42,54,284,1092,1376
1,38,50,1,38,39
20,42,54,197,840,1037
2,1912,3400,2704,3824,6528
1,1266,2320,961,1266,2227
1,1252,2295,1020,1252,2272
1,1266,2320,892,1266,2158
1,1266,2320,544,1266,1810
1,295,540,240,295,535
1,1252,2295,676,1252,1928
1,295,540,234,295,529
3,295,540,703,885,1588
1,420,769,211,420,631
3,1252,2295,1614,3756,5370
1,2171,3578,1371,2171,3542
2,1083,1701,794,2166,2960
1,487,783,108,487,595
1,1083,1701,380,1083,1463
2,2171,3578,1669,4342,6011
1,2171,3578,835,2171,3006
2,713,1120,321,1426,1747
1,487,783,155,487,642
2,1555,2443,1141,3110,4251
1,713,1120,261,713,974
1,487,783,132,487,619
1,713,1120,205,713,918
13,26,70,445,338,783
19,3,9,76,57,133
20,2,5,44,40,84
13,1,2,7,13,20
18,13,35,283,234,517
10,13,35,157,130,287
18,2,5,34,36,70
6,2,5,18,12,30
26,1,2,24,26,50
6,1,2,6,6,12
12,1,2,11,12,23
10,11,29,177,110,287
1,11,29,18,11,29
27,2,5,76,54,130
6,2,5,17,12,29
14,1,2,10,14,24
2,1,2,1,2,3
21,2,5,62,42,104
30,2,5,89,60,149
26,2,5,77,52,129
4,1,2,4,4,8
14,1,4,29,14,43
14,1,4,29,14,43
6,1,2,4,6,10
19,9,25,271,171,442
28,9,25,399,252,651
27,2,5,57,54,111
4,2,5,8,8,16
9,1,4,21,9,30
25,1,2,25,25,50
10,2,5,21,20,41
7,2,5,21,14,35
11,2,5,32,22,54
16,2,5,46,32,78
11,2,5,21,22,43
4,1,4,12,4,16
7,1,4,17,7,24
7,9,25,81,63,144
19,1,4,55,19,74
15,12,33,305,180,485
17,12,33,346,204,550
10,9,25,120,90,210
23,8,21,280,184,464
13,1,2,7,13,20
25,1,4,62,25,87
29,1,4,72,29,101
13,1,2,13,13,26
18,1,4,51,18,69
9,1,2,6,9,15
5,1,4,11,5,16
1,1,4,2,1,3
10,1,2,6,10,16
21,1,2,16,21,37
7,1,2,5,7,12
17,1,2,13,17,30
3,461,742,353,1383,1736
1,755,1215,411,755,1166
3,1482,2384,2420,4446,6866
1,1482,2384,473,1482,1955
1,755,1215,241,755,996
1,461,742,147,461,608
1,1482,2384,854,1482,2336
3,461,742,798,1383,2181
7,45,120,433,315,748
5,45,120,297,225,522
2,45,120,140,90,230
1,2,5,3,2,5
10,2,5,28,20,48
19,2,5,40,38,78
3,2,5,6,6,12
20,4,10,84,80,164
15,4,10,63,60,123
29,2,5,84,58,142
20,2,5,58,40,98
7,2,5,21,14,35
21,2,5,62,42,104
23,4,10,133,92,225
32,4,10,186,128,314
4,2,5,9,8,17
10,2,5,29,20,49
3,2,5,9,6,15
16,2,5,38,32,70
19,2,5,45,38,83
22,2,5,64,44,108
1,2,5,3,2,5
26,2,5,75,52,127
12,2,5,35,24,59
10,2,5,30,20,50
23,2,5,53,46,99
5,2,5,12,10,22
26,2,5,75,52,127
10,2,5,29,20,49
8,2,5,23,16,39
30,2,5,87,60,147
4,2,5,12,8,20
17,2,5,48,34,82
12,3,9,58,36,94
12,2,5,23,24,47
14,2,5,27,28,55
27,2,5,63,54,117
7,2,5,16,14,30
6,7,9,8,42,50
25,7,9,21,175,196
13,7,9,5,91,96
13,7,9,24,91,115
24,7,9,44,168,212
28,7,9,51,196,247
18,7,9,33,126,159
8,7,9,0,56,56
22,7,9,42,154,196
22,7,9,18,154,172
15,7,9,25,105,130
25,3,8,93,75,168
12,3,8,48,36,84
11,8,22,149,88,237
4,8,22,54,32,86
24,8,22,220,192,412
31,8,22,420,248,668
20,8,22,183,160,343
30,8,22,413,240,653
20,8,22,223,160,383
19,9,24,280,171,451
24,9,24,348,216,564
5,9,24,53,45,98
10,9,24,145,90,235
21,9,24,204,189,393
21,9,24,224,189,413
1,9,24,10,9,19
10,9,24,140,90,230
11,9,24,128,99,227
14,13,35,190,182,372
17,13,35,362,221,583
17,13,35,279,221,500
27,13,35,528,351,879
12,13,35,188,156,344
2,13,35,43,26,69
21,13,35,433,273,706
26,13,35,454,338,792
7,13,35,144,91,235
8,13,35,140,104,244
26,13,35,563,338,901
24,13,35,343,312,655
10,13,35,175,130,305
12,13,35,205,156,361
7,13,35,110,91,201
28,13,35,596,364,960
16,13,35,279,208,487
3,13,35,64,39,103
1,13,35,14,13,27
21,13,35,366,273,639
13,13,35,277,169,446
10,13,35,213,130,343
20,21,55,482,420,902
1,42,54,0,42,42
14,42,54,115,588,703
11,38,50,61,418,479
7,38,50,7,266,273
8,38,50,24,304,328
21,42,54,71,882,953
9,42,54,103,378,481
26,38,50,26,988,1014
19,42,54,95,798,893
26,42,54,3,1092,1095
5,38,50,58,190,248
10,38,50,55,380,435
1,42,54,11,42,53
1,42,54,-1,42,41
23,38,50,230,874,1104
1,1912,3400,1046,1912,2958
2,1266,2320,1922,2532,4454
1,1266,2320,799,1266,2065
1,1252,2295,745,1252,1997
1,1266,2320,1031,1266,2297
1,1266,2320,729,1266,1995
3,1266,2320,3023,3798,6821
1,1252,2295,882,1252,2134
1,1266,2320,636,1266,1902
1,420,769,334,420,754
3,295,540,670,885,1555
1,1252,2295,745,1252,1997
2,308,565,491,616,1107
2,1252,2295,1489,2504,3993
1,1252,2295,951,1252,2203
2,1083,1701,998,2166,3164
1,2171,3578,763,2171,2934
1,2171,3578,1335,2171,3506
1,487,783,124,487,611
1,487,783,124,487,611
1,1083,1701,346,1083,1429
3,2171,3578,1967,6513,8480
1,1555,2443,864,1555,2419
1,1555,2443,790,1555,2345
2,2171,3578,1669,4342,6011
1,2171,3578,942,2171,3113
1,1555,2443,839,1555,2394
2,487,783,529,974,1503
3,1555,2443,1711,4665,6376
2,1555,2443,897,3110,4007
1,344,540,185,344,529
1,713,1120,261,713,974
1,344,540,66,344,410
1,344,540,83,344,427
3,2171,3578,4006,6513,10519
3,2171,3578,1860,6513,8373
1,344,540,174,344,518
29,26,70,1256,754,2010
19,26,70,809,494,1303
9,26,70,257,234,491
1,26,70,43,26,69
7,2,5,15,14,29
29,2,5,61,58,119
32,13,35,682,416,1098
3,1,2,3,3,6
25,2,5,48,50,98
1,2,5,2,2,4
28,2,5,66,56,122
1,1,2,1,1,2
13,1,2,9,13,22
22,1,2,12,22,34
29,1,4,86,29,115
17,1,4,50,17,67
14,2,5,41,28,69
14,2,5,41,28,69
17,2,5,48,34,82
23,1,2,17,23,40
28,1,2,21,28,49
25,1,4,62,25,87
9,1,4,22,9,31
29,1,4,72,29,101
21,1,4,52,21,73
1,2,5,3,2,5
27,2,5,76,54,130
4,2,5,11,8,19
1,2,5,2,2,4
20,2,5,47,40,87
18,12,33,283,216,499
22,12,33,346,264,610
7,1,2,5,7,12
12,2,5,25,24,49
17,2,5,36,34,70
21,2,5,61,42,103
23,2,5,67,46,113
27,1,2,26,27,53
11,1,2,11,11,22
31,2,5,87,62,149
28,9,25,420,252,672
26,9,25,390,234,624
25,9,25,375,225,600
5,1,2,4,5,9
3,1,2,2,3,5
6,2,5,18,12,30
5,2,5,15,10,25
24,1,2,14,24,38
15,2,5,42,30,72
25,2,5,70,50,120
25,2,5,59,50,109
19,2,5,45,38,83
4,8,21,49,32,81
24,8,21,292,192,484
9,2,5,26,18,44
2,1482,2384,660,2964,3624
1,461,742,185,461,646
1,1482,2384,878,1482,2360
1,461,742,185,461,646
1,1482,2384,854,1482,2336
1,755,1215,302,755,1057
1,1482,2384,854,1482,2336
21,2,5,62,42,104
25,2,5,74,50,124
16,4,10,61,64,125
16,4,10,61,64,125
24,2,5,71,48,119
15,2,5,44,30,74
12,4,10,71,48,119
1,4,10,6,4,10
26,4,10,151,104,255
3,4,10,17,12,29
9,2,5,26,18,44
24,2,5,70,48,118
18,2,5,41,36,77
5,2,5,12,10,22
1,4,10,6,4,10
12,4,10,70,48,118
18,2,5,52,36,88
16,2,5,46,32,78
8,2,5,22,16,38
15,2,5,42,30,72
3,4,10,17,12,29
2,4,10,12,8,20
26,2,5,61,52,113
3,2,5,7,6,13
4,4,10,15,16,31
1,2,5,2,2,4
9,3,9,52,27,79
1,3,9,6,3,9
6,2,5,11,12,23
1,2,5,3,2,5
25,2,5,73,50,123
30,2,5,87,60,147
17,2,5,49,34,83
3,3,9,14,9,23
25,2,5,49,50,99
7,3,9,34,21,55
15,3,9,72,45,117
19,2,5,45,38,83
14,2,5,33,28,61
10,2,5,29,20,49
1,2,5,3,2,5
19,2,5,36,38,74
30,2,5,57,60,117
10,2,5,21,20,41
7,2,5,15,14,29
16,7,9,31,112,143
12,7,9,22,84,106
1,7,9,2,7,9
14,7,9,23,98,121
18,3,8,89,54,143
4,8,22,44,32,76
5,8,22,68,40,108
1,8,22,9,8,17
4,8,22,37,32,69
24,8,22,325,192,517
7,8,22,64,56,120
9,8,22,122,72,194
11,8,22,149,88,237
5,8,22,68,40,108
25,8,22,345,200,545
23,9,24,224,207,431
22,9,24,214,198,412
26,9,24,378,234,612
1,9,24,12,9,21
12,9,24,143,108,251
17,9,24,239,153,392
28,9,24,407,252,659
1,9,24,12,9,21
20,13,35,426,260,686
25,13,35,515,325,840
25,13,35,358,325,683
23,13,35,498,299,797
18,13,35,264,234,498
9,13,35,192,117,309
1,13,35,14,13,27
9,13,35,141,117,258
4,13,35,87,52,139
5,13,35,107,65,172
28,13,35,479,364,843
1,13,35,22,13,35
26,13,35,554,338,892
8,13,35,170,104,274
1,13,35,14,13,27
8,13,35,117,104,221
4,13,35,85,52,137
32,13,35,558,416,974
21,13,35,455,273,728
28,13,35,596,364,960
12,13,35,247,156,403
10,13,35,157,130,287
20,13,35,426,260,686
9,13,35,192,117,309
11,13,35,192,143,335
12,13,35,176,156,332
6,13,35,86,78,164
14,13,35,205,182,387
16,13,35,251,208,459
4,21,55,88,84,172
8,21,55,268,168,436
10,38,50,85,380,465
22,42,54,74,924,998
21,38,50,242,798,1040
5,42,54,17,210,227
16,38,50,176,608,784
8,42,54,18,336,354
13,38,50,150,494,644
23,38,50,230,874,1104
22,42,54,15,924,939
1,1252,2295,951,1252,2203
3,1266,2320,2884,3798,6682
1,1252,2295,745,1252,1997
1,1252,2295,722,1252,1974
1,1252,2295,538,1252,1790
1,1266,2320,1008,1266,2274
1,420,769,341,420,761
1,1266,2320,544,1266,1810
1,420,769,334,420,754
1,420,769,180,420,600
1,1252,2295,538,1252,1790
1,1266,2320,1008,1266,2274
1,1266,2320,567,1266,1833
1,1266,2320,1008,1266,2274
2,308,565,503,616,1119
2,1252,2295,1489,2504,3993
1,1252,2295,997,1252,2249
3,1266,2320,3023,3798,6821
3,2171,3578,4006,6513,10519
1,2171,3578,942,2171,3113
3,713,1120,1087,2139,3226
1,487,783,241,487,728
3,2171,3578,2504,6513,9017
1,2171,3578,1371,2171,3542
1,344,540,185,344,529
1,713,1120,228,713,941
2,487,783,388,974,1362
3,1555,2443,2591,4665,7256
1,2171,3578,1335,2171,3506
6,26,70,247,156,403
3,26,70,94,78,172
23,3,9,92,69,161
6,1,2,3,6,9
13,1,2,8,13,21
31,8,21,266,248,514
4,8,21,34,32,66
17,2,5,32,34,66
11,2,5,21,22,43
7,2,5,13,14,27
15,1,2,14,15,29
21,1,2,19,21,40
2,2,5,6,4,10
2,2,5,6,4,10
4,2,5,12,8,20
19,2,5,37,38,75
11,2,5,21,22,43
13,11,29,230,143,373
21,1,2,20,21,41
19,2,5,53,38,91
27,2,5,76,54,130
25,2,5,48,50,98
16,9,25,172,144,316
1,9,25,11,9,20
22,2,5,46,44,90
26,2,5,55,52,107
27,2,5,57,54,111
2,1,4,5,2,7
12,2,5,34,24,58
6,2,5,17,12,29
16,1,2,10,16,26
11,1,2,7,11,18
23,1,4,69,23,92
11,1,4,33,11,44
22,2,5,52,44,96
17,2,5,32,34,66
31,2,5,59,62,121
10,11,30,184,110,294
22,11,30,411,242,653
3,11,30,56,33,89
31,12,33,631,372,1003
19,12,33,386,228,614
23,8,21,280,184,464
28,8,21,340,224,564
22,8,21,268,176,444
1,2,5,3,2,5
3,2,5,8,6,14
25,2,5,70,50,120
10,1,2,9,10,19
30,2,5,87,60,147
17,2,5,49,34,83
2,2,5,6,4,10
23,2,5,67,46,113
16,2,5,46,32,78
28,2,5,81,56,137
19,2,5,40,38,78
26,2,5,55,52,107
1,1482,2384,878,1482,2360
3,1482,2384,1204,4446,5650
2,1482,2384,1613,2964,4577
1,1482,2384,878,1482,2360
1,755,1215,302,755,1057
3,755,1215,1344,2265,3609
1,1482,2384,854,1482,2336
3,461,742,442,1383,1825
1,1482,2384,378,1482,1860
1,1482,2384,807,1482,2289
13,24,64,412,312,724
12,24,64,465,288,753
6,45,120,292,270,562
29,4,10,168,116,284
7,4,10,41,28,69
13,4,10,77,52,129
18,4,10,106,72,178
15,2,5,29,30,59
19,2,5,36,38,74
16,2,5,46,32,78
1,2,5,3,2,5
10,2,5,27,20,47
19,2,5,50,38,88
13,2,5,25,26,51
26,3,9,151,78,229
12,2,5,28,24,52
19,2,5,45,38,83
13,3,9,63,39,102
17,3,9,82,51,133
20,7,9,33,140,173
26,7,9,50,182,232
6,7,9,10,42,52
5,7,9,4,35,39
4,7,9,3,28,31
9,7,9,7,63,70
20,7,9,36,140,176
11,7,9,15,77,92
18,3,8,89,54,143
14,3,8,68,42,110
19,8,22,178,152,330
12,8,22,134,96,230
24,8,22,325,192,517
29,8,22,266,232,498
28,8,22,380,224,604
10,8,22,111,80,191
13,8,22,131,104,235
18,8,22,201,144,345
1,8,22,11,8,19
7,8,22,78,56,134
3,8,22,37,24,61
3,9,24,29,27,56
18,9,24,214,162,376
2,9,24,29,18,47
1,9,24,15,9,24
10,13,35,213,130,343
16,13,35,330,208,538
20,13,35,433,260,693
15,13,35,309,195,504
23,13,35,401,299,700
18,13,35,371,234,605
16,13,35,279,208,487
6,13,35,128,78,206
12,13,35,172,156,328
12,13,35,247,156,403
25,13,35,533,325,858
13,13,35,281,169,450
22,13,35,430,286,716
16,13,35,341,208,549
19,13,35,411,247,658
22,13,35,322,286,608
9,13,35,157,117,274
1,13,35,17,13,30
12,13,35,256,156,412
22,13,35,361,286,647
9,13,35,132,117,249
8,21,55,175,168,343
15,21,55,395,315,710
23,21,55,757,483,1240
9,21,55,237,189,426
2,38,50,10,76,86
19,42,54,95,798,893
20,42,54,46,840,886
20,38,50,100,760,860
7,42,54,35,294,329
10,42,54,50,420,470
16,38,50,16,608,624
8,42,54,40,336,376
27,42,54,134,1134,1268
15,42,54,164,630,794
2,1898,3375,2077,3796,5873
2,1898,3375,2077,3796,5873
2,1252,2295,1994,2504,4498
3,420,769,1024,1260,2284
1,1252,2295,745,1252,1997
1,1252,2295,951,1252,2203
3,420,769,678,1260,1938
1,420,769,188,420,608
2,1252,2295,1443,2504,3947
1,1252,2295,538,1252,1790
3,420,769,886,1260,2146
1,1252,2295,997,1252,2249
2,1266,2320,2015,2532,4547
2,2171,3578,1240,4342,5582
1,1083,1701,397,1083,1480
1,344,540,126,344,470
1,2171,3578,942,2171,3113
1,1083,1701,244,1083,1327
2,1083,1701,488,2166,2654
1,1083,1701,380,1083,1463
2,713,1120,724,1426,2150
1,2171,3578,1371,2171,3542
1,344,540,174,344,518
3,1519,2443,1819,4557,6376
1,1519,2443,606,1519,2125
1,344,540,126,344,470
3,487,783,512,1461,1973
1,2171,3578,906,2171,3077
1,344,540,174,344,518
1,2171,3578,1335,2171,3506
29,26,70,992,754,1746
6,3,9,35,18,53
27,3,9,130,81,211
6,3,9,35,18,53
1,3,9,4,3,7
21,3,9,118,63,181
29,2,5,68,58,126
13,2,5,31,26,57
27,13,35,462,351,813
13,13,35,222,169,391
4,13,35,82,52,134
17,1,2,13,17,30
7,8,21,60,56,116
17,1,4,48,17,65
18,1,4,51,18,69
9,1,2,7,9,16
25,1,2,23,25,48
6,1,2,6,6,12
23,2,5,64,46,110
4,12,33,83,48,131
13,12,33,269,156,425
4,12,33,83,48,131
18,1,4,45,18,63
1,1,4,2,1,3
21,2,5,59,42,101
22,1,2,12,22,34
6,1,2,3,6,9
23,2,5,67,46,113
7,1,2,6,7,13
12,12,33,169,144,313
13,12,33,183,156,339
1,2,5,3,2,5
10,2,5,29,20,49
2,2,5,6,4,10
8,2,5,23,16,39
29,2,5,84,58,142
21,2,5,62,42,104
8,2,5,24,16,40
12,1,2,12,12,24
1,1,2,1,1,2
26,1,2,18,26,44
21,1,2,14,21,35
22,1,4,60,22,82
2,8,21,24,16,40
5,8,21,61,40,101
16,9,25,168,144,312
25,9,25,263,225,488
29,9,25,305,261,566
9,1,4,26,9,35
20,1,4,58,20,78
1,2,5,2,2,4
12,2,5,23,24,47
21,2,5,56,42,98
10,2,5,27,20,47
7,8,21,85,56,141
23,8,21,280,184,464
16,2,5,31,32,63
2,1482,2384,1756,2964,4720
1,461,742,185,461,646
3,1482,2384,2634,4446,7080
1,461,742,266,461,727
3,1482,2384,1705,4446,6151
4,24,64,119,96,215
1,45,120,73,45,118
27,2,5,78,54,132
28,2,5,81,56,137
7,4,10,41,28,69
17,2,5,36,34,70
22,2,5,62,44,106
24,2,5,46,48,94
16,2,5,30,32,62
7,4,10,27,28,55
5,2,5,15,10,25
21,2,5,40,42,82
2,2,5,4,4,8
3,2,5,9,6,15
7,2,5,20,14,34
13,2,5,38,26,64
11,3,9,44,33,77
27,2,5,76,54,130
1,2,5,2,2,4
26,2,5,55,52,107
7,2,5,15,14,29
16,2,5,38,32,70
3,2,5,7,6,13
1,7,9,2,7,9
31,7,9,51,217,268
2,7,9,3,14,17
21,7,9,17,147,164
26,7,9,50,182,232
19,7,9,36,133,169
14,7,9,25,98,123
9,7,9,15,63,78
12,7,9,10,84,94
21,3,8,83,63,146
1,3,8,3,3,6
3,8,22,27,24,51
7,8,22,95,56,151
25,8,22,339,200,539
20,8,22,262,160,422
29,8,22,304,232,536
22,8,22,298,176,474
28,8,22,256,224,480
11,8,22,152,88,240
20,9,24,295,180,475
4,9,24,48,36,84
19,9,24,280,171,451
23,9,24,273,207,480
3,9,24,42,27,69
24,13,35,419,312,731
13,13,35,281,169,450
13,13,35,227,169,396
23,13,35,490,299,789
25,13,35,393,325,718
27,13,35,386,351,737
23,13,35,474,299,773
11,13,35,227,143,370
21,13,35,433,273,706
19,13,35,332,247,579
15,13,35,320,195,515
14,13,35,298,182,480
26,13,35,472,338,810
1,13,35,14,13,27
14,13,35,303,182,485
1,13,35,16,13,29
20,13,35,286,260,546
27,21,55,903,567,1470
8,21,55,263,168,431
12,42,54,131,504,635
5,42,54,25,210,235
27,42,54,266,1134,1400
29,38,50,334,1102,1436
1,38,50,10,38,48
9,38,50,99,342,441
1,42,54,0,42,42
1,1912,3400,774,1912,2686
1,1252,2295,997,1252,2249
1,1252,2295,951,1252,2203
1,1252,2295,997,1252,2249
3,295,540,379,885,1264
1,1252,2295,997,1252,2249
3,1266,2320,3023,3798,6821
1,1252,2295,538,1252,1790
1,1266,2320,915,1266,2181
3,308,565,737,924,1661
1,295,540,240,295,535
1,2171,3578,906,2171,3077
1,2171,3578,1157,2171,3328
2,487,783,561,974,1535
1,1519,2443,900,1519,2419
1,1555,2443,351,1555,1906
2,2171,3578,1884,4342,6226
2,2171,3578,1884,4342,6226
1,487,783,202,487,689
1,487,783,265,487,752
1,1519,2443,606,1519,2125
1,1555,2443,497,1555,2052
1,344,540,137,344,481
2,713,1120,523,1426,1949
1,1083,1701,601,1083,1684
2,713,1120,456,1426,1882
13,3,9,57,39,96
16,3,9,93,48,141
22,11,29,294,242,536
16,11,29,214,176,390
5,1,2,5,5,10
25,1,2,25,25,50
6,1,2,6,6,12
27,2,5,76,54,130
6,2,5,17,12,29
9,8,21,109,72,181
1,8,21,12,8,20
13,13,35,254,169,423
14,12,33,262,168,430
7,12,33,131,84,215
15,1,2,8,15,23
14,2,5,41,28,69
15,2,5,44,30,74
8,2,5,23,16,39
30,2,5,87,60,147
24,1,2,14,24,38
14,1,2,8,14,22
6,13,35,128,78,206
22,2,5,42,44,86
18,2,5,34,36,70
23,2,5,44,46,90
2,2,5,4,4,8
12,2,5,23,24,47
16,1,2,11,16,27
20,1,2,13,20,33
20,1,2,13,20,33
29,9,25,370,261,631
13,12,33,217,156,373
7,12,33,117,84,201
16,9,25,252,144,396
22,9,25,347,198,545
1,2,5,3,2,5
6,2,5,17,12,29
21,9,25,305,189,494
21,9,25,305,189,494
19,9,25,276,171,447
17,1,2,17,17,34
22,1,2,22,22,44
10,9,25,115,90,205
2,9,25,23,18,41
12,1,2,11,12,23
10,1,2,9,10,19
20,1,4,58,20,78
4,1,4,12,4,16
4,1,4,12,4,16
26,2,5,49,52,101
1,2,5,2,2,4
24,2,5,55,48,103
23,2,5,53,46,99
7,1,4,20,7,27
14,2,5,32,28,60
8,2,5,18,16,34
29,11,29,514,319,833
3,11,29,53,33,86
1,2,5,3,2,5
2,1,4,5,2,7
15,1,4,37,15,52
1,1482,2384,807,1482,2289
1,755,1215,302,755,1057
1,1482,2384,878,1482,2360
1,461,742,274,461,735
3,24,64,95,72,167
10,24,64,387,240,627
2,45,120,133,90,223
32,2,5,93,64,157
26,2,5,75,52,127
11,4,10,65,44,109
5,4,10,30,20,50
17,2,5,39,34,73
20,2,5,46,40,86
31,4,10,121,124,245
19,4,10,74,76,150
14,2,5,32,28,60
4,2,5,9,8,17
11,4,10,65,44,109
23,4,10,136,92,228
1,2,5,3,2,5
13,2,5,25,26,51
8,2,5,15,16,31
13,2,5,38,26,64
6,2,5,17,12,29
11,3,9,44,33,77
4,3,9,16,12,28
28,2,5,55,56,111
2,2,5,4,4,8
24,7,9,18,168,186
1,7,9,1,7,8
21,7,9,8,147,155
2,7,9,4,14,18
15,7,9,27,105,132
6,7,9,11,42,53
18,7,9,7,126,133
5,7,9,0,35,35
6,3,8,28,18,46
3,3,8,12,9,21
27,8,22,372,216,588
6,8,22,81,48,129
23,8,22,231,184,415
23,8,22,231,184,415
27,9,24,392,243,635
2,9,24,22,18,40
18,9,24,266,162,428
30,9,24,436,270,706
17,9,24,169,153,322
7,13,35,100,91,191
7,13,35,115,91,206
15,13,35,309,195,504
1,13,35,17,13,30
26,13,35,563,338,901
25,13,35,541,325,866
19,13,35,332,247,579
23,13,35,490,299,789
27,13,35,443,351,794
8,13,35,170,104,274
14,13,35,220,182,402
4,13,35,63,52,115
10,13,35,206,130,336
6,13,35,88,78,166
8,13,35,140,104,244
23,13,35,490,299,789
8,38,50,88,304,392
10,38,50,110,380,490
16,42,54,80,672,752
15,38,50,45,570,615
3,42,54,33,126,159
8,42,54,87,336,423
10,38,50,50,380,430
1,1266,2320,1008,1266,2274
2,1266,2320,1458,2532,3990
1,1252,2295,676,1252,1928
1,1266,2320,567,1266,1833
1,1252,2295,997,1252,2249
1,295,540,175,295,470
1,308,565,155,308,463
1,1252,2295,997,1252,2249
2,1252,2295,1260,2504,3764
1,420,769,211,420,631
3,1252,2295,1890,3756,5646
1,295,540,207,295,502
1,1252,2295,561,1252,1813
1,1266,2320,892,1266,2158
2,1555,2443,1092,3110,4202
1,344,540,185,344,529
1,1555,2443,497,1555,2052
1,344,540,185,344,529
1,713,1120,362,713,1075
2,713,1120,344,1426,1770
1,344,540,126,344,470
1,2171,3578,906,2171,3077
1,2171,3578,1335,2171,3506
6,26,70,256,156,412
19,26,70,809,494,1303
27,3,9,160,81,241
6,3,9,34,18,52
17,2,5,49,34,83
10,1,2,7,10,17
9,1,2,7,9,16
28,1,2,27,28,55
25,2,5,74,50,124
21,12,33,351,252,603
8,12,33,134,96,230
4,12,33,67,48,115
21,1,2,21,21,42
6,1,2,6,6,12
11,1,2,11,11,22
18,1,2,17,18,35
22,1,2,21,22,43
13,1,2,8,13,21
17,1,2,11,17,28
7,1,4,15,7,22
21,1,4,45,21,66
16,1,2,15,16,31
7,1,2,6,7,13
21,2,5,61,42,103
24,11,30,406,264,670
17,11,30,287,187,474
20,13,35,328,260,588
17,2,5,40,34,74
1,2,5,2,2,4
30,1,2,17,30,47
9,1,2,5,9,14
17,2,5,40,34,74
14,2,5,32,28,60
6,2,5,14,12,26
26,1,2,19,26,45
25,1,2,19,25,44
25,8,21,231,200,431
1,8,21,9,8,17
29,2,5,67,58,125
3,1,2,3,3,6
27,1,4,77,27,104
10,1,4,28,10,38
14,1,4,40,14,54
6,1,4,17,6,23
12,2,5,25,24,49
15,2,5,32,30,62
25,9,25,313,225,538
20,9,25,250,180,430
1,1482,2384,521,1482,2003
3,1482,2384,2634,4446,7080
2,1482,2384,1709,2964,4673
3,755,1215,1344,2265,3609
1,1482,2384,807,1482,2289
17,45,120,1255,765,2020
27,45,120,1993,1215,3208
1,4,10,6,4,10
9,4,10,53,36,89
30,2,5,87,60,147
26,2,5,75,52,127
21,2,5,41,42,83
17,2,5,33,34,67
21,2,5,59,42,101
1,2,5,3,2,5
7,2,5,17,14,31
18,2,5,43,36,79
29,2,5,81,58,139
3,2,5,8,6,14
1,4,10,6,4,10
7,4,10,39,28,67
7,2,5,21,14,35
26,2,5,77,52,129
25,4,10,105,100,205
21,4,10,88,84,172
4,2,5,9,8,17
6,2,5,14,12,26
24,2,5,70,48,118
27,2,5,78,54,132
28,2,5,81,56,137
19,2,5,55,38,93
21,2,5,41,42,83
7,4,10,41,28,69
15,4,10,87,60,147
18,2,5,53,36,89
27,2,5,80,54,134
7,3,9,41,21,62
11,2,5,32,22,54
28,2,5,55,56,111
25,2,5,49,50,99
13,2,5,38,26,64
1,2,5,3,2,5
19,2,5,45,38,83
18,2,5,42,36,78
22,4,10,130,88,218
4,4,10,24,16,40
22,2,5,52,44,96
20,2,5,44,40,84
26,2,5,57,52,109
12,2,5,34,24,58
16,2,5,45,32,77
4,2,5,8,8,16
32,7,9,61,224,285
9,7,9,16,63,79
23,7,9,44,161,205
20,7,9,36,140,176
9,7,9,15,63,78
19,7,9,36,133,169
9,7,9,3,63,66
12,7,9,20,84,104
27,7,9,44,189,233
21,7,9,8,147,155
11,7,9,18,77,95
23,7,9,3,161,164
16,3,8,60,48,108
9,3,8,30,27,57
15,3,8,61,45,106
8,3,8,39,24,63
3,8,22,27,24,51
28,8,22,293,224,517
20,8,22,201,160,361
10,8,22,111,80,191
8,8,22,105,64,169
12,8,22,165,96,261
27,8,22,271,216,487
21,8,22,276,168,444
18,8,22,165,144,309
8,8,22,84,64,148
18,8,22,236,144,380
8,8,22,105,64,169
23,8,22,302,184,486
15,8,22,207,120,327
11,8,22,110,88,198
19,9,24,276,171,447
20,9,24,266,180,446
3,9,24,44,27,71
21,9,24,305,189,494
11,9,24,162,99,261
26,9,24,378,234,612
25,13,35,541,325,866
3,13,35,64,39,103
17,13,35,368,221,589
1,13,35,21,13,34
18,13,35,390,234,624
10,13,35,206,130,336
14,13,35,288,182,470
27,13,35,556,351,907
1,13,35,21,13,34
17,13,35,297,221,518
13,13,35,268,169,437
19,13,35,411,247,658
12,13,35,188,156,344
23,13,35,361,299,660
25,13,35,410,325,735
11,13,35,234,143,377
6,13,35,105,78,183
9,13,35,132,117,249
31,13,35,454,403,857
1,13,35,21,13,34
17,13,35,297,221,518
12,21,55,382,252,634
1,21,55,25,21,46
12,21,55,289,252,541
23,21,55,618,483,1101
6,21,55,135,126,261
13,21,55,349,273,622
13,21,55,306,273,579
1,38,50,3,38,41
25,38,50,275,950,1225
27,38,50,81,1026,1107
3,42,54,25,126,151
20,38,50,230,760,990
32,38,50,320,1216,1536
25,38,50,250,950,1200
1,42,54,0,42,42
1,38,50,4,38,42
21,38,50,84,798,882
12,42,54,99,504,603
1,1266,2320,1008,1266,2274
1,1266,2320,961,1266,2227
3,1252,2295,2027,3756,5783
3,1252,2295,2027,3756,5783
2,1252,2295,1994,2504,4498
2,1266,2320,1273,2532,3805
1,1266,2320,636,1266,1902
1,1266,2320,961,1266,2227
3,1252,2295,2647,3756,6403
3,1266,2320,2884,3798,6682
2,1266,2320,1134,2532,3666
3,420,769,747,1260,2007
1,1266,2320,752,1266,2018
1,420,769,249,420,669
1,1252,2295,630,1252,1882
3,420,769,955,1260,2215
2,1252,2295,1260,2504,3764
1,1266,2320,961,1266,2227
1,1252,2295,538,1252,1790
2,295,540,350,590,940
2,295,540,468,590,1058
1,308,565,246,308,554
1,420,769,295,420,715
1,295,540,207,295,502
1,1252,2295,630,1252,1882
1,1266,2320,752,1266,2018
3,2171,3578,4006,6513,10519
1,1555,2443,717,1555,2272
1,1519,2443,631,1519,2150
2,1519,2443,1653,3038,4691
1,487,783,124,487,611
3,2171,3578,2826,6513,9339
1,713,1120,261,713,974
1,713,1120,340,713,1053
1,1555,2443,375,1555,1930
1,713,1120,329,713,1042
1,1555,2443,497,1555,2052
1,2171,3578,656,2171,2827
27,26,70,1150,702,1852
23,3,9,92,69,161
10,3,9,56,30,86
8,1,2,8,8,16
4,1,2,4,4,8
31,1,2,24,31,55
20,1,2,15,20,35
24,1,2,23,24,47
11,1,2,11,11,22
5,1,2,5,5,10
19,1,2,19,19,38
2,1,2,2,2,4
12,2,5,23,24,47
3,2,5,6,6,12
2,2,5,4,4,8
20,1,4,59,20,79
6,1,4,18,6,24
20,13,35,426,260,686
10,2,5,30,20,50
22,2,5,65,44,109
10,2,5,20,20,40
1,1,2,1,1,2
22,1,2,20,22,42
30,1,2,28,30,58
15,1,2,14,15,29
15,9,25,214,135,349
30,1,4,74,30,104
19,1,4,47,19,66
20,1,4,57,20,77
1,1,4,3,1,4
28,2,5,59,56,115
24,2,5,50,48,98
23,1,2,17,23,40
2,1,2,1,2,3
24,1,2,18,24,42
11,9,25,140,99,239
2,9,25,26,18,44
1,2,5,3,2,5
4,2,5,12,8,20
12,1,4,27,12,39
4,1,4,9,4,13
17,8,21,175,136,311
14,2,5,41,28,69
27,2,5,78,54,132
16,2,5,46,32,78
17,12,33,234,204,438
11,9,25,124,99,223
26,9,25,293,234,527
5,9,25,60,45,105
7,9,25,84,63,147
3,2,5,7,6,13
19,2,5,44,38,82
1,461,742,274,461,735
2,1482,2384,1613,2964,4577
2,461,742,250,922,1172
29,24,64,919,696,1615
4,45,120,238,180,418
5,4,10,28,20,48
5,4,10,28,20,48
21,2,5,48,42,90
8,2,5,18,16,34
14,2,5,41,28,69
14,2,5,32,28,60
1,2,5,2,2,4
3,2,5,9,6,15
7,2,5,21,14,35
7,2,5,21,14,35
11,2,5,26,22,48
10,2,5,24,20,44
18,2,5,53,36,89
10,2,5,30,20,50
5,2,5,10,10,20
4,2,5,8,8,16
17,4,10,65,68,133
25,2,5,48,50,98
13,2,5,25,26,51
20,2,5,58,40,98
26,3,9,151,78,229
16,2,5,30,32,62
11,2,5,31,22,53
5,3,9,21,15,36
23,3,9,95,69,164
7,3,9,33,21,54
19,2,5,55,38,93
2,2,5,6,4,10
28,7,9,51,196,247
17,7,9,28,119,147
3,7,9,0,21,21
23,7,9,19,161,180
5,7,9,9,35,44
8,7,9,15,56,71
15,7,9,11,105,116
13,3,8,46,39,85
2,3,8,10,6,16
26,3,8,126,78,204
30,3,8,119,90,209
17,8,22,189,136,325
6,8,22,81,48,129
4,8,22,44,32,76
25,8,22,339,200,539
24,8,22,325,192,517
25,8,22,339,200,539
1,8,22,12,8,20
32,8,22,420,256,676
3,8,22,39,24,63
10,9,24,100,90,190
6,9,24,60,54,114
1,9,24,15,9,24
18,9,24,175,162,337
18,9,24,261,162,423
7,9,24,98,63,161
11,9,24,107,99,206
31,13,35,454,403,857
16,13,35,341,208,549
1,13,35,17,13,30
4,13,35,70,52,122
12,13,35,188,156,344
3,13,35,52,39,91
15,13,35,262,195,457
31,13,35,454,403,857
15,13,35,320,195,515
18,13,35,264,234,498
22,13,35,453,286,739
22,13,35,361,286,647
5,13,35,72,65,137
28,13,35,606,364,970
3,13,35,64,39,103
1,13,35,15,13,28
13,13,35,222,169,391
1,21,55,33,21,54
26,21,55,827,546,1373
15,21,55,477,315,792
27,42,54,120,1134,1254
2,42,54,22,84,106
3,42,54,30,126,156
28,42,54,18,1176,1194
1,1252,2295,745,1252,1997
1,1266,2320,1008,1266,2274
1,1266,2320,892,1266,2158
1,420,769,318,420,738
1,308,565,184,308,492
3,1266,2320,3023,3798,6821
3,308,565,703,924,1627
3,295,540,703,885,1588
1,487,783,124,487,611
1,2171,3578,942,2171,3113
2,713,1120,724,1426,2150
1,487,783,265,487,752
1,1083,1701,550,1083,1633
1,1519,2443,900,1519,2419
1,487,783,132,487,619
13,3,9,62,39,101
8,3,9,43,24,67
4,3,9,23,12,35
20,1,2,19,20,39
23,1,2,23,23,46
9,1,2,6,9,15
23,1,2,15,23,38
23,1,2,13,23,36
25,1,2,14,25,39
2,2,5,6,4,10
6,2,5,18,12,30
4,2,5,12,8,20
25,1,2,24,25,49
16,2,5,42,32,74
13,2,5,34,26,60
21,1,2,19,21,40
26,13,35,536,338,874
15,13,35,309,195,504
1,13,35,17,13,30
26,9,25,332,234,566
19,9,25,242,171,413
28,2,5,59,56,115
5,2,5,11,10,21
13,11,30,231,143,374
11,11,30,196,121,317
7,8,21,85,56,141
25,8,21,304,200,504
12,2,5,28,24,52
6,9,25,60,54,114
6,9,25,60,54,114
3,9,25,30,27,57
24,2,5,70,48,118
12,2,5,35,24,59
1,1,4,3,1,4
21,2,5,49,42,91
11,2,5,26,22,48
2,1,4,5,2,7
1,1482,2384,401,1482,1883
1,461,742,118,461,579
1,1482,2384,401,1482,1883
2,461,742,250,922,1172
1,1482,2384,592,1482,2074
1,755,1215,168,755,923
6,3,9,32,18,50
6,2,5,18,12,30
4,2,5,11,8,19
17,2,5,48,34,82
19,4,10,112,76,188
31,4,10,183,124,307
14,3,9,83,42,125
32,3,9,180,96,276
12,2,5,35,24,59
21,2,5,61,42,103
1,2,5,2,2,4
27,2,5,57,54,111
6,2,5,13,12,25
10,4,10,46,40,86
12,4,10,55,48,103
17,3,9,96,51,147
23,3,9,130,69,199
26,7,9,3,182,185
5,7,9,1,35,36
30,7,9,17,210,227
9,7,9,17,63,80
4,7,9,3,28,31
1,7,9,2,7,9
7,7,9,3,49,52
21,7,9,29,147,176
13,3,8,63,39,102
25,3,8,123,75,198
25,8,22,229,200,429
1,8,22,10,8,18
11,8,22,144,88,232
8,9,24,93,72,165
26,9,24,309,234,543
30,9,24,421,270,691
13,9,24,183,117,300
23,13,35,329,299,628
26,13,35,536,338,874
20,13,35,433,260,693
12,13,35,209,156,365
12,13,35,260,156,416
8,13,35,131,104,235
29,13,35,597,377,974
12,13,35,209,156,365
19,13,35,325,247,572
30,13,35,650,390,1040
22,13,35,345,286,631
26,13,35,408,338,746
8,13,35,126,104,230
4,13,35,70,52,122
1,13,35,14,13,27
5,21,55,159,105,264
20,21,55,658,420,1078
21,42,54,241,882,1123
2,38,50,6,76,82
16,38,50,160,608,768
10,38,50,85,380,465
13,38,50,143,494,637
3,42,54,15,126,141
28,42,54,139,1176,1315
21,42,54,3,882,885
1,1252,2295,951,1252,2203
1,1252,2295,722,1252,1974
1,420,769,211,420,631
2,308,565,311,616,927
1,1266,2320,1008,1266,2274
3,1252,2295,3060,3756,6816
1,1266,2320,752,1266,2018
2,1266,2320,2015,2532,4547
1,344,540,158,344,502
1,2171,3578,1264,2171,3435
1,2171,3578,1264,2171,3435
2,1555,2443,1581,3110,4691
2,487,783,482,974,1456
2,713,1120,769,1426,2195
1,2171,3578,656,2171,2827
2,1083,1701,624,2166,2790
3,1519,2443,1599,4557,6156
1,1519,2443,484,1519,2003
1,344,540,83,344,427
1,713,1120,228,713,941
1,26,70,31,26,57
5,26,70,213,130,343
31,3,9,136,93,229
27,3,9,152,81,233
2,1,2,2,2,4
24,8,21,201,192,393
2,8,21,17,16,33
18,9,25,216,162,378
14,9,25,168,126,294
1,13,35,15,13,28
13,2,5,31,26,57
11,2,5,26,22,48
4,1,2,4,4,8
11,1,2,11,11,22
10,1,2,10,10,20
27,1,2,26,27,53
13,1,2,12,13,25
21,13,35,366,273,639
16,13,35,279,208,487
8,1,2,5,8,13
31,1,2,21,31,52
4,1,4,10,4,14
11,1,4,27,11,38
13,1,2,10,13,23
22,1,2,14,22,36
23,1,2,15,23,38
13,1,2,8,13,21
28,1,2,27,28,55
25,1,2,24,25,49
1,2,5,2,2,4
16,2,5,30,32,62
1,2,5,3,2,5
20,2,5,58,40,98
20,2,5,58,40,98
23,2,5,68,46,114
21,9,25,252,189,441
4,9,25,48,36,84
20,1,2,20,20,40
12,1,2,12,12,24
4,2,5,8,8,16
9,2,5,17,18,35
17,1,2,16,17,33
28,8,21,288,224,512
23,8,21,236,184,420
18,1,4,51,18,69
13,1,4,37,13,50
15,2,5,44,30,74
32,2,5,93,64,157
2,2,5,6,4,10
2,1,4,6,2,8
11,1,4,32,11,43
2,1482,2384,1613,2964,4577
1,1482,2384,521,1482,2003
1,1482,2384,473,1482,1955
2,755,1215,531,1510,2041
1,755,1215,302,755,1057
1,1482,2384,807,1482,2289
1,1482,2384,878,1482,2360
1,1482,2384,878,1482,2360
1,1482,2384,378,1482,1860
2,1482,2384,1613,2964,4577
15,24,64,590,360,950
28,24,64,726,672,1398
10,24,64,394,240,634
1,24,64,37,24,61
1,45,120,53,45,98
3,59,159,290,177,467
9,2,5,19,18,37
22,4,10,92,88,180
24,4,10,101,96,197
4,2,5,11,8,19
24,2,5,67,48,115
9,3,9,51,27,78
31,3,9,175,93,268
23,2,5,68,46,114
29,2,5,86,58,144
23,2,5,68,46,114
17,2,5,48,34,82
11,2,5,31,22,53
27,2,5,53,54,107
13,2,5,25,26,51
4,2,5,8,8,16
7,2,5,15,14,29
26,2,5,55,52,107
16,2,5,34,32,66
22,3,9,128,66,194
27,3,9,157,81,238
7,4,10,39,28,67
1,4,10,6,4,10
24,4,10,139,96,235
1,4,10,6,4,10
9,4,10,34,36,70
30,4,10,114,120,234
19,2,5,56,38,94
22,2,5,65,44,109
24,3,9,96,72,168
26,3,9,105,78,183
21,2,5,49,42,91
6,2,5,14,12,26
12,2,5,35,24,59
31,7,9,51,217,268
6,7,9,5,42,47
16,7,9,6,112,118
10,7,9,16,70,86
16,7,9,6,112,118
5,7,9,5,35,40
22,3,8,106,66,172
13,3,8,46,39,85
27,8,22,354,216,570
21,8,22,192,168,360
23,8,22,312,184,496
13,8,22,119,104,223
17,8,22,156,136,292
16,8,22,161,128,289
27,8,22,253,216,469
6,8,22,81,48,129
21,8,22,276,168,444
27,8,22,271,216,487
15,8,22,187,120,307
30,9,24,443,270,713
1,9,24,15,9,24
1,9,24,10,9,19
16,9,24,156,144,300
6,9,24,64,54,118
16,9,24,190,144,334
6,9,24,71,54,125
9,9,24,126,81,207
13,13,35,186,169,355
15,13,35,262,195,457
6,13,35,105,78,183
31,13,35,487,403,890
5,13,35,107,65,172
22,13,35,384,286,670
17,13,35,243,221,464
2,13,35,41,26,67
20,13,35,433,260,693
20,13,35,433,260,693
7,13,35,122,91,213
15,13,35,215,195,410
28,13,35,596,364,960
20,13,35,314,260,574
5,13,35,77,65,142
26,13,35,563,338,901
9,13,35,157,117,274
30,13,35,524,390,914
11,13,35,161,143,304
24,13,35,511,312,823
16,13,35,251,208,459
10,13,35,217,130,347
21,13,35,447,273,720
15,13,35,309,195,504
21,13,35,455,273,728
16,13,35,330,208,538
25,13,35,393,325,718
25,13,35,515,325,840
28,13,35,577,364,941
16,13,35,330,208,538
17,13,35,243,221,464
6,13,35,98,78,176
14,13,35,288,182,470
13,13,35,268,169,437
11,13,35,234,143,377
2,13,35,31,26,57
3,21,55,76,63,139
11,21,55,265,231,496
24,21,55,790,504,1294
2,42,54,20,84,104
3,42,54,2,126,128
14,38,50,161,532,693
23,38,50,23,874,897
5,38,50,58,190,248
27,42,54,62,1134,1196
18,38,50,180,684,864
7,42,54,5,294,299
13,42,54,65,546,611
21,42,54,207,882,1089
4,38,50,6,152,158
17,38,50,85,646,731
26,42,54,59,1092,1151
14,42,54,138,588,726
14,38,50,42,532,574
3,38,50,15,114,129
16,42,54,132,672,804
17,42,54,85,714,799
15,42,54,123,630,753
14,42,54,153,588,741
17,42,54,2,714,716
25,38,50,25,950,975
1,1898,3375,1038,1898,2936
2,1252,2295,1260,2504,3764
1,1252,2295,1020,1252,2272
1,1252,2295,951,1252,2203
1,1266,2320,752,1266,2018
1,1266,2320,752,1266,2018
3,420,769,747,1260,2007
1,1252,2295,997,1252,2249
1,1266,2320,1008,1266,2274
1,1266,2320,961,1266,2227
1,420,769,334,420,754
3,420,769,632,1260,1892
1,308,565,155,308,463
1,1266,2320,961,1266,2227
1,1266,2320,961,1266,2227
2,420,769,590,840,1430
1,1252,2295,882,1252,2134
1,1252,2295,997,1252,2249
1,2171,3578,1264,2171,3435
3,2171,3578,4114,6513,10627
1,487,783,280,487,767
3,487,783,371,1461,1832
1,487,783,124,487,611
1,1555,2443,790,1555,2345
3,1519,2443,1453,4557,6010
3,344,540,556,1032,1588
1,2171,3578,656,2171,2827
1,1083,1701,380,1083,1463
2,487,783,310,974,1284
2,713,1120,769,1426,2195
1,1083,1701,414,1083,1497
2,344,540,349,688,1037
1,344,540,174,344,518
1,344,540,99,344,443
2,344,540,349,688,1037
1,713,1120,362,713,1075
1,1555,2443,570,1555,2125
3,344,540,556,1032,1588
1,713,1120,261,713,974
1,487,783,132,487,619
2,487,783,341,974,1315
27,26,70,1169,702,1871
14,26,70,596,364,960
5,26,70,164,130,294
3,26,70,105,78,183
6,26,70,260,156,416
8,3,9,32,24,56
13,3,9,57,39,96
24,3,9,114,72,186
25,1,2,25,25,50
27,2,5,78,54,132
26,2,5,61,52,113
5,2,5,12,10,22
2,2,5,5,4,9
5,2,5,12,10,22
23,1,2,21,23,44
10,11,30,187,110,297
26,11,30,486,286,772
5,13,35,107,65,172
3,13,35,64,39,103
2,1,2,1,2,3
28,1,2,18,28,46
4,13,35,70,52,122
23,1,4,49,23,72
11,1,2,6,11,17
21,1,2,12,21,33
22,12,33,455,264,719
3,2,5,7,6,13
24,2,5,55,48,103
22,2,5,64,44,108
3,2,5,9,6,15
16,1,2,12,16,28
1,1,4,2,1,3
24,1,4,55,24,79
1,9,25,13,9,22
27,9,25,344,243,587
9,1,2,8,9,17
12,1,2,11,12,23
10,1,2,9,10,19
20,9,25,255,180,435
27,9,25,344,243,587
14,1,2,13,14,27
8,1,4,18,8,26
16,1,4,36,16,52
20,2,5,47,40,87
2,2,5,5,4,9
18,11,30,223,198,421
20,11,30,248,220,468
1,1,2,1,1,2
4,1,2,3,4,7
26,11,29,370,286,656
2,11,29,28,22,50
4,2,5,8,8,16
1,2,5,2,2,4
16,11,29,232,176,408
11,11,29,128,121,249
22,8,21,203,176,379
15,8,21,138,120,258
1,1,2,1,1,2
21,1,2,18,21,39
20,12,33,334,240,574
28,12,33,468,336,804
1,2,5,2,2,4
4,2,5,12,8,20
2,461,742,503,922,1425
1,461,742,251,461,712
2,755,1215,483,1510,1993
1,755,1215,290,755,1045
3,1482,2384,2563,4446,7009
1,755,1215,302,755,1057
2,1482,2384,1709,2964,4673
1,461,742,266,461,727
1,24,64,39,24,63
19,45,120,1379,855,2234
10,59,159,714,590,1304
10,59,159,968,590,1558
10,3,9,54,30,84
5,3,9,27,15,42
21,2,5,44,42,86
20,2,5,42,40,82
3,4,10,12,12,24
24,4,10,94,96,190
24,2,5,71,48,119
26,2,5,75,52,127
5,2,5,15,10,25
24,2,5,55,48,103
6,2,5,18,12,30
1,2,5,3,2,5
13,4,10,73,52,125
24,2,5,56,48,104
26,2,5,61,52,113
10,2,5,30,20,50
4,3,9,23,12,35
14,3,9,81,42,123
28,2,5,81,56,137
17,2,5,49,34,83
28,2,5,78,56,134
27,2,5,76,54,130
27,3,9,145,81,226
24,3,9,129,72,201
20,2,5,42,40,82
29,2,5,61,58,119
14,3,9,54,42,96
20,2,5,56,40,96
18,2,5,50,36,86
18,2,5,52,36,88
22,2,5,64,44,108
25,7,9,19,175,194
2,7,9,4,14,18
17,7,9,23,119,142
18,7,9,7,126,133
17,7,9,14,119,133
15,7,9,2,105,107
4,7,9,2,28,30
14,7,9,12,98,110
29,7,9,48,203,251
25,7,9,21,175,196
29,7,9,48,203,251
12,3,8,58,36,94
1,3,8,4,3,7
21,3,8,102,63,165
16,3,8,53,48,101
3,3,8,12,9,21
11,8,22,149,88,237
21,8,22,211,168,379
7,8,22,87,56,143
18,8,22,244,144,388
18,8,22,244,144,388
5,8,22,66,40,106
25,8,22,279,200,479
20,8,22,262,160,422
23,8,22,256,184,440
17,8,22,171,136,307
8,8,22,100,64,164
15,9,24,221,135,356
7,9,24,98,63,161
19,13,35,411,247,658
19,13,35,371,247,618
10,13,35,196,130,326
16,13,35,234,208,442
11,13,35,215,143,358
5,13,35,87,65,152
19,13,35,411,247,658
7,13,35,149,91,240
27,13,35,396,351,747
22,13,35,430,286,716
28,13,35,596,364,960
5,13,35,108,65,173
9,13,35,185,117,302
27,13,35,556,351,907
30,13,35,440,390,830
15,13,35,325,195,520
15,13,35,262,195,457
23,13,35,498,299,797
13,13,35,204,169,373
8,13,35,114,104,218
26,38,50,286,988,1274
26,38,50,299,988,1287
14,38,50,21,532,553
2,42,54,1,84,85
7,38,50,77,266,343
18,38,50,180,684,864
5,38,50,25,190,215
25,42,54,125,1050,1175
21,38,50,231,798,1029
3,1252,2295,2991,3756,6747
1,1898,3375,870,1898,2768
1,1266,2320,961,1266,2227
1,1266,2320,892,1266,2158
1,1266,2320,892,1266,2158
1,1266,2320,1008,1266,2274
1,420,769,249,420,669
2,1266,2320,1134,2532,3666
1,295,540,240,295,535
1,1266,2320,1008,1266,2274
3,1266,2320,2884,3798,6682
1,295,540,234,295,529
3,308,565,737,924,1661
2,1266,2320,1922,2532,4454
1,1266,2320,636,1266,1902
2,1555,2443,1434,3110,4544
1,1555,2443,448,1555,2003
3,344,540,556,1032,1588
1,2171,3578,942,2171,3113
2,1519,2443,1506,3038,4544
2,1519,2443,1653,3038,4691
1,487,783,194,487,681
1,2171,3578,763,2171,2934
1,713,1120,172,713,885
1,487,783,132,487,619
2,26,70,87,52,139
15,26,70,440,390,830
10,26,70,286,260,546
32,26,70,1005,832,1837
30,3,9,169,90,259
18,3,9,87,54,141
17,1,4,50,17,67
21,1,4,62,21,83
12,8,21,103,96,199
24,8,21,206,192,398
17,2,5,50,34,84
27,12,33,451,324,775
23,1,2,22,23,45
16,13,35,341,208,549
24,9,25,258,216,474
17,9,25,183,153,336
9,1,4,22,9,31
11,1,4,27,11,38
26,13,35,508,338,846
1,1,4,2,1,3
25,1,4,62,25,87
11,1,2,10,11,21
10,1,2,9,10,19
26,1,4,74,26,100
19,1,4,54,19,73
2,8,21,18,16,34
21,1,4,43,21,64
24,1,4,49,24,73
9,2,5,26,18,44
27,2,5,78,54,132
19,2,5,55,38,93
9,1,2,9,9,18
5,1,2,5,5,10
11,1,2,11,11,22
12,1,2,12,12,24
15,1,2,14,15,29
26,1,4,56,26,82
30,1,4,65,30,95
14,1,4,30,14,44
11,8,21,134,88,222
9,2,5,21,18,39
21,2,5,48,42,90
21,2,5,61,42,103
22,2,5,64,44,108
9,1,2,6,9,15
21,1,2,13,21,34
13,1,2,8,13,21
4,1,4,12,4,16
14,11,29,163,154,317
15,11,29,174,165,339
2,2,5,4,4,8
11,2,5,20,22,42
8,2,5,14,16,30
15,2,5,42,30,72
13,2,5,31,26,57
24,2,5,56,48,104
11,2,5,21,22,43
15,1,2,11,15,26
15,1,2,8,15,23
1,1482,2384,807,1482,2289
1,461,742,125,461,586
1,461,742,125,461,586
1,1482,2384,592,1482,2074
2,1482,2384,1613,2964,4577
2,1482,2384,1756,2964,4720
1,1482,2384,878,1482,2360
2,461,742,295,922,1217
2,461,742,206,922,1128
1,1482,2384,854,1482,2336
1,461,742,251,461,712
14,24,64,524,336,860
14,24,64,524,336,860
17,24,64,539,408,947
20,45,120,1476,900,2376
19,3,9,87,57,144
11,2,5,23,22,45
20,2,5,56,40,96
7,2,5,20,14,34
15,4,10,59,60,119
4,4,10,16,16,32
8,2,5,22,16,38
7,2,5,20,14,34
1,2,5,3,2,5
9,2,5,26,18,44
24,2,5,55,48,103
10,2,5,19,20,39
9,2,5,17,18,35
12,2,5,35,24,59
23,2,5,54,46,100
29,2,5,68,58,126
27,2,5,76,54,130
6,2,5,13,12,25
27,2,5,57,54,111
26,7,9,22,182,204
3,7,9,2,21,23
24,7,9,18,168,186
8,7,9,15,56,71
16,3,8,53,48,101
27,3,8,133,81,214
14,3,8,68,42,110
17,3,8,80,51,131
21,8,22,285,168,453
1,8,22,11,8,19
19,8,22,212,152,364
30,9,24,436,270,706
3,9,24,44,27,71
23,9,24,323,207,530
9,9,24,87,81,168
3,9,24,44,27,71
6,13,35,86,78,164
3,13,35,64,39,103
29,13,35,628,377,1005
24,13,35,352,312,664
29,13,35,618,377,995
3,13,35,65,39,104
3,13,35,62,39,101
11,13,35,234,143,377
6,13,35,82,78,160
1,13,35,17,13,30
25,13,35,541,325,866
18,13,35,371,234,605
10,13,35,143,130,273
14,13,35,298,182,480
18,21,55,394,378,772
15,21,55,337,315,652
7,38,50,70,266,336
25,42,54,-24,1050,1026
1,42,54,3,42,45
9,38,50,27,342,369
21,42,54,105,882,987
31,38,50,341,1178,1519
7,38,50,7,266,273
7,42,54,35,294,329
10,42,54,44,420,464
20,38,50,110,760,870
14,42,54,70,588,658
22,42,54,240,924,1164
1,42,54,2,42,44
1,1266,2320,961,1266,2227
1,1252,2295,630,1252,1882
2,420,769,683,840,1523
1,1266,2320,567,1266,1833
1,420,769,249,420,669
3,1266,2320,3092,3798,6890
3,1252,2295,2854,3756,6610
2,420,769,498,840,1338
3,1266,2320,2257,3798,6055
1,1266,2320,636,1266,1902
1,1083,1701,584,1083,1667
1,487,783,288,487,775
1,713,1120,385,713,1098
1,487,783,265,487,752
3,1083,1701,1191,3249,4440
3,344,540,377,1032,1409
3,344,540,361,1032,1393
1,344,540,120,344,464
1,2171,3578,1371,2171,3542
1,1083,1701,550,1083,1633
9,26,70,390,234,624
17,26,70,593,442,1035
18,26,70,628,468,1096
4,3,9,24,12,36
22,3,9,104,66,170
28,3,9,165,84,249
29,1,2,28,29,57
9,1,2,9,9,18
20,13,35,426,260,686
6,13,35,128,78,206
16,8,21,137,128,265
16,8,21,137,128,265
26,2,5,60,52,112
2,2,5,5,4,9
12,12,33,236,144,380
9,2,5,27,18,45
27,2,5,51,54,105
2,9,25,20,18,38
19,9,25,190,171,361
12,1,2,9,12,21
28,13,35,400,364,764
17,13,35,243,221,464
13,9,25,205,117,322
1,1,4,2,1,3
21,1,2,15,21,36
13,1,2,9,13,22
24,1,2,22,24,46
4,1,2,4,4,8
20,1,2,20,20,40
7,1,2,4,7,11
17,1,4,41,17,58
5,1,4,12,5,17
6,2,5,17,12,29
18,2,5,50,36,86
14,2,5,39,28,67
1,461,742,266,461,727
1,1482,2384,735,1482,2217
1,755,1215,241,755,996
2,755,1215,896,1510,2406
1,1482,2384,378,1482,1860
1,755,1215,436,755,1191
2,755,1215,871,1510,2381
2,755,1215,483,1510,1993
1,1482,2384,378,1482,1860
29,2,5,68,58,126
4,2,5,9,8,17
19,2,5,53,38,91
27,2,5,76,54,130
1,3,9,4,3,7
30,3,9,131,90,221
18,2,5,34,36,70
31,2,5,90,62,152
18,2,5,53,36,89
8,2,5,24,16,40
6,4,10,23,24,47
21,4,10,80,84,164
11,2,5,27,22,49
24,2,5,46,48,94
14,2,5,27,28,55
4,2,5,11,8,19
3,2,5,6,6,12
7,2,5,13,14,27
5,2,5,15,10,25
8,2,5,19,16,35
6,2,5,14,12,26
1,4,10,6,4,10
19,2,5,44,38,82
19,2,5,44,38,82
10,2,5,29,20,49
7,2,5,20,14,34
4,3,9,16,12,28
6,3,9,25,18,43
9,3,9,37,27,64
27,2,5,78,54,132
23,2,5,67,46,113
20,2,5,56,40,96
27,2,5,76,54,130
13,2,5,38,26,64
8,2,5,23,16,39
22,2,5,52,44,96
5,2,5,12,10,22
13,7,9,0,91,91
16,7,9,22,112,134
17,7,9,32,119,151
2,7,9,4,14,18
11,7,9,9,77,86
17,7,9,28,119,147
12,7,9,5,84,89
10,3,8,33,30,63
26,3,8,122,78,200
13,8,22,145,104,249
7,8,22,87,56,143
20,8,22,188,160,348
26,8,22,353,208,561
28,8,22,306,224,530
16,8,22,220,128,348
1,8,22,13,8,21
31,9,24,301,279,580
22,9,24,235,198,433
10,9,24,100,90,190
21,9,24,295,189,484
11,9,24,131,99,230
11,9,24,123,99,222
1,9,24,10,9,19
28,9,24,407,252,659
8,9,24,116,72,188
9,13,35,192,117,309
26,13,35,536,338,874
17,13,35,267,221,488
14,13,35,288,182,470
11,13,35,157,143,300
23,13,35,329,299,628
12,13,35,188,156,344
29,13,35,506,377,883
18,13,35,371,234,605
26,13,35,381,338,719
22,13,35,453,286,739
27,13,35,471,351,822
15,13,35,236,195,431
2,13,35,43,26,69
19,13,35,391,247,638
16,13,35,279,208,487
4,13,35,70,52,122
18,13,35,383,234,617
28,13,35,596,364,960
1,13,35,16,13,29
10,13,35,217,130,347
5,13,35,103,65,168
17,13,35,332,221,553
1,13,35,16,13,29
11,13,35,157,143,300
22,13,35,469,286,755
8,13,35,140,104,244
5,13,35,87,65,152
24,13,35,394,312,706
28,21,55,890,588,1478
27,21,55,888,567,1455
1,21,55,32,21,53
27,21,55,591,567,1158
24,42,54,120,1008,1128
13,38,50,150,494,644
4,38,50,46,152,198
1,42,54,5,42,47
27,38,50,41,1026,1067
15,38,50,165,570,735
1,38,50,11,38,49
15,38,50,150,570,720
1,42,54,10,42,52
1,38,50,9,38,47
1,1252,2295,997,1252,2249
1,1252,2295,538,1252,1790
1,1252,2295,951,1252,2203
1,1266,2320,961,1266,2227
2,295,540,252,590,842
1,295,540,207,295,502
3,1266,2320,1909,3798,5707
1,1252,2295,951,1252,2203
1,1266,2320,799,1266,2065
2,308,565,469,616,1085
1,1266,2320,729,1266,1995
1,1266,2320,961,1266,2227
1,308,565,246,308,554
2,1252,2295,1902,2504,4406
1,420,769,318,420,738
1,1252,2295,997,1252,2249
3,2171,3578,1860,6513,8373
1,2171,3578,620,2171,2791
1,487,783,124,487,611
1,1519,2443,606,1519,2125
1,2171,3578,656,2171,2827
2,2171,3578,1884,4342,6226
1,1519,2443,606,1519,2125
1,1555,2443,570,1555,2125
1,2171,3578,1371,2171,3542
2,1519,2443,822,3038,3860
1,1519,2443,411,1519,1930
1,344,540,174,344,518
1,487,783,194,487,681
2,344,540,349,688,1037
1,487,783,171,487,658
1,487,783,194,487,681
3,26,70,128,78,206
29,26,70,992,754,1746
10,26,70,426,260,686
17,3,9,78,51,129
5,3,9,24,15,39
30,1,2,29,30,59
16,1,2,15,16,31
26,1,2,25,26,51
14,13,35,298,182,480
2,1,2,1,2,3
8,2,5,24,16,40
23,1,2,21,23,44
27,13,35,471,351,822
16,13,35,279,208,487
4,1,2,4,4,8
8,1,2,8,8,16
1,1,2,1,1,2
16,2,5,45,32,77
12,2,5,34,24,58
10,2,5,19,20,39
18,2,5,34,36,70
24,1,2,15,24,39
18,1,2,12,18,30
10,1,2,6,10,16
14,1,2,10,14,24
25,9,25,269,225,494
16,9,25,172,144,316
21,1,2,14,21,35
20,1,2,14,20,34
3,1,2,2,3,5
29,1,2,20,29,49
20,1,2,14,20,34
5,1,2,3,5,8
32,1,2,31,32,63
7,1,4,16,7,23
14,1,4,32,14,46
26,1,2,17,26,43
12,1,2,8,12,20
7,2,5,20,14,34
15,2,5,44,30,74
3,1,2,2,3,5
20,1,2,19,20,39
9,1,2,9,9,18
8,1,2,8,8,16
6,1,2,3,6,9
10,1,2,6,10,16
24,1,2,17,24,41
16,1,2,12,16,28
16,9,25,228,144,372
7,2,5,20,14,34
20,2,5,38,40,78
14,2,5,27,28,55
26,1,2,19,26,45
8,1,2,6,8,14
11,1,2,6,11,17
2,1,4,4,2,6
18,2,5,50,36,86
2,2,5,6,4,10
12,2,5,35,24,59
2,2,5,6,4,10
1,461,742,147,461,608
2,1482,2384,803,2964,3767
1,1482,2384,473,1482,1955
3,755,1215,1307,2265,3572
1,755,1215,241,755,996
2,1482,2384,1136,2964,4100
1,45,120,70,45,115
3,59,159,290,177,467
22,2,5,65,44,109
22,2,5,52,44,96
5,4,10,30,20,50
23,4,10,136,92,228
26,2,5,55,52,107
10,2,5,23,20,43
2,2,5,5,4,9
17,2,5,49,34,83
26,2,5,57,52,109
1,2,5,2,2,4
14,7,9,27,98,125
7,7,9,10,49,59
15,7,9,25,105,130
14,7,9,19,98,117
1,7,9,2,7,9
27,7,9,52,189,241
29,7,9,53,203,256
22,7,9,8,154,162
14,7,9,25,98,123
6,7,9,4,42,46
5,3,8,24,15,39
1,3,8,5,3,8
21,3,8,83,63,146
3,3,8,10,9,19
7,3,8,34,21,55
15,3,8,49,45,94
17,3,8,80,51,131
22,3,8,71,66,137
30,8,22,262,240,502
15,8,22,203,120,323
17,8,22,231,136,367
16,8,22,217,128,345
10,8,22,136,80,216
32,8,22,441,256,697
13,9,24,192,117,309
16,9,24,232,144,376
5,9,24,73,45,118
1,13,35,21,13,34
5,13,35,79,65,144
16,13,35,313,208,521
26,13,35,445,338,783
27,13,35,443,351,794
10,13,35,213,130,343
28,13,35,577,364,941
4,13,35,87,52,139
4,13,35,63,52,115
1,13,35,17,13,30
23,13,35,490,299,789
7,13,35,100,91,191
17,13,35,362,221,583
20,13,35,293,260,553
28,13,35,489,364,853
18,13,35,383,234,617
2,13,35,43,26,69
4,13,35,63,52,115
8,21,55,241,168,409
19,21,55,636,399,1035
7,21,55,157,147,304
10,38,50,110,380,490
28,38,50,280,1064,1344
6,38,50,51,228,279
20,42,54,46,840,886
3,38,50,35,114,149
19,38,50,209,722,931
5,42,54,55,210,265
22,38,50,242,836,1078
1,1252,2295,745,1252,1997
3,1252,2295,2647,3756,6403
2,1252,2295,984,2504,3488
1,420,769,341,420,761
1,1266,2320,544,1266,1810
1,1266,2320,1008,1266,2274
1,1266,2320,1008,1266,2274
1,420,769,341,420,761
1,1266,2320,1031,1266,2297
3,1252,2295,2854,3756,6610
2,1266,2320,1134,2532,3666
1,1266,2320,544,1266,1810
2,308,565,491,616,1107
2,2171,3578,2528,4342,6870
1,1519,2443,582,1519,2101
1,2171,3578,763,2171,2934
1,1555,2443,717,1555,2272
1,2171,3578,1157,2171,3328
2,2171,3578,1669,4342,6011
1,713,1120,205,713,918
1,1519,2443,606,1519,2125
1,1519,2443,411,1519,1930
1,2171,3578,620,2171,2791
4,26,70,173,104,277
2,1,2,2,2,4
14,1,2,13,14,27
24,1,2,22,24,46
1,13,35,22,13,35
12,13,35,260,156,416
1,2,5,3,2,5
7,2,5,21,14,35
23,2,5,64,46,110
19,2,5,53,38,91
22,12,33,455,264,719
1,13,35,22,13,35
13,13,35,281,169,450
14,2,5,25,28,53
2,11,30,37,22,59
27,11,30,505,297,802
27,2,5,78,54,132
6,2,5,17,12,29
15,2,5,44,30,74
11,2,5,32,22,54
12,2,5,35,24,59
25,2,5,74,50,124
31,2,5,91,62,153
32,2,5,94,64,158
24,2,5,71,48,119
6,13,35,124,78,202
25,2,5,70,50,120
13,2,5,31,26,57
4,13,35,57,52,109
13,13,35,186,169,355
19,13,35,272,247,519
8,1,2,4,8,12
4,1,2,2,4,6
30,1,2,17,30,47
19,11,30,350,209,559
12,11,30,221,132,353
24,11,30,442,264,706
10,1,4,25,10,35
30,1,4,74,30,104
14,2,5,41,28,69
24,11,30,427,264,691
27,11,30,481,297,778
20,1,2,15,20,35
11,1,4,32,11,43
10,1,4,29,10,39
7,1,4,20,7,27
26,11,29,453,286,739
1,11,29,17,11,28
19,12,33,386,228,614
6,1,2,6,6,12
6,2,5,17,12,29
29,2,5,84,58,142
30,2,5,87,60,147
25,9,25,388,225,613
6,1,4,18,6,24
1,461,742,185,461,646
1,1482,2384,807,1482,2289
3,755,1215,1307,2265,3572
1,1482,2384,568,1482,2050
1,1482,2384,473,1482,1955
12,45,120,886,540,1426
26,45,120,1264,1170,2434
8,2,5,19,16,35
20,2,5,47,40,87
17,2,5,48,34,82
8,2,5,22,16,38
3,2,5,7,6,13
11,2,5,26,22,48
20,2,5,58,40,98
24,2,5,70,48,118
16,2,5,30,32,62
6,2,5,11,12,23
6,2,5,11,12,23
15,2,5,35,30,65
13,2,5,30,26,56
27,2,5,76,54,130
8,2,5,22,16,38
6,4,10,28,24,52
3,4,10,14,12,26
24,2,5,46,48,94
6,2,5,11,12,23
25,2,5,73,50,123
1,2,5,3,2,5
11,2,5,26,22,48
8,2,5,17,16,33
4,2,5,8,8,16
5,2,5,14,10,24
7,2,5,20,14,34
1,2,5,3,2,5
17,3,9,74,51,125
19,3,9,83,57,140
1,2,5,2,2,4
18,2,5,42,36,78
24,2,5,50,48,98
1,2,5,2,2,4
12,7,9,22,84,106
8,7,9,13,56,69
23,7,9,38,161,199
16,7,9,31,112,143
9,7,9,3,63,66
28,7,9,23,196,219
23,7,9,0,161,161
2,7,9,0,14,14
12,7,9,10,84,94
31,7,9,26,217,243
22,7,9,12,154,166
4,3,8,19,12,31
13,3,8,63,39,102
14,3,8,68,42,110
28,3,8,100,84,184
1,8,22,14,8,22
23,8,22,216,184,400
8,8,22,108,64,172
13,8,22,145,104,249
4,8,22,54,32,86
27,8,22,366,216,582
20,8,22,276,160,436
31,8,22,386,248,634
10,9,24,140,90,230
12,9,24,143,108,251
21,13,35,366,273,639
19,13,35,278,247,525
25,13,35,533,325,858
22,13,35,476,286,762
27,13,35,575,351,926
1,13,35,21,13,34
26,13,35,536,338,874
9,13,35,163,117,280
21,13,35,359,273,632
5,13,35,87,65,152
9,13,35,185,117,302
25,13,35,533,325,858
11,13,35,180,143,323
10,13,35,157,130,287
2,13,35,29,26,55
16,13,35,346,208,554
15,13,35,325,195,520
12,13,35,247,156,403
17,13,35,368,221,589
19,13,35,298,247,545
2,13,35,29,26,55
1,21,55,32,21,53
19,21,55,625,399,1024
22,21,55,724,462,1186
11,38,50,121,418,539
2,38,50,20,76,96
9,38,50,59,342,401
6,38,50,60,228,288
17,38,50,94,646,740
8,38,50,88,304,392
2,42,54,23,84,107
10,42,54,34,420,454
24,38,50,276,912,1188
5,42,54,49,210,259
20,38,50,20,760,780
1,1898,3375,1038,1898,2936
3,1266,2320,2884,3798,6682
3,1252,2295,2991,3756,6747
1,1252,2295,722,1252,1974
1,1252,2295,997,1252,2249
1,420,769,318,420,738
3,308,565,703,924,1627
1,295,540,234,295,529
1,308,565,246,308,554
1,295,540,207,295,502
1,420,769,211,420,631
1,1252,2295,561,1252,1813
1,1266,2320,752,1266,2018
1,2171,3578,763,2171,2934
2,2171,3578,2528,4342,6870
3,2171,3578,3792,6513,10305
1,2171,3578,942,2171,3113
1,2171,3578,942,2171,3113
1,487,783,288,487,775
1,487,783,155,487,642
2,2171,3578,1669,4342,6011
1,487,783,108,487,595
2,713,1120,769,1426,2195
3,344,540,361,1032,1393
1,344,540,174,344,518
2,344,540,370,688,1058
1,2171,3578,1335,2171,3506
1,344,540,99,344,443
1,1083,1701,550,1083,1633
26,26,70,1126,676,1802
26,26,70,1108,676,1784
25,26,70,1083,650,1733
24,26,70,1022,624,1646
25,26,70,855,650,1505
1,26,70,43,26,69
26,3,9,151,78,229
28,3,9,133,84,217
13,1,2,7,13,20
24,8,21,246,192,438
1,8,21,8,8,16
1,8,21,8,8,16
15,1,2,14,15,29
29,1,2,28,29,57
12,1,2,12,12,24
19,13,35,411,247,658
13,13,35,281,169,450
6,1,2,4,6,10
16,1,4,45,16,61
21,9,25,331,189,520
1,2,5,3,2,5
1,13,35,17,13,30
9,2,5,26,18,44
2,2,5,6,4,10
10,11,30,151,110,261
3,9,25,40,27,67
22,9,25,292,198,490
1,1,2,1,1,2
6,1,2,4,6,10
1,2,5,3,2,5
19,11,30,241,209,450
10,1,2,9,10,19
22,1,2,20,22,42
4,1,4,8,4,12
4,8,21,49,32,81
29,11,30,490,319,809
19,2,5,55,38,93
8,2,5,23,16,39
6,2,5,17,12,29
26,2,5,73,52,125
4,2,5,11,8,19
28,9,25,420,252,672
26,2,5,77,52,129
3,1,2,3,3,6
11,1,2,11,11,22
1,2,5,3,2,5
8,2,5,23,16,39
7,2,5,15,14,29
26,2,5,55,52,107
28,1,4,64,28,92
1,1482,2384,807,1482,2289
1,1482,2384,401,1482,1883
1,1482,2384,807,1482,2289
2,1482,2384,1184,2964,4148
1,461,742,185,461,646
3,461,742,376,1383,1759
3,1482,2384,2420,4446,6866
1,1482,2384,854,1482,2336
1,1482,2384,378,1482,1860
4,24,64,157,96,253
22,4,10,79,88,167
28,4,10,101,112,213
22,2,5,62,44,106
23,4,10,133,92,225
15,4,10,87,60,147
21,2,5,48,42,90
30,2,5,87,60,147
7,2,5,20,14,34
13,2,5,36,26,62
8,2,5,22,16,38
22,3,9,128,66,194
9,3,9,52,27,79
2,2,5,6,4,10
28,2,5,81,56,137
8,2,5,21,16,37
27,2,5,78,54,132
25,2,5,73,50,123
26,4,10,109,104,213
20,4,10,84,80,164
9,2,5,24,18,42
9,2,5,24,18,42
4,3,9,18,12,30
13,3,9,59,39,98
18,3,9,74,54,128
15,3,9,62,45,107
25,3,9,119,75,194
1,3,9,5,3,8
5,7,9,8,35,43
16,7,9,26,112,138
16,7,9,29,112,141
20,7,9,15,140,155
18,7,9,25,126,151
21,7,9,29,147,176
16,7,9,12,112,124
28,3,8,138,84,222
9,3,8,44,27,71
6,3,8,28,18,46
19,3,8,92,57,149
3,3,8,15,9,24
9,3,8,36,27,63
31,3,8,145,93,238
24,8,22,262,192,454
9,8,22,82,72,154
21,8,22,229,168,397
6,8,22,55,48,103
14,8,22,156,112,268
15,8,22,197,120,317
28,8,22,312,224,536
4,8,22,38,32,70
1,9,24,10,9,19
18,9,24,214,162,376
17,9,24,202,153,355
16,13,35,330,208,538
18,13,35,245,234,479
10,13,35,143,130,273
1,13,35,17,13,30
23,13,35,361,299,660
21,13,35,447,273,720
13,13,35,190,169,359
17,13,35,368,221,589
5,13,35,108,65,173
2,13,35,29,26,55
7,13,35,120,91,211
15,13,35,262,195,457
14,13,35,274,182,456
28,13,35,596,364,960
11,13,35,173,143,316
22,13,35,476,286,762
18,13,35,295,234,529
6,13,35,105,78,183
17,13,35,350,221,571
10,13,35,175,130,305
4,13,35,70,52,122
19,13,35,325,247,572
21,13,35,433,273,706
22,13,35,345,286,631
28,13,35,479,364,843
20,21,55,636,420,1056
1,21,55,33,21,54
15,42,54,67,630,697
15,42,54,148,630,778
20,42,54,13,840,853
6,38,50,33,228,261
3,38,50,33,114,147
23,42,54,115,966,1081
9,42,54,1,378,379
8,42,54,66,336,402
18,38,50,198,684,882
3,38,50,15,114,129
1,1912,3400,774,1912,2686
1,1266,2320,961,1266,2227
1,1252,2295,492,1252,1744
1,1252,2295,607,1252,1859
2,1252,2295,1489,2504,3993
3,1252,2295,1683,3756,5439
1,1266,2320,1008,1266,2274
1,1266,2320,961,1266,2227
1,1252,2295,630,1252,1882
1,295,540,207,295,502
2,1519,2443,1750,3038,4788
1,2171,3578,656,2171,2827
2,1555,2443,1092,3110,4202
3,713,1120,1154,2139,3293
1,2171,3578,656,2171,2827
2,1555,2443,1092,3110,4202
3,1519,2443,1819,4557,6376
1,344,540,185,344,529
1,344,540,185,344,529
1,1555,2443,570,1555,2125
3,713,1120,683,2139,2822
1,344,540,126,344,470
10,26,70,286,260,546
20,26,70,684,520,1204
27,26,70,1169,702,1871
25,1,2,14,25,39
26,1,2,15,26,41
10,1,2,6,10,16
3,2,5,7,6,13
1,2,5,2,2,4
25,1,2,24,25,49
24,1,2,23,24,47
26,1,2,25,26,51
24,12,33,361,288,649
2,13,35,35,26,61
6,2,5,18,12,30
1,2,5,3,2,5
16,2,5,37,32,69
4,2,5,12,8,20
18,2,5,53,36,89
27,13,35,575,351,926
6,13,35,128,78,206
25,11,30,318,275,593
4,11,30,51,44,95
1,2,5,3,2,5
16,2,5,45,32,77
23,12,33,475,276,751
29,1,2,20,29,49
27,2,5,63,54,117
15,1,2,11,15,26
25,1,2,19,25,44
10,11,30,178,110,288
28,11,30,498,308,806
24,11,30,427,264,691
31,2,5,73,62,135
12,12,33,165,144,309
7,12,33,96,84,180
30,8,21,258,240,498
16,8,21,137,128,265
12,8,21,103,96,199
30,1,2,22,30,52
21,8,21,189,168,357
21,2,5,59,42,101
13,2,5,36,26,62
1,2,5,2,2,4
12,2,5,28,24,52
26,2,5,61,52,113
31,2,5,73,62,135
12,2,5,28,24,52
7,2,5,16,14,30
19,1,4,54,19,73
9,2,5,19,18,37
2,461,742,532,922,1454
1,1482,2384,878,1482,2360
1,1482,2384,878,1482,2360
2,1482,2384,1613,2964,4577
3,1482,2384,2420,4446,6866
1,1482,2384,807,1482,2289
1,1482,2384,568,1482,2050
1,755,1215,205,755,960
2,1482,2384,1136,2964,4100
1,1482,2384,568,1482,2050
2,1482,2384,1184,2964,4148
18,24,64,708,432,1140
24,45,120,1685,1080,2765
2,2,5,6,4,10
19,2,5,56,38,94
27,4,10,124,108,232
19,3,9,92,57,149
14,3,9,68,42,110
21,2,5,59,42,101
21,2,5,59,42,101
2,2,5,6,4,10
17,2,5,48,34,82
27,3,9,145,81,226
4,3,9,21,12,33
4,2,5,8,8,16
25,2,5,73,50,123
6,2,5,17,12,29
8,4,10,34,32,66
17,2,5,48,34,82
22,2,5,62,44,106
1,4,10,6,4,10
27,4,10,157,108,265
26,4,10,151,104,255
11,2,5,26,22,48
2,2,5,5,4,9
19,3,9,90,57,147
23,3,9,109,69,178
20,2,5,59,40,99
15,2,5,44,30,74
1,2,5,2,2,4
12,2,5,23,24,47
28,7,9,23,196,219
1,7,9,0,7,7
25,3,8,121,75,196
25,3,8,117,75,192
13,8,22,179,104,283
12,8,22,165,96,261
6,9,24,67,54,121
1,9,24,14,9,23
8,9,24,80,72,152
3,9,24,32,27,59
26,9,24,309,234,543
25,9,24,363,225,588
10,9,24,145,90,235
21,13,35,455,273,728
2,13,35,43,26,69
13,13,35,227,169,396
12,13,35,209,156,365
21,13,35,381,273,654
8,13,35,140,104,244
31,13,35,487,403,890
16,13,35,341,208,549
24,13,35,352,312,664
17,13,35,350,221,571
1,13,35,16,13,29
19,13,35,405,247,652
24,13,35,511,312,823
1,13,35,21,13,34
15,13,35,236,195,431
19,13,35,371,247,618
20,13,35,349,260,609
15,13,35,236,195,431
27,13,35,386,351,737
4,13,35,85,52,137
15,13,35,320,195,515
4,13,35,57,52,109
15,13,35,204,195,399
19,13,35,411,247,658
14,21,55,376,294,670
14,21,55,337,294,631
13,21,55,435,273,708
1,21,55,33,21,54
26,42,54,214,1092,1306
12,42,54,60,504,564
8,38,50,88,304,392
1,38,50,6,38,44
8,38,50,92,304,396
12,42,54,1,504,505
24,38,50,240,912,1152
31,38,50,93,1178,1271
4,42,54,20,168,188
27,38,50,297,1026,1323
32,42,54,349,1344,1693
15,38,50,173,570,743
18,38,50,99,684,783
3,42,54,0,126,126
1,1266,2320,892,1266,2158
3,1266,2320,2257,3798,6055
1,1252,2295,951,1252,2203
3,1252,2295,2854,3756,6610
1,1266,2320,636,1266,1902
1,420,769,318,420,738
1,1266,2320,544,1266,1810
1,1252,2295,630,1252,1882
2,295,540,447,590,1037
2,295,540,468,590,1058
1,1266,2320,961,1266,2227
1,420,769,295,420,715
1,1252,2295,997,1252,2249
3,1266,2320,3023,3798,6821
3,713,1120,1154,2139,3293
1,2171,3578,1264,2171,3435
1,2171,3578,656,2171,2827
1,2171,3578,942,2171,3113
3,1083,1701,731,3249,3980
3,1083,1701,731,3249,3980
2,487,783,310,974,1284
1,713,1120,396,713,1109
1,713,1120,329,713,1042
3,1555,2443,1491,4665,6156
1,1519,2443,606,1519,2125
1,344,540,185,344,529
3,1555,2443,1711,4665,6376
1,344,540,126,344,470
3,487,783,395,1461,1856
1,487,783,288,487,775
3,2171,3578,4006,6513,10519
3,2171,3578,2718,6513,9231
1,713,1120,329,713,1042
2,2171,3578,1240,4342,5582
5,26,70,143,130,273
21,26,70,718,546,1264
19,3,9,92,57,149
3,3,9,18,9,27
7,3,9,41,21,62
29,1,2,28,29,57
12,1,2,12,12,24
15,11,29,200,165,365
7,13,35,149,91,240
10,13,35,213,130,343
22,2,5,64,44,108
29,2,5,84,58,142
6,13,35,130,78,208
20,13,35,433,260,693
26,1,4,74,26,100
31,1,4,88,31,119
16,9,25,172,144,316
24,9,25,258,216,474
27,9,25,290,243,533
20,11,30,374,220,594
13,11,30,243,143,386
24,2,5,56,48,104
16,2,5,30,32,62
23,12,33,346,276,622
19,9,25,252,171,423
14,9,25,186,126,312
22,1,2,15,22,37
7,1,2,5,7,12
31,9,25,442,279,721
27,9,25,385,243,628
5,9,25,71,45,116
9,1,2,8,9,17
4,11,30,54,44,98
4,11,30,54,44,98
22,13,35,384,286,670
13,1,4,35,13,48
26,9,25,410,234,644
5,9,25,79,45,124
15,1,2,14,15,29
25,1,4,74,25,99
15,1,4,44,15,59
9,1,4,27,9,36
18,1,4,53,18,71
6,2,5,17,12,29
17,1,2,16,17,33
24,1,4,55,24,79
17,1,4,39,17,56
24,2,5,70,48,118
12,2,5,35,24,59
12,2,5,35,24,59
13,2,5,38,26,64
19,2,5,45,38,83
2,11,30,37,22,59
7,11,30,129,77,206
14,11,30,258,154,412
28,1,4,68,28,96
18,1,2,15,18,33
23,1,2,20,23,43
22,1,2,19,22,41
26,2,5,55,52,107
25,1,4,73,25,98
2,1,4,6,2,8
24,1,2,13,24,37
8,9,25,80,72,152
29,9,25,290,261,551
20,2,5,38,40,78
24,2,5,46,48,94
28,8,21,352,224,576
16,1,4,40,16,56
20,1,2,19,20,39
28,1,2,27,28,55
3,2,5,8,6,14
9,2,5,25,18,43
2,1482,2384,1184,2964,4148
3,1482,2384,1204,4446,5650
1,461,742,185,461,646
1,1482,2384,878,1482,2360
1,1482,2384,807,1482,2289
1,755,1215,436,755,1191
1,1482,2384,854,1482,2336
1,755,1215,168,755,923
1,1482,2384,854,1482,2336
10,24,64,394,240,634
1,59,159,97,59,156
1,2,5,3,2,5
14,4,10,83,56,139
17,3,9,96,51,147
30,2,5,57,60,117
14,2,5,27,28,55
10,2,5,29,20,49
2,2,5,6,4,10
12,2,5,35,24,59
14,4,10,81,56,137
8,2,5,23,16,39
1,2,5,3,2,5
22,3,9,88,66,154
13,3,9,52,39,91
28,2,5,59,56,115
7,2,5,15,14,29
16,4,10,93,64,157
16,4,10,93,64,157
15,2,5,44,30,74
26,2,5,75,52,127
8,2,5,24,16,40
16,2,5,47,32,79
18,2,5,42,36,78
30,2,5,66,60,126
26,2,5,57,52,109
14,2,5,33,28,61
14,2,5,33,28,61
22,7,9,40,154,194
9,7,9,17,63,80
28,7,9,53,196,249
2,7,9,4,14,18
21,7,9,34,147,181
27,7,9,1,189,190
1,7,9,1,7,8
9,7,9,16,63,79
14,3,8,62,42,104
4,3,8,16,12,28
23,3,8,91,69,160
20,3,8,74,60,134
20,3,8,74,60,134
29,8,22,317,232,549
4,8,22,40,32,72
3,8,22,41,24,65
11,8,22,149,88,237
20,8,22,210,160,370
25,8,22,339,200,539
7,8,22,95,56,151
25,8,22,229,200,429
29,9,24,338,261,599
8,9,24,116,72,188
20,9,24,194,180,374
17,13,35,362,221,583
22,13,35,376,286,662
18,13,35,314,234,548
28,13,35,606,364,970
6,13,35,103,78,181
7,13,35,144,91,235
3,13,35,62,39,101
23,13,35,474,299,773
19,13,35,332,247,579
22,13,35,469,286,755
11,13,35,234,143,377
24,13,35,511,312,823
11,13,35,157,143,300
7,13,35,100,91,191
2,13,35,40,26,66
8,13,35,126,104,230
23,13,35,401,299,700
1,13,35,22,13,35
26,13,35,463,338,801
17,13,35,267,221,488
32,13,35,626,416,1042
25,13,35,358,325,683
21,13,35,344,273,617
24,13,35,377,312,689
8,21,55,175,168,343
5,21,55,167,105,272
13,21,55,428,273,701
22,21,55,579,462,1041
18,42,54,197,756,953
2,42,54,23,84,107
14,38,50,70,532,602
16,42,54,36,672,708
14,38,50,14,532,546
14,42,54,2,588,590
18,38,50,99,684,783
21,38,50,32,798,830
18,42,54,99,756,855
1,1912,3400,774,1912,2686
1,1266,2320,752,1266,2018
2,1252,2295,1352,2504,3856
2,1252,2295,1994,2504,4498
1,1266,2320,1008,1266,2274
1,1266,2320,1008,1266,2274
2,1252,2295,1994,2504,4498
1,420,769,318,420,738
1,420,769,180,420,600
3,1252,2295,2854,3756,6610
1,308,565,234,308,542
3,420,769,747,1260,2007
1,295,540,234,295,529
1,1266,2320,636,1266,1902
1,308,565,251,308,559
3,308,565,568,924,1492
1,1083,1701,499,1083,1582
1,1555,2443,546,1555,2101
1,1083,1701,244,1083,1327
1,1555,2443,570,1555,2125
2,1519,2443,1213,3038,4251
1,344,540,185,344,529
1,344,540,110,344,454
14,26,70,400,364,764
4,26,70,137,104,241
27,3,9,157,81,238
4,2,5,8,8,16
1,2,5,2,2,4
11,1,2,11,11,22
6,1,2,6,6,12
9,1,2,9,9,18
26,1,2,25,26,51
20,1,2,14,20,34
9,1,2,6,9,15
19,1,2,19,19,38
22,1,2,16,22,38
19,2,5,53,38,91
32,2,5,90,64,154
23,2,5,64,46,110
15,13,35,320,195,515
16,13,35,341,208,549
2,2,5,4,4,8
2,2,5,4,4,8
9,2,5,17,18,35
16,2,5,30,32,62
21,2,5,59,42,101
26,2,5,73,52,125
24,2,5,71,48,119
30,1,4,68,30,98
14,1,4,32,14,46
8,1,2,5,8,13
10,1,2,6,10,16
15,1,2,10,15,25
23,9,25,293,207,500
21,9,25,268,189,457
26,9,25,332,234,566
4,11,30,69,44,113
15,2,5,44,30,74
15,2,5,44,30,74
18,2,5,34,36,70
16,2,5,30,32,62
27,1,4,62,27,89
4,1,4,9,4,13
5,2,5,12,10,22
28,9,25,336,252,588
28,9,25,336,252,588
7,2,5,21,14,35
11,2,5,32,22,54
23,1,4,63,23,86
2,1,2,1,2,3
26,8,21,223,208,431
17,8,21,146,136,282
1,1,4,2,1,3
14,1,4,34,14,48
23,2,5,44,46,90
20,2,5,38,40,78
27,2,5,78,54,132
26,2,5,75,52,127
2,2,5,6,4,10
3,1,4,8,3,11
8,1,4,22,8,30
6,2,5,11,12,23
8,9,25,124,72,196
7,9,25,109,63,172
1,1482,2384,521,1482,2003
2,461,742,354,922,1276
3,1482,2384,1705,4446,6151
1,461,742,185,461,646
2,461,742,532,922,1454
3,24,64,93,72,165
15,24,64,466,360,826
26,24,64,807,624,1431
19,4,10,84,76,160
13,4,10,57,52,109
22,2,5,65,44,109
14,2,5,41,28,69
5,2,5,10,10,20
1,2,5,3,2,5
28,2,5,81,56,137
23,2,5,64,46,110
7,2,5,20,14,34
7,2,5,16,14,30
20,2,5,47,40,87
11,2,5,25,22,47
5,2,5,12,10,22
27,3,9,160,81,241
13,3,9,77,39,116
6,2,5,13,12,25
13,3,9,57,39,96
27,3,9,118,81,199
22,2,5,52,44,96
7,2,5,16,14,30
12,7,9,22,84,106
20,7,9,33,140,173
31,7,9,12,217,229
25,7,9,14,175,189
22,7,9,40,154,194
23,7,9,19,161,180
9,7,9,7,63,70
14,7,9,25,98,123
24,7,9,44,168,212
19,7,9,31,133,164
30,7,9,49,210,259
17,7,9,28,119,147
19,3,8,63,57,120
23,9,24,279,207,486
8,9,24,116,72,188
28,9,24,326,252,578
14,13,35,298,182,480
25,13,35,340,325,665
4,13,35,59,52,111
5,13,35,103,65,168
1,13,35,21,13,34
21,13,35,366,273,639
1,13,35,14,13,27
27,13,35,575,351,926
10,13,35,217,130,347
13,13,35,190,169,359
3,13,35,62,39,101
22,13,35,376,286,662
1,13,35,18,13,31
19,13,35,405,247,652
3,13,35,62,39,101
3,13,35,65,39,104
14,13,35,220,182,402
7,38,50,21,266,287
22,42,54,15,924,939
16,42,54,80,672,752
15,42,54,148,630,778
1,38,50,6,38,44
10,42,54,109,420,529
1,1266,2320,497,1266,1763
1,1252,2295,882,1252,2134
1,420,769,318,420,738
2,1266,2320,1505,2532,4037
1,295,540,234,295,529
2,1252,2295,1994,2504,4498
3,2171,3578,2826,6513,9339
1,487,783,202,487,689
1,344,540,77,344,421
3,487,783,794,1461,2255
3,344,540,523,1032,1555
1,487,783,194,487,681
1,344,540,191,344,535
1,2171,3578,906,2171,3077
1,713,1120,205,713,918
1,1519,2443,900,1519,2419
21,26,70,865,546,1411
5,26,70,213,130,343
16,26,70,458,416,874
29,26,70,1235,754,1989
17,26,70,724,442,1166
28,26,70,1193,728,1921
1,3,9,6,3,9
2,3,9,12,6,18
5,1,2,5,5,10
5,1,2,5,5,10
8,2,5,23,16,39
7,2,5,20,14,34
22,1,2,11,22,33
17,1,2,9,17,26
8,1,2,7,8,15
1,1,2,1,1,2
11,1,2,7,11,18
8,1,2,5,8,13
8,12,33,134,96,230
27,11,30,505,297,802
6,11,30,112,66,178
27,1,4,80,27,107
23,1,4,68,23,91
27,2,5,76,54,130
11,2,5,21,22,43
1,2,5,2,2,4
6,2,5,12,12,24
16,1,4,40,16,56
11,1,4,27,11,38
22,1,2,22,22,44
15,1,2,11,15,26
12,1,2,9,12,21
21,2,5,56,42,98
14,2,5,27,28,55
11,2,5,21,22,43
25,2,5,70,50,120
26,2,5,73,52,125
7,1,4,17,7,24
25,13,35,541,325,866
15,13,35,325,195,520
24,1,4,71,24,95
1,9,25,16,9,25
15,9,25,236,135,371
26,9,25,410,234,644
8,1,2,6,8,14
26,1,2,15,26,41
14,1,2,13,14,27
23,1,2,21,23,44
12,1,2,11,12,23
31,1,2,29,31,60
15,1,4,44,15,59
31,2,5,60,62,122
4,2,5,8,8,16
24,2,5,47,48,95
2,2,5,4,4,8
6,1,4,17,6,23
4,1,4,11,4,15
2,1,2,1,2,3
27,1,2,15,27,42
4,1,2,4,4,8
19,1,4,46,19,65
7,1,4,17,7,24
3,1,2,2,3,5
21,1,2,13,21,34
31,1,2,20,31,51
1,1482,2384,521,1482,2003
1,1482,2384,616,1482,2098
3,1482,2384,2420,4446,6866
1,1482,2384,735,1482,2217
1,1482,2384,854,1482,2336
1,755,1215,290,755,1045
1,1482,2384,854,1482,2336
27,24,64,804,648,1452
9,24,64,354,216,570
5,45,120,363,225,588
22,2,5,46,44,90
11,2,5,23,22,45
20,3,9,97,60,157
19,3,9,92,57,149
18,2,5,34,36,70
29,2,5,55,58,113
6,2,5,11,12,23
11,2,5,21,22,43
22,3,9,100,66,166
16,3,9,73,48,121
14,2,5,27,28,55
12,2,5,23,24,47
4,2,5,9,8,17
15,2,5,35,30,65
26,2,5,60,52,112
19,2,5,44,38,82
10,2,5,29,20,49
4,2,5,12,8,20
12,2,5,34,24,58
7,2,5,20,14,34
19,2,5,36,38,74
15,2,5,29,30,59
4,2,5,12,8,20
27,2,5,76,54,130
10,2,5,28,20,48
30,4,10,126,120,246
18,3,9,105,54,159
4,3,9,23,12,35
25,4,10,140,100,240
16,4,10,90,64,154
20,2,5,59,40,99
1,2,5,3,2,5
22,2,5,46,44,90
15,2,5,32,30,62
27,2,5,63,54,117
3,2,5,7,6,13
16,2,5,34,32,66
27,2,5,57,54,111
2,3,9,11,6,17
30,3,9,169,90,259
26,3,9,107,78,185
22,3,9,90,66,156
24,2,5,70,48,118
13,2,5,38,26,64
24,7,9,3,168,171
19,7,9,0,133,133
21,7,9,34,147,181
9,7,9,5,63,68
11,7,9,9,77,86
10,7,9,7,70,77
19,7,9,35,133,168
26,7,9,3,182,185
1,7,9,2,7,9
30,3,8,119,90,209
16,3,8,52,48,100
7,3,8,28,21,49
26,3,8,101,78,179
13,8,22,176,104,280
21,8,22,211,168,379
8,8,22,73,64,137
6,9,24,74,54,128
29,9,24,428,261,689
15,9,24,211,135,346
30,9,24,421,270,691
1,13,35,14,13,27
25,13,35,533,325,858
8,13,35,131,104,235
19,13,35,332,247,579
7,13,35,100,91,191
9,13,35,195,117,312
18,13,35,295,234,529
21,13,35,447,273,720
15,13,35,236,195,431
20,13,35,286,260,546
5,13,35,103,65,168
19,13,35,411,247,658
27,13,35,575,351,926
5,13,35,107,65,172
24,13,35,394,312,706
11,13,35,227,143,370
4,21,55,88,84,172
26,21,55,684,546,1230
14,21,55,461,294,755
31,42,54,4,1302,1306
28,38,50,280,1064,1344
12,38,50,36,456,492
18,38,50,180,684,864
1,38,50,4,38,42
28,38,50,42,1064,1106
27,42,54,164,1134,1298
14,42,54,32,588,620
2,42,54,22,84,106
4,38,50,40,152,192
15,42,54,10,630,640
1,1252,2295,538,1252,1790
1,1266,2320,636,1266,1902
1,1266,2320,636,1266,1902
1,420,769,180,420,600
1,308,565,184,308,492
1,420,769,249,420,669
1,420,769,318,420,738
1,1266,2320,961,1266,2227
1,1266,2320,961,1266,2227
1,1266,2320,961,1266,2227
1,1266,2320,636,1266,1902
2,1252,2295,1489,2504,3993
2,1555,2443,1678,3110,4788
1,2171,3578,763,2171,2934
1,2171,3578,656,2171,2827
1,2171,3578,656,2171,2827
1,2171,3578,656,2171,2827
1,713,1120,205,713,918
2,344,540,273,688,961
1,2171,3578,1335,2171,3506
3,1555,2443,2371,4665,7036
3,487,783,512,1461,1973
1,2171,3578,1335,2171,3506
2,26,70,66,52,118
4,26,70,126,104,230
15,3,9,60,45,105
13,3,9,57,39,96
10,3,9,46,30,76
19,1,2,11,19,30
28,13,35,459,364,823
15,1,2,11,15,26
20,1,2,15,20,35
23,11,30,430,253,683
27,11,30,505,297,802
7,2,5,20,14,34
1,9,25,11,9,20
26,9,25,280,234,514
31,1,2,30,31,61
11,1,2,11,11,22
17,9,25,196,153,349
10,9,25,115,90,205
6,12,33,88,72,160
21,12,33,309,252,561
1,1,2,1,1,2
26,1,2,17,26,43
2,1,2,1,2,3
8,1,2,4,8,12
31,1,2,20,31,51
7,1,2,4,7,11
11,1,2,8,11,19
17,1,2,13,17,30
1,1,2,1,1,2
22,1,2,20,22,42
13,1,2,12,13,25
22,2,5,64,44,108
4,2,5,12,8,20
24,2,5,70,48,118
8,1,2,7,8,15
8,1,2,7,8,15
16,1,2,10,16,26
21,2,5,40,42,82
26,2,5,49,52,101
27,11,30,335,297,632
27,11,30,335,297,632
18,11,30,337,198,535
28,2,5,69,56,125
23,2,5,56,46,102
10,2,5,25,20,45
14,1,4,32,14,46
8,1,4,18,8,26
14,11,29,179,154,333
31,11,29,396,341,737
20,12,33,407,240,647
17,12,33,346,204,550
19,2,5,45,38,83
25,2,5,59,50,109
28,1,2,20,28,48
21,9,25,221,189,410
8,9,25,84,72,156
1,9,25,11,9,20
21,2,5,62,42,104
23,2,5,68,46,114
17,2,5,49,34,83
29,1,4,63,29,92
2,461,742,236,922,1158
1,461,742,162,461,623
1,461,742,251,461,712
1,1482,2384,878,1482,2360
1,1482,2384,378,1482,1860
1,755,1215,436,755,1191
2,1482,2384,1709,2964,4673
1,1482,2384,854,1482,2336
3,461,742,554,1383,1937
10,24,64,394,240,634
25,24,64,968,600,1568
22,45,120,1597,990,2587
8,59,159,635,472,1107
26,4,10,153,104,257
1,4,10,6,4,10
26,3,9,151,78,229
13,4,10,47,52,99
31,4,10,112,124,236
1,4,10,6,4,10
18,4,10,106,72,178
22,2,5,54,44,98
28,2,5,69,56,125
4,2,5,8,8,16
20,2,5,58,40,98
31,2,5,90,62,152
9,2,5,25,18,43
15,2,5,42,30,72
15,3,9,72,45,117
19,2,5,56,38,94
7,2,5,21,14,35
25,3,9,103,75,178
22,3,9,90,66,156
25,2,5,58,50,108
15,2,5,35,30,65
23,2,5,67,46,113
2,2,5,6,4,10
22,4,10,92,88,180
5,4,10,21,20,41
22,7,9,18,154,172
8,7,9,15,56,71
15,7,9,2,105,107
28,7,9,53,196,249
13,7,9,-2,91,89
21,7,9,0,147,147
17,7,9,6,119,125
30,3,8,107,90,197
10,3,8,40,30,70
21,3,8,83,63,146
7,8,22,95,56,151
26,8,22,244,208,452
30,8,22,407,240,647
26,8,22,290,208,498
16,8,22,178,128,306
25,9,24,309,225,534
7,9,24,98,63,161
11,13,35,192,143,335
3,13,35,62,39,101
18,13,35,245,234,479
4,13,35,87,52,139
6,13,35,92,78,170
23,13,35,417,299,716
22,13,35,384,286,670
12,13,35,209,156,365
24,13,35,352,312,664
23,13,35,329,299,628
24,13,35,469,312,781
27,13,35,556,351,907
17,13,35,362,221,583
17,13,35,267,221,488
9,13,35,185,117,302
19,13,35,298,247,545
5,13,35,87,65,152
6,13,35,94,78,172
1,13,35,17,13,30
1,21,55,24,21,45
8,21,55,180,168,348
26,38,50,299,988,1287
22,38,50,242,836,1078
15,42,54,148,630,778
19,38,50,190,722,912
29,38,50,160,1102,1262
5,38,50,58,190,248
15,42,54,148,630,778
10,38,50,65,380,445
27,42,54,309,1134,1443
5,38,50,55,190,245
18,42,54,90,756,846
6,38,50,66,228,294
24,42,54,16,1008,1024
28,38,50,140,1064,1204
2,1252,2295,1122,2504,3626
1,420,769,241,420,661
1,1252,2295,538,1252,1790
1,1252,2295,745,1252,1997
1,1252,2295,745,1252,1997
2,1266,2320,1922,2532,4454
3,1266,2320,3023,3798,6821
1,1266,2320,729,1266,1995
1,308,565,246,308,554
3,1252,2295,1890,3756,5646
1,2171,3578,1264,2171,3435
3,2171,3578,3792,6513,10305
1,2171,3578,548,2171,2719
1,1519,2443,875,1519,2394
1,1519,2443,655,1519,2174
3,487,783,841,1461,2302
2,1555,2443,750,3110,3860
1,713,1120,284,713,997
1,2171,3578,656,2171,2827
1,713,1120,362,713,1075
1,713,1120,362,713,1075
3,713,1120,1154,2139,3293
1,487,783,265,487,752
2,713,1120,411,1426,1837
1,2171,3578,1335,2171,3506
1,713,1120,205,713,918
9,26,70,371,234,605
30,26,70,1299,780,2079
9,26,70,390,234,624
17,26,70,724,442,1166
21,3,9,124,63,187
11,3,9,64,33,97
3,3,9,17,9,26
2,1,2,1,2,3
21,1,2,12,21,33
14,1,2,14,14,28
11,2,5,32,22,54
19,9,25,242,171,413
26,1,2,17,26,43
1,1,2,1,1,2
26,1,2,19,26,45
23,1,2,17,23,40
7,1,2,5,7,12
6,13,35,130,78,208
20,13,35,433,260,693
1,2,5,2,2,4
14,2,5,27,28,55
10,2,5,19,20,39
6,2,5,18,12,30
5,13,35,79,65,144
22,2,5,42,44,86
14,9,25,151,126,277
31,9,25,333,279,612
26,1,2,19,26,45
26,9,25,345,234,579
5,9,25,66,45,111
16,9,25,212,144,356
2,1,4,6,2,8
29,2,5,68,58,126
23,2,5,54,46,100
18,2,5,52,36,88
11,2,5,32,22,54
21,2,5,48,42,90
26,2,5,60,52,112
29,8,21,334,232,566
6,8,21,69,48,117
24,2,5,56,48,104
8,1,2,6,8,14
8,1,2,6,8,14
12,1,4,35,12,47
7,1,4,20,7,27
20,12,33,295,240,535
11,12,33,162,132,294
6,2,5,14,12,26
12,1,4,27,12,39
7,1,4,16,7,23
23,1,4,68,23,91
25,2,5,53,50,103
20,2,5,42,40,82
19,1,2,18,19,37
10,1,2,10,10,20
1,1,2,1,1,2
2,1482,2384,1184,2964,4148
3,1482,2384,2634,4446,7080
1,461,742,251,461,712
1,1482,2384,807,1482,2289
3,1482,2384,1705,4446,6151
1,1482,2384,854,1482,2336
1,1482,2384,568,1482,2050
1,461,742,229,461,690
1,24,64,39,24,63
9,24,64,251,216,467
22,45,120,1624,990,2614
2,59,159,187,118,305
24,2,5,56,48,104
24,3,9,129,72,201
25,2,5,74,50,124
2,4,10,9,8,17
15,4,10,71,60,131
5,3,9,23,15,38
5,3,9,23,15,38
9,2,5,19,18,37
1,2,5,3,2,5
27,2,5,78,54,132
13,2,5,38,26,64
10,2,5,22,20,42
9,2,5,26,18,44
28,2,5,81,56,137
8,3,9,39,24,63
1,3,9,5,3,8
23,2,5,64,46,110
2,2,5,6,4,10
26,2,5,77,52,129
4,7,9,8,28,36
20,7,9,33,140,173
2,7,9,3,14,17
4,7,9,7,28,35
14,7,9,0,98,98
24,7,9,13,168,181
9,7,9,17,63,80
19,7,9,36,133,169
30,7,9,25,210,235
3,7,9,0,21,21
15,7,9,29,105,134
8,3,8,36,24,60
21,3,8,102,63,165
14,3,8,68,42,110
11,8,22,123,88,211
11,8,22,149,88,237
8,8,22,108,64,172
6,8,22,83,48,131
19,8,22,191,152,343
24,8,22,325,192,517
24,8,22,331,192,523
15,9,24,178,135,313
17,9,24,182,153,335
23,9,24,306,207,513
11,9,24,154,99,253
17,13,35,362,221,583
12,13,35,247,156,403
17,13,35,297,221,518
22,13,35,469,286,755
5,13,35,108,65,173
20,13,35,426,260,686
10,13,35,206,130,336
1,13,35,20,13,33
19,13,35,332,247,579
15,13,35,320,195,515
3,13,35,44,39,83
1,13,35,17,13,30
11,13,35,234,143,377
23,13,35,329,299,628
7,13,35,103,91,194
6,13,35,105,78,183
23,21,55,731,483,1214
5,38,50,50,190,240
12,38,50,66,456,522
8,38,50,80,304,384
11,38,50,127,418,545
16,42,54,80,672,752
2,42,54,10,84,94
18,42,54,206,756,962
5,42,54,55,210,265
1,42,54,1,42,43
3,38,50,35,114,149
15,42,54,10,630,640
27,38,50,297,1026,1323
2,1266,2320,1505,2532,4037
3,1252,2295,2854,3756,6610
3,1266,2320,3092,3798,6890
1,308,565,184,308,492
3,1252,2295,2854,3756,6610
3,420,769,955,1260,2215
1,1252,2295,997,1252,2249
1,1266,2320,1008,1266,2274
1,295,540,240,295,535
1,1266,2320,1008,1266,2274
1,295,540,164,295,459
3,1912,3400,2220,5736,7956
1,2171,3578,1335,2171,3506
1,1083,1701,397,1083,1480
3,1555,2443,2151,4665,6816
1,1555,2443,448,1555,2003
1,487,783,265,487,752
2,1519,2443,822,3038,3860
1,2171,3578,1371,2171,3542
1,1519,2443,411,1519,1930
1,344,540,126,344,470
1,713,1120,396,713,1109
1,2171,3578,620,2171,2791
12,26,70,494,312,806
19,26,70,557,494,1051
24,3,9,109,72,181
16,1,2,14,16,30
3,1,2,3,3,6
7,2,5,20,14,34
7,13,35,149,91,240
28,13,35,596,364,960
12,13,35,256,156,412
17,1,2,12,17,29
3,1,2,2,3,5
29,1,2,20,29,49
6,1,2,6,6,12
2,11,30,30,22,52
8,11,30,121,88,209
21,11,30,317,231,548
9,1,2,9,9,18
1,9,25,11,9,20
23,9,25,247,207,454
16,1,2,15,16,31
22,1,2,21,22,43
20,1,2,19,20,39
26,1,2,25,26,51
2,2,5,6,4,10
8,1,2,6,8,14
21,1,2,13,21,34
24,1,2,23,24,47
17,1,2,16,17,33
27,1,2,26,27,53
10,1,2,10,10,20
22,2,5,52,44,96
1,2,5,3,2,5
26,11,30,346,286,632
14,11,30,186,154,340
32,1,4,87,32,119
6,1,4,16,6,22
14,1,4,33,14,47
1,9,25,13,9,22
21,9,25,268,189,457
19,13,35,312,247,559
13,11,30,231,143,374
27,1,2,19,27,46
4,1,2,4,4,8
26,2,5,75,52,127
1,2,5,2,2,4
2,2,5,4,4,8
1,1,2,1,1,2
21,2,5,62,42,104
16,2,5,47,32,79
9,2,5,27,18,45
22,2,5,65,44,109
3,1,2,2,3,5
26,1,2,19,26,45
26,2,5,75,52,127
23,2,5,67,46,113
10,1,4,25,10,35
21,1,4,52,21,73
27,1,4,79,27,106
15,1,4,44,15,59
6,2,5,11,12,23
6,2,5,17,12,29
25,2,5,70,50,120
1,1482,2384,735,1482,2217
2,1482,2384,1470,2964,4434
1,1482,2384,807,1482,2289
2,461,742,547,922,1469
2,1482,2384,1709,2964,4673
1,1482,2384,854,1482,2336
2,24,64,79,48,127
20,4,10,118,80,198
13,3,9,77,39,116
1,2,5,3,2,5
4,2,5,11,8,19
15,3,9,89,45,134
7,3,9,41,21,62
1,4,10,4,4,8
5,2,5,10,10,20
10,2,5,19,20,39
27,2,5,78,54,132
1,2,5,3,2,5
20,2,5,39,40,79
19,2,5,37,38,75
22,4,10,128,88,216
21,4,10,122,84,206
24,2,5,71,48,119
1,2,5,3,2,5
24,4,10,142,96,238
3,4,10,18,12,30
14,2,5,41,28,69
4,2,5,12,8,20
23,2,5,61,46,107
26,2,5,69,52,121
18,7,9,15,126,141
13,7,9,24,91,115
28,7,9,51,196,247
24,7,9,9,168,177
13,7,9,1,91,92
23,3,8,75,69,144
4,3,8,20,12,32
21,8,22,211,168,379
20,8,22,262,160,422
11,8,22,101,88,189
20,8,22,223,160,383
8,8,22,100,64,164
11,8,22,149,88,237
13,8,22,179,104,283
11,8,22,152,88,240
7,9,24,98,63,161
9,9,24,133,81,214
4,9,24,59,36,95
22,9,24,319,198,517
26,13,35,408,338,746
24,13,35,410,312,722
27,13,35,585,351,936
18,13,35,283,234,517
5,13,35,103,65,168
3,13,35,65,39,104
1,13,35,21,13,34
17,13,35,332,221,553
21,13,35,433,273,706
8,13,35,140,104,244
22,13,35,315,286,601
4,13,35,78,52,130
18,13,35,257,234,491
21,13,35,433,273,706
11,13,35,234,143,377
10,13,35,164,130,294
16,13,35,313,208,521
4,13,35,66,52,118
8,13,35,170,104,274
27,13,35,386,351,737
1,13,35,22,13,35
16,13,35,274,208,482
18,13,35,283,234,517
10,42,54,115,420,535
7,38,50,11,266,277
17,42,54,85,714,799
1,38,50,2,38,40
21,38,50,210,798,1008
12,38,50,60,456,516
2,42,54,10,84,94
1,42,54,4,42,46
12,42,54,118,504,622
12,38,50,138,456,594
8,38,50,40,304,344
3,1266,2320,1909,3798,5707
2,1252,2295,2040,2504,4544
1,1266,2320,752,1266,2018
2,420,769,636,840,1476
1,1252,2295,951,1252,2203
2,1252,2295,1352,2504,3856
3,1266,2320,3023,3798,6821
1,1252,2295,745,1252,1997
1,1252,2295,561,1252,1813
3,1266,2320,3023,3798,6821
1,1252,2295,630,1252,1882
1,1898,3375,1410,1898,3308
2,1083,1701,794,2166,2960
1,713,1120,362,713,1075
3,2171,3578,2289,6513,8802
1,1555,2443,448,1555,2003
2,487,783,561,974,1535
1,1083,1701,244,1083,1327
2,487,783,310,974,1284
1,713,1120,385,713,1098
1,1555,2443,497,1555,2052
1,344,540,77,344,421
2,344,540,154,688,842
3,2171,3578,4114,6513,10627
1,1083,1701,499,1083,1582
1,2171,3578,906,2171,3077
16,26,70,682,416,1098
4,26,70,137,104,241
13,26,70,372,338,710
9,3,9,37,27,64
22,3,9,124,66,190
20,2,5,58,40,98
10,2,5,19,20,39
8,2,5,15,16,31
4,2,5,8,8,16
4,2,5,8,8,16
25,13,35,428,325,753
30,13,35,513,390,903
25,2,5,70,50,120
4,2,5,11,8,19
12,11,29,153,132,285
8,11,29,102,88,190
24,1,2,15,24,39
27,1,2,17,27,44
30,11,30,561,330,891
21,13,35,455,273,728
21,13,35,455,273,728
4,2,5,12,8,20
15,2,5,44,30,74
13,1,4,31,13,44
21,1,2,16,21,37
18,1,2,13,18,31
15,2,5,44,30,74
14,2,5,41,28,69
24,9,25,276,216,492
4,1,2,2,4,6
16,1,2,9,16,25
29,1,2,27,29,56
30,1,2,28,30,58
2,1,2,2,2,4
20,2,5,56,40,96
7,1,2,5,7,12
13,1,2,9,13,22
16,1,2,11,16,27
22,1,2,12,22,34
9,1,2,5,9,14
4,1,2,2,4,6
26,1,2,22,26,48
13,1,2,11,13,24
16,11,30,294,176,470
5,1,4,15,5,20
32,2,5,67,64,131
29,2,5,61,58,119
22,1,2,21,22,43
16,2,5,46,32,78
23,2,5,67,46,113
12,2,5,35,24,59
22,9,25,231,198,429
28,1,4,68,28,96
8,2,5,22,16,38
11,2,5,31,22,53
1,1482,2384,735,1482,2217
1,1482,2384,807,1482,2289
3,461,742,487,1383,1870
1,461,742,229,461,690
18,24,64,467,432,899
7,45,120,508,315,823
25,45,120,1485,1125,2610
4,45,120,281,180,461
3,2,5,9,6,15
2,2,5,6,4,10
15,2,5,42,30,72
2,2,5,6,4,10
28,3,9,150,84,234
3,3,9,16,9,25
27,4,10,127,108,235
21,4,10,82,84,166
20,2,5,58,40,98
5,2,5,15,10,25
13,2,5,31,26,57
25,2,5,59,50,109
31,2,5,59,62,121
17,2,5,39,34,73
31,2,5,71,62,133
14,2,5,41,28,69
6,2,5,17,12,29
7,2,5,16,14,30
18,2,5,44,36,80
19,2,5,47,38,85
26,2,5,69,52,121
1,2,5,3,2,5
1,3,9,4,3,7
27,3,9,109,81,190
27,3,9,109,81,190
17,3,9,68,51,119
21,3,9,100,63,163
6,3,9,28,18,46
4,3,9,23,12,35
22,3,9,124,66,190
27,2,5,63,54,117
20,7,9,27,140,167
12,7,9,20,84,104
7,7,9,11,49,60
24,7,9,0,168,168
12,7,9,22,84,106
17,7,9,0,119,119
13,7,9,10,91,101
15,3,8,59,45,104
13,3,8,42,39,81
3,3,8,10,9,19
22,3,8,106,66,172
22,8,22,298,176,474
16,8,22,217,128,345
23,8,22,312,184,496
25,8,22,279,200,479
12,8,22,110,96,206
14,8,22,190,112,302
22,8,22,303,176,479
12,9,24,143,108,251
12,9,24,174,108,282
28,9,24,407,252,659
25,9,24,363,225,588
28,9,24,326,252,578
1,9,24,10,9,19
20,13,35,433,260,693
5,13,35,79,65,144
13,13,35,190,169,359
26,13,35,554,338,892
27,13,35,575,351,926
23,13,35,490,299,789
9,13,35,185,117,302
18,13,35,308,234,542
19,13,35,332,247,579
31,13,35,487,403,890
7,13,35,122,91,213
2,13,35,39,26,65
20,13,35,412,260,672
6,13,35,124,78,202
26,13,35,454,338,792
28,13,35,606,364,970
22,13,35,430,286,716
2,13,35,39,26,65
11,13,35,234,143,377
18,13,35,383,234,617
9,13,35,195,117,312
13,13,35,186,169,355
9,13,35,185,117,302
24,13,35,394,312,706
3,13,35,62,39,101
19,21,55,604,399,1003
14,21,55,307,294,601
22,21,55,591,462,1053
25,21,55,671,525,1196
18,38,50,198,684,882
7,38,50,77,266,343
2,38,50,20,76,96
6,38,50,51,228,279
23,42,54,251,966,1217
6,38,50,30,228,258
1,38,50,3,38,41
29,42,54,238,1218,1456
11,42,54,126,462,588
11,42,54,90,462,552
3,42,54,10,126,136
1,1252,2295,997,1252,2249
2,1252,2295,1076,2504,3580
1,1252,2295,1020,1252,2272
1,308,565,246,308,554
1,1252,2295,538,1252,1790
1,1252,2295,997,1252,2249
3,1266,2320,1631,3798,5429
1,1266,2320,1008,1266,2274
1,1266,2320,961,1266,2227
1,1266,2320,961,1266,2227
1,1252,2295,882,1252,2134
2,1252,2295,1994,2504,4498
2,2171,3578,1812,4342,6154
1,2171,3578,942,2171,3113
3,487,783,841,1461,2302
1,1555,2443,790,1555,2345
1,1555,2443,790,1555,2345
2,1083,1701,488,2166,2654
2,487,783,482,974,1456
1,713,1120,284,713,997
1,713,1120,161,713,874
1,2171,3578,1371,2171,3542
3,1519,2443,1599,4557,6156
1,344,540,158,344,502
1,713,1120,228,713,941
1,713,1120,362,713,1075
1,344,540,174,344,518
2,344,540,198,688,886
1,487,783,155,487,642
3,2171,3578,1860,6513,8373
1,344,540,126,344,470
22,26,70,629,572,1201
15,26,70,650,390,1040
5,3,9,30,15,45
4,3,9,19,12,31
2,1,2,2,2,4
7,1,2,6,7,13
17,2,5,49,34,83
12,2,5,35,24,59
10,13,35,213,130,343
15,1,2,15,15,30
21,8,21,180,168,348
30,8,21,258,240,498
14,1,2,10,14,24
24,1,2,18,24,42
23,1,2,17,23,40
13,9,25,140,117,257
15,9,25,161,135,296
20,1,2,19,20,39
13,1,2,12,13,25
5,9,25,78,45,123
17,1,2,17,17,34
27,1,2,19,27,46
25,1,2,18,25,43
1,1,2,1,1,2
31,1,4,77,31,108
19,1,4,47,19,66
6,2,5,17,12,29
12,2,5,35,24,59
14,2,5,37,28,65
6,2,5,16,12,28
13,9,25,166,117,283
12,9,25,153,108,261
25,2,5,59,50,109
20,2,5,39,40,79
23,2,5,45,46,91
18,1,4,49,18,67
8,1,4,23,8,31
10,2,5,29,20,49
28,2,5,81,56,137
12,2,5,35,24,59
22,1,2,16,22,38
30,11,30,552,330,882
24,1,2,17,24,41
9,1,2,6,9,15
21,2,5,59,42,101
26,1,2,24,26,50
12,1,2,11,12,23
20,1,2,18,20,38
8,1,2,7,8,15
27,1,2,26,27,53
20,1,2,19,20,39
16,2,5,45,32,77
26,2,5,73,52,125
15,2,5,35,30,65
26,2,5,77,52,129
14,2,5,41,28,69
31,1,2,30,31,61
15,1,4,44,15,59
10,1,4,29,10,39
24,1,2,13,24,37
3,2,5,9,6,15
20,9,25,310,180,490
29,2,5,81,58,139
26,1,2,19,26,45
4,1,2,3,4,7
1,1482,2384,592,1482,2074
1,1482,2384,735,1482,2217
1,1482,2384,878,1482,2360
1,755,1215,241,755,996
2,755,1215,337,1510,1847
30,24,64,1181,720,1901
13,24,64,370,312,682
1,59,159,97,59,156
16,4,10,90,64,154
17,4,10,95,68,163
12,2,5,35,24,59
6,2,5,15,12,27
23,2,5,56,46,102
21,2,5,59,42,101
1,2,5,3,2,5
12,4,10,71,48,119
26,4,10,151,104,255
13,4,10,75,52,127
24,2,5,67,48,115
28,2,5,78,56,134
19,2,5,55,38,93
7,2,5,20,14,34
14,3,9,58,42,100
15,3,9,62,45,107
1,4,10,6,4,10
25,3,9,146,75,221
12,3,9,70,36,106
9,2,5,17,18,35
5,2,5,10,10,20
22,7,9,40,154,194
22,7,9,36,154,190
11,7,9,11,77,88
1,7,9,2,7,9
19,7,9,35,133,168
3,7,9,4,21,25
6,7,9,5,42,47
30,7,9,49,210,259
2,7,9,4,14,18
11,7,9,15,77,92
24,3,8,118,72,190
19,3,8,89,57,146
29,3,8,129,87,216
27,8,22,253,216,469
19,8,22,262,152,414
1,9,24,15,9,24
28,9,24,326,252,578
10,9,24,97,90,187
16,9,24,159,144,303
12,9,24,174,108,282
22,13,35,469,286,755
17,13,35,267,221,488
11,13,35,238,143,381
6,13,35,103,78,181
1,13,35,20,13,33
6,13,35,124,78,202
8,13,35,165,104,269
30,13,35,650,390,1040
17,13,35,350,221,571
1,13,35,17,13,30
15,13,35,293,195,488
1,13,35,14,13,27
5,13,35,86,65,151
19,13,35,405,247,652
26,13,35,454,338,792
1,13,35,17,13,30
28,13,35,479,364,843
5,13,35,87,65,152
5,13,35,87,65,152
3,21,55,99,63,162
25,38,50,288,950,1238
22,42,54,216,924,1140
26,38,50,143,988,1131
8,42,54,5,336,341
12,38,50,66,456,522
23,38,50,253,874,1127
3,1252,2295,1890,3756,5646
1,1266,2320,683,1266,1949
1,1252,2295,722,1252,1974
1,1266,2320,892,1266,2158
1,1252,2295,1020,1252,2272
1,1252,2295,951,1252,2203
2,1252,2295,1902,2504,4406
1,420,769,341,420,761
1,1266,2320,1031,1266,2297
1,1898,3375,1410,1898,3308
1,1898,3375,1005,1898,2903
1,1252,2295,997,1252,2249
1,2171,3578,548,2171,2719
1,2171,3578,1371,2171,3542
1,1519,2443,655,1519,2174
1,344,540,185,344,529
2,2171,3578,1884,4342,6226
1,713,1120,385,713,1098
1,1083,1701,550,1083,1633
1,2171,3578,1335,2171,3506
3,713,1120,784,2139,2923
1,2171,3578,906,2171,3077
2,344,540,252,688,940
12,26,70,520,312,832
16,26,70,626,416,1042
30,26,70,1299,780,2079
11,26,70,469,286,755
1,2,5,2,2,4
24,1,2,24,24,48
12,1,2,12,12,24
7,1,2,4,7,11
16,1,2,9,16,25
4,1,2,2,4,6
5,13,35,108,65,173
6,13,35,130,78,208
10,2,5,23,20,43
17,9,25,183,153,336
9,2,5,24,18,42
25,2,5,66,50,116
28,2,5,74,56,130
11,2,5,29,22,51
14,2,5,37,28,65
12,2,5,32,24,56
8,11,30,114,88,202
24,11,30,341,264,605
21,1,2,20,21,41
23,1,2,22,23,45
10,2,5,28,20,48
5,2,5,14,10,24
26,1,2,18,26,44
4,2,5,12,8,20
16,9,25,228,144,372
14,9,25,200,126,326
26,1,4,76,26,102
8,1,2,4,8,12
19,1,2,11,19,30
22,1,2,12,22,34
6,2,5,13,12,25
5,2,5,11,10,21
20,2,5,42,40,82
20,1,2,18,20,38
8,1,2,7,8,15
4,2,5,9,8,17
30,2,5,69,60,129
27,8,21,340,216,556
4,1,2,4,4,8
14,2,5,33,28,61
5,2,5,12,10,22
19,2,5,55,38,93
6,2,5,17,12,29
21,2,5,61,42,103
1,461,742,185,461,646
1,755,1215,411,755,1166
1,461,742,147,461,608
3,1482,2384,2420,4446,6866
1,461,742,251,461,712
1,755,1215,436,755,1191
1,755,1215,302,755,1057
1,461,742,251,461,712
2,461,742,532,922,1454
13,45,120,647,585,1232
21,2,5,62,42,104
14,2,5,41,28,69
3,3,9,17,9,26
23,3,9,130,69,199
6,2,5,18,12,30
20,2,5,59,40,99
5,2,5,14,10,24
20,2,5,56,40,96
9,2,5,27,18,45
12,2,5,35,24,59
15,2,5,42,30,72
12,3,9,68,36,104
10,3,9,56,30,86
15,2,5,44,30,74
11,2,5,32,22,54
26,2,5,57,52,109
3,2,5,7,6,13
22,3,9,88,66,154
27,3,9,109,81,190
13,3,9,78,39,117
25,3,9,150,75,225
23,3,9,95,69,164
28,3,9,115,84,199
17,2,5,40,34,74
30,2,5,71,60,131
21,2,5,59,42,101
11,2,5,31,22,53
17,3,9,68,51,119
21,3,9,84,63,147
26,7,9,43,182,225
13,7,9,21,91,112
9,7,9,0,63,63
25,7,9,50,175,225
17,3,8,82,51,133
26,3,8,126,78,204
10,3,8,40,30,70
24,8,22,225,192,417
11,8,22,123,88,211
31,8,22,325,248,573
19,8,22,191,152,343
23,9,24,339,207,546
30,9,24,421,270,691
5,13,35,108,65,173
27,13,35,585,351,936
22,13,35,361,286,647
10,13,35,213,130,343
22,13,35,384,286,670
4,13,35,66,52,118
1,13,35,16,13,29
21,13,35,433,273,706
1,13,35,22,13,35
25,13,35,436,325,761
10,13,35,171,130,301
28,21,55,890,588,1478
15,42,54,2,630,632
6,38,50,66,228,294
10,42,54,34,420,454
5,38,50,50,190,240
31,42,54,20,1302,1322
2,1252,2295,2040,2504,4544
3,1898,3375,2305,5694,7999
1,1912,3400,1046,1912,2958
1,1266,2320,961,1266,2227
1,1266,2320,1031,1266,2297
2,295,540,447,590,1037
1,1266,2320,544,1266,1810
1,420,769,318,420,738
3,1252,2295,2991,3756,6747
2,1266,2320,2015,2532,4547
1,2171,3578,1335,2171,3506
1,2171,3578,1264,2171,3435
2,487,783,529,974,1503
1,1555,2443,570,1555,2125
1,487,783,132,487,619
2,26,70,57,52,109
5,26,70,213,130,343
15,26,70,639,390,1029
5,3,9,28,15,43
10,3,9,56,30,86
13,3,9,76,39,115
5,2,5,10,10,20
1,2,5,2,2,4
8,1,4,24,8,32
14,2,5,27,28,55
19,2,5,53,38,91
21,2,5,61,42,103
18,2,5,52,36,88
18,2,5,52,36,88
3,2,5,7,6,13
4,2,5,9,8,17
19,13,35,391,247,638
17,13,35,350,221,571
6,13,35,124,78,202
22,1,2,15,22,37
25,1,2,22,25,47
2,1,2,2,2,4
23,11,30,292,253,545
16,11,30,203,176,379
5,11,30,64,55,119
27,11,30,343,297,640
25,11,30,318,275,593
1,2,5,2,2,4
3,2,5,7,6,13
5,2,5,12,10,22
5,1,2,5,5,10
8,1,2,5,8,13
6,1,2,6,6,12
12,1,4,33,12,45
26,1,4,71,26,97
10,2,5,29,20,49
1,2,5,3,2,5
7,2,5,20,14,34
24,12,33,330,288,618
15,1,4,43,15,58
7,1,4,20,7,27
14,1,4,40,14,54
1,755,1215,411,755,1166
1,1482,2384,878,1482,2360
1,755,1215,241,755,996
1,1482,2384,902,1482,2384
3,461,742,554,1383,1937
12,24,64,372,288,660
17,24,64,452,408,860
10,24,64,285,240,525
28,4,10,165,112,277
14,2,5,41,28,69
26,2,5,77,52,129
3,2,5,7,6,13
22,2,5,52,44,96
23,2,5,44,46,90
23,2,5,44,46,90
21,2,5,59,42,101
4,3,9,21,12,33
1,3,9,4,3,7
18,3,9,74,54,128
16,7,9,9,112,121
10,7,9,0,70,70
5,3,8,25,15,40
16,3,8,79,48,127
24,8,22,331,192,523
6,8,22,79,48,127
18,8,22,169,144,313
13,8,22,131,104,235
5,9,24,59,45,104
9,9,24,126,81,207
4,13,35,57,52,109
2,13,35,43,26,69
17,13,35,368,221,589
11,13,35,238,143,381
28,13,35,400,364,764
5,13,35,72,65,137
21,21,55,506,441,947
10,42,54,34,420,454
1,38,50,1,38,39
27,38,50,311,1026,1337
11,42,54,1,462,463
13,26,70,563,338,901
26,26,70,744,676,1420
27,2,5,51,54,105
21,2,5,40,42,82
24,2,5,46,48,94
29,13,35,415,377,792
19,13,35,272,247,519
3,1,2,3,3,6
11,9,25,173,99,272
28,9,25,441,252,693
18,2,5,32,36,68
10,13,35,217,130,347
23,13,35,498,299,797
17,2,5,50,34,84
17,2,5,50,34,84
18,1,2,12,18,30
29,1,2,20,29,49
6,1,2,4,6,10
1,1,2,1,1,2
6,1,4,14,6,20
16,1,4,38,16,54
24,1,4,71,24,95
18,1,4,53,18,71
22,1,2,14,22,36
15,1,2,10,15,25
17,9,25,264,153,417
11,1,2,7,11,18
17,1,4,50,17,67
7,12,33,142,84,226
4,12,33,81,48,129
26,1,2,17,26,43
19,1,2,12,19,31
1,1,2,1,1,2
31,1,2,21,31,52
22,1,2,15,22,37
5,2,5,15,10,25
8,2,5,23,16,39
11,2,5,32,22,54
16,24,64,456,384,840
1,24,64,39,24,63
12,24,64,342,288,630
9,24,64,233,216,449
9,2,5,27,18,45
21,2,5,62,42,104
26,2,5,75,52,127
1,2,5,3,2,5
11,2,5,25,22,47
19,4,10,110,76,186
13,4,10,75,52,127
19,2,5,44,38,82
12,2,5,28,24,52
16,2,5,37,32,69
18,2,5,41,36,77
4,2,5,7,8,15
27,2,5,49,54,103
8,2,5,24,16,40
11,2,5,32,22,54
24,2,5,71,48,119
23,2,5,68,46,114
8,7,9,15,56,71
15,7,9,12,105,117
16,7,9,29,112,141
22,7,9,42,154,196
27,7,9,52,189,241
1,3,8,4,3,7
22,3,8,73,66,139
2,8,22,22,16,38
5,8,22,68,40,108
21,13,35,455,273,728
23,13,35,393,299,692
18,13,35,390,234,624
12,13,35,256,156,412
1,13,35,21,13,34
5,13,35,107,65,172
10,13,35,206,130,336
27,13,35,424,351,775
8,13,35,162,104,266
7,13,35,152,91,243
8,21,55,254,168,422
3,21,55,67,63,130
12,38,50,132,456,588
16,38,50,184,608,792
6,38,50,66,228,294
6,38,50,69,228,297
9,38,50,23,342,365
22,26,70,675,572,1247
16,1,2,12,16,28
14,1,2,10,14,24
7,1,2,4,7,11
15,1,2,8,15,23
23,1,2,13,23,36
18,13,35,371,234,605
22,13,35,453,286,739
27,1,2,26,27,53
11,1,2,11,11,22
18,1,2,17,18,35
25,1,2,24,25,49
26,1,2,15,26,41
10,1,2,6,10,16
13,2,5,38,26,64
13,2,5,38,26,64
26,2,5,77,52,129
9,2,5,27,18,45
18,1,4,45,18,63
1,1,4,2,1,3
22,1,2,20,22,42
7,1,2,6,7,13
7,1,2,6,7,13
25,9,25,250,225,475
1,9,25,10,9,19
23,2,5,48,46,94
28,2,5,59,56,115
15,2,5,44,30,74
23,2,5,68,46,114
7,2,5,21,14,35
20,1,4,58,20,78
17,1,4,50,17,67
6,8,21,55,48,103
14,2,5,41,28,69
14,1,2,13,14,27
5,9,25,64,45,109
9,9,25,115,81,196
9,2,5,27,18,45
25,2,5,74,50,124
15,4,10,89,60,149
18,4,10,106,72,178
3,3,9,14,9,23
6,2,5,18,12,30
29,4,10,128,116,244
16,4,10,70,64,134
14,7,9,19,98,117
15,7,9,25,105,130
20,7,9,6,140,146
2,7,9,4,14,18
6,7,9,3,42,45
1,3,8,4,3,7
10,8,22,138,80,218
2,8,22,28,16,44
17,8,22,234,136,370
5,8,22,69,40,109
2,8,22,28,16,44
1,8,22,11,8,19
12,9,24,143,108,251
32,13,35,458,416,874
5,13,35,103,65,168
3,13,35,65,39,104
1,13,35,21,13,34
23,13,35,474,299,773
13,13,35,227,169,396
18,13,35,390,234,624
28,13,35,606,364,970
19,13,35,272,247,519
27,13,35,462,351,813
5,13,35,108,65,173
19,13,35,332,247,579
28,21,55,937,588,1525
24,38,50,24,912,936
12,38,50,138,456,594
2,38,50,2,76,78
28,38,50,322,1064,1386
3,42,54,34,126,160
10,26,70,314,260,574
4,1,2,4,4,8
7,1,2,7,7,14
6,1,2,3,6,9
17,13,35,291,221,512
18,13,35,308,234,542
4,13,35,87,52,139
22,2,5,62,44,106
21,2,5,59,42,101
11,2,5,25,22,47
19,2,5,44,38,82
15,2,5,29,30,59
19,1,4,52,19,71
24,1,4,65,24,89
15,1,2,11,15,26
20,1,2,20,20,40
17,1,4,48,17,65
26,1,4,74,26,100
17,1,4,48,17,65
26,1,4,74,26,100
27,1,4,73,27,100
26,1,4,71,26,97
7,2,5,21,14,35
3,1,4,9,3,12
9,1,4,26,9,35
5,11,30,62,55,117
26,11,30,322,286,608
9,8,21,92,72,164
32,8,21,329,256,585
30,2,5,84,60,144
32,2,5,90,64,154
1,2,5,3,2,5
19,1,2,14,19,33
13,1,2,10,13,23
17,24,64,669,408,1077
2,45,120,97,90,187
12,2,5,25,24,49
11,2,5,23,22,45
5,4,10,19,20,39
15,3,9,85,45,130
14,7,9,12,98,110
3,7,9,0,21,21
9,3,8,44,27,71
25,8,22,345,200,545
22,8,22,245,176,421
25,8,22,251,200,451
6,9,24,84,54,138
7,9,24,75,63,138
25,9,24,267,225,492
27,13,35,471,351,822
10,13,35,217,130,347
8,13,35,126,104,230
3,13,35,65,39,104
7,13,35,115,91,206
20,13,35,286,260,546
1,13,35,21,13,34
23,21,55,554,483,1037
23,42,54,3,966,969
16,38,50,88,608,696
17,42,54,167,714,881
6,26,70,247,156,403
22,26,70,752,572,1324
29,26,70,1012,754,1766
4,2,5,12,8,20
15,2,5,44,30,74
13,2,5,31,26,57
23,2,5,54,46,100
4,2,5,9,8,17
21,9,25,252,189,441
6,9,25,72,54,126
24,9,25,276,216,492
22,11,30,332,242,574
4,13,35,59,52,111
27,1,4,80,27,107
24,1,4,71,24,95
22,2,5,64,44,108
18,2,5,52,36,88
25,2,5,73,50,123
30,1,4,74,30,104
24,1,2,24,24,48
26,1,4,63,26,89
25,2,5,53,50,103
3,1,2,2,3,5
20,1,4,43,20,63
10,2,5,21,20,41
5,2,5,12,10,22
1,2,5,2,2,4
10,2,5,27,20,47
21,2,5,40,42,82
27,2,5,51,54,105
3,2,5,9,6,15
19,4,10,72,76,148
6,4,10,23,24,47
16,2,5,38,32,70
15,2,5,35,30,65
20,2,5,56,40,96
6,2,5,18,12,30
23,7,9,38,161,199
12,3,8,58,36,94
24,3,8,95,72,167
1,8,22,10,8,18
1,8,22,11,8,19
21,8,22,289,168,457
17,9,24,202,153,355
11,9,24,107,99,206
18,9,24,261,162,423
1,13,35,16,13,29
3,13,35,43,39,82
27,38,50,311,1026,1337
12,38,50,66,456,522
7,38,50,7,266,273
13,38,50,13,494,507
1,26,70,43,26,69
27,26,70,942,702,1644
3,3,9,13,9,22
2,2,5,6,4,10
2,2,5,6,4,10
6,2,5,17,12,29
32,2,5,90,64,154
20,2,5,56,40,96
8,9,25,100,72,172
20,9,25,250,180,430
7,2,5,21,14,35
14,2,5,41,28,69
7,2,5,20,14,34
11,2,5,32,22,54
7,1,2,4,7,11
6,1,2,6,6,12
24,2,5,64,48,112
8,1,2,7,8,15
20,1,2,18,20,38
18,9,25,284,162,446
26,9,25,410,234,644
22,1,2,15,22,37
5,2,5,15,10,25
18,2,5,52,36,88
9,1,2,7,9,16
4,1,2,3,4,7
12,1,4,27,12,39
22,1,4,50,22,72
14,1,4,32,14,46
19,1,4,43,19,62
23,24,64,729,552,1281
14,24,64,551,336,887
10,59,159,746,590,1336
7,2,5,15,14,29
26,2,5,77,52,129
9,2,5,27,18,45
19,3,9,112,57,169
2,3,9,12,6,18
1,2,5,3,2,5
5,2,5,15,10,25
17,7,9,31,119,150
3,7,9,0,21,21
21,7,9,40,147,187
5,8,22,52,40,92
20,8,22,223,160,383
1,9,24,12,9,21
13,9,24,189,117,306
29,13,35,455,377,832
20,13,35,433,260,693
6,13,35,130,78,208
24,13,35,469,312,781
25,13,35,541,325,866
13,13,35,277,169,446
1,13,35,21,13,34
1,13,35,17,13,30
1,13,35,17,13,30
9,13,35,195,117,312
5,21,55,110,105,215
21,42,54,241,882,1123
2,38,50,2,76,78
27,26,70,772,702,1474
16,26,70,693,416,1109
4,1,2,4,4,8
9,2,5,21,18,39
18,13,35,308,234,542
3,1,4,9,3,12
3,1,4,9,3,12
22,1,4,65,22,87
24,1,4,51,24,75
18,2,5,34,36,70
23,2,5,44,46,90
7,1,2,4,7,11
4,1,2,2,4,6
14,1,2,12,14,26
30,1,2,26,30,56
12,1,2,10,12,22
12,1,4,36,12,48
19,1,4,56,19,75
29,1,4,86,29,115
20,9,25,315,180,495
9,9,25,142,81,223
13,11,30,165,143,308
13,2,5,38,26,64
5,2,5,15,10,25
8,2,5,22,16,38
22,1,4,65,22,87
1,1,4,2,1,3
9,1,4,22,9,31
20,9,25,250,180,430
14,1,4,40,14,54
9,8,21,104,72,176
27,8,21,311,216,527
26,8,21,327,208,535
17,2,5,37,34,71
9,24,64,348,216,564
19,2,5,36,38,74
27,2,5,63,54,117
3,2,5,6,6,12
20,2,5,38,40,78
20,2,5,58,40,98
12,2,5,32,24,56
24,7,9,9,168,177
15,7,9,-2,105,103
24,7,9,33,168,201
2,8,22,27,16,43
15,8,22,203,120,323
5,8,22,69,40,109
27,8,22,247,216,463
4,9,24,40,36,76
20,13,35,314,260,574
18,13,35,390,234,624
1,13,35,14,13,27
3,13,35,47,39,86
10,13,35,196,130,326
15,13,35,215,195,410
2,13,35,29,26,55
14,42,54,9,588,597
11,1,2,7,11,18
7,13,35,103,91,194
14,13,35,205,182,387
3,9,25,32,27,59
4,2,5,12,8,20
25,2,5,74,50,124
5,2,5,11,10,21
7,2,5,15,14,29
24,2,5,50,48,98
7,9,25,70,63,133
12,9,25,138,108,246
11,9,25,127,99,226
8,1,4,22,8,30
5,1,4,14,5,19
21,1,2,16,21,37
13,1,2,12,13,25
6,1,2,6,6,12
1,11,30,15,11,26
14,11,30,207,154,361
4,2,5,12,8,20
31,2,5,91,62,153
11,2,5,21,22,43
11,2,5,21,22,43
10,2,5,30,20,50
23,2,5,68,46,114
24,2,5,70,48,118
2,2,5,6,4,10
6,2,5,17,12,29
7,2,5,20,14,34
6,1,4,13,6,19
10,1,4,21,10,31
3,24,64,116,72,188
24,24,64,760,576,1336
1,24,64,36,24,60
22,2,5,42,44,86
9,2,5,25,18,43
14,2,5,41,28,69
22,2,5,52,44,96
14,2,5,41,28,69
6,2,5,11,12,23
27,2,5,51,54,105
3,2,5,9,6,15
2,2,5,6,4,10
12,4,10,71,48,119
16,4,10,94,64,158
5,2,5,15,10,25
2,7,9,4,14,18
1,7,9,0,7,7
29,7,9,1,203,204
11,7,9,10,77,87
20,8,22,271,160,431
4,8,22,54,32,86
6,8,22,66,48,114
26,8,22,358,208,566
30,8,22,334,240,574
17,9,24,165,153,318
26,13,35,372,338,710
21,13,35,308,273,581
7,13,35,149,91,240
6,13,35,124,78,202
3,13,35,43,39,82
21,13,35,308,273,581
10,13,35,217,130,347
2,13,35,43,26,69
21,13,35,433,273,706
24,13,35,419,312,731
5,13,35,89,65,154
13,13,35,281,169,450
4,13,35,85,52,137
6,13,35,128,78,206
31,13,35,443,403,846
20,13,35,426,260,686
12,13,35,205,156,361
24,21,55,539,504,1043
23,38,50,230,874,1104
7,38,50,11,266,277
19,38,50,219,722,941
24,42,54,107,1008,1115
27,38,50,230,1026,1256
17,3,9,99,51,150
31,3,9,150,93,243
26,1,4,55,26,81
3,1,4,9,3,12
2,1,4,6,2,8
13,1,2,9,13,22
8,2,5,15,16,31
9,2,5,17,18,35
22,11,30,411,242,653
18,11,30,337,198,535
8,11,30,150,88,238
12,13,35,256,156,412
1,13,35,21,13,34
16,2,5,46,32,78
7,1,2,7,7,14
4,2,5,11,8,19
1,2,5,3,2,5
27,2,5,72,54,126
13,9,25,166,117,283
5,9,25,64,45,109
27,9,25,344,243,587
13,2,5,36,26,62
18,2,5,50,36,86
10,1,2,9,10,19
10,1,2,9,10,19
1,1,2,1,1,2
12,1,2,8,12,20
30,1,2,19,30,49
23,2,5,64,46,110
27,9,25,425,243,668
13,9,25,205,117,322
6,9,25,93,54,147
24,9,25,372,216,588
7,2,5,20,14,34
8,1,2,4,8,12
32,1,2,18,32,50
11,2,5,25,22,47
16,2,5,37,32,69
29,1,4,71,29,100
9,1,4,22,9,31
22,1,4,55,22,77
25,1,2,16,25,41
1,1,2,1,1,2
25,2,5,70,50,120
1,2,5,3,2,5
22,8,21,231,176,407
17,8,21,178,136,314
25,1,2,18,25,43
16,8,21,201,128,329
12,1,2,10,12,22
6,1,2,3,6,9
1,1,2,1,1,2
29,1,2,16,29,45
1,1,4,3,1,4
4,1,4,12,4,16
21,1,4,61,21,82
22,24,64,824,528,1352
24,4,10,142,96,238
3,4,10,18,12,30
7,2,5,21,14,35
30,4,10,174,120,294
4,4,10,23,16,39
14,3,9,64,42,106
17,3,9,78,51,129
27,4,10,105,108,213
5,4,10,20,20,40
31,7,9,56,217,273
19,3,8,89,57,146
1,8,22,14,8,22
9,8,22,82,72,154
23,8,22,211,184,395
27,9,24,399,243,642
17,9,24,206,153,359
4,13,35,66,52,118
19,13,35,298,247,545
8,13,35,156,104,260
29,13,35,516,377,893
11,13,35,157,143,300
14,13,35,200,182,382
18,13,35,383,234,617
9,13,35,141,117,258
5,13,35,68,65,133
12,21,55,263,252,515
30,38,50,30,1140,1170
2,38,50,12,76,88
24,3,9,140,72,212
9,3,9,37,27,64
8,2,5,22,16,38
7,2,5,20,14,34
8,11,30,150,88,238
29,1,4,72,29,101
3,1,4,7,3,10
1,9,25,13,9,22
6,9,25,78,54,132
29,1,2,21,29,50
24,1,2,18,24,42
19,1,2,14,19,33
23,1,2,23,23,46
18,1,2,18,18,36
21,2,5,61,42,103
17,2,5,49,34,83
9,2,5,26,18,44
27,11,30,505,297,802
9,1,2,5,9,14
24,1,4,70,24,94
5,1,4,15,5,20
31,8,21,286,248,534
23,8,21,212,184,396
13,1,2,7,13,20
25,1,2,14,25,39
19,1,2,18,19,37
27,1,2,26,27,53
10,8,21,80,80,160
12,45,120,871,540,1411
6,45,120,436,270,706
23,2,5,68,46,114
1,2,5,3,2,5
2,3,9,9,6,15
32,3,9,137,96,233
29,4,10,168,116,284
23,4,10,133,92,225
12,2,5,35,24,59
14,2,5,41,28,69
20,8,22,262,160,422
8,8,22,110,64,174
2,8,22,28,16,44
23,8,22,317,184,501
19,8,22,249,152,401
14,9,24,207,126,333
26,9,24,365,234,599
29,13,35,597,377,974
16,13,35,246,208,454
16,13,35,346,208,554
29,13,35,628,377,1005
9,13,35,185,117,302
31,13,35,541,403,944
2,26,70,87,52,139
20,26,70,572,520,1092
25,3,9,148,75,223
13,8,21,164,104,268
4,8,21,50,32,82
21,8,21,180,168,348
17,8,21,146,136,282
20,8,21,172,160,332
11,2,5,32,22,54
27,2,5,80,54,134
3,2,5,9,6,15
1,2,5,3,2,5
15,1,4,44,15,59
26,1,4,77,26,103
30,1,4,74,30,104
3,1,4,7,3,10
2,1,2,2,2,4
1,2,5,2,2,4
6,2,5,11,12,23
13,2,5,25,26,51
20,1,2,20,20,40
14,1,2,14,14,28
24,1,2,24,24,48
5,1,2,5,5,10
10,2,5,23,20,43
25,2,5,58,50,108
5,1,2,4,5,9
12,2,5,34,24,58
12,2,5,34,24,58
16,2,5,45,32,77
28,2,5,78,56,134
3,1,2,3,3,6
1,1,2,1,1,2
31,1,4,91,31,122
13,1,4,38,13,51
25,8,21,315,200,515
1,8,21,13,8,21
12,1,2,12,12,24
21,1,2,20,21,41
6,1,2,6,6,12
23,8,21,280,184,464
28,8,21,340,224,564
17,24,64,473,408,881
3,3,9,17,9,26
21,2,5,56,42,98
16,7,9,6,112,118
1,3,8,4,3,7
16,3,8,79,48,127
2,8,22,28,16,44
1,9,24,11,9,20
11,13,35,180,143,323
2,13,35,41,26,67
23,13,35,329,299,628
7,13,35,152,91,243
30,13,35,471,390,861
18,13,35,352,234,586
19,13,35,298,247,545
12,13,35,260,156,416
24,38,50,276,912,1188
26,38,50,260,988,1248
14,38,50,154,532,686
16,38,50,88,608,696
13,26,70,563,338,901
12,26,70,419,312,731
18,3,9,82,54,136
15,3,9,89,45,134
17,3,9,100,51,151
21,9,25,252,189,441
25,11,30,468,275,743
8,11,30,150,88,238
9,11,30,168,99,267
32,1,2,18,32,50
17,1,2,10,17,27
11,1,2,6,11,17
25,13,35,489,325,814
8,13,35,156,104,260
5,13,35,98,65,163
18,2,5,53,36,89
25,2,5,74,50,124
2,2,5,6,4,10
23,11,29,387,253,640
18,11,29,303,198,501
10,1,2,6,10,16
28,2,5,83,56,139
7,1,2,4,7,11
9,2,5,21,18,39
22,2,5,52,44,96
29,1,4,86,29,115
5,11,30,76,55,131
8,11,30,121,88,209
4,1,2,4,4,8
8,2,5,15,16,31
27,1,2,15,27,42
4,1,2,2,4,6
30,1,2,17,30,47
28,1,4,80,28,108
6,1,4,17,6,23
1,2,5,2,2,4
5,2,5,15,10,25
12,1,4,35,12,47
9,2,5,26,18,44
8,1,2,8,8,16
22,1,2,22,22,44
26,45,120,1732,1170,2902
9,59,159,886,531,1417
4,59,159,375,236,611
9,2,5,27,18,45
18,2,5,42,36,78
12,2,5,25,24,49
25,2,5,58,50,108
21,2,5,59,42,101
12,7,9,9,84,93
17,7,9,28,119,147
11,3,8,53,33,86
22,8,22,298,176,474
10,9,24,145,90,235
12,13,35,247,156,403
15,13,35,215,195,410
9,13,35,192,117,309
3,13,35,47,39,86
15,13,35,320,195,515
3,13,35,51,39,90
20,42,54,197,840,1037
20,42,54,229,840,1069
20,26,70,866,520,1386
20,26,70,866,520,1386
5,26,70,171,130,301
11,26,70,469,286,755
22,3,9,130,66,196
5,3,9,22,15,37
16,2,5,30,32,62
6,2,5,11,12,23
14,1,2,14,14,28
9,13,35,192,117,309
16,13,35,341,208,549
15,13,35,320,195,515
9,1,2,8,9,17
24,1,2,22,24,46
29,2,5,86,58,144
12,12,33,224,144,368
25,12,33,467,300,767
21,1,2,20,21,41
28,1,2,27,28,55
15,12,33,310,180,490
26,12,33,537,312,849
22,2,5,42,44,86
13,1,2,8,13,21
14,1,2,9,14,23
32,9,25,504,288,792
6,9,25,95,54,149
9,11,30,136,99,235
14,11,30,211,154,365
1,1,4,3,1,4
14,1,4,40,14,54
20,1,4,57,20,77
7,2,5,16,14,30
25,1,4,61,25,86
5,1,4,12,5,17
14,2,5,41,28,69
24,7,9,39,168,207
24,7,9,44,168,212
19,8,22,258,152,410
25,8,22,339,200,539
27,8,22,247,216,463
14,8,22,131,112,243
22,9,24,214,198,412
13,9,24,173,117,290
7,13,35,100,91,191
28,13,35,400,364,764
22,13,35,299,286,585
20,13,35,433,260,693
4,38,50,40,152,192
7,38,50,0,266,266
25,1,2,25,25,50
26,1,2,26,26,52
9,1,2,5,9,14
17,1,2,10,17,27
4,2,5,11,8,19
8,1,2,4,8,12
5,1,2,3,5,8
17,2,5,50,34,84
26,2,5,77,52,129
14,1,4,33,14,47
27,1,4,64,27,91
29,2,5,86,58,144
19,2,5,56,38,94
6,2,5,11,12,23
7,9,25,109,63,172
4,9,25,62,36,98
17,45,120,908,765,1673
4,59,159,387,236,623
4,4,10,16,16,32
11,4,10,43,44,87
4,2,5,9,8,17
1,2,5,2,2,4
7,2,5,15,14,29
11,3,9,64,33,97
19,2,5,36,38,74
3,2,5,6,6,12
13,2,5,30,26,56
13,7,9,1,91,92
26,7,9,3,182,185
15,7,9,11,105,116
5,7,9,2,35,37
29,3,8,113,87,200
18,3,8,60,54,114
5,13,35,73,65,138
14,13,35,230,182,412
24,13,35,511,312,823
7,13,35,100,91,191
18,13,35,245,234,479
13,13,35,227,169,396
23,13,35,329,299,628
15,13,35,215,195,410
8,21,55,210,168,378
7,38,50,7,266,273
13,42,54,9,546,555
8,42,54,92,336,428
1,42,54,5,42,47
3,26,70,124,78,202
7,26,70,274,182,456
8,1,4,24,8,32
7,1,4,21,7,28
24,1,2,23,24,47
14,1,2,13,14,27
3,2,5,9,6,15
19,2,5,56,38,94
24,1,4,71,24,95
31,1,4,92,31,123
32,1,4,95,32,127
4,2,5,8,8,16
15,2,5,29,30,59
3,12,33,62,36,98
1,1,4,2,1,3
22,2,5,64,44,108
3,2,5,9,6,15
19,2,5,56,38,94
23,2,5,54,46,100
1,2,5,2,2,4
2,2,5,4,4,8
15,2,5,29,30,59
3,2,5,6,6,12
12,2,5,23,24,47
21,2,5,40,42,82
27,1,4,64,27,91
2,1,4,5,2,7
29,1,4,66,29,95
19,2,5,53,38,91
7,2,5,20,14,34
24,2,5,67,48,115
12,2,5,35,24,59
17,2,5,49,34,83
14,2,5,41,28,69
2,2,5,6,4,10
1,1,2,1,1,2
10,24,64,298,240,538
1,4,10,6,4,10
13,4,10,75,52,127
14,4,10,59,56,115
10,4,10,42,40,82
30,2,5,84,60,144
3,2,5,8,6,14
17,4,10,90,68,158
2,4,10,11,8,19
11,2,5,21,22,43
28,2,5,81,56,137
3,2,5,9,6,15
1,2,5,3,2,5
27,2,5,78,54,132
18,3,9,72,54,126
17,7,9,14,119,133
17,7,9,31,119,150
31,7,9,26,217,243
20,7,9,0,140,140
14,3,8,68,42,110
11,3,8,53,33,86
6,3,8,29,18,47
25,8,22,339,200,539
13,8,22,162,104,266
20,8,22,262,160,422
29,9,24,282,261,543
21,9,24,249,189,438
15,9,24,221,135,356
14,13,35,220,182,402
24,13,35,520,312,832
5,13,35,103,65,168
29,13,35,496,377,873
11,13,35,157,143,300
16,13,35,313,208,521
12,13,35,260,156,416
4,13,35,68,52,120
10,13,35,157,130,287
1,13,35,16,13,29
4,13,35,57,52,109
24,13,35,419,312,731
15,21,55,494,315,809
12,38,50,120,456,576
6,38,50,6,228,234
9,42,54,30,378,408
19,26,70,809,494,1303
26,3,9,105,78,183
1,2,5,3,2,5
11,1,2,11,11,22
21,1,2,20,21,41
6,1,4,18,6,24
1,1,4,3,1,4
8,2,5,15,16,31
12,2,5,25,24,49
24,1,2,18,24,42
4,1,2,3,4,7
26,13,35,536,338,874
15,13,35,309,195,504
10,1,2,7,10,17
21,1,2,14,21,35
2,13,35,33,26,59
1,1,2,1,1,2
3,2,5,7,6,13
26,1,2,19,26,45
10,2,5,28,20,48
9,2,5,25,18,43
12,1,4,27,12,39
17,1,4,39,17,56
21,1,2,21,21,42
28,2,5,81,56,137
16,2,5,46,32,78
20,2,5,58,40,98
13,8,21,164,104,268
2,8,21,25,16,41
24,1,2,13,24,37
25,1,2,14,25,39
22,1,4,62,22,84
7,1,4,20,7,27
3,2,5,7,6,13
18,2,5,40,36,76
16,3,9,86,48,134
3,3,9,16,9,25
1,2,5,3,2,5
5,2,5,15,10,25
3,2,5,9,6,15
1,3,9,5,3,8
24,2,5,71,48,119
22,2,5,65,44,109
2,7,9,4,14,18
6,7,9,11,42,53
8,7,9,6,56,62
17,7,9,31,119,150
15,8,22,207,120,327
26,8,22,358,208,566
9,9,24,133,81,214
26,9,24,384,234,618
4,9,24,48,36,84
20,13,35,433,260,693
22,13,35,476,286,762
27,13,35,414,351,765
17,13,35,362,221,583
1,13,35,22,13,35
6,13,35,105,78,183
12,13,35,256,156,412
17,21,55,428,357,785
23,42,54,189,966,1155
5,38,50,55,190,245
12,38,50,138,456,594
25,42,54,273,1050,1323
27,26,70,772,702,1474
1,26,70,34,26,60
31,3,9,183,93,276
29,3,9,169,87,256
26,13,35,372,338,710
22,2,5,64,44,108
19,2,5,55,38,93
1,11,30,19,11,30
1,11,30,19,11,30
29,1,2,28,29,57
20,1,2,20,20,40
23,1,2,14,23,37
11,1,2,7,11,18
11,2,5,25,22,47
15,9,25,225,135,360
12,9,25,180,108,288
8,9,25,120,72,192
20,11,30,302,220,522
30,11,30,453,330,783
1,1,2,1,1,2
3,1,2,3,3,6
15,8,21,138,120,258
6,1,2,6,6,12
6,1,2,6,6,12
23,1,2,23,23,46
28,12,33,468,336,804
8,9,25,124,72,196
8,9,25,124,72,196
6,24,64,179,144,323
4,24,64,124,96,220
2,2,5,6,4,10
23,3,9,105,69,174
8,3,9,36,24,60
7,4,10,41,28,69
19,2,5,55,38,93
25,2,5,59,50,109
3,2,5,9,6,15
6,2,5,17,12,29
14,2,5,41,28,69
13,7,9,24,91,115
17,7,9,32,119,151
21,7,9,34,147,181
4,7,9,8,28,36
24,7,9,20,168,188
11,8,22,149,88,237
5,8,22,55,40,95
15,8,22,151,120,271
20,8,22,271,160,431
18,8,22,236,144,380
28,8,22,367,224,591
4,9,24,58,36,94
25,9,24,351,225,576
26,13,35,536,338,874
22,13,35,469,286,755
6,13,35,105,78,183
19,13,35,332,247,579
25,13,35,410,325,735
18,13,35,390,234,624
17,13,35,249,221,470
19,13,35,405,247,652
11,13,35,157,143,300
14,21,55,376,294,670
10,42,54,109,420,529
3,42,54,33,126,159
4,42,54,3,168,171
27,42,54,134,1134,1268
17,42,54,186,714,900
1,38,50,10,38,48
16,42,54,80,672,752
24,26,70,1022,624,1646
20,1,2,20,20,40
20,2,5,56,40,96
10,2,5,28,20,48
24,1,4,60,24,84
28,1,4,69,28,97
24,1,2,14,24,38
25,13,35,436,325,761
18,13,35,314,234,548
19,2,5,55,38,93
2,2,5,6,4,10
26,1,2,17,26,43
19,8,21,191,152,343
19,8,21,191,152,343
26,8,21,262,208,470
19,1,2,13,19,32
25,1,2,17,25,42
3,1,4,9,3,12
8,1,4,23,8,31
27,1,4,77,27,104
28,11,30,356,308,664
15,11,30,191,165,356
17,1,2,11,17,28
28,1,2,27,28,55
29,1,2,28,29,57
29,9,25,457,261,718
25,9,25,394,225,619
7,1,2,6,7,13
28,1,2,26,28,54
26,11,30,463,286,749
3,1,2,2,3,5
4,2,5,8,8,16
20,1,2,12,20,32
30,1,2,17,30,47
11,2,5,21,22,43
31,2,5,59,62,121
5,1,2,5,5,10
15,2,5,42,30,72
28,2,5,53,56,109
1,2,5,2,2,4
6,1,4,17,6,23
10,1,4,28,10,38
28,1,2,21,28,49
15,24,64,562,360,922
10,45,120,738,450,1188
19,4,10,112,76,188
32,4,10,189,128,317
12,4,10,56,48,104
31,2,5,91,62,153
7,2,5,16,14,30
19,2,5,55,38,93
19,2,5,55,38,93
12,2,5,35,24,59
6,2,5,18,12,30
18,7,9,7,126,133
18,7,9,34,126,160
25,7,9,34,175,209
11,7,9,9,77,86
18,3,8,89,54,143
23,3,8,108,69,177
21,3,8,103,63,166
28,8,22,380,224,604
1,8,22,11,8,19
15,9,24,218,135,353
1,9,24,11,9,20
4,13,35,85,52,137
5,13,35,79,65,144
20,13,35,349,260,609
15,13,35,325,195,520
9,13,35,176,117,293
5,13,35,86,65,151
2,13,35,35,26,61
20,13,35,342,260,602
12,13,35,256,156,412
27,13,35,386,351,737
16,21,55,535,336,871
4,38,50,6,152,158
19,38,50,57,722,779
1,26,70,35,26,61
26,2,5,77,52,129
31,2,5,91,62,153
17,2,5,39,34,73
20,1,2,20,20,40
6,1,2,6,6,12
21,1,2,21,21,42
24,13,35,494,312,806
12,13,35,247,156,403
25,13,35,515,325,840
23,9,25,293,207,500
25,9,25,319,225,544
2,9,25,26,18,44
6,8,21,55,48,103
13,8,21,120,104,224
19,1,2,16,19,35
30,1,2,26,30,56
4,1,4,9,4,13
24,1,4,70,24,94
27,2,5,76,54,130
14,2,5,39,28,67
1,2,5,3,2,5
23,1,2,23,23,46
13,1,2,9,13,22
5,1,2,4,5,9
10,1,2,10,10,20
12,1,2,12,12,24
6,1,2,6,6,12
25,11,29,291,275,566
1,11,29,12,11,23
8,2,5,23,16,39
5,2,5,15,10,25
1,2,5,3,2,5
30,1,2,17,30,47
1,2,5,3,2,5
20,2,5,56,40,96
5,24,64,158,120,278
11,3,9,53,33,86
19,2,5,56,38,94
27,2,5,57,54,111
24,2,5,50,48,98
19,2,5,36,38,74
19,2,5,55,38,93
1,4,10,4,4,8
19,4,10,72,76,148
5,7,9,7,35,42
30,7,9,49,210,259
4,3,8,20,12,32
8,3,8,37,24,61
9,8,22,124,72,196
18,8,22,165,144,309
7,8,22,95,56,151
21,8,22,192,168,360
17,8,22,231,136,367
8,8,22,80,64,144
19,8,22,178,152,330
5,9,24,74,45,119
6,9,24,58,54,112
3,9,24,44,27,71
5,9,24,49,45,94
8,13,35,165,104,269
9,13,35,141,117,258
10,13,35,175,130,305
25,13,35,533,325,858
31,13,35,454,403,857
12,13,35,256,156,412
7,13,35,149,91,240
26,13,35,372,338,710
9,13,35,129,117,246
5,13,35,79,65,144
8,13,35,165,104,269
22,21,55,591,462,1053
15,42,54,2,630,632
6,38,50,6,228,234
10,38,50,100,380,480
8,42,54,66,336,402
10,42,54,1,420,421
11,38,50,33,418,451
1,26,70,31,26,57
4,26,70,114,104,218
11,3,9,53,33,86
3,3,9,13,9,22
10,1,2,7,10,17
25,1,2,19,25,44
1,9,25,16,9,25
9,1,2,9,9,18
19,1,2,18,19,37
13,1,2,12,13,25
16,1,2,15,16,31
24,2,5,64,48,112
15,2,5,40,30,70
14,2,5,32,28,60
9,1,2,6,9,15
21,2,5,49,42,91
27,1,4,77,27,104
4,1,4,11,4,15
6,1,4,18,6,24
23,1,4,65,23,88
19,1,4,54,19,73
3,1,2,3,3,6
28,2,5,66,56,122
6,2,5,14,12,26
18,13,35,314,234,548
12,1,2,12,12,24
6,1,2,6,6,12
1,1,2,1,1,2
21,1,2,12,21,33
23,1,2,13,23,36
21,1,4,61,21,82
19,1,4,55,19,74
21,2,5,61,42,103
9,2,5,26,18,44
6,1,2,3,6,9
15,1,2,8,15,23
27,8,21,249,216,465
3,8,21,28,24,52
16,1,4,45,16,61
21,2,5,59,42,101
19,2,5,53,38,91
1,59,159,97,59,156
17,4,10,99,68,167
15,4,10,87,60,147
29,3,9,171,87,258
20,3,9,118,60,178
1,2,5,2,2,4
8,4,10,30,32,62
18,4,10,68,72,140
16,2,5,46,32,78
8,3,9,45,24,69
29,2,5,68,58,126
16,2,5,45,32,77
1,7,9,2,7,9
15,3,8,73,45,118
3,3,8,15,9,24
13,8,22,176,104,280
1,8,22,13,8,21
8,8,22,110,64,174
8,9,24,89,72,161
11,9,24,154,99,253
24,9,24,354,216,570
26,13,35,563,338,901
4,13,35,68,52,120
9,13,35,129,117,246
27,13,35,386,351,737
32,13,35,659,416,1075
12,13,35,205,156,361
20,13,35,328,260,588
32,13,35,682,416,1098
24,13,35,394,312,706
9,13,35,141,117,258
8,21,55,263,168,431
13,38,50,130,494,624
19,38,50,76,722,798
18,38,50,18,684,702
21,38,50,21,798,819
11,38,50,110,418,528
14,42,54,115,588,703
8,3,9,45,24,69
14,1,4,30,14,44
14,1,4,30,14,44
6,1,4,18,6,24
4,2,5,9,8,17
25,1,2,18,25,43
1,1,2,1,1,2
14,1,2,10,14,24
20,11,30,374,220,594
27,11,30,505,297,802
30,1,2,20,30,50
25,2,5,53,50,103
14,2,5,29,28,57
15,13,35,320,195,515
9,13,35,192,117,309
21,9,25,242,189,431
1,1,4,2,1,3
15,1,2,8,15,23
28,1,2,16,28,44
23,9,25,345,207,552
30,9,25,450,270,720
13,1,2,13,13,26
21,1,2,21,21,42
4,2,5,9,8,17
15,2,5,35,30,65
23,2,5,54,46,100
3,2,5,6,6,12
17,11,30,313,187,500
24,11,30,442,264,706
21,11,30,386,231,617
29,2,5,84,58,142
5,2,5,15,10,25
9,1,4,24,9,33
5,1,4,14,5,19
3,12,33,41,36,77
6,12,33,82,72,154
3,1,2,3,3,6
4,1,2,4,4,8
20,3,9,118,60,178
1,3,9,6,3,9
20,4,10,118,80,198
8,4,10,47,32,79
24,4,10,91,96,187
18,4,10,85,72,157
10,7,9,1,70,71
25,7,9,46,175,221
31,7,9,26,217,243
7,7,9,1,49,50
10,7,9,1,70,71
23,7,9,42,161,203
1,3,8,5,3,8
6,3,8,29,18,47
11,3,8,53,33,86
17,8,22,231,136,367
25,9,24,369,225,594
27,13,35,585,351,936
22,13,35,345,286,631
26,42,54,256,1092,1348
14,38,50,154,532,686
3,42,54,33,126,159
2,42,54,22,84,106
21,26,70,615,546,1161
7,26,70,298,182,480
10,2,5,19,20,39
27,13,35,575,351,926
16,13,35,341,208,549
20,13,35,433,260,693
11,1,2,11,11,22
1,1,4,2,1,3
17,1,4,40,17,57
2,1,2,2,2,4
1,1,2,1,1,2
18,2,5,53,36,89
6,2,5,18,12,30
21,1,4,50,21,71
11,1,4,26,11,37
20,9,25,230,180,410
2,9,25,23,18,41
1,1,2,1,1,2
29,1,2,27,29,56
14,1,2,13,14,27
5,1,2,4,5,9
1,1,2,1,1,2
10,1,2,10,10,20
18,2,5,52,36,88
8,4,10,38,32,70
3,2,5,9,6,15
14,4,10,81,56,137
11,2,5,31,22,53
11,4,10,62,44,106
9,4,10,41,36,77
1,4,10,5,4,9
4,2,5,9,8,17
4,7,9,8,28,36
3,7,9,5,21,26
7,7,9,13,49,62
14,3,8,69,42,111
18,8,22,244,144,388
6,8,22,60,48,108
1,8,22,14,8,22
8,8,22,110,64,174
13,8,22,142,104,246
8,9,24,118,72,190
2,9,24,30,18,48
3,9,24,44,27,71
27,13,35,556,351,907
2,13,35,43,26,69
15,13,35,220,195,415
13,13,35,186,169,355
3,13,35,64,39,103
8,13,35,156,104,260
20,13,35,391,260,651
18,13,35,383,234,617
30,21,55,987,630,1617
8,42,54,5,336,341
26,38,50,221,988,1209
1,38,50,11,38,49
25,42,54,273,1050,1323
9,38,50,99,342,441
27,38,50,311,1026,1337
23,26,70,996,598,1594
31,26,70,1212,806,2018
28,26,70,1193,728,1921
18,26,70,779,468,1247
30,3,9,142,90,232
19,3,9,112,57,169
1,3,9,4,3,7
23,2,5,44,46,90
2,2,5,4,4,8
1,1,2,1,1,2
27,1,2,26,27,53
21,12,33,351,252,603
27,1,2,26,27,53
10,2,5,20,20,40
4,2,5,8,8,16
10,2,5,19,20,39
10,1,2,9,10,19
12,1,2,8,12,20
8,1,2,6,8,14
12,1,2,9,12,21
8,2,5,23,16,39
16,11,29,256,176,432
8,11,29,128,88,216
21,11,30,393,231,624
6,2,5,17,12,29
17,2,5,45,34,79
25,2,5,66,50,116
9,1,2,5,9,14
6,1,2,3,6,9
12,2,5,28,24,52
32,2,5,75,64,139
17,24,64,658,408,1066
21,24,64,598,504,1102
1,24,64,37,24,61
2,59,159,143,118,261
3,59,159,224,177,401
21,4,10,124,84,208
24,4,10,142,96,238
22,4,10,92,88,180
22,4,10,92,88,180
4,2,5,12,8,20
29,2,5,84,58,142
10,3,9,59,30,89
14,3,9,83,42,125
31,2,5,71,62,133
26,2,5,60,52,112
18,2,5,53,36,89
1,2,5,3,2,5
11,2,5,32,22,54
28,2,5,81,56,137
10,2,5,28,20,48
9,7,9,16,63,79
1,7,9,0,7,7
16,7,9,31,112,143
6,7,9,10,42,52
9,7,9,3,63,66
20,8,22,276,160,436
22,9,24,246,198,444
19,9,24,276,171,447
6,13,35,88,78,166
10,13,35,217,130,347
13,13,35,281,169,450
32,38,50,176,1216,1392
25,42,54,111,1050,1161
11,38,50,11,418,429
4,42,54,20,168,188
8,38,50,80,304,384
6,26,70,172,156,328
7,26,70,205,182,387
8,3,9,47,24,71
14,13,35,239,182,421
1,13,35,17,13,30
13,1,2,13,13,26
28,1,2,27,28,55
8,9,25,86,72,158
27,9,25,290,243,533
24,2,5,56,48,104
14,12,33,289,168,457
4,9,25,43,36,79
26,1,2,18,26,44
22,1,2,15,22,37
24,1,2,16,24,40
17,1,2,11,17,28
16,1,2,10,16,26
3,1,2,2,3,5
19,1,4,45,19,64
1,1,4,2,1,3
10,1,4,24,10,34
23,2,5,68,46,114
19,2,5,56,38,94
16,1,2,15,16,31
5,2,5,9,10,19
23,2,5,41,46,87
24,1,2,24,24,48
1,1,2,1,1,2
13,1,2,8,13,21
16,1,4,34,16,50
10,1,4,21,10,31
12,8,21,151,96,247
30,8,21,377,240,617
12,12,33,181,144,325
22,12,33,331,264,595
2,59,159,159,118,277
15,2,5,44,30,74
9,2,5,21,18,39
15,3,9,87,45,132
15,2,5,44,30,74
22,7,9,0,154,154
14,7,9,27,98,125
5,7,9,9,35,44
14,7,9,25,98,123
18,3,8,71,54,125
26,3,8,128,78,206
6,8,22,83,48,131
1,8,22,10,8,18
8,9,24,95,72,167
24,9,24,279,216,495
2,13,35,43,26,69
23,13,35,393,299,692
1,13,35,16,13,29
16,13,35,274,208,482
16,13,35,279,208,487
10,13,35,213,130,343
2,21,55,54,42,96
9,38,50,36,342,378
24,42,54,120,1008,1128
5,42,54,55,210,265
27,26,70,1169,702,1871
1,26,70,34,26,60
9,26,70,383,234,617
25,26,70,1083,650,1733
5,3,9,28,15,43
5,8,21,63,40,103
1,8,21,13,8,21
4,1,2,4,4,8
3,2,5,6,6,12
30,2,5,57,60,117
32,1,2,24,32,56
3,1,2,2,3,5
24,2,5,71,48,119
20,1,2,19,20,39
23,1,2,22,23,45
10,1,2,10,10,20
4,1,2,4,4,8
11,1,2,11,11,22
1,1,2,1,1,2
17,2,5,32,34,66
21,2,5,40,42,82
24,2,5,46,48,94
16,2,5,30,32,62
21,1,2,20,21,41
1,1,2,1,1,2
15,1,2,10,15,25
2,1,2,1,2,3
23,2,5,44,46,90
20,9,25,255,180,435
29,9,25,370,261,631
18,1,2,12,18,30
19,1,2,13,19,32
26,2,5,73,52,125
21,2,5,59,42,101
17,1,2,17,17,34
1,1,2,1,1,2
22,1,4,50,22,72
22,2,5,51,44,95
27,2,5,62,54,116
13,2,5,36,26,62
2,2,5,5,4,9
4,2,5,9,8,17
25,2,5,59,50,109
29,2,5,68,58,126
16,2,5,30,32,62
2,2,5,4,4,8
5,2,5,10,10,20
4,2,5,11,8,19
23,2,5,64,46,110
11,2,5,32,22,54
9,24,64,337,216,553
21,4,10,80,84,164
9,2,5,21,18,39
21,2,5,62,42,104
20,2,5,59,40,99
21,2,5,40,42,82
12,7,9,22,84,106
1,7,9,1,7,8
20,7,9,17,140,157
15,7,9,0,105,105
4,3,8,16,12,28
20,3,8,98,60,158
26,8,22,358,208,566
28,8,22,281,224,505
26,8,22,244,208,452
9,9,24,90,81,171
11,13,35,238,143,381
5,13,35,108,65,173
25,13,35,541,325,866
7,13,35,122,91,213
3,13,35,65,39,104
3,13,35,65,39,104
20,13,35,293,260,553
3,38,50,17,114,131
5,42,54,57,210,267
22,38,50,242,836,1078
24,26,70,1022,624,1646
20,3,9,118,60,178
15,1,2,15,15,30
15,1,4,44,15,59
6,1,4,18,6,24
30,1,2,22,30,52
4,1,2,3,4,7
20,2,5,38,40,78
17,2,5,32,34,66
2,2,5,6,4,10
14,2,5,41,28,69
30,13,35,524,390,914
10,13,35,175,130,305
9,2,5,19,18,37
19,2,5,40,38,78
7,2,5,14,14,28
20,2,5,39,40,79
3,11,30,55,33,88
2,2,5,6,4,10
16,2,5,46,32,78
10,2,5,29,20,49
30,2,5,87,60,147
28,2,5,83,56,139
20,2,5,59,40,99
9,2,5,26,18,44
22,1,4,54,22,76
26,1,4,63,26,89
5,24,64,194,120,314
1,59,159,75,59,134
1,59,159,65,59,124
20,4,10,118,80,198
18,4,10,106,72,178
5,2,5,12,10,22
7,2,5,16,14,30
5,2,5,15,10,25
10,2,5,19,20,39
7,2,5,13,14,27
17,2,5,49,34,83
20,2,5,58,40,98
2,2,5,6,4,10
21,2,5,61,42,103
6,7,9,11,42,53
11,7,9,8,77,85
15,3,8,56,45,101
11,8,22,120,88,208
28,8,22,380,224,604
4,8,22,52,32,84
3,8,22,35,24,59
27,8,22,247,216,463
10,8,22,111,80,191
22,9,24,214,198,412
1,13,35,22,13,35
17,13,35,350,221,571
17,13,35,243,221,464
5,13,35,107,65,172
24,13,35,520,312,832
20,13,35,286,260,546
20,13,35,314,260,574
5,13,35,86,65,151
16,42,54,71,672,743
1,38,50,3,38,41
1,38,50,11,38,49
6,42,54,30,252,282
3,42,54,33,126,159
8,42,54,36,336,372
8,26,70,341,208,549
20,1,2,14,20,34
16,2,5,46,32,78
22,2,5,64,44,108
13,2,5,30,26,56
29,2,5,67,58,125
18,1,4,53,18,71
1,1,4,3,1,4
2,11,30,37,22,59
6,11,30,110,66,176
5,2,5,15,10,25
21,2,5,62,42,104
7,1,2,7,7,14
13,1,2,12,13,25
5,1,4,15,5,20
25,1,4,73,25,98
3,1,4,9,3,12
18,1,2,17,18,35
4,1,2,4,4,8
25,1,2,18,25,43
21,2,5,46,42,88
16,12,33,220,192,412
7,2,5,13,14,27
22,8,21,203,176,379
12,8,21,111,96,207
25,1,4,71,25,96
24,8,21,277,192,469
19,8,21,219,152,371
25,8,21,288,200,488
8,8,21,101,64,165
1,8,21,13,8,21
2,8,21,25,16,41
1,9,25,16,9,25
11,9,25,171,99,270
28,2,5,83,56,139
3,2,5,9,6,15
6,2,5,14,12,26
12,2,5,25,24,49
11,7,9,9,77,86
18,7,9,33,126,159
24,7,9,46,168,214
17,8,22,231,136,367
19,8,22,249,152,401
15,9,24,221,135,356
22,9,24,325,198,523
11,9,24,154,99,253
5,9,24,74,45,119
4,9,24,39,36,75
11,9,24,131,99,230
4,9,24,47,36,83
13,13,35,222,169,391
11,13,35,161,143,304
9,13,35,192,117,309
5,13,35,87,65,152
6,13,35,130,78,208
13,13,35,281,169,450
14,13,35,244,182,426
18,13,35,390,234,624
6,13,35,86,78,164
3,38,50,33,114,147
23,38,50,23,874,897
16,38,50,184,608,792
11,26,70,322,286,608
9,26,70,390,234,624
20,1,2,14,20,34
14,1,2,13,14,27
3,9,25,47,27,74
21,1,2,21,21,42
3,1,2,3,3,6
5,1,2,3,5,8
32,1,2,18,32,50
8,11,29,142,88,230
4,1,2,3,4,7
24,1,2,18,24,42
25,1,2,19,25,44
29,9,25,435,261,696
10,9,25,150,90,240
2,1,4,6,2,8
25,9,25,288,225,513
9,1,2,6,9,15
16,1,2,11,16,27
4,9,25,63,36,99
18,1,2,13,18,31
28,1,2,21,28,49
29,11,29,371,319,690
14,11,29,179,154,333
23,8,21,198,184,382
12,8,21,151,96,247
15,1,4,37,15,52
14,1,4,35,14,49
23,8,21,289,184,473
3,1,2,2,3,5
7,24,64,262,168,430
3,45,120,178,135,313
14,4,10,55,56,111
23,4,10,90,92,182
28,4,10,157,112,269
23,4,10,136,92,228
18,2,5,42,36,78
1,2,5,2,2,4
3,2,5,5,6,11
10,2,5,18,20,38
28,2,5,66,56,122
14,2,5,41,28,69
29,2,5,86,58,144
28,2,5,83,56,139
20,2,5,59,40,99
15,7,9,6,105,111
2,7,9,0,14,14
26,8,22,290,208,498
21,8,22,183,168,351
8,8,22,87,64,151
4,8,22,55,32,87
28,8,22,386,224,610
29,9,24,345,261,606
25,9,24,297,225,522
29,13,35,425,377,802
14,13,35,288,182,470
7,13,35,100,91,191
14,13,35,288,182,470
6,13,35,130,78,208
29,13,35,394,377,771
22,13,35,469,286,755
7,13,35,152,91,243
18,13,35,283,234,517
21,13,35,447,273,720
26,13,35,454,338,792
13,21,55,435,273,708
13,38,50,20,494,514
19,38,50,105,722,827
25,42,54,125,1050,1175
24,38,50,120,912,1032
3,38,50,33,114,147
1,42,54,1,42,43
16,26,70,682,416,1098
9,1,2,9,9,18
18,1,2,17,18,35
18,2,5,34,36,70
27,1,2,19,27,46
5,1,2,4,5,9
1,2,5,3,2,5
11,2,5,31,22,53
26,2,5,77,52,129
2,2,5,6,4,10
19,2,5,56,38,94
27,1,2,15,27,42
16,1,4,47,16,63
4,1,2,3,4,7
27,1,2,18,27,45
24,2,5,71,48,119
19,2,5,56,38,94
21,2,5,62,42,104
8,2,5,22,16,38
4,2,5,11,8,19
28,1,2,27,28,55
32,1,2,31,32,63
1,1,2,1,1,2
12,1,2,8,12,20
13,1,4,32,13,45
1,1,2,1,1,2
19,1,2,17,19,36
27,1,2,24,27,51
27,2,5,57,54,111
16,2,5,34,32,66
10,1,4,27,10,37
15,1,4,41,15,56
16,1,4,35,16,51
21,12,33,427,252,679
8,12,33,163,96,259
10,1,2,10,10,20
27,1,2,16,27,43
1,1,2,1,1,2
31,2,5,87,62,149
20,2,5,56,40,96
4,2,5,11,8,19
10,45,120,666,450,1116
16,45,120,1123,720,1843
14,4,10,83,56,139
27,4,10,159,108,267
16,2,5,46,32,78
16,2,5,46,32,78
14,2,5,33,28,61
24,4,10,110,96,206
8,4,10,37,32,69
9,2,5,26,18,44
32,2,5,93,64,157
22,2,5,64,44,108
11,7,9,20,77,97
26,7,9,3,182,185
13,7,9,25,91,116
5,3,8,25,15,40
25,3,8,99,75,174
6,8,22,81,48,129
18,8,22,248,144,392
24,9,24,354,216,570
10,13,35,213,130,343
2,13,35,35,26,61
21,13,35,330,273,603
9,13,35,192,117,309
10,13,35,217,130,347
28,38,50,322,1064,1386
8,38,50,88,304,392
22,42,54,252,924,1176
5,42,54,57,210,267
4,42,54,44,168,212
15,42,54,123,630,753
1,38,50,3,38,41
22,26,70,953,572,1525
15,26,70,639,390,1029
10,26,70,286,260,546
27,1,2,20,27,47
14,11,30,262,154,416
5,11,30,94,55,149
30,9,25,473,270,743
9,1,2,9,9,18
13,1,2,13,13,26
11,1,2,11,11,22
11,1,4,27,11,38
19,9,25,271,171,442
26,9,25,371,234,605
5,2,5,15,10,25
7,2,5,16,14,30
4,2,5,12,8,20
31,2,5,91,62,153
19,1,2,19,19,38
11,1,2,11,11,22
20,11,30,368,220,588
2,11,30,37,22,59
17,1,2,13,17,30
25,1,2,19,25,44
31,8,21,396,248,644
9,8,21,115,72,187
26,2,5,49,52,101
1,2,5,3,2,5
3,2,5,8,6,14
1,2,5,2,2,4
21,2,5,40,42,82
13,2,5,25,26,51
27,4,10,124,108,232
26,4,10,120,104,224
1,2,5,3,2,5
13,2,5,38,26,64
10,2,5,30,20,50
16,7,9,12,112,124
18,7,9,34,126,160
17,3,8,84,51,135
8,8,22,87,64,151
1,9,24,10,9,19
17,9,24,202,153,355
2,13,35,43,26,69
30,13,35,639,390,1029
8,13,35,114,104,218
23,13,35,498,299,797
14,13,35,205,182,387
11,13,35,192,143,335
5,21,55,167,105,272
16,21,55,421,336,757
18,38,50,207,684,891
9,38,50,104,342,446
6,42,54,4,252,256
25,42,54,111,1050,1161
19,38,50,190,722,912
22,3,9,90,66,156
24,2,5,70,48,118
21,2,5,61,42,103
1,2,5,3,2,5
1,1,2,1,1,2
1,1,2,1,1,2
30,13,35,650,390,1040
6,13,35,130,78,208
23,13,35,393,299,692
13,13,35,222,169,391
24,2,5,70,48,118
22,2,5,64,44,108
18,1,4,45,18,63
20,1,4,59,20,79
1,1,2,1,1,2
12,1,2,7,12,19
24,8,21,206,192,398
25,2,5,59,50,109
19,1,2,14,19,33
3,1,2,2,3,5
13,1,2,9,13,22
10,1,2,6,10,16
4,1,2,2,4,6
31,1,2,30,31,61
17,1,2,17,17,34
1,1,2,1,1,2
7,1,2,6,7,13
27,1,2,20,27,47
21,1,2,16,21,37
18,24,64,708,432,1140
10,24,64,310,240,550
23,45,120,1228,1035,2263
6,45,120,335,270,605
6,2,5,18,12,30
13,2,5,38,26,64
12,2,5,23,24,47
11,2,5,21,22,43
19,4,10,110,76,186
18,2,5,52,36,88
27,7,9,52,189,241
23,7,9,42,161,203
3,7,9,6,21,27
16,7,9,26,112,138
18,7,9,0,126,126
23,3,8,75,69,144
8,3,8,28,24,52
16,3,8,63,48,111
12,3,8,39,36,75
5,3,8,24,15,39
24,3,8,116,72,188
29,3,8,140,87,227
19,8,22,258,152,410
1,8,22,14,8,22
14,8,22,193,112,305
21,9,24,295,189,484
26,9,24,259,234,493
30,13,35,639,390,1029
7,13,35,115,91,206
23,13,35,498,299,797
12,13,35,247,156,403
19,13,35,278,247,525
9,13,35,185,117,302
14,13,35,303,182,485
30,13,35,639,390,1029
8,13,35,140,104,244
6,21,55,197,126,323
3,21,55,81,63,144
7,21,55,230,147,377
24,21,55,803,504,1307
17,38,50,187,646,833
25,38,50,288,950,1238
25,38,50,100,950,1050
22,42,54,3,924,927
20,38,50,200,760,960
11,26,70,315,286,601
11,26,70,469,286,755
21,3,9,92,63,155
5,2,5,10,10,20
16,2,5,30,32,62
3,2,5,6,6,12
18,2,5,38,36,74
32,1,2,31,32,63
17,2,5,36,34,70
27,2,5,57,54,111
7,1,2,7,7,14
10,1,2,10,10,20
20,1,4,59,20,79
22,1,4,52,22,74
10,1,4,24,10,34
16,1,4,38,16,54
19,1,4,45,19,64
14,2,5,39,28,67
23,2,5,67,46,113
10,2,5,30,20,50
1,2,5,3,2,5
26,11,29,438,286,724
27,2,5,76,54,130
3,1,2,2,3,5
6,11,30,82,66,148
16,2,5,45,32,77
3,2,5,8,6,14
1,2,5,2,2,4
14,1,2,8,14,22
16,1,2,9,16,25
4,1,2,2,4,6
23,1,2,23,23,46
27,1,2,26,27,53
29,13,35,425,377,802
13,13,35,190,169,359
16,2,5,38,32,70
8,2,5,19,16,35
11,24,64,433,264,697
17,24,64,658,408,1066
